DATE,YEAR,MONTH,DAY, HR ,LUZON,VISAYAS,MINDANAO,PH
1/1/2013,2013,1,1, 1 ,4303,1100,928,6331
1/1/2013,2013,1,1, 2 ,3918,965,819,5702
1/1/2013,2013,1,1, 3 ,3709,903,761,5373
1/1/2013,2013,1,1, 4 ,3529,864,728,5121
1/1/2013,2013,1,1, 5 ,3450,848,731,5029
1/1/2013,2013,1,1, 6 ,3411,815,677,4903
1/1/2013,2013,1,1, 7 ,3240,794,659,4693
1/1/2013,2013,1,1, 8 ,3292,810,673,4775
1/1/2013,2013,1,1, 9 ,3362,835,698,4895
1/1/2013,2013,1,1, 10 ,3461,867,713,5041
1/1/2013,2013,1,1, 11 ,3699,896,748,5343
1/1/2013,2013,1,1, 12 ,3945,942,780,5667
1/1/2013,2013,1,1, 13 ,3921,941,792,5654
1/1/2013,2013,1,1, 14 ,3945,955,800,5700
1/1/2013,2013,1,1, 15 ,3889,948,805,5642
1/1/2013,2013,1,1, 16 ,3861,934,802,5597
1/1/2013,2013,1,1, 17 ,3883,924,798,5605
1/1/2013,2013,1,1, 18 ,4558,1163,969,6690
1/1/2013,2013,1,1, 19 ,4800,1226,1007,7033
1/1/2013,2013,1,1, 20 ,4791,1176,1027,6994
1/1/2013,2013,1,1, 21 ,4668,1120,973,6761
1/1/2013,2013,1,1, 22 ,4406,1034,886,6326
1/1/2013,2013,1,1, 23 ,4075,951,811,5837
1/1/2013,2013,1,1, 24 ,3794,889,766,5449
1/2/2013,2013,1,2, 1 ,3657,863,732,5252
1/2/2013,2013,1,2, 2 ,3545,842,710,5097
1/2/2013,2013,1,2, 3 ,3437,818,690,4945
1/2/2013,2013,1,2, 4 ,3373,808,678,4859
1/2/2013,2013,1,2, 5 ,3418,820,686,4924
1/2/2013,2013,1,2, 6 ,3588,836,711,5135
1/2/2013,2013,1,2, 7 ,3781,850,733,5364
1/2/2013,2013,1,2, 8 ,4375,949,820,6144
1/2/2013,2013,1,2, 9 ,5110,1124,952,7186
1/2/2013,2013,1,2, 10 ,5701,1215,1042,7958
1/2/2013,2013,1,2, 11 ,6011,1253,1083,8347
1/2/2013,2013,1,2, 12 ,5976,1252,1069,8297
1/2/2013,2013,1,2, 13 ,5950,1251,1055,8256
1/2/2013,2013,1,2, 14 ,6115,1271,1082,8468
1/2/2013,2013,1,2, 15 ,6036,1264,1031,8331
1/2/2013,2013,1,2, 16 ,5944,1245,1073,8262
1/2/2013,2013,1,2, 17 ,5676,1209,1082,7967
1/2/2013,2013,1,2, 18 ,6061,1382,1198,8641
1/2/2013,2013,1,2, 19 ,6092,1381,1180,8653
1/2/2013,2013,1,2, 20 ,5874,1325,1129,8328
1/2/2013,2013,1,2, 21 ,5676,1239,1055,7970
1/2/2013,2013,1,2, 22 ,5371,1151,954,7476
1/2/2013,2013,1,2, 23 ,4944,1054,865,6863
1/2/2013,2013,1,2, 24 ,4675,976,794,6445
1/3/2013,2013,1,3, 1 ,4446,907,766,6119
1/3/2013,2013,1,3, 2 ,4273,886,746,5905
1/3/2013,2013,1,3, 3 ,4153,872,733,5758
1/3/2013,2013,1,3, 4 ,4160,871,724,5755
1/3/2013,2013,1,3, 5 ,4213,890,724,5827
1/3/2013,2013,1,3, 6 ,4372,924,780,6076
1/3/2013,2013,1,3, 7 ,4577,927,775,6279
1/3/2013,2013,1,3, 8 ,5075,1010,859,6944
1/3/2013,2013,1,3, 9 ,5810,1175,1026,8011
1/3/2013,2013,1,3, 10 ,6309,1253,1095,8657
1/3/2013,2013,1,3, 11 ,6531,1293,1150,8974
1/3/2013,2013,1,3, 12 ,6446,1263,1151,8860
1/3/2013,2013,1,3, 13 ,6353,1257,1148,8758
1/3/2013,2013,1,3, 14 ,6556,1310,1171,9037
1/3/2013,2013,1,3, 15 ,6403,1303,1159,8865
1/3/2013,2013,1,3, 16 ,6359,1279,1134,8772
1/3/2013,2013,1,3, 17 ,6167,1253,1108,8528
1/3/2013,2013,1,3, 18 ,6454,1422,1233,9109
1/3/2013,2013,1,3, 19 ,6457,1414,1222,9093
1/3/2013,2013,1,3, 20 ,6220,1337,1183,8740
1/3/2013,2013,1,3, 21 ,6010,1264,1116,8390
1/3/2013,2013,1,3, 22 ,5636,1150,995,7781
1/3/2013,2013,1,3, 23 ,5237,1063,891,7191
1/3/2013,2013,1,3, 24 ,4878,993,835,6706
1/4/2013,2013,1,4, 1 ,4734,952,789,6475
1/4/2013,2013,1,4, 2 ,4509,920,769,6198
1/4/2013,2013,1,4, 3 ,4428,888,737,6053
1/4/2013,2013,1,4, 4 ,4349,881,747,5977
1/4/2013,2013,1,4, 5 ,4388,893,769,6050
1/4/2013,2013,1,4, 6 ,4612,934,792,6338
1/4/2013,2013,1,4, 7 ,4715,933,791,6439
1/4/2013,2013,1,4, 8 ,5237,1043,874,7154
1/4/2013,2013,1,4, 9 ,5963,1212,983,8158
1/4/2013,2013,1,4, 10 ,6383,1290,1106,8779
1/4/2013,2013,1,4, 11 ,6686,1342,1135,9163
1/4/2013,2013,1,4, 12 ,6532,1318,1101,8951
1/4/2013,2013,1,4, 13 ,6460,1307,1110,8877
1/4/2013,2013,1,4, 14 ,6624,1355,1143,9122
1/4/2013,2013,1,4, 15 ,6577,1334,1130,9041
1/4/2013,2013,1,4, 16 ,6520,1314,1140,8974
1/4/2013,2013,1,4, 17 ,6209,1260,1099,8568
1/4/2013,2013,1,4, 18 ,6469,1426,1223,9118
1/4/2013,2013,1,4, 19 ,6491,1428,1207,9126
1/4/2013,2013,1,4, 20 ,6235,1372,1174,8781
1/4/2013,2013,1,4, 21 ,6090,1298,1124,8512
1/4/2013,2013,1,4, 22 ,5697,1180,1007,7884
1/4/2013,2013,1,4, 23 ,5421,1082,908,7411
1/4/2013,2013,1,4, 24 ,5044,1008,841,6893
1/5/2013,2013,1,5, 1 ,4807,959,807,6573
1/5/2013,2013,1,5, 2 ,4688,923,781,6392
1/5/2013,2013,1,5, 3 ,4552,906,761,6219
1/5/2013,2013,1,5, 4 ,4421,897,758,6076
1/5/2013,2013,1,5, 5 ,4449,906,770,6125
1/5/2013,2013,1,5, 6 ,4562,916,787,6265
1/5/2013,2013,1,5, 7 ,4536,917,787,6240
1/5/2013,2013,1,5, 8 ,4976,995,843,6814
1/5/2013,2013,1,5, 9 ,5625,1130,939,7694
1/5/2013,2013,1,5, 10 ,6003,1215,1035,8253
1/5/2013,2013,1,5, 11 ,6199,1260,1093,8552
1/5/2013,2013,1,5, 12 ,6148,1234,1088,8470
1/5/2013,2013,1,5, 13 ,6074,1220,1101,8395
1/5/2013,2013,1,5, 14 ,6248,1250,1126,8624
1/5/2013,2013,1,5, 15 ,6130,1220,1110,8460
1/5/2013,2013,1,5, 16 ,6002,1199,1081,8282
1/5/2013,2013,1,5, 17 ,5788,1168,1072,8028
1/5/2013,2013,1,5, 18 ,6231,1365,1232,8828
1/5/2013,2013,1,5, 19 ,6341,1396,1228,8965
1/5/2013,2013,1,5, 20 ,6183,1341,1181,8705
1/5/2013,2013,1,5, 21 ,6061,1274,1145,8480
1/5/2013,2013,1,5, 22 ,5710,1169,1017,7896
1/5/2013,2013,1,5, 23 ,5373,1068,933,7374
1/5/2013,2013,1,5, 24 ,5044,994,858,6896
1/6/2013,2013,1,6, 1 ,4755,946,821,6522
1/6/2013,2013,1,6, 2 ,4642,913,788,6343
1/6/2013,2013,1,6, 3 ,4466,889,766,6121
1/6/2013,2013,1,6, 4 ,4443,872,759,6074
1/6/2013,2013,1,6, 5 ,4404,870,757,6031
1/6/2013,2013,1,6, 6 ,4409,866,764,6039
1/6/2013,2013,1,6, 7 ,4300,854,751,5905
1/6/2013,2013,1,6, 8 ,4459,908,766,6133
1/6/2013,2013,1,6, 9 ,4849,988,831,6668
1/6/2013,2013,1,6, 10 ,5235,1066,893,7194
1/6/2013,2013,1,6, 11 ,5489,1117,951,7557
1/6/2013,2013,1,6, 12 ,5535,1131,944,7610
1/6/2013,2013,1,6, 13 ,5440,1121,940,7501
1/6/2013,2013,1,6, 14 ,5504,1123,928,7555
1/6/2013,2013,1,6, 15 ,5440,1116,929,7485
1/6/2013,2013,1,6, 16 ,5331,1086,933,7350
1/6/2013,2013,1,6, 17 ,5203,1084,965,7252
1/6/2013,2013,1,6, 18 ,5833,1314,1117,8264
1/6/2013,2013,1,6, 19 ,6028,1341,1118,8487
1/6/2013,2013,1,6, 20 ,6042,1305,1076,8423
1/6/2013,2013,1,6, 21 ,5890,1220,992,8102
1/6/2013,2013,1,6, 22 ,5527,1130,860,7517
1/6/2013,2013,1,6, 23 ,5132,1041,818,6991
1/6/2013,2013,1,6, 24 ,4846,967,768,6581
1/7/2013,2013,1,7, 1 ,4564,904,731,6199
1/7/2013,2013,1,7, 2 ,4387,876,718,5981
1/7/2013,2013,1,7, 3 ,4268,854,694,5816
1/7/2013,2013,1,7, 4 ,4273,853,682,5808
1/7/2013,2013,1,7, 5 ,4431,888,740,6059
1/7/2013,2013,1,7, 6 ,4670,950,813,6433
1/7/2013,2013,1,7, 7 ,4811,938,760,6509
1/7/2013,2013,1,7, 8 ,5350,1032,832,7214
1/7/2013,2013,1,7, 9 ,6080,1221,959,8260
1/7/2013,2013,1,7, 10 ,6606,1329,1026,8961
1/7/2013,2013,1,7, 11 ,6967,1394,1095,9456
1/7/2013,2013,1,7, 12 ,6800,1366,1076,9242
1/7/2013,2013,1,7, 13 ,6776,1355,1049,9180
1/7/2013,2013,1,7, 14 ,6913,1358,1089,9360
1/7/2013,2013,1,7, 15 ,6866,1369,1083,9318
1/7/2013,2013,1,7, 16 ,6811,1342,1090,9243
1/7/2013,2013,1,7, 17 ,6510,1298,1107,8915
1/7/2013,2013,1,7, 18 ,6734,1462,1217,9413
1/7/2013,2013,1,7, 19 ,6850,1446,1148,9444
1/7/2013,2013,1,7, 20 ,6647,1370,1097,9114
1/7/2013,2013,1,7, 21 ,6374,1319,1046,8739
1/7/2013,2013,1,7, 22 ,6000,1207,906,8113
1/7/2013,2013,1,7, 23 ,5547,1083,841,7471
1/7/2013,2013,1,7, 24 ,5166,1013,764,6943
1/8/2013,2013,1,8, 1 ,4925,977,728,6630
1/8/2013,2013,1,8, 2 ,4717,938,702,6357
1/8/2013,2013,1,8, 3 ,4608,921,696,6225
1/8/2013,2013,1,8, 4 ,4570,920,717,6207
1/8/2013,2013,1,8, 5 ,4717,953,755,6425
1/8/2013,2013,1,8, 6 ,4900,1005,819,6724
1/8/2013,2013,1,8, 7 ,4972,967,830,6769
1/8/2013,2013,1,8, 8 ,5535,1046,870,7451
1/8/2013,2013,1,8, 9 ,6299,1238,992,8529
1/8/2013,2013,1,8, 10 ,6742,1323,1058,9123
1/8/2013,2013,1,8, 11 ,7023,1362,1115,9500
1/8/2013,2013,1,8, 12 ,6825,1321,1106,9252
1/8/2013,2013,1,8, 13 ,6792,1317,1078,9187
1/8/2013,2013,1,8, 14 ,6986,1359,1092,9437
1/8/2013,2013,1,8, 15 ,6879,1339,1093,9311
1/8/2013,2013,1,8, 16 ,6770,1326,1106,9202
1/8/2013,2013,1,8, 17 ,6475,1298,1111,8884
1/8/2013,2013,1,8, 18 ,6680,1455,1210,9345
1/8/2013,2013,1,8, 19 ,6829,1429,1168,9426
1/8/2013,2013,1,8, 20 ,6595,1345,1113,9053
1/8/2013,2013,1,8, 21 ,6355,1249,1061,8665
1/8/2013,2013,1,8, 22 ,5991,1130,924,8045
1/8/2013,2013,1,8, 23 ,5440,1027,864,7331
1/8/2013,2013,1,8, 24 ,5218,962,800,6980
1/9/2013,2013,1,9, 1 ,4882,924,740,6546
1/9/2013,2013,1,9, 2 ,4715,896,745,6356
1/9/2013,2013,1,9, 3 ,4617,880,723,6220
1/9/2013,2013,1,9, 4 ,4573,871,712,6156
1/9/2013,2013,1,9, 5 ,4773,914,748,6435
1/9/2013,2013,1,9, 6 ,5010,976,834,6820
1/9/2013,2013,1,9, 7 ,5053,942,776,6771
1/9/2013,2013,1,9, 8 ,5552,1036,875,7463
1/9/2013,2013,1,9, 9 ,6229,1213,1017,8459
1/9/2013,2013,1,9, 10 ,6733,1318,1104,9155
1/9/2013,2013,1,9, 11 ,6983,1377,1141,9501
1/9/2013,2013,1,9, 12 ,6797,1270,1122,9189
1/9/2013,2013,1,9, 13 ,6774,1296,1101,9171
1/9/2013,2013,1,9, 14 ,6965,1346,1130,9441
1/9/2013,2013,1,9, 15 ,6904,1317,1109,9330
1/9/2013,2013,1,9, 16 ,6786,1305,1120,9211
1/9/2013,2013,1,9, 17 ,6485,1252,1123,8860
1/9/2013,2013,1,9, 18 ,6687,1403,1223,9313
1/9/2013,2013,1,9, 19 ,6763,1430,1191,9384
1/9/2013,2013,1,9, 20 ,6569,1377,1122,9068
1/9/2013,2013,1,9, 21 ,6243,1295,1072,8610
1/9/2013,2013,1,9, 22 ,5912,1169,938,8019
1/9/2013,2013,1,9, 23 ,5426,1053,873,7352
1/9/2013,2013,1,9, 24 ,5060,984,780,6824
1/10/2013,2013,1,10, 1 ,4829,941,745,6515
1/10/2013,2013,1,10, 2 ,4629,912,722,6263
1/10/2013,2013,1,10, 3 ,4519,913,715,6147
1/10/2013,2013,1,10, 4 ,4465,892,716,6073
1/10/2013,2013,1,10, 5 ,4625,940,754,6319
1/10/2013,2013,1,10, 6 ,4821,977,806,6604
1/10/2013,2013,1,10, 7 ,4851,963,820,6634
1/10/2013,2013,1,10, 8 ,5463,1035,850,7348
1/10/2013,2013,1,10, 9 ,6180,1203,956,8339
1/10/2013,2013,1,10, 10 ,6621,1284,1040,8945
1/10/2013,2013,1,10, 11 ,6859,1320,1067,9246
1/10/2013,2013,1,10, 12 ,6663,1258,1041,8962
1/10/2013,2013,1,10, 13 ,6606,1228,1034,8868
1/10/2013,2013,1,10, 14 ,6814,1260,1055,9129
1/10/2013,2013,1,10, 15 ,6695,1239,1063,8997
1/10/2013,2013,1,10, 16 ,6618,1246,1074,8938
1/10/2013,2013,1,10, 17 ,6328,1238,1049,8615
1/10/2013,2013,1,10, 18 ,6528,1392,1184,9104
1/10/2013,2013,1,10, 19 ,6598,1371,1161,9130
1/10/2013,2013,1,10, 20 ,6447,1288,1101,8836
1/10/2013,2013,1,10, 21 ,6171,1204,1045,8420
1/10/2013,2013,1,10, 22 ,5689,1076,918,7683
1/10/2013,2013,1,10, 23 ,5315,974,852,7141
1/10/2013,2013,1,10, 24 ,4973,911,772,6656
1/11/2013,2013,1,11, 1 ,4684,874,750,6308
1/11/2013,2013,1,11, 2 ,4595,854,739,6188
1/11/2013,2013,1,11, 3 ,4505,837,736,6078
1/11/2013,2013,1,11, 4 ,4449,840,715,6004
1/11/2013,2013,1,11, 5 ,4625,879,760,6264
1/11/2013,2013,1,11, 6 ,4824,940,847,6611
1/11/2013,2013,1,11, 7 ,4938,928,814,6680
1/11/2013,2013,1,11, 8 ,5428,1004,850,7282
1/11/2013,2013,1,11, 9 ,6120,1177,1019,8316
1/11/2013,2013,1,11, 10 ,6544,1266,1100,8910
1/11/2013,2013,1,11, 11 ,6699,1308,1135,9142
1/11/2013,2013,1,11, 12 ,6488,1275,1122,8885
1/11/2013,2013,1,11, 13 ,6349,1300,1111,8760
1/11/2013,2013,1,11, 14 ,6527,1313,1149,8989
1/11/2013,2013,1,11, 15 ,6429,1291,1146,8866
1/11/2013,2013,1,11, 16 ,6374,1275,1134,8783
1/11/2013,2013,1,11, 17 ,6196,1236,1111,8543
1/11/2013,2013,1,11, 18 ,6492,1385,1229,9106
1/11/2013,2013,1,11, 19 ,6422,1399,1222,9043
1/11/2013,2013,1,11, 20 ,6257,1331,1182,8770
1/11/2013,2013,1,11, 21 ,6008,1248,1127,8383
1/11/2013,2013,1,11, 22 ,5612,1124,1023,7759
1/11/2013,2013,1,11, 23 ,5174,1026,914,7114
1/11/2013,2013,1,11, 24 ,4881,953,829,6663
1/12/2013,2013,1,12, 1 ,4579,911,795,6285
1/12/2013,2013,1,12, 2 ,4483,884,771,6138
1/12/2013,2013,1,12, 3 ,4379,874,754,6007
1/12/2013,2013,1,12, 4 ,4272,853,740,5865
1/12/2013,2013,1,12, 5 ,4347,864,758,5969
1/12/2013,2013,1,12, 6 ,4425,900,776,6101
1/12/2013,2013,1,12, 7 ,4562,906,774,6242
1/12/2013,2013,1,12, 8 ,4978,970,826,6774
1/12/2013,2013,1,12, 9 ,5470,1091,950,7511
1/12/2013,2013,1,12, 10 ,5865,1174,1023,8062
1/12/2013,2013,1,12, 11 ,6211,1224,1105,8540
1/12/2013,2013,1,12, 12 ,6043,1209,1089,8341
1/12/2013,2013,1,12, 13 ,5934,1205,1079,8218
1/12/2013,2013,1,12, 14 ,6061,1231,1103,8395
1/12/2013,2013,1,12, 15 ,5940,1201,1088,8229
1/12/2013,2013,1,12, 16 ,5787,1175,1070,8032
1/12/2013,2013,1,12, 17 ,5710,1165,1071,7946
1/12/2013,2013,1,12, 18 ,6089,1359,1205,8653
1/12/2013,2013,1,12, 19 ,6173,1405,1214,8792
1/12/2013,2013,1,12, 20 ,6056,1341,1163,8560
1/12/2013,2013,1,12, 21 ,5896,1292,1103,8291
1/12/2013,2013,1,12, 22 ,5526,1174,1022,7722
1/12/2013,2013,1,12, 23 ,5067,1075,919,7061
1/12/2013,2013,1,12, 24 ,4795,1005,843,6643
1/13/2013,2013,1,13, 1 ,4627,954,809,6390
1/13/2013,2013,1,13, 2 ,4444,930,769,6143
1/13/2013,2013,1,13, 3 ,4275,904,758,5937
1/13/2013,2013,1,13, 4 ,4193,891,735,5819
1/13/2013,2013,1,13, 5 ,4247,894,757,5898
1/13/2013,2013,1,13, 6 ,4242,893,767,5902
1/13/2013,2013,1,13, 7 ,4147,884,750,5781
1/13/2013,2013,1,13, 8 ,4397,934,782,6113
1/13/2013,2013,1,13, 9 ,4744,1011,842,6597
1/13/2013,2013,1,13, 10 ,5165,1085,909,7159
1/13/2013,2013,1,13, 11 ,5427,1126,959,7512
1/13/2013,2013,1,13, 12 ,5384,1132,964,7480
1/13/2013,2013,1,13, 13 ,5396,1130,962,7488
1/13/2013,2013,1,13, 14 ,5384,1123,941,7448
1/13/2013,2013,1,13, 15 ,5239,1111,927,7277
1/13/2013,2013,1,13, 16 ,5210,1092,915,7217
1/13/2013,2013,1,13, 17 ,5192,1108,922,7222
1/13/2013,2013,1,13, 18 ,5736,1291,1124,8151
1/13/2013,2013,1,13, 19 ,5928,1362,1157,8447
1/13/2013,2013,1,13, 20 ,5866,1315,1130,8311
1/13/2013,2013,1,13, 21 ,5596,1236,1066,7898
1/13/2013,2013,1,13, 22 ,5229,1146,969,7344
1/13/2013,2013,1,13, 23 ,4902,1053,868,6823
1/13/2013,2013,1,13, 24 ,4558,989,819,6366
1/14/2013,2013,1,14, 1 ,4322,942,779,6043
1/14/2013,2013,1,14, 2 ,4142,907,745,5794
1/14/2013,2013,1,14, 3 ,4018,886,724,5628
1/14/2013,2013,1,14, 4 ,4011,883,725,5619
1/14/2013,2013,1,14, 5 ,4229,915,749,5893
1/14/2013,2013,1,14, 6 ,4499,977,831,6307
1/14/2013,2013,1,14, 7 ,4635,952,766,6353
1/14/2013,2013,1,14, 8 ,5203,1050,845,7098
1/14/2013,2013,1,14, 9 ,5870,1234,1017,8121
1/14/2013,2013,1,14, 10 ,6276,1335,1154,8765
1/14/2013,2013,1,14, 11 ,6504,1402,1202,9108
1/14/2013,2013,1,14, 12 ,6293,1371,1189,8853
1/14/2013,2013,1,14, 13 ,6230,1351,1193,8774
1/14/2013,2013,1,14, 14 ,6423,1396,1233,9052
1/14/2013,2013,1,14, 15 ,6402,1359,1230,8991
1/14/2013,2013,1,14, 16 ,6341,1346,1209,8896
1/14/2013,2013,1,14, 17 ,6196,1314,1174,8684
1/14/2013,2013,1,14, 18 ,6465,1433,1267,9165
1/14/2013,2013,1,14, 19 ,6420,1443,1250,9113
1/14/2013,2013,1,14, 20 ,6196,1386,1203,8785
1/14/2013,2013,1,14, 21 ,5928,1306,1181,8415
1/14/2013,2013,1,14, 22 ,5512,1182,1072,7766
1/14/2013,2013,1,14, 23 ,5081,1073,974,7128
1/14/2013,2013,1,14, 24 ,4702,995,869,6566
1/15/2013,2013,1,15, 1 ,4481,948,848,6277
1/15/2013,2013,1,15, 2 ,4302,917,820,6039
1/15/2013,2013,1,15, 3 ,4192,896,790,5878
1/15/2013,2013,1,15, 4 ,4271,888,776,5935
1/15/2013,2013,1,15, 5 ,4407,923,819,6149
1/15/2013,2013,1,15, 6 ,4676,979,889,6544
1/15/2013,2013,1,15, 7 ,4682,957,821,6460
1/15/2013,2013,1,15, 8 ,5213,1027,891,7131
1/15/2013,2013,1,15, 9 ,5887,1192,1048,8127
1/15/2013,2013,1,15, 10 ,6276,1261,1133,8670
1/15/2013,2013,1,15, 11 ,6491,1291,1156,8938
1/15/2013,2013,1,15, 12 ,6310,1252,1146,8708
1/15/2013,2013,1,15, 13 ,6268,1223,1155,8646
1/15/2013,2013,1,15, 14 ,6427,1249,1171,8847
1/15/2013,2013,1,15, 15 ,6402,1243,1156,8801
1/15/2013,2013,1,15, 16 ,6252,1231,1158,8641
1/15/2013,2013,1,15, 17 ,6072,1204,1184,8460
1/15/2013,2013,1,15, 18 ,6252,1340,1223,8815
1/15/2013,2013,1,15, 19 ,6315,1347,1210,8872
1/15/2013,2013,1,15, 20 ,6077,1280,1189,8546
1/15/2013,2013,1,15, 21 ,5757,1193,1115,8065
1/15/2013,2013,1,15, 22 ,5370,1072,1000,7442
1/15/2013,2013,1,15, 23 ,4950,971,920,6841
1/15/2013,2013,1,15, 24 ,4596,900,856,6352
1/16/2013,2013,1,16, 1 ,4429,873,809,6111
1/16/2013,2013,1,16, 2 ,4275,852,787,5914
1/16/2013,2013,1,16, 3 ,4236,837,787,5860
1/16/2013,2013,1,16, 4 ,4214,832,776,5822
1/16/2013,2013,1,16, 5 ,4366,871,822,6059
1/16/2013,2013,1,16, 6 ,4725,930,878,6533
1/16/2013,2013,1,16, 7 ,4788,909,847,6544
1/16/2013,2013,1,16, 8 ,5210,980,902,7092
1/16/2013,2013,1,16, 9 ,5847,1136,1050,8033
1/16/2013,2013,1,16, 10 ,6184,1217,1152,8553
1/16/2013,2013,1,16, 11 ,6412,1269,1207,8888
1/16/2013,2013,1,16, 12 ,6222,1226,1168,8616
1/16/2013,2013,1,16, 13 ,6202,1197,1177,8576
1/16/2013,2013,1,16, 14 ,6345,1233,1201,8779
1/16/2013,2013,1,16, 15 ,6307,1217,1197,8721
1/16/2013,2013,1,16, 16 ,6211,1219,1201,8631
1/16/2013,2013,1,16, 17 ,5994,1195,1134,8323
1/16/2013,2013,1,16, 18 ,6182,1328,1240,8750
1/16/2013,2013,1,16, 19 ,6332,1343,1238,8913
1/16/2013,2013,1,16, 20 ,6089,1273,1195,8557
1/16/2013,2013,1,16, 21 ,5780,1189,1178,8147
1/16/2013,2013,1,16, 22 ,5360,1068,1069,7497
1/16/2013,2013,1,16, 23 ,4882,958,930,6770
1/16/2013,2013,1,16, 24 ,4554,893,871,6318
1/17/2013,2013,1,17, 1 ,4307,857,815,5979
1/17/2013,2013,1,17, 2 ,4138,825,801,5764
1/17/2013,2013,1,17, 3 ,4084,811,773,5668
1/17/2013,2013,1,17, 4 ,4085,815,774,5674
1/17/2013,2013,1,17, 5 ,4255,856,807,5918
1/17/2013,2013,1,17, 6 ,4571,922,873,6366
1/17/2013,2013,1,17, 7 ,4591,901,812,6304
1/17/2013,2013,1,17, 8 ,5114,976,906,6996
1/17/2013,2013,1,17, 9 ,5724,1143,1073,7940
1/17/2013,2013,1,17, 10 ,6212,1232,1129,8573
1/17/2013,2013,1,17, 11 ,6505,1292,1202,8999
1/17/2013,2013,1,17, 12 ,6336,1235,1165,8736
1/17/2013,2013,1,17, 13 ,6245,1231,1178,8654
1/17/2013,2013,1,17, 14 ,6481,1271,1173,8925
1/17/2013,2013,1,17, 15 ,6337,1252,1175,8764
1/17/2013,2013,1,17, 16 ,6245,1248,1167,8660
1/17/2013,2013,1,17, 17 ,5954,1198,1135,8287
1/17/2013,2013,1,17, 18 ,6156,1347,1238,8741
1/17/2013,2013,1,17, 19 ,6335,1379,1239,8953
1/17/2013,2013,1,17, 20 ,6070,1305,1192,8567
1/17/2013,2013,1,17, 21 ,5792,1229,1153,8174
1/17/2013,2013,1,17, 22 ,5362,1099,1072,7533
1/17/2013,2013,1,17, 23 ,4899,1009,947,6855
1/17/2013,2013,1,17, 24 ,4632,933,862,6427
1/18/2013,2013,1,18, 1 ,4388,889,825,6102
1/18/2013,2013,1,18, 2 ,4306,878,812,5996
1/18/2013,2013,1,18, 3 ,4155,868,793,5816
1/18/2013,2013,1,18, 4 ,4189,856,794,5839
1/18/2013,2013,1,18, 5 ,4406,892,827,6125
1/18/2013,2013,1,18, 6 ,4673,939,876,6488
1/18/2013,2013,1,18, 7 ,4705,936,838,6479
1/18/2013,2013,1,18, 8 ,5237,1008,890,7135
1/18/2013,2013,1,18, 9 ,5759,1178,1069,8006
1/18/2013,2013,1,18, 10 ,6172,1262,1134,8568
1/18/2013,2013,1,18, 11 ,6393,1310,1157,8860
1/18/2013,2013,1,18, 12 ,6218,1247,1156,8621
1/18/2013,2013,1,18, 13 ,6148,1226,1132,8506
1/18/2013,2013,1,18, 14 ,6325,1274,1193,8792
1/18/2013,2013,1,18, 15 ,6233,1259,1188,8680
1/18/2013,2013,1,18, 16 ,6140,1241,1167,8548
1/18/2013,2013,1,18, 17 ,5915,1206,1135,8256
1/18/2013,2013,1,18, 18 ,6052,1331,1210,8593
1/18/2013,2013,1,18, 19 ,6212,1352,1191,8755
1/18/2013,2013,1,18, 20 ,5968,1281,1163,8412
1/18/2013,2013,1,18, 21 ,5772,1200,1153,8125
1/18/2013,2013,1,18, 22 ,5394,1091,1081,7566
1/18/2013,2013,1,18, 23 ,4967,984,930,6881
1/18/2013,2013,1,18, 24 ,4633,915,834,6382
1/19/2013,2013,1,19, 1 ,4359,873,795,6027
1/19/2013,2013,1,19, 2 ,4272,854,766,5892
1/19/2013,2013,1,19, 3 ,4155,836,770,5761
1/19/2013,2013,1,19, 4 ,4132,832,765,5729
1/19/2013,2013,1,19, 5 ,4185,849,779,5813
1/19/2013,2013,1,19, 6 ,4324,885,813,6022
1/19/2013,2013,1,19, 7 ,4449,892,821,6162
1/19/2013,2013,1,19, 8 ,4846,966,874,6686
1/19/2013,2013,1,19, 9 ,5314,1075,944,7333
1/19/2013,2013,1,19, 10 ,5672,1135,1009,7816
1/19/2013,2013,1,19, 11 ,5937,1174,1031,8142
1/19/2013,2013,1,19, 12 ,5753,1151,1028,7932
1/19/2013,2013,1,19, 13 ,5646,1128,1028,7802
1/19/2013,2013,1,19, 14 ,5754,1134,1035,7923
1/19/2013,2013,1,19, 15 ,5617,1112,1032,7761
1/19/2013,2013,1,19, 16 ,5454,1102,1033,7589
1/19/2013,2013,1,19, 17 ,5328,1101,1052,7481
1/19/2013,2013,1,19, 18 ,5590,1242,1158,7990
1/19/2013,2013,1,19, 19 ,5892,1294,1173,8359
1/19/2013,2013,1,19, 20 ,5654,1235,1118,8007
1/19/2013,2013,1,19, 21 ,5487,1166,1043,7696
1/19/2013,2013,1,19, 22 ,5045,1060,935,7040
1/19/2013,2013,1,19, 23 ,4668,970,829,6467
1/19/2013,2013,1,19, 24 ,4366,915,798,6079
1/20/2013,2013,1,20, 1 ,4152,868,769,5789
1/20/2013,2013,1,20, 2 ,4045,840,745,5630
1/20/2013,2013,1,20, 3 ,3920,817,725,5462
1/20/2013,2013,1,20, 4 ,3902,815,718,5435
1/20/2013,2013,1,20, 5 ,3903,816,734,5453
1/20/2013,2013,1,20, 6 ,3935,835,758,5528
1/20/2013,2013,1,20, 7 ,3929,834,756,5519
1/20/2013,2013,1,20, 8 ,4160,869,765,5794
1/20/2013,2013,1,20, 9 ,4417,923,814,6154
1/20/2013,2013,1,20, 10 ,4834,982,850,6666
1/20/2013,2013,1,20, 11 ,5092,1022,878,6992
1/20/2013,2013,1,20, 12 ,4977,1006,874,6857
1/20/2013,2013,1,20, 13 ,4924,998,866,6788
1/20/2013,2013,1,20, 14 ,4942,1004,872,6818
1/20/2013,2013,1,20, 15 ,4878,991,849,6718
1/20/2013,2013,1,20, 16 ,4825,978,862,6665
1/20/2013,2013,1,20, 17 ,4747,975,908,6630
1/20/2013,2013,1,20, 18 ,5135,1163,1078,7376
1/20/2013,2013,1,20, 19 ,5534,1237,1112,7883
1/20/2013,2013,1,20, 20 ,5432,1200,1085,7717
1/20/2013,2013,1,20, 21 ,5155,1106,1010,7271
1/20/2013,2013,1,20, 22 ,4771,1013,919,6703
1/20/2013,2013,1,20, 23 ,4460,928,876,6264
1/20/2013,2013,1,20, 24 ,4168,861,842,5871
1/21/2013,2013,1,21, 1 ,3894,819,733,5446
1/21/2013,2013,1,21, 2 ,3774,789,710,5273
1/21/2013,2013,1,21, 3 ,3711,777,687,5175
1/21/2013,2013,1,21, 4 ,3702,773,688,5163
1/21/2013,2013,1,21, 5 ,3952,813,738,5503
1/21/2013,2013,1,21, 6 ,4300,885,814,5999
1/21/2013,2013,1,21, 7 ,4405,869,801,6075
1/21/2013,2013,1,21, 8 ,4980,959,846,6785
1/21/2013,2013,1,21, 9 ,5660,1140,994,7794
1/21/2013,2013,1,21, 10 ,6206,1235,1093,8534
1/21/2013,2013,1,21, 11 ,6470,1301,1118,8889
1/21/2013,2013,1,21, 12 ,6307,1282,1101,8690
1/21/2013,2013,1,21, 13 ,6222,1269,1091,8582
1/21/2013,2013,1,21, 14 ,6453,1309,1107,8869
1/21/2013,2013,1,21, 15 ,6349,1305,1089,8743
1/21/2013,2013,1,21, 16 ,6306,1277,1089,8672
1/21/2013,2013,1,21, 17 ,6101,1221,1075,8397
1/21/2013,2013,1,21, 18 ,6260,1355,1152,8767
1/21/2013,2013,1,21, 19 ,6367,1401,1148,8916
1/21/2013,2013,1,21, 20 ,6153,1325,1131,8609
1/21/2013,2013,1,21, 21 ,5918,1252,1079,8249
1/21/2013,2013,1,21, 22 ,5456,1136,987,7579
1/21/2013,2013,1,21, 23 ,5024,1021,858,6903
1/21/2013,2013,1,21, 24 ,4754,944,803,6501
1/22/2013,2013,1,22, 1 ,4479,901,768,6148
1/22/2013,2013,1,22, 2 ,4350,879,742,5971
1/22/2013,2013,1,22, 3 ,4258,853,722,5833
1/22/2013,2013,1,22, 4 ,4241,848,725,5814
1/22/2013,2013,1,22, 5 ,4433,889,776,6098
1/22/2013,2013,1,22, 6 ,4722,955,854,6531
1/22/2013,2013,1,22, 7 ,4782,920,817,6519
1/22/2013,2013,1,22, 8 ,5297,1005,880,7182
1/22/2013,2013,1,22, 9 ,5973,1190,1000,8163
1/22/2013,2013,1,22, 10 ,6371,1261,1088,8720
1/22/2013,2013,1,22, 11 ,6647,1314,1099,9060
1/22/2013,2013,1,22, 12 ,6416,1284,1090,8790
1/22/2013,2013,1,22, 13 ,6377,1261,1062,8700
1/22/2013,2013,1,22, 14 ,6463,1318,1066,8847
1/22/2013,2013,1,22, 15 ,6360,1290,1070,8720
1/22/2013,2013,1,22, 16 ,6301,1269,1094,8664
1/22/2013,2013,1,22, 17 ,6086,1216,1084,8386
1/22/2013,2013,1,22, 18 ,6259,1356,1146,8761
1/22/2013,2013,1,22, 19 ,6388,1399,1148,8935
1/22/2013,2013,1,22, 20 ,6169,1320,1092,8581
1/22/2013,2013,1,22, 21 ,5862,1235,1020,8117
1/22/2013,2013,1,22, 22 ,5446,1124,935,7505
1/22/2013,2013,1,22, 23 ,4988,1016,818,6822
1/22/2013,2013,1,22, 24 ,4637,941,757,6335
1/23/2013,2013,1,23, 1 ,4389,892,722,6003
1/23/2013,2013,1,23, 2 ,4256,862,720,5838
1/23/2013,2013,1,23, 3 ,4136,840,702,5678
1/23/2013,2013,1,23, 4 ,4177,847,715,5739
1/23/2013,2013,1,23, 5 ,4354,891,746,5991
1/23/2013,2013,1,23, 6 ,4616,958,827,6401
1/23/2013,2013,1,23, 7 ,4710,921,810,6441
1/23/2013,2013,1,23, 8 ,5174,1000,849,7023
1/23/2013,2013,1,23, 9 ,5852,1180,994,8026
1/23/2013,2013,1,23, 10 ,6249,1263,1053,8565
1/23/2013,2013,1,23, 11 ,6422,1315,1114,8851
1/23/2013,2013,1,23, 12 ,6255,1280,1101,8636
1/23/2013,2013,1,23, 13 ,6198,1264,1056,8518
1/23/2013,2013,1,23, 14 ,6397,1303,1104,8804
1/23/2013,2013,1,23, 15 ,6298,1285,1100,8683
1/23/2013,2013,1,23, 16 ,6195,1267,1091,8553
1/23/2013,2013,1,23, 17 ,6012,1222,1084,8318
1/23/2013,2013,1,23, 18 ,6233,1370,1172,8775
1/23/2013,2013,1,23, 19 ,6335,1397,1175,8907
1/23/2013,2013,1,23, 20 ,6069,1336,1160,8565
1/23/2013,2013,1,23, 21 ,5837,1266,1118,8221
1/23/2013,2013,1,23, 22 ,5348,1132,1026,7506
1/23/2013,2013,1,23, 23 ,4846,1020,886,6752
1/23/2013,2013,1,23, 24 ,4495,945,829,6269
1/24/2013,2013,1,24, 1 ,4211,912,802,5925
1/24/2013,2013,1,24, 2 ,4138,885,779,5802
1/24/2013,2013,1,24, 3 ,4041,869,765,5675
1/24/2013,2013,1,24, 4 ,4018,867,750,5635
1/24/2013,2013,1,24, 5 ,4238,911,808,5957
1/24/2013,2013,1,24, 6 ,4524,970,872,6366
1/24/2013,2013,1,24, 7 ,4556,933,843,6332
1/24/2013,2013,1,24, 8 ,5052,1024,905,6981
1/24/2013,2013,1,24, 9 ,5747,1191,1016,7954
1/24/2013,2013,1,24, 10 ,6176,1279,1123,8578
1/24/2013,2013,1,24, 11 ,6440,1323,1153,8916
1/24/2013,2013,1,24, 12 ,6297,1276,1119,8692
1/24/2013,2013,1,24, 13 ,6275,1269,1156,8700
1/24/2013,2013,1,24, 14 ,6517,1295,1138,8950
1/24/2013,2013,1,24, 15 ,6410,1281,1136,8827
1/24/2013,2013,1,24, 16 ,6372,1268,1143,8783
1/24/2013,2013,1,24, 17 ,6120,1235,1146,8501
1/24/2013,2013,1,24, 18 ,6241,1356,1215,8812
1/24/2013,2013,1,24, 19 ,6445,1385,1190,9020
1/24/2013,2013,1,24, 20 ,6229,1329,1152,8710
1/24/2013,2013,1,24, 21 ,5945,1245,1106,8296
1/24/2013,2013,1,24, 22 ,5449,1117,1001,7567
1/24/2013,2013,1,24, 23 ,4987,1012,868,6867
1/24/2013,2013,1,24, 24 ,4630,948,831,6409
1/25/2013,2013,1,25, 1 ,4369,894,797,6060
1/25/2013,2013,1,25, 2 ,4293,875,774,5942
1/25/2013,2013,1,25, 3 ,4138,860,760,5758
1/25/2013,2013,1,25, 4 ,4136,853,771,5760
1/25/2013,2013,1,25, 5 ,4336,885,807,6028
1/25/2013,2013,1,25, 6 ,4612,948,877,6437
1/25/2013,2013,1,25, 7 ,4652,933,841,6426
1/25/2013,2013,1,25, 8 ,5121,1006,908,7035
1/25/2013,2013,1,25, 9 ,5798,1157,1066,8021
1/25/2013,2013,1,25, 10 ,6245,1249,1152,8646
1/25/2013,2013,1,25, 11 ,6590,1283,1184,9057
1/25/2013,2013,1,25, 12 ,6396,1234,1146,8776
1/25/2013,2013,1,25, 13 ,6407,1229,1143,8779
1/25/2013,2013,1,25, 14 ,6625,1266,1166,9057
1/25/2013,2013,1,25, 15 ,6513,1247,1143,8903
1/25/2013,2013,1,25, 16 ,6429,1243,1152,8824
1/25/2013,2013,1,25, 17 ,6208,1213,1139,8560
1/25/2013,2013,1,25, 18 ,6360,1346,1230,8936
1/25/2013,2013,1,25, 19 ,6527,1368,1205,9100
1/25/2013,2013,1,25, 20 ,6319,1300,1147,8766
1/25/2013,2013,1,25, 21 ,6133,1221,1114,8468
1/25/2013,2013,1,25, 22 ,5698,1119,1038,7855
1/25/2013,2013,1,25, 23 ,5279,1010,919,7208
1/25/2013,2013,1,25, 24 ,4881,932,852,6665
1/26/2013,2013,1,26, 1 ,4593,896,792,6281
1/26/2013,2013,1,26, 2 ,4493,868,779,6140
1/26/2013,2013,1,26, 3 ,4355,848,759,5962
1/26/2013,2013,1,26, 4 ,4328,846,748,5922
1/26/2013,2013,1,26, 5 ,4356,862,769,5987
1/26/2013,2013,1,26, 6 ,4504,870,808,6182
1/26/2013,2013,1,26, 7 ,4582,871,795,6248
1/26/2013,2013,1,26, 8 ,4938,929,825,6692
1/26/2013,2013,1,26, 9 ,5446,1048,928,7422
1/26/2013,2013,1,26, 10 ,5891,1139,980,8010
1/26/2013,2013,1,26, 11 ,6202,1198,1065,8465
1/26/2013,2013,1,26, 12 ,6050,1167,1055,8272
1/26/2013,2013,1,26, 13 ,5953,1151,1065,8169
1/26/2013,2013,1,26, 14 ,6085,1166,1014,8265
1/26/2013,2013,1,26, 15 ,5911,1127,1054,8092
1/26/2013,2013,1,26, 16 ,5751,1135,1044,7930
1/26/2013,2013,1,26, 17 ,5561,1141,1041,7743
1/26/2013,2013,1,26, 18 ,5885,1260,1185,8330
1/26/2013,2013,1,26, 19 ,6202,1334,1207,8743
1/26/2013,2013,1,26, 20 ,6001,1286,1155,8442
1/26/2013,2013,1,26, 21 ,5887,1223,1125,8235
1/26/2013,2013,1,26, 22 ,5530,1120,1037,7687
1/26/2013,2013,1,26, 23 ,5127,1005,915,7047
1/26/2013,2013,1,26, 24 ,4773,930,832,6535
1/27/2013,2013,1,27, 1 ,4534,884,799,6217
1/27/2013,2013,1,27, 2 ,4394,857,766,6017
1/27/2013,2013,1,27, 3 ,4270,836,741,5847
1/27/2013,2013,1,27, 4 ,4157,817,729,5703
1/27/2013,2013,1,27, 5 ,4153,836,754,5743
1/27/2013,2013,1,27, 6 ,4142,849,758,5749
1/27/2013,2013,1,27, 7 ,4099,840,734,5673
1/27/2013,2013,1,27, 8 ,4290,872,759,5921
1/27/2013,2013,1,27, 9 ,4634,947,824,6405
1/27/2013,2013,1,27, 10 ,5110,1016,885,7011
1/27/2013,2013,1,27, 11 ,5333,1053,931,7317
1/27/2013,2013,1,27, 12 ,5326,1054,940,7320
1/27/2013,2013,1,27, 13 ,5357,1064,957,7378
1/27/2013,2013,1,27, 14 ,5301,1063,971,7335
1/27/2013,2013,1,27, 15 ,5257,1049,955,7261
1/27/2013,2013,1,27, 16 ,5137,1029,938,7104
1/27/2013,2013,1,27, 17 ,5069,997,946,7012
1/27/2013,2013,1,27, 18 ,5473,1168,1068,7709
1/27/2013,2013,1,27, 19 ,5872,1261,1147,8280
1/27/2013,2013,1,27, 20 ,5816,1225,1115,8156
1/27/2013,2013,1,27, 21 ,5618,1150,1030,7798
1/27/2013,2013,1,27, 22 ,5214,1073,941,7228
1/27/2013,2013,1,27, 23 ,4873,987,864,6724
1/27/2013,2013,1,27, 24 ,4585,925,794,6304
1/28/2013,2013,1,28, 1 ,4334,877,768,5979
1/28/2013,2013,1,28, 2 ,4142,845,734,5721
1/28/2013,2013,1,28, 3 ,4085,824,705,5614
1/28/2013,2013,1,28, 4 ,4018,823,717,5558
1/28/2013,2013,1,28, 5 ,4270,863,764,5897
1/28/2013,2013,1,28, 6 ,4569,932,834,6335
1/28/2013,2013,1,28, 7 ,4693,910,793,6396
1/28/2013,2013,1,28, 8 ,5263,1003,849,7115
1/28/2013,2013,1,28, 9 ,6018,1185,1003,8206
1/28/2013,2013,1,28, 10 ,6506,1283,1102,8891
1/28/2013,2013,1,28, 11 ,6783,1337,1153,9273
1/28/2013,2013,1,28, 12 ,6640,1302,1132,9074
1/28/2013,2013,1,28, 13 ,6543,1284,1130,8957
1/28/2013,2013,1,28, 14 ,6818,1338,1180,9336
1/28/2013,2013,1,28, 15 ,6637,1324,1163,9124
1/28/2013,2013,1,28, 16 ,6539,1296,1143,8978
1/28/2013,2013,1,28, 17 ,6238,1234,1112,8584
1/28/2013,2013,1,28, 18 ,6284,1346,1188,8818
1/28/2013,2013,1,28, 19 ,6477,1420,1216,9113
1/28/2013,2013,1,28, 20 ,6223,1347,1184,8754
1/28/2013,2013,1,28, 21 ,5961,1266,1126,8353
1/28/2013,2013,1,28, 22 ,5555,1142,1000,7697
1/28/2013,2013,1,28, 23 ,5124,1026,881,7031
1/28/2013,2013,1,28, 24 ,4740,958,832,6530
1/29/2013,2013,1,29, 1 ,4551,913,795,6259
1/29/2013,2013,1,29, 2 ,4413,884,777,6074
1/29/2013,2013,1,29, 3 ,4307,855,748,5910
1/29/2013,2013,1,29, 4 ,4297,871,750,5918
1/29/2013,2013,1,29, 5 ,4465,905,795,6165
1/29/2013,2013,1,29, 6 ,4712,961,854,6527
1/29/2013,2013,1,29, 7 ,4742,928,799,6469
1/29/2013,2013,1,29, 8 ,5288,1025,883,7196
1/29/2013,2013,1,29, 9 ,5936,1204,1018,8158
1/29/2013,2013,1,29, 10 ,6251,1299,1128,8678
1/29/2013,2013,1,29, 11 ,6557,1354,1178,9089
1/29/2013,2013,1,29, 12 ,6377,1304,1133,8814
1/29/2013,2013,1,29, 13 ,6296,1305,1143,8744
1/29/2013,2013,1,29, 14 ,6498,1351,1168,9017
1/29/2013,2013,1,29, 15 ,6379,1329,1163,8871
1/29/2013,2013,1,29, 16 ,6244,1305,1147,8696
1/29/2013,2013,1,29, 17 ,6213,1265,1128,8606
1/29/2013,2013,1,29, 18 ,6219,1366,1230,8815
1/29/2013,2013,1,29, 19 ,6530,1418,1201,9149
1/29/2013,2013,1,29, 20 ,6249,1336,1169,8754
1/29/2013,2013,1,29, 21 ,5911,1239,1125,8275
1/29/2013,2013,1,29, 22 ,5531,1118,1011,7660
1/29/2013,2013,1,29, 23 ,5056,1012,885,6953
1/29/2013,2013,1,29, 24 ,4751,937,851,6539
1/30/2013,2013,1,30, 1 ,4489,906,824,6219
1/30/2013,2013,1,30, 2 ,4332,876,779,5987
1/30/2013,2013,1,30, 3 ,4224,858,768,5850
1/30/2013,2013,1,30, 4 ,4198,849,763,5810
1/30/2013,2013,1,30, 5 ,4407,886,816,6109
1/30/2013,2013,1,30, 6 ,4670,951,881,6502
1/30/2013,2013,1,30, 7 ,4705,928,829,6462
1/30/2013,2013,1,30, 8 ,5243,1007,905,7155
1/30/2013,2013,1,30, 9 ,5890,1168,1056,8114
1/30/2013,2013,1,30, 10 ,6341,1232,1140,8713
1/30/2013,2013,1,30, 11 ,6678,1271,1155,9104
1/30/2013,2013,1,30, 12 ,6438,1240,1133,8811
1/30/2013,2013,1,30, 13 ,6413,1203,1115,8731
1/30/2013,2013,1,30, 14 ,6592,1232,1141,8965
1/30/2013,2013,1,30, 15 ,6468,1216,1120,8804
1/30/2013,2013,1,30, 16 ,6379,1214,1133,8726
1/30/2013,2013,1,30, 17 ,6042,1195,1142,8379
1/30/2013,2013,1,30, 18 ,6051,1313,1197,8561
1/30/2013,2013,1,30, 19 ,6328,1331,1186,8845
1/30/2013,2013,1,30, 20 ,6082,1262,1158,8502
1/30/2013,2013,1,30, 21 ,5772,1163,1094,8029
1/30/2013,2013,1,30, 22 ,5380,1034,994,7408
1/30/2013,2013,1,30, 23 ,4894,934,885,6713
1/30/2013,2013,1,30, 24 ,4554,866,821,6241
1/31/2013,2013,1,31, 1 ,4345,839,789,5973
1/31/2013,2013,1,31, 2 ,4215,819,781,5815
1/31/2013,2013,1,31, 3 ,4164,807,757,5728
1/31/2013,2013,1,31, 4 ,4165,810,755,5730
1/31/2013,2013,1,31, 5 ,4373,846,811,6030
1/31/2013,2013,1,31, 6 ,4642,920,877,6439
1/31/2013,2013,1,31, 7 ,4727,901,806,6434
1/31/2013,2013,1,31, 8 ,5147,985,892,7024
1/31/2013,2013,1,31, 9 ,5751,1162,1033,7946
1/31/2013,2013,1,31, 10 ,6220,1264,1113,8597
1/31/2013,2013,1,31, 11 ,6546,1322,1158,9026
1/31/2013,2013,1,31, 12 ,6318,1296,1139,8753
1/31/2013,2013,1,31, 13 ,6230,1299,1139,8668
1/31/2013,2013,1,31, 14 ,6443,1342,1169,8954
1/31/2013,2013,1,31, 15 ,6336,1323,1174,8833
1/31/2013,2013,1,31, 16 ,6334,1304,1167,8805
1/31/2013,2013,1,31, 17 ,6115,1230,1094,8439
1/31/2013,2013,1,31, 18 ,6226,1329,1196,8751
1/31/2013,2013,1,31, 19 ,6425,1405,1204,9034
1/31/2013,2013,1,31, 20 ,6252,1346,1180,8778
1/31/2013,2013,1,31, 21 ,6035,1262,1137,8434
1/31/2013,2013,1,31, 22 ,5591,1139,1041,7771
1/31/2013,2013,1,31, 23 ,5146,1023,918,7087
1/31/2013,2013,1,31, 24 ,4870,947,842,6659
2/1/2013,2013,2,1, 1 ,4617,900,799,6316
2/1/2013,2013,2,1, 2 ,4466,873,766,6105
2/1/2013,2013,2,1, 3 ,4339,849,746,5934
2/1/2013,2013,2,1, 4 ,4348,847,747,5942
2/1/2013,2013,2,1, 5 ,4503,880,790,6173
2/1/2013,2013,2,1, 6 ,4799,940,864,6603
2/1/2013,2013,2,1, 7 ,4803,899,809,6511
2/1/2013,2013,2,1, 8 ,5399,999,878,7276
2/1/2013,2013,2,1, 9 ,6064,1205,1036,8305
2/1/2013,2013,2,1, 10 ,6539,1306,1133,8978
2/1/2013,2013,2,1, 11 ,6850,1371,1170,9391
2/1/2013,2013,2,1, 12 ,6700,1335,1165,9200
2/1/2013,2013,2,1, 13 ,6738,1306,1154,9198
2/1/2013,2013,2,1, 14 ,6954,1347,1209,9510
2/1/2013,2013,2,1, 15 ,6871,1319,1201,9391
2/1/2013,2013,2,1, 16 ,6810,1305,1177,9292
2/1/2013,2013,2,1, 17 ,6494,1230,1108,8832
2/1/2013,2013,2,1, 18 ,6410,1329,1190,8929
2/1/2013,2013,2,1, 19 ,6710,1377,1188,9275
2/1/2013,2013,2,1, 20 ,6489,1329,1190,9008
2/1/2013,2013,2,1, 21 ,6298,1254,1144,8696
2/1/2013,2013,2,1, 22 ,5849,1153,1058,8060
2/1/2013,2013,2,1, 23 ,5571,1054,961,7586
2/1/2013,2013,2,1, 24 ,5177,961,852,6990
2/2/2013,2013,2,2, 1 ,4921,917,823,6661
2/2/2013,2013,2,2, 2 ,4779,876,799,6454
2/2/2013,2013,2,2, 3 ,4619,859,778,6256
2/2/2013,2013,2,2, 4 ,4564,850,768,6182
2/2/2013,2013,2,2, 5 ,4577,865,787,6229
2/2/2013,2013,2,2, 6 ,4707,888,815,6410
2/2/2013,2013,2,2, 7 ,4712,893,812,6417
2/2/2013,2013,2,2, 8 ,5130,958,863,6951
2/2/2013,2013,2,2, 9 ,5656,1102,983,7741
2/2/2013,2013,2,2, 10 ,6143,1175,1036,8354
2/2/2013,2013,2,2, 11 ,6398,1241,1055,8694
2/2/2013,2013,2,2, 12 ,6269,1213,1035,8517
2/2/2013,2013,2,2, 13 ,6147,1201,1028,8376
2/2/2013,2013,2,2, 14 ,6219,1209,1056,8484
2/2/2013,2013,2,2, 15 ,6065,1189,1030,8284
2/2/2013,2013,2,2, 16 ,5895,1159,1020,8074
2/2/2013,2013,2,2, 17 ,5648,1121,1006,7775
2/2/2013,2013,2,2, 18 ,5796,1258,1116,8170
2/2/2013,2013,2,2, 19 ,6272,1349,1153,8774
2/2/2013,2013,2,2, 20 ,6123,1288,1116,8527
2/2/2013,2013,2,2, 21 ,5954,1229,1108,8291
2/2/2013,2013,2,2, 22 ,5666,1131,1011,7808
2/2/2013,2013,2,2, 23 ,5272,1027,917,7216
2/2/2013,2013,2,2, 24 ,4952,955,844,6751
2/3/2013,2013,2,3, 1 ,4774,909,800,6483
2/3/2013,2013,2,3, 2 ,4593,874,761,6228
2/3/2013,2013,2,3, 3 ,4427,851,747,6025
2/3/2013,2013,2,3, 4 ,4350,843,731,5924
2/3/2013,2013,2,3, 5 ,4324,848,746,5918
2/3/2013,2013,2,3, 6 ,4339,850,770,5959
2/3/2013,2013,2,3, 7 ,4274,834,763,5871
2/3/2013,2013,2,3, 8 ,4467,867,775,6109
2/3/2013,2013,2,3, 9 ,4770,927,822,6519
2/3/2013,2013,2,3, 10 ,5226,991,888,7105
2/3/2013,2013,2,3, 11 ,5441,1033,928,7402
2/3/2013,2013,2,3, 12 ,5420,1038,936,7394
2/3/2013,2013,2,3, 13 ,5435,1036,937,7408
2/3/2013,2013,2,3, 14 ,5421,1031,955,7407
2/3/2013,2013,2,3, 15 ,5294,1017,969,7280
2/3/2013,2013,2,3, 16 ,5157,972,937,7066
2/3/2013,2013,2,3, 17 ,5050,997,932,6979
2/3/2013,2013,2,3, 18 ,5402,1126,1041,7569
2/3/2013,2013,2,3, 19 ,5882,1205,1171,8258
2/3/2013,2013,2,3, 20 ,5816,1201,1128,8145
2/3/2013,2013,2,3, 21 ,5621,1137,1069,7827
2/3/2013,2013,2,3, 22 ,5289,1031,910,7230
2/3/2013,2013,2,3, 23 ,5000,940,862,6802
2/3/2013,2013,2,3, 24 ,4633,856,800,6289
2/4/2013,2013,2,4, 1 ,4398,821,753,5972
2/4/2013,2013,2,4, 2 ,4177,793,714,5684
2/4/2013,2013,2,4, 3 ,4115,782,715,5612
2/4/2013,2013,2,4, 4 ,4060,783,699,5542
2/4/2013,2013,2,4, 5 ,4232,826,761,5819
2/4/2013,2013,2,4, 6 ,4533,895,844,6272
2/4/2013,2013,2,4, 7 ,4667,865,783,6315
2/4/2013,2013,2,4, 8 ,5262,962,862,7086
2/4/2013,2013,2,4, 9 ,6040,1154,1070,8264
2/4/2013,2013,2,4, 10 ,6636,1256,1116,9008
2/4/2013,2013,2,4, 11 ,6876,1329,1158,9363
2/4/2013,2013,2,4, 12 ,6793,1304,1158,9255
2/4/2013,2013,2,4, 13 ,6716,1311,1139,9166
2/4/2013,2013,2,4, 14 ,6985,1344,1147,9476
2/4/2013,2013,2,4, 15 ,6907,1331,1138,9376
2/4/2013,2013,2,4, 16 ,6802,1313,1139,9254
2/4/2013,2013,2,4, 17 ,6426,1238,1132,8796
2/4/2013,2013,2,4, 18 ,6363,1325,1190,8878
2/4/2013,2013,2,4, 19 ,6718,1417,1177,9312
2/4/2013,2013,2,4, 20 ,6466,1342,1164,8972
2/4/2013,2013,2,4, 21 ,6188,1277,1156,8621
2/4/2013,2013,2,4, 22 ,5858,1161,1078,8097
2/4/2013,2013,2,4, 23 ,5395,1036,948,7379
2/4/2013,2013,2,4, 24 ,4977,956,880,6813
2/5/2013,2013,2,5, 1 ,4737,909,811,6457
2/5/2013,2013,2,5, 2 ,4614,885,825,6324
2/5/2013,2013,2,5, 3 ,4435,865,793,6093
2/5/2013,2013,2,5, 4 ,4437,861,791,6089
2/5/2013,2013,2,5, 5 ,4606,896,837,6339
2/5/2013,2013,2,5, 6 ,4777,955,912,6644
2/5/2013,2013,2,5, 7 ,4806,916,842,6564
2/5/2013,2013,2,5, 8 ,5424,1016,935,7375
2/5/2013,2013,2,5, 9 ,6137,1199,1087,8423
2/5/2013,2013,2,5, 10 ,6651,1271,1158,9080
2/5/2013,2013,2,5, 11 ,6881,1334,1162,9377
2/5/2013,2013,2,5, 12 ,6749,1307,1129,9185
2/5/2013,2013,2,5, 13 ,6733,1290,1143,9166
2/5/2013,2013,2,5, 14 ,6996,1338,1185,9519
2/5/2013,2013,2,5, 15 ,6903,1341,1178,9422
2/5/2013,2013,2,5, 16 ,6841,1316,1170,9327
2/5/2013,2013,2,5, 17 ,6490,1255,1119,8864
2/5/2013,2013,2,5, 18 ,6354,1346,1189,8889
2/5/2013,2013,2,5, 19 ,6771,1414,1231,9416
2/5/2013,2013,2,5, 20 ,6477,1333,1203,9013
2/5/2013,2013,2,5, 21 ,6240,1265,1189,8694
2/5/2013,2013,2,5, 22 ,5855,1150,1110,8115
2/5/2013,2013,2,5, 23 ,5354,1022,1083,7459
2/5/2013,2013,2,5, 24 ,4936,955,909,6800
2/6/2013,2013,2,6, 1 ,4707,913,853,6473
2/6/2013,2013,2,6, 2 ,4585,884,821,6290
2/6/2013,2013,2,6, 3 ,4426,864,809,6099
2/6/2013,2013,2,6, 4 ,4404,857,803,6064
2/6/2013,2013,2,6, 5 ,4589,899,850,6338
2/6/2013,2013,2,6, 6 ,4850,951,912,6713
2/6/2013,2013,2,6, 7 ,4831,921,848,6600
2/6/2013,2013,2,6, 8 ,5429,1016,922,7367
2/6/2013,2013,2,6, 9 ,6095,1210,1080,8385
2/6/2013,2013,2,6, 10 ,6622,1293,1167,9082
2/6/2013,2013,2,6, 11 ,6879,1361,1195,9435
2/6/2013,2013,2,6, 12 ,6730,1332,1163,9225
2/6/2013,2013,2,6, 13 ,6709,1309,1156,9174
2/6/2013,2013,2,6, 14 ,7027,1371,1179,9577
2/6/2013,2013,2,6, 15 ,6920,1370,1167,9457
2/6/2013,2013,2,6, 16 ,6811,1341,1132,9284
2/6/2013,2013,2,6, 17 ,6554,1272,1118,8944
2/6/2013,2013,2,6, 18 ,6450,1351,1207,9008
2/6/2013,2013,2,6, 19 ,6838,1445,1203,9486
2/6/2013,2013,2,6, 20 ,6631,1324,1183,9138
2/6/2013,2013,2,6, 21 ,6389,1257,1162,8808
2/6/2013,2013,2,6, 22 ,6032,1147,1102,8281
2/6/2013,2013,2,6, 23 ,5463,1016,981,7460
2/6/2013,2013,2,6, 24 ,5078,940,878,6896
2/7/2013,2013,2,7, 1 ,4841,904,848,6593
2/7/2013,2013,2,7, 2 ,4746,880,810,6436
2/7/2013,2013,2,7, 3 ,4616,875,783,6274
2/7/2013,2013,2,7, 4 ,4576,863,786,6225
2/7/2013,2013,2,7, 5 ,4733,907,828,6468
2/7/2013,2013,2,7, 6 ,4965,956,887,6808
2/7/2013,2013,2,7, 7 ,4980,916,823,6719
2/7/2013,2013,2,7, 8 ,5534,1018,906,7458
2/7/2013,2013,2,7, 9 ,6284,1209,1073,8566
2/7/2013,2013,2,7, 10 ,6734,1311,1173,9218
2/7/2013,2013,2,7, 11 ,7030,1376,1182,9588
2/7/2013,2013,2,7, 12 ,6834,1347,1149,9330
2/7/2013,2013,2,7, 13 ,6830,1332,1159,9321
2/7/2013,2013,2,7, 14 ,7131,1391,1192,9714
2/7/2013,2013,2,7, 15 ,7009,1369,1186,9564
2/7/2013,2013,2,7, 16 ,6868,1337,1164,9369
2/7/2013,2013,2,7, 17 ,6615,1254,1129,8998
2/7/2013,2013,2,7, 18 ,6622,1354,1211,9187
2/7/2013,2013,2,7, 19 ,6891,1438,1192,9521
2/7/2013,2013,2,7, 20 ,6652,1354,1170,9176
2/7/2013,2013,2,7, 21 ,6435,1299,1172,8906
2/7/2013,2013,2,7, 22 ,6038,1174,1111,8323
2/7/2013,2013,2,7, 23 ,5583,1052,977,7612
2/7/2013,2013,2,7, 24 ,5135,961,908,7004
2/8/2013,2013,2,8, 1 ,4873,933,861,6667
2/8/2013,2013,2,8, 2 ,4758,900,834,6492
2/8/2013,2013,2,8, 3 ,4642,876,817,6335
2/8/2013,2013,2,8, 4 ,4583,870,807,6260
2/8/2013,2013,2,8, 5 ,4710,897,846,6453
2/8/2013,2013,2,8, 6 ,4935,946,894,6775
2/8/2013,2013,2,8, 7 ,4911,910,833,6654
2/8/2013,2013,2,8, 8 ,5486,1010,911,7407
2/8/2013,2013,2,8, 9 ,6200,1202,1102,8504
2/8/2013,2013,2,8, 10 ,6813,1312,1176,9301
2/8/2013,2013,2,8, 11 ,7058,1380,1209,9647
2/8/2013,2013,2,8, 12 ,6883,1344,1196,9423
2/8/2013,2013,2,8, 13 ,6879,1327,1186,9392
2/8/2013,2013,2,8, 14 ,7194,1385,1199,9778
2/8/2013,2013,2,8, 15 ,7026,1362,1180,9568
2/8/2013,2013,2,8, 16 ,6987,1339,1193,9519
2/8/2013,2013,2,8, 17 ,6592,1244,1151,8987
2/8/2013,2013,2,8, 18 ,6564,1317,1189,9070
2/8/2013,2013,2,8, 19 ,6912,1430,1202,9544
2/8/2013,2013,2,8, 20 ,6697,1357,1193,9247
2/8/2013,2013,2,8, 21 ,6481,1287,1191,8959
2/8/2013,2013,2,8, 22 ,6119,1186,1091,8396
2/8/2013,2013,2,8, 23 ,5678,1063,985,7726
2/8/2013,2013,2,8, 24 ,5278,984,892,7154
2/9/2013,2013,2,9, 1 ,4944,933,846,6723
2/9/2013,2013,2,9, 2 ,4792,902,825,6519
2/9/2013,2013,2,9, 3 ,4633,884,805,6322
2/9/2013,2013,2,9, 4 ,4563,867,797,6227
2/9/2013,2013,2,9, 5 ,4571,882,815,6268
2/9/2013,2013,2,9, 6 ,4667,898,839,6404
2/9/2013,2013,2,9, 7 ,4677,902,828,6407
2/9/2013,2013,2,9, 8 ,5084,971,889,6944
2/9/2013,2013,2,9, 9 ,5577,1116,988,7681
2/9/2013,2013,2,9, 10 ,6108,1198,1075,8381
2/9/2013,2013,2,9, 11 ,6315,1244,1118,8677
2/9/2013,2013,2,9, 12 ,6218,1210,1095,8523
2/9/2013,2013,2,9, 13 ,6074,1206,1096,8376
2/9/2013,2013,2,9, 14 ,6202,1247,1100,8549
2/9/2013,2013,2,9, 15 ,6058,1212,1083,8353
2/9/2013,2013,2,9, 16 ,5901,1181,1052,8134
2/9/2013,2013,2,9, 17 ,5745,1135,1025,7905
2/9/2013,2013,2,9, 18 ,5875,1244,1140,8259
2/9/2013,2013,2,9, 19 ,6290,1351,1159,8800
2/9/2013,2013,2,9, 20 ,6158,1301,1121,8580
2/9/2013,2013,2,9, 21 ,5999,1229,1091,8319
2/9/2013,2013,2,9, 22 ,5609,1114,1028,7751
2/9/2013,2013,2,9, 23 ,5293,1024,966,7283
2/9/2013,2013,2,9, 24 ,4975,960,877,6812
2/10/2013,2013,2,10, 1 ,4660,909,830,6399
2/10/2013,2013,2,10, 2 ,4529,874,793,6196
2/10/2013,2013,2,10, 3 ,4397,844,764,6005
2/10/2013,2013,2,10, 4 ,4304,825,747,5876
2/10/2013,2013,2,10, 5 ,4194,837,758,5789
2/10/2013,2013,2,10, 6 ,4225,830,778,5833
2/10/2013,2013,2,10, 7 ,4107,821,759,5687
2/10/2013,2013,2,10, 8 ,4409,854,782,6045
2/10/2013,2013,2,10, 9 ,4749,930,850,6529
2/10/2013,2013,2,10, 10 ,5164,1005,915,7084
2/10/2013,2013,2,10, 11 ,5441,1040,961,7442
2/10/2013,2013,2,10, 12 ,5399,1044,960,7403
2/10/2013,2013,2,10, 13 ,5411,1047,965,7423
2/10/2013,2013,2,10, 14 ,5474,1058,1000,7532
2/10/2013,2013,2,10, 15 ,5424,1048,999,7471
2/10/2013,2013,2,10, 16 ,5244,1027,978,7249
2/10/2013,2013,2,10, 17 ,5111,1005,947,7063
2/10/2013,2013,2,10, 18 ,5373,1142,1081,7596
2/10/2013,2013,2,10, 19 ,5964,1282,1124,8370
2/10/2013,2013,2,10, 20 ,5921,1237,1102,8260
2/10/2013,2013,2,10, 21 ,5681,1175,1056,7912
2/10/2013,2013,2,10, 22 ,5309,1085,988,7382
2/10/2013,2013,2,10, 23 ,5005,988,900,6893
2/10/2013,2013,2,10, 24 ,4672,919,822,6413
2/11/2013,2013,2,11, 1 ,4373,863,766,6002
2/11/2013,2013,2,11, 2 ,4232,841,736,5809
2/11/2013,2013,2,11, 3 ,4115,822,708,5645
2/11/2013,2013,2,11, 4 ,4043,809,703,5555
2/11/2013,2013,2,11, 5 ,4190,845,767,5802
2/11/2013,2013,2,11, 6 ,4549,899,817,6265
2/11/2013,2013,2,11, 7 ,4660,883,767,6310
2/11/2013,2013,2,11, 8 ,5269,974,864,7107
2/11/2013,2013,2,11, 9 ,6103,1140,1011,8254
2/11/2013,2013,2,11, 10 ,6629,1231,1051,8911
2/11/2013,2013,2,11, 11 ,6925,1276,1129,9330
2/11/2013,2013,2,11, 12 ,6814,1250,1120,9184
2/11/2013,2013,2,11, 13 ,6775,1235,1112,9122
2/11/2013,2013,2,11, 14 ,6992,1288,1144,9424
2/11/2013,2013,2,11, 15 ,6869,1269,1148,9286
2/11/2013,2013,2,11, 16 ,6769,1252,1132,9153
2/11/2013,2013,2,11, 17 ,6517,1240,1091,8848
2/11/2013,2013,2,11, 18 ,6342,1309,1161,8812
2/11/2013,2013,2,11, 19 ,6759,1376,1145,9280
2/11/2013,2013,2,11, 20 ,6577,1319,1136,9032
2/11/2013,2013,2,11, 21 ,6329,1249,1123,8701
2/11/2013,2013,2,11, 22 ,5935,1115,1036,8086
2/11/2013,2013,2,11, 23 ,5454,1001,940,7395
2/11/2013,2013,2,11, 24 ,5080,915,868,6863
2/12/2013,2013,2,12, 1 ,4908,882,836,6626
2/12/2013,2013,2,12, 2 ,4791,863,808,6462
2/12/2013,2013,2,12, 3 ,4581,845,766,6192
2/12/2013,2013,2,12, 4 ,4562,840,767,6169
2/12/2013,2013,2,12, 5 ,4776,882,805,6463
2/12/2013,2013,2,12, 6 ,4945,940,875,6760
2/12/2013,2013,2,12, 7 ,4973,893,810,6676
2/12/2013,2013,2,12, 8 ,5522,990,895,7407
2/12/2013,2013,2,12, 9 ,6283,1185,1030,8498
2/12/2013,2013,2,12, 10 ,6716,1289,1112,9117
2/12/2013,2013,2,12, 11 ,6954,1342,1167,9463
2/12/2013,2013,2,12, 12 ,6836,1280,1136,9252
2/12/2013,2013,2,12, 13 ,6782,1276,1132,9190
2/12/2013,2013,2,12, 14 ,7035,1320,1142,9497
2/12/2013,2013,2,12, 15 ,6903,1284,1139,9326
2/12/2013,2013,2,12, 16 ,6793,1284,1130,9207
2/12/2013,2013,2,12, 17 ,6500,1246,1106,8852
2/12/2013,2013,2,12, 18 ,6437,1318,1171,8926
2/12/2013,2013,2,12, 19 ,6766,1410,1162,9338
2/12/2013,2013,2,12, 20 ,6551,1347,1183,9081
2/12/2013,2013,2,12, 21 ,6336,1256,1148,8740
2/12/2013,2013,2,12, 22 ,5925,1147,1086,8158
2/12/2013,2013,2,12, 23 ,5434,1029,955,7418
2/12/2013,2013,2,12, 24 ,5115,949,866,6930
2/13/2013,2013,2,13, 1 ,4835,905,862,6602
2/13/2013,2013,2,13, 2 ,4680,877,813,6370
2/13/2013,2013,2,13, 3 ,4540,853,793,6186
2/13/2013,2013,2,13, 4 ,4480,845,809,6134
2/13/2013,2013,2,13, 5 ,4669,894,841,6404
2/13/2013,2013,2,13, 6 ,4950,946,885,6781
2/13/2013,2013,2,13, 7 ,4880,901,827,6608
2/13/2013,2013,2,13, 8 ,5490,999,931,7420
2/13/2013,2013,2,13, 9 ,6198,1195,1062,8455
2/13/2013,2013,2,13, 10 ,6631,1289,1119,9039
2/13/2013,2013,2,13, 11 ,6906,1361,1151,9418
2/13/2013,2013,2,13, 12 ,6792,1304,1126,9222
2/13/2013,2013,2,13, 13 ,6725,1303,1135,9163
2/13/2013,2013,2,13, 14 ,7006,1351,1173,9530
2/13/2013,2013,2,13, 15 ,6932,1343,1158,9433
2/13/2013,2013,2,13, 16 ,6824,1321,1153,9298
2/13/2013,2013,2,13, 17 ,6507,1240,1125,8872
2/13/2013,2013,2,13, 18 ,6394,1321,1161,8876
2/13/2013,2013,2,13, 19 ,6758,1405,1174,9337
2/13/2013,2013,2,13, 20 ,6606,1365,1155,9126
2/13/2013,2013,2,13, 21 ,6368,1303,1125,8796
2/13/2013,2013,2,13, 22 ,5999,1183,1067,8249
2/13/2013,2013,2,13, 23 ,5477,1061,971,7509
2/13/2013,2013,2,13, 24 ,5209,965,916,7090
2/14/2013,2013,2,14, 1 ,4864,934,813,6611
2/14/2013,2013,2,14, 2 ,4740,892,817,6449
2/14/2013,2013,2,14, 3 ,4605,872,795,6272
2/14/2013,2013,2,14, 4 ,4550,863,805,6218
2/14/2013,2013,2,14, 5 ,4702,898,839,6439
2/14/2013,2013,2,14, 6 ,4926,955,884,6765
2/14/2013,2013,2,14, 7 ,4969,919,839,6727
2/14/2013,2013,2,14, 8 ,5555,1021,927,7503
2/14/2013,2013,2,14, 9 ,6234,1211,1064,8509
2/14/2013,2013,2,14, 10 ,6673,1306,1124,9103
2/14/2013,2013,2,14, 11 ,6975,1354,1157,9486
2/14/2013,2013,2,14, 12 ,6802,1322,1142,9266
2/14/2013,2013,2,14, 13 ,6840,1323,1151,9314
2/14/2013,2013,2,14, 14 ,7113,1378,1162,9653
2/14/2013,2013,2,14, 15 ,7032,1359,1148,9539
2/14/2013,2013,2,14, 16 ,6891,1334,1142,9367
2/14/2013,2013,2,14, 17 ,6565,1256,1106,8927
2/14/2013,2013,2,14, 18 ,6439,1313,1138,8890
2/14/2013,2013,2,14, 19 ,6778,1427,1137,9342
2/14/2013,2013,2,14, 20 ,6659,1358,1116,9133
2/14/2013,2013,2,14, 21 ,6391,1308,1109,8808
2/14/2013,2013,2,14, 22 ,6105,1191,1061,8357
2/14/2013,2013,2,14, 23 ,5564,1069,964,7597
2/14/2013,2013,2,14, 24 ,5216,985,887,7088
2/15/2013,2013,2,15, 1 ,4969,937,848,6754
2/15/2013,2013,2,15, 2 ,4805,905,828,6538
2/15/2013,2013,2,15, 3 ,4722,890,805,6417
2/15/2013,2013,2,15, 4 ,4718,873,796,6387
2/15/2013,2013,2,15, 5 ,4825,900,825,6550
2/15/2013,2013,2,15, 6 ,4996,948,875,6819
2/15/2013,2013,2,15, 7 ,5056,918,831,6805
2/15/2013,2013,2,15, 8 ,5678,994,905,7577
2/15/2013,2013,2,15, 9 ,6295,1177,992,8464
2/15/2013,2013,2,15, 10 ,6691,1239,1077,9007
2/15/2013,2013,2,15, 11 ,7028,1285,1087,9400
2/15/2013,2013,2,15, 12 ,6934,1267,1079,9280
2/15/2013,2013,2,15, 13 ,6892,1260,1096,9248
2/15/2013,2013,2,15, 14 ,7133,1275,1108,9516
2/15/2013,2013,2,15, 15 ,7058,1266,1110,9434
2/15/2013,2013,2,15, 16 ,6956,1253,1094,9303
2/15/2013,2013,2,15, 17 ,6638,1214,1072,8924
2/15/2013,2013,2,15, 18 ,6436,1292,1122,8850
2/15/2013,2013,2,15, 19 ,6891,1371,1105,9367
2/15/2013,2013,2,15, 20 ,6615,1314,1099,9028
2/15/2013,2013,2,15, 21 ,6458,1243,1101,8802
2/15/2013,2013,2,15, 22 ,6107,1124,1024,8255
2/15/2013,2013,2,15, 23 ,5619,1001,940,7560
2/15/2013,2013,2,15, 24 ,5218,927,892,7037
2/16/2013,2013,2,16, 1 ,4917,888,833,6638
2/16/2013,2013,2,16, 2 ,4792,851,810,6453
2/16/2013,2013,2,16, 3 ,4662,823,788,6273
2/16/2013,2013,2,16, 4 ,4595,824,780,6199
2/16/2013,2013,2,16, 5 ,4611,835,794,6240
2/16/2013,2013,2,16, 6 ,4657,862,819,6338
2/16/2013,2013,2,16, 7 ,4621,858,800,6279
2/16/2013,2013,2,16, 8 ,5078,942,850,6870
2/16/2013,2013,2,16, 9 ,5636,1064,927,7627
2/16/2013,2013,2,16, 10 ,6043,1146,980,8169
2/16/2013,2013,2,16, 11 ,6351,1195,1038,8584
2/16/2013,2013,2,16, 12 ,6191,1181,1014,8386
2/16/2013,2013,2,16, 13 ,6177,1188,964,8329
2/16/2013,2013,2,16, 14 ,6342,1219,1010,8571
2/16/2013,2013,2,16, 15 ,6231,1187,999,8417
2/16/2013,2013,2,16, 16 ,6017,1156,985,8158
2/16/2013,2013,2,16, 17 ,5704,1104,991,7799
2/16/2013,2013,2,16, 18 ,5795,1223,1073,8091
2/16/2013,2013,2,16, 19 ,6374,1337,1055,8766
2/16/2013,2013,2,16, 20 ,6229,1297,1049,8575
2/16/2013,2013,2,16, 21 ,6064,1232,1020,8316
2/16/2013,2013,2,16, 22 ,5835,1116,972,7923
2/16/2013,2013,2,16, 23 ,5384,1015,907,7306
2/16/2013,2013,2,16, 24 ,5062,943,814,6819
2/17/2013,2013,2,17, 1 ,4744,890,776,6410
2/17/2013,2013,2,17, 2 ,4691,864,749,6304
2/17/2013,2013,2,17, 3 ,4535,832,728,6095
2/17/2013,2013,2,17, 4 ,4474,821,716,6011
2/17/2013,2013,2,17, 5 ,4413,826,740,5979
2/17/2013,2013,2,17, 6 ,4386,820,752,5958
2/17/2013,2013,2,17, 7 ,4309,814,745,5868
2/17/2013,2013,2,17, 8 ,4491,833,784,6108
2/17/2013,2013,2,17, 9 ,4817,890,847,6554
2/17/2013,2013,2,17, 10 ,5292,965,902,7159
2/17/2013,2013,2,17, 11 ,5470,1008,933,7411
2/17/2013,2013,2,17, 12 ,5412,1009,938,7359
2/17/2013,2013,2,17, 13 ,5390,1015,937,7342
2/17/2013,2013,2,17, 14 ,5424,1005,938,7367
2/17/2013,2013,2,17, 15 ,5307,1015,921,7243
2/17/2013,2013,2,17, 16 ,5232,997,918,7147
2/17/2013,2013,2,17, 17 ,5128,973,937,7038
2/17/2013,2013,2,17, 18 ,5393,1137,995,7525
2/17/2013,2013,2,17, 19 ,5997,1280,1061,8338
2/17/2013,2013,2,17, 20 ,5907,1252,1055,8214
2/17/2013,2013,2,17, 21 ,5805,1180,1006,7991
2/17/2013,2013,2,17, 22 ,5393,1087,926,7406
2/17/2013,2013,2,17, 23 ,5120,988,874,6982
2/17/2013,2013,2,17, 24 ,4657,909,775,6341
2/18/2013,2013,2,18, 1 ,4476,866,759,6101
2/18/2013,2013,2,18, 2 ,4316,833,736,5885
2/18/2013,2013,2,18, 3 ,4214,822,713,5749
2/18/2013,2013,2,18, 4 ,4198,822,709,5729
2/18/2013,2013,2,18, 5 ,4378,862,752,5992
2/18/2013,2013,2,18, 6 ,4676,927,838,6441
2/18/2013,2013,2,18, 7 ,4689,896,800,6385
2/18/2013,2013,2,18, 8 ,5399,1003,862,7264
2/18/2013,2013,2,18, 9 ,6145,1194,1010,8349
2/18/2013,2013,2,18, 10 ,6719,1288,1057,9064
2/18/2013,2013,2,18, 11 ,7009,1319,1111,9439
2/18/2013,2013,2,18, 12 ,6895,1286,1093,9274
2/18/2013,2013,2,18, 13 ,6873,1273,1075,9221
2/18/2013,2013,2,18, 14 ,7111,1308,1122,9541
2/18/2013,2013,2,18, 15 ,7037,1281,1090,9408
2/18/2013,2013,2,18, 16 ,6867,1264,1117,9248
2/18/2013,2013,2,18, 17 ,6554,1220,1094,8868
2/18/2013,2013,2,18, 18 ,6369,1333,1163,8865
2/18/2013,2013,2,18, 19 ,6759,1407,1133,9299
2/18/2013,2013,2,18, 20 ,6561,1345,1087,8993
2/18/2013,2013,2,18, 21 ,6314,1261,1072,8647
2/18/2013,2013,2,18, 22 ,5972,1146,935,8053
2/18/2013,2013,2,18, 23 ,5435,1034,859,7328
2/18/2013,2013,2,18, 24 ,5109,949,796,6854
2/19/2013,2013,2,19, 1 ,4833,921,756,6510
2/19/2013,2013,2,19, 2 ,4714,896,737,6347
2/19/2013,2013,2,19, 3 ,4571,876,722,6169
2/19/2013,2013,2,19, 4 ,4584,863,726,6173
2/19/2013,2013,2,19, 5 ,4691,898,748,6337
2/19/2013,2013,2,19, 6 ,4884,962,811,6657
2/19/2013,2013,2,19, 7 ,4928,936,865,6729
2/19/2013,2013,2,19, 8 ,5470,1018,893,7381
2/19/2013,2013,2,19, 9 ,6199,1169,1025,8393
2/19/2013,2013,2,19, 10 ,6654,1230,1078,8962
2/19/2013,2013,2,19, 11 ,6940,1262,1098,9300
2/19/2013,2013,2,19, 12 ,6790,1218,1095,9103
2/19/2013,2013,2,19, 13 ,6784,1185,1085,9054
2/19/2013,2013,2,19, 14 ,7043,1216,1116,9375
2/19/2013,2013,2,19, 15 ,6928,1206,1110,9244
2/19/2013,2013,2,19, 16 ,6840,1208,1120,9168
2/19/2013,2013,2,19, 17 ,6561,1211,1097,8869
2/19/2013,2013,2,19, 18 ,6449,1306,1168,8923
2/19/2013,2013,2,19, 19 ,6801,1316,1193,9310
2/19/2013,2013,2,19, 20 ,6577,1237,1152,8966
2/19/2013,2013,2,19, 21 ,6367,1153,1077,8597
2/19/2013,2013,2,19, 22 ,5991,1031,981,8003
2/19/2013,2013,2,19, 23 ,5524,933,881,7338
2/19/2013,2013,2,19, 24 ,5191,857,807,6855
2/20/2013,2013,2,20, 1 ,4910,842,778,6530
2/20/2013,2013,2,20, 2 ,4740,817,754,6311
2/20/2013,2013,2,20, 3 ,4627,803,744,6174
2/20/2013,2013,2,20, 4 ,4621,802,737,6160
2/20/2013,2013,2,20, 5 ,4744,830,779,6353
2/20/2013,2013,2,20, 6 ,5007,916,853,6776
2/20/2013,2013,2,20, 7 ,4996,941,844,6781
2/20/2013,2013,2,20, 8 ,5551,1000,892,7443
2/20/2013,2013,2,20, 9 ,6330,1148,1011,8489
2/20/2013,2013,2,20, 10 ,6692,1200,1117,9009
2/20/2013,2013,2,20, 11 ,6315,1237,1175,8727
2/20/2013,2013,2,20, 12 ,6494,1206,1161,8861
2/20/2013,2013,2,20, 13 ,6516,1191,1137,8844
2/20/2013,2013,2,20, 14 ,6754,1232,1196,9182
2/20/2013,2013,2,20, 15 ,6571,1221,1178,8970
2/20/2013,2013,2,20, 16 ,6560,1229,1160,8949
2/20/2013,2013,2,20, 17 ,6226,1197,1135,8558
2/20/2013,2013,2,20, 18 ,6087,1326,1215,8628
2/20/2013,2013,2,20, 19 ,6541,1346,1243,9130
2/20/2013,2013,2,20, 20 ,6378,1296,1202,8876
2/20/2013,2013,2,20, 21 ,6171,1199,1147,8517
2/20/2013,2013,2,20, 22 ,5818,1087,1006,7911
2/20/2013,2013,2,20, 23 ,5303,966,917,7186
2/20/2013,2013,2,20, 24 ,5015,900,834,6749
2/21/2013,2013,2,21, 1 ,4787,856,780,6423
2/21/2013,2013,2,21, 2 ,4609,830,745,6184
2/21/2013,2013,2,21, 3 ,4524,815,754,6093
2/21/2013,2013,2,21, 4 ,4525,813,749,6087
2/21/2013,2013,2,21, 5 ,4718,859,794,6371
2/21/2013,2013,2,21, 6 ,4970,929,876,6775
2/21/2013,2013,2,21, 7 ,5004,907,832,6743
2/21/2013,2013,2,21, 8 ,5523,990,886,7399
2/21/2013,2013,2,21, 9 ,6140,1178,1022,8340
2/21/2013,2013,2,21, 10 ,6594,1276,1111,8981
2/21/2013,2013,2,21, 11 ,6804,1330,1193,9327
2/21/2013,2013,2,21, 12 ,6657,1303,1190,9150
2/21/2013,2013,2,21, 13 ,6620,1308,1180,9108
2/21/2013,2013,2,21, 14 ,6828,1350,1220,9398
2/21/2013,2013,2,21, 15 ,6755,1330,1214,9299
2/21/2013,2013,2,21, 16 ,6581,1304,1170,9055
2/21/2013,2013,2,21, 17 ,6498,1249,1156,8903
2/21/2013,2013,2,21, 18 ,6528,1326,1233,9087
2/21/2013,2013,2,21, 19 ,6709,1407,1255,9371
2/21/2013,2013,2,21, 20 ,6499,1354,1217,9070
2/21/2013,2013,2,21, 21 ,6290,1274,1172,8736
2/21/2013,2013,2,21, 22 ,5897,1166,1037,8100
2/21/2013,2013,2,21, 23 ,5438,1037,947,7422
2/21/2013,2013,2,21, 24 ,5055,950,873,6878
2/22/2013,2013,2,22, 1 ,4780,911,834,6525
2/22/2013,2013,2,22, 2 ,4633,886,810,6329
2/22/2013,2013,2,22, 3 ,4568,868,789,6225
2/22/2013,2013,2,22, 4 ,4503,862,788,6153
2/22/2013,2013,2,22, 5 ,4649,898,818,6365
2/22/2013,2013,2,22, 6 ,4892,959,863,6714
2/22/2013,2013,2,22, 7 ,5016,930,849,6795
2/22/2013,2013,2,22, 8 ,5512,1014,921,7447
2/22/2013,2013,2,22, 9 ,6037,1185,1047,8269
2/22/2013,2013,2,22, 10 ,6430,1270,1122,8822
2/22/2013,2013,2,22, 11 ,6579,1328,1168,9075
2/22/2013,2013,2,22, 12 ,6291,1310,1141,8742
2/22/2013,2013,2,22, 13 ,6322,1301,1127,8750
2/22/2013,2013,2,22, 14 ,6448,1347,1143,8938
2/22/2013,2013,2,22, 15 ,6411,1316,1131,8858
2/22/2013,2013,2,22, 16 ,6351,1304,1116,8771
2/22/2013,2013,2,22, 17 ,6190,1240,1114,8544
2/22/2013,2013,2,22, 18 ,6236,1314,1178,8728
2/22/2013,2013,2,22, 19 ,6491,1397,1168,9056
2/22/2013,2013,2,22, 20 ,6211,1338,1124,8673
2/22/2013,2013,2,22, 21 ,6020,1288,1102,8410
2/22/2013,2013,2,22, 22 ,5575,1182,961,7718
2/22/2013,2013,2,22, 23 ,5127,1059,888,7074
2/22/2013,2013,2,22, 24 ,4845,985,833,6663
2/23/2013,2013,2,23, 1 ,4608,937,792,6337
2/23/2013,2013,2,23, 2 ,4423,911,769,6103
2/23/2013,2013,2,23, 3 ,4342,886,741,5969
2/23/2013,2013,2,23, 4 ,4258,869,739,5866
2/23/2013,2013,2,23, 5 ,4299,882,756,5937
2/23/2013,2013,2,23, 6 ,4392,912,797,6101
2/23/2013,2013,2,23, 7 ,4550,911,802,6263
2/23/2013,2013,2,23, 8 ,4968,987,839,6794
2/23/2013,2013,2,23, 9 ,5484,1129,945,7558
2/23/2013,2013,2,23, 10 ,6001,1212,1049,8262
2/23/2013,2013,2,23, 11 ,6245,1274,1098,8617
2/23/2013,2013,2,23, 12 ,6108,1249,1091,8448
2/23/2013,2013,2,23, 13 ,6060,1247,1112,8419
2/23/2013,2013,2,23, 14 ,6249,1277,1141,8667
2/23/2013,2013,2,23, 15 ,6177,1239,1111,8527
2/23/2013,2013,2,23, 16 ,5948,1206,1084,8238
2/23/2013,2013,2,23, 17 ,5727,1163,1058,7948
2/23/2013,2013,2,23, 18 ,5773,1234,1148,8155
2/23/2013,2013,2,23, 19 ,6292,1377,1184,8853
2/23/2013,2013,2,23, 20 ,6146,1331,1139,8616
2/23/2013,2013,2,23, 21 ,5987,1274,1118,8379
2/23/2013,2013,2,23, 22 ,5694,1187,1036,7917
2/23/2013,2013,2,23, 23 ,5278,1071,935,7284
2/23/2013,2013,2,23, 24 ,4942,985,843,6770
2/24/2013,2013,2,24, 1 ,4700,930,805,6435
2/24/2013,2013,2,24, 2 ,4556,904,785,6245
2/24/2013,2013,2,24, 3 ,4398,879,762,6039
2/24/2013,2013,2,24, 4 ,4300,859,749,5908
2/24/2013,2013,2,24, 5 ,4285,861,762,5908
2/24/2013,2013,2,24, 6 ,4273,857,778,5908
2/24/2013,2013,2,24, 7 ,4175,840,722,5737
2/24/2013,2013,2,24, 8 ,4371,862,725,5958
2/24/2013,2013,2,24, 9 ,4732,933,824,6489
2/24/2013,2013,2,24, 10 ,5151,1007,866,7024
2/24/2013,2013,2,24, 11 ,5417,1042,923,7382
2/24/2013,2013,2,24, 12 ,5342,1056,921,7319
2/24/2013,2013,2,24, 13 ,5389,1065,944,7398
2/24/2013,2013,2,24, 14 ,5356,1074,951,7381
2/24/2013,2013,2,24, 15 ,5348,1063,933,7344
2/24/2013,2013,2,24, 16 ,5180,1031,920,7131
2/24/2013,2013,2,24, 17 ,5111,1017,864,6992
2/24/2013,2013,2,24, 18 ,5294,1178,997,7469
2/24/2013,2013,2,24, 19 ,5904,1316,1151,8371
2/24/2013,2013,2,24, 20 ,5885,1283,1114,8282
2/24/2013,2013,2,24, 21 ,5657,1203,1076,7936
2/24/2013,2013,2,24, 22 ,5385,1123,994,7502
2/24/2013,2013,2,24, 23 ,5027,1029,882,6938
2/24/2013,2013,2,24, 24 ,4721,957,824,6502
2/25/2013,2013,2,25, 1 ,4504,908,773,6185
2/25/2013,2013,2,25, 2 ,4365,875,736,5976
2/25/2013,2013,2,25, 3 ,4203,853,716,5772
2/25/2013,2013,2,25, 4 ,4182,843,710,5735
2/25/2013,2013,2,25, 5 ,4236,863,728,5827
2/25/2013,2013,2,25, 6 ,4434,893,770,6097
2/25/2013,2013,2,25, 7 ,4698,909,770,6377
2/25/2013,2013,2,25, 8 ,5367,1034,883,7284
2/25/2013,2013,2,25, 9 ,6091,1209,1013,8313
2/25/2013,2013,2,25, 10 ,6593,1261,1099,8953
2/25/2013,2013,2,25, 11 ,6886,1359,1181,9426
2/25/2013,2013,2,25, 12 ,6809,1328,1157,9294
2/25/2013,2013,2,25, 13 ,6757,1323,1175,9255
2/25/2013,2013,2,25, 14 ,6969,1366,1223,9558
2/25/2013,2013,2,25, 15 ,6886,1349,1209,9444
2/25/2013,2013,2,25, 16 ,6746,1330,1173,9249
2/25/2013,2013,2,25, 17 ,6436,1264,1116,8816
2/25/2013,2013,2,25, 18 ,6282,1331,1183,8796
2/25/2013,2013,2,25, 19 ,6690,1429,1230,9349
2/25/2013,2013,2,25, 20 ,6526,1368,1191,9085
2/25/2013,2013,2,25, 21 ,6295,1314,1150,8759
2/25/2013,2013,2,25, 22 ,5991,1192,1045,8228
2/25/2013,2013,2,25, 23 ,5498,1067,959,7524
2/25/2013,2013,2,25, 24 ,5095,989,863,6947
2/26/2013,2013,2,26, 1 ,4859,940,821,6620
2/26/2013,2013,2,26, 2 ,4699,905,800,6404
2/26/2013,2013,2,26, 3 ,4581,883,779,6243
2/26/2013,2013,2,26, 4 ,4554,874,773,6201
2/26/2013,2013,2,26, 5 ,4729,915,785,6429
2/26/2013,2013,2,26, 6 ,4948,966,870,6784
2/26/2013,2013,2,26, 7 ,4955,916,805,6676
2/26/2013,2013,2,26, 8 ,5590,1020,897,7507
2/26/2013,2013,2,26, 9 ,6225,1203,1062,8490
2/26/2013,2013,2,26, 10 ,6670,1291,1115,9076
2/26/2013,2013,2,26, 11 ,6958,1327,1154,9439
2/26/2013,2013,2,26, 12 ,6722,1295,1120,9137
2/26/2013,2013,2,26, 13 ,6834,1282,1147,9263
2/26/2013,2013,2,26, 14 ,6995,1322,1190,9507
2/26/2013,2013,2,26, 15 ,6895,1303,1177,9375
2/26/2013,2013,2,26, 16 ,6792,1273,1158,9223
2/26/2013,2013,2,26, 17 ,6521,1227,1119,8867
2/26/2013,2013,2,26, 18 ,6367,1318,1160,8845
2/26/2013,2013,2,26, 19 ,6845,1405,1178,9428
2/26/2013,2013,2,26, 20 ,6676,1338,1187,9201
2/26/2013,2013,2,26, 21 ,6397,1272,1168,8837
2/26/2013,2013,2,26, 22 ,6047,1137,1077,8261
2/26/2013,2013,2,26, 23 ,5505,1020,980,7505
2/26/2013,2013,2,26, 24 ,5229,951,880,7060
2/27/2013,2013,2,27, 1 ,4908,918,836,6662
2/27/2013,2013,2,27, 2 ,4751,893,800,6444
2/27/2013,2013,2,27, 3 ,4601,874,785,6260
2/27/2013,2013,2,27, 4 ,4600,864,783,6247
2/27/2013,2013,2,27, 5 ,4731,907,831,6469
2/27/2013,2013,2,27, 6 ,4960,964,893,6817
2/27/2013,2013,2,27, 7 ,4909,920,836,6665
2/27/2013,2013,2,27, 8 ,5569,1030,967,7566
2/27/2013,2013,2,27, 9 ,6326,1201,1086,8613
2/27/2013,2013,2,27, 10 ,6896,1295,1145,9336
2/27/2013,2013,2,27, 11 ,7155,1341,1172,9668
2/27/2013,2013,2,27, 12 ,7021,1309,1166,9496
2/27/2013,2013,2,27, 13 ,6928,1312,1172,9412
2/27/2013,2013,2,27, 14 ,7194,1365,1196,9755
2/27/2013,2013,2,27, 15 ,7121,1349,1173,9643
2/27/2013,2013,2,27, 16 ,7007,1333,1182,9522
2/27/2013,2013,2,27, 17 ,6651,1254,1145,9050
2/27/2013,2013,2,27, 18 ,6525,1311,1200,9036
2/27/2013,2013,2,27, 19 ,6951,1438,1233,9622
2/27/2013,2013,2,27, 20 ,6779,1383,1209,9371
2/27/2013,2013,2,27, 21 ,6506,1312,1208,9026
2/27/2013,2013,2,27, 22 ,6195,1185,1117,8497
2/27/2013,2013,2,27, 23 ,5636,1051,1013,7700
2/27/2013,2013,2,27, 24 ,5268,986,921,7175
2/28/2013,2013,2,28, 1 ,4970,938,872,6780
2/28/2013,2013,2,28, 2 ,4868,910,842,6620
2/28/2013,2013,2,28, 3 ,4738,886,825,6449
2/28/2013,2013,2,28, 4 ,4721,881,809,6411
2/28/2013,2013,2,28, 5 ,4772,915,850,6537
2/28/2013,2013,2,28, 6 ,4977,962,885,6824
2/28/2013,2013,2,28, 7 ,4978,909,834,6721
2/28/2013,2013,2,28, 8 ,5568,1020,958,7546
2/28/2013,2013,2,28, 9 ,6350,1213,1087,8650
2/28/2013,2013,2,28, 10 ,6840,1303,1159,9302
2/28/2013,2013,2,28, 11 ,7123,1357,1195,9675
2/28/2013,2013,2,28, 12 ,6969,1324,1167,9460
2/28/2013,2013,2,28, 13 ,6979,1343,1175,9497
2/28/2013,2013,2,28, 14 ,7236,1376,1191,9803
2/28/2013,2013,2,28, 15 ,7137,1352,1194,9683
2/28/2013,2013,2,28, 16 ,7033,1312,1190,9535
2/28/2013,2013,2,28, 17 ,6747,1235,1158,9140
2/28/2013,2013,2,28, 18 ,6489,1279,1202,8970
2/28/2013,2013,2,28, 19 ,6922,1403,1205,9530
2/28/2013,2013,2,28, 20 ,6759,1362,1186,9307
2/28/2013,2013,2,28, 21 ,6566,1293,1159,9018
2/28/2013,2013,2,28, 22 ,6190,1165,1101,8456
2/28/2013,2013,2,28, 23 ,5689,1047,989,7725
2/28/2013,2013,2,28, 24 ,5326,970,917,7213
3/1/2013,2013,3,1, 1 ,5031,917,868,6816
3/1/2013,2013,3,1, 2 ,4922,889,843,6654
3/1/2013,2013,3,1, 3 ,4725,869,810,6404
3/1/2013,2013,3,1, 4 ,4662,861,801,6324
3/1/2013,2013,3,1, 5 ,4709,897,842,6448
3/1/2013,2013,3,1, 6 ,4973,926,880,6779
3/1/2013,2013,3,1, 7 ,4920,889,815,6624
3/1/2013,2013,3,1, 8 ,5554,992,922,7468
3/1/2013,2013,3,1, 9 ,6304,1188,1033,8525
3/1/2013,2013,3,1, 10 ,6790,1278,1082,9150
3/1/2013,2013,3,1, 11 ,7062,1331,1091,9484
3/1/2013,2013,3,1, 12 ,6998,1308,1114,9420
3/1/2013,2013,3,1, 13 ,6957,1325,1127,9409
3/1/2013,2013,3,1, 14 ,7182,1376,1146,9704
3/1/2013,2013,3,1, 15 ,7122,1350,1132,9604
3/1/2013,2013,3,1, 16 ,6961,1327,1123,9411
3/1/2013,2013,3,1, 17 ,6657,1230,1096,8983
3/1/2013,2013,3,1, 18 ,6472,1274,1158,8904
3/1/2013,2013,3,1, 19 ,6862,1416,1158,9436
3/1/2013,2013,3,1, 20 ,6741,1376,1144,9261
3/1/2013,2013,3,1, 21 ,6481,1306,1156,8943
3/1/2013,2013,3,1, 22 ,6188,1192,1102,8482
3/1/2013,2013,3,1, 23 ,5752,1073,1007,7832
3/1/2013,2013,3,1, 24 ,5344,994,939,7277
3/2/2013,2013,3,2, 1 ,5045,936,884,6865
3/2/2013,2013,3,2, 2 ,4881,908,846,6635
3/2/2013,2013,3,2, 3 ,4669,889,817,6375
3/2/2013,2013,3,2, 4 ,4550,886,812,6248
3/2/2013,2013,3,2, 5 ,4548,888,827,6263
3/2/2013,2013,3,2, 6 ,4625,903,847,6375
3/2/2013,2013,3,2, 7 ,4656,906,816,6378
3/2/2013,2013,3,2, 8 ,5112,989,856,6957
3/2/2013,2013,3,2, 9 ,5674,1128,994,7796
3/2/2013,2013,3,2, 10 ,6177,1216,1057,8450
3/2/2013,2013,3,2, 11 ,6530,1288,1091,8909
3/2/2013,2013,3,2, 12 ,6395,1269,1079,8743
3/2/2013,2013,3,2, 13 ,6404,1276,1090,8770
3/2/2013,2013,3,2, 14 ,6560,1302,1122,8984
3/2/2013,2013,3,2, 15 ,6471,1282,1104,8857
3/2/2013,2013,3,2, 16 ,6272,1237,1072,8581
3/2/2013,2013,3,2, 17 ,6041,1179,1049,8269
3/2/2013,2013,3,2, 18 ,6023,1253,1145,8421
3/2/2013,2013,3,2, 19 ,6567,1396,1182,9145
3/2/2013,2013,3,2, 20 ,6392,1345,1155,8892
3/2/2013,2013,3,2, 21 ,6277,1309,1168,8754
3/2/2013,2013,3,2, 22 ,6059,1216,1105,8380
3/2/2013,2013,3,2, 23 ,5635,1107,999,7741
3/2/2013,2013,3,2, 24 ,5325,1017,920,7262
3/3/2013,2013,3,3, 1 ,4995,964,864,6823
3/3/2013,2013,3,3, 2 ,4834,927,838,6599
3/3/2013,2013,3,3, 3 ,4673,896,808,6377
3/3/2013,2013,3,3, 4 ,4566,882,806,6254
3/3/2013,2013,3,3, 5 ,4551,885,805,6241
3/3/2013,2013,3,3, 6 ,4517,871,813,6201
3/3/2013,2013,3,3, 7 ,4342,853,792,5987
3/3/2013,2013,3,3, 8 ,4516,894,812,6222
3/3/2013,2013,3,3, 9 ,4821,974,894,6689
3/3/2013,2013,3,3, 10 ,5220,1048,966,7234
3/3/2013,2013,3,3, 11 ,5481,1091,1001,7573
3/3/2013,2013,3,3, 12 ,5420,1095,972,7487
3/3/2013,2013,3,3, 13 ,5287,1088,986,7361
3/3/2013,2013,3,3, 14 ,5271,1094,988,7353
3/3/2013,2013,3,3, 15 ,5199,1078,974,7251
3/3/2013,2013,3,3, 16 ,5073,1033,946,7052
3/3/2013,2013,3,3, 17 ,5067,1047,908,7022
3/3/2013,2013,3,3, 18 ,5409,1154,1056,7619
3/3/2013,2013,3,3, 19 ,5932,1330,1125,8387
3/3/2013,2013,3,3, 20 ,5829,1308,1125,8262
3/3/2013,2013,3,3, 21 ,5667,1241,1084,7992
3/3/2013,2013,3,3, 22 ,5352,1133,1000,7485
3/3/2013,2013,3,3, 23 ,4994,1040,903,6937
3/3/2013,2013,3,3, 24 ,4672,959,837,6468
3/4/2013,2013,3,4, 1 ,4400,910,784,6094
3/4/2013,2013,3,4, 2 ,4224,877,760,5861
3/4/2013,2013,3,4, 3 ,4171,849,744,5764
3/4/2013,2013,3,4, 4 ,4117,838,749,5704
3/4/2013,2013,3,4, 5 ,4319,881,790,5990
3/4/2013,2013,3,4, 6 ,4635,931,855,6421
3/4/2013,2013,3,4, 7 ,4714,893,811,6418
3/4/2013,2013,3,4, 8 ,5415,1013,892,7320
3/4/2013,2013,3,4, 9 ,6127,1222,976,8325
3/4/2013,2013,3,4, 10 ,6573,1324,1086,8983
3/4/2013,2013,3,4, 11 ,6830,1372,1116,9318
3/4/2013,2013,3,4, 12 ,6715,1353,1093,9161
3/4/2013,2013,3,4, 13 ,6654,1318,1114,9086
3/4/2013,2013,3,4, 14 ,6747,1362,1118,9227
3/4/2013,2013,3,4, 15 ,6758,1339,1101,9198
3/4/2013,2013,3,4, 16 ,6670,1324,1090,9084
3/4/2013,2013,3,4, 17 ,6315,1259,1094,8668
3/4/2013,2013,3,4, 18 ,6267,1308,1127,8702
3/4/2013,2013,3,4, 19 ,6592,1429,1124,9145
3/4/2013,2013,3,4, 20 ,6434,1371,1107,8912
3/4/2013,2013,3,4, 21 ,6177,1297,1111,8585
3/4/2013,2013,3,4, 22 ,5753,1174,1004,7931
3/4/2013,2013,3,4, 23 ,5289,1056,944,7289
3/4/2013,2013,3,4, 24 ,4955,984,869,6808
3/5/2013,2013,3,5, 1 ,4712,940,832,6484
3/5/2013,2013,3,5, 2 ,4560,905,807,6272
3/5/2013,2013,3,5, 3 ,4474,888,789,6151
3/5/2013,2013,3,5, 4 ,4404,880,787,6071
3/5/2013,2013,3,5, 5 ,4625,925,836,6386
3/5/2013,2013,3,5, 6 ,4866,971,893,6730
3/5/2013,2013,3,5, 7 ,4905,912,844,6661
3/5/2013,2013,3,5, 8 ,5482,1030,941,7453
3/5/2013,2013,3,5, 9 ,6178,1206,1039,8423
3/5/2013,2013,3,5, 10 ,6596,1303,1124,9023
3/5/2013,2013,3,5, 11 ,6836,1349,1137,9322
3/5/2013,2013,3,5, 12 ,6698,1320,1073,9091
3/5/2013,2013,3,5, 13 ,6593,1306,1081,8980
3/5/2013,2013,3,5, 14 ,6867,1367,1123,9357
3/5/2013,2013,3,5, 15 ,6726,1331,1103,9160
3/5/2013,2013,3,5, 16 ,6647,1313,1093,9053
3/5/2013,2013,3,5, 17 ,6369,1253,1066,8688
3/5/2013,2013,3,5, 18 ,6294,1326,1139,8759
3/5/2013,2013,3,5, 19 ,6667,1421,1102,9190
3/5/2013,2013,3,5, 20 ,6469,1365,1106,8940
3/5/2013,2013,3,5, 21 ,6075,1277,1110,8462
3/5/2013,2013,3,5, 22 ,5768,1161,1016,7945
3/5/2013,2013,3,5, 23 ,5317,1038,975,7330
3/5/2013,2013,3,5, 24 ,4926,978,911,6815
3/6/2013,2013,3,6, 1 ,4699,928,857,6484
3/6/2013,2013,3,6, 2 ,4611,896,831,6338
3/6/2013,2013,3,6, 3 ,4439,881,810,6130
3/6/2013,2013,3,6, 4 ,4401,871,815,6087
3/6/2013,2013,3,6, 5 ,4604,909,850,6363
3/6/2013,2013,3,6, 6 ,4769,949,905,6623
3/6/2013,2013,3,6, 7 ,4812,916,852,6580
3/6/2013,2013,3,6, 8 ,5437,1042,959,7438
3/6/2013,2013,3,6, 9 ,6045,1228,1075,8348
3/6/2013,2013,3,6, 10 ,6581,1327,1144,9052
3/6/2013,2013,3,6, 11 ,6840,1385,1146,9371
3/6/2013,2013,3,6, 12 ,6713,1344,1119,9176
3/6/2013,2013,3,6, 13 ,6725,1345,1116,9186
3/6/2013,2013,3,6, 14 ,6922,1397,1162,9481
3/6/2013,2013,3,6, 15 ,6870,1373,1112,9355
3/6/2013,2013,3,6, 16 ,6689,1357,1091,9137
3/6/2013,2013,3,6, 17 ,6397,1273,1060,8730
3/6/2013,2013,3,6, 18 ,6340,1344,1133,8817
3/6/2013,2013,3,6, 19 ,6684,1453,1118,9255
3/6/2013,2013,3,6, 20 ,6448,1394,1134,8976
3/6/2013,2013,3,6, 21 ,6208,1325,1135,8668
3/6/2013,2013,3,6, 22 ,5785,1194,1069,8048
3/6/2013,2013,3,6, 23 ,5363,1077,971,7411
3/6/2013,2013,3,6, 24 ,4937,995,917,6849
3/7/2013,2013,3,7, 1 ,4732,959,878,6569
3/7/2013,2013,3,7, 2 ,4612,948,851,6411
3/7/2013,2013,3,7, 3 ,4456,910,830,6196
3/7/2013,2013,3,7, 4 ,4451,899,839,6189
3/7/2013,2013,3,7, 5 ,4587,933,866,6386
3/7/2013,2013,3,7, 6 ,4812,974,920,6706
3/7/2013,2013,3,7, 7 ,4894,928,855,6677
3/7/2013,2013,3,7, 8 ,5485,1036,956,7477
3/7/2013,2013,3,7, 9 ,6098,1238,1069,8405
3/7/2013,2013,3,7, 10 ,6502,1342,1129,8973
3/7/2013,2013,3,7, 11 ,6796,1358,1146,9300
3/7/2013,2013,3,7, 12 ,6708,1356,1116,9180
3/7/2013,2013,3,7, 13 ,6602,1326,1128,9056
3/7/2013,2013,3,7, 14 ,6853,1397,1131,9381
3/7/2013,2013,3,7, 15 ,6769,1373,1115,9257
3/7/2013,2013,3,7, 16 ,6615,1374,1106,9095
3/7/2013,2013,3,7, 17 ,6299,1298,1092,8689
3/7/2013,2013,3,7, 18 ,6336,1369,1131,8836
3/7/2013,2013,3,7, 19 ,6750,1477,1088,9315
3/7/2013,2013,3,7, 20 ,6523,1415,1095,9033
3/7/2013,2013,3,7, 21 ,6286,1335,1083,8704
3/7/2013,2013,3,7, 22 ,5994,1211,1051,8256
3/7/2013,2013,3,7, 23 ,5518,1100,964,7582
3/7/2013,2013,3,7, 24 ,5124,1022,921,7067
3/8/2013,2013,3,8, 1 ,4843,973,869,6685
3/8/2013,2013,3,8, 2 ,4760,942,850,6552
3/8/2013,2013,3,8, 3 ,4598,917,816,6331
3/8/2013,2013,3,8, 4 ,4576,906,816,6298
3/8/2013,2013,3,8, 5 ,4685,946,854,6485
3/8/2013,2013,3,8, 6 ,4929,991,883,6803
3/8/2013,2013,3,8, 7 ,4957,948,837,6742
3/8/2013,2013,3,8, 8 ,5595,1061,908,7564
3/8/2013,2013,3,8, 9 ,6078,1248,1055,8381
3/8/2013,2013,3,8, 10 ,6645,1324,1094,9063
3/8/2013,2013,3,8, 11 ,6876,1369,1134,9379
3/8/2013,2013,3,8, 12 ,6743,1342,1107,9192
3/8/2013,2013,3,8, 13 ,6723,1329,1128,9180
3/8/2013,2013,3,8, 14 ,6891,1366,1124,9381
3/8/2013,2013,3,8, 15 ,6794,1333,1113,9240
3/8/2013,2013,3,8, 16 ,6662,1314,1098,9074
3/8/2013,2013,3,8, 17 ,6405,1265,1063,8733
3/8/2013,2013,3,8, 18 ,6306,1337,1144,8787
3/8/2013,2013,3,8, 19 ,6709,1418,1114,9241
3/8/2013,2013,3,8, 20 ,6527,1357,1120,9004
3/8/2013,2013,3,8, 21 ,6283,1273,1091,8647
3/8/2013,2013,3,8, 22 ,5948,1153,1052,8153
3/8/2013,2013,3,8, 23 ,5440,1049,984,7473
3/8/2013,2013,3,8, 24 ,5112,975,909,6996
3/9/2013,2013,3,9, 1 ,4848,936,867,6651
3/9/2013,2013,3,9, 2 ,4718,908,862,6488
3/9/2013,2013,3,9, 3 ,4596,887,834,6317
3/9/2013,2013,3,9, 4 ,4498,876,827,6201
3/9/2013,2013,3,9, 5 ,4539,891,853,6283
3/9/2013,2013,3,9, 6 ,4648,912,877,6437
3/9/2013,2013,3,9, 7 ,4696,920,848,6464
3/9/2013,2013,3,9, 8 ,5146,990,910,7046
3/9/2013,2013,3,9, 9 ,5604,1121,1003,7728
3/9/2013,2013,3,9, 10 ,6162,1197,1081,8440
3/9/2013,2013,3,9, 11 ,6469,1254,1101,8824
3/9/2013,2013,3,9, 12 ,6304,1232,1072,8608
3/9/2013,2013,3,9, 13 ,6329,1236,1111,8676
3/9/2013,2013,3,9, 14 ,6502,1269,1113,8884
3/9/2013,2013,3,9, 15 ,6343,1239,1083,8665
3/9/2013,2013,3,9, 16 ,6133,1220,1063,8416
3/9/2013,2013,3,9, 17 ,5959,1190,1076,8225
3/9/2013,2013,3,9, 18 ,6103,1285,1150,8538
3/9/2013,2013,3,9, 19 ,6484,1395,1128,9007
3/9/2013,2013,3,9, 20 ,6398,1352,1118,8868
3/9/2013,2013,3,9, 21 ,6262,1301,1103,8666
3/9/2013,2013,3,9, 22 ,6012,1206,1070,8288
3/9/2013,2013,3,9, 23 ,5584,1089,964,7637
3/9/2013,2013,3,9, 24 ,5233,1017,912,7162
3/10/2013,2013,3,10, 1 ,4959,968,868,6795
3/10/2013,2013,3,10, 2 ,4791,936,840,6567
3/10/2013,2013,3,10, 3 ,4647,906,805,6358
3/10/2013,2013,3,10, 4 ,4609,887,788,6284
3/10/2013,2013,3,10, 5 ,4602,896,808,6306
3/10/2013,2013,3,10, 6 ,4525,879,819,6223
3/10/2013,2013,3,10, 7 ,4489,876,793,6158
3/10/2013,2013,3,10, 8 ,4631,910,832,6373
3/10/2013,2013,3,10, 9 ,4982,971,908,6861
3/10/2013,2013,3,10, 10 ,5414,1035,968,7417
3/10/2013,2013,3,10, 11 ,5672,1082,988,7742
3/10/2013,2013,3,10, 12 ,5670,1072,1004,7746
3/10/2013,2013,3,10, 13 ,5632,1083,1006,7721
3/10/2013,2013,3,10, 14 ,5706,1104,1010,7820
3/10/2013,2013,3,10, 15 ,5673,1094,998,7765
3/10/2013,2013,3,10, 16 ,5526,1049,984,7559
3/10/2013,2013,3,10, 17 ,5476,1082,980,7538
3/10/2013,2013,3,10, 18 ,5747,1207,1072,8026
3/10/2013,2013,3,10, 19 ,6280,1328,1088,8696
3/10/2013,2013,3,10, 20 ,6377,1303,1077,8757
3/10/2013,2013,3,10, 21 ,6208,1249,1075,8532
3/10/2013,2013,3,10, 22 ,5960,1152,1030,8142
3/10/2013,2013,3,10, 23 ,5502,1055,942,7499
3/10/2013,2013,3,10, 24 ,5168,975,865,7008
3/11/2013,2013,3,11, 1 ,4868,923,826,6617
3/11/2013,2013,3,11, 2 ,4691,891,799,6381
3/11/2013,2013,3,11, 3 ,4604,870,771,6245
3/11/2013,2013,3,11, 4 ,4572,860,758,6190
3/11/2013,2013,3,11, 5 ,4692,897,795,6384
3/11/2013,2013,3,11, 6 ,4930,954,848,6732
3/11/2013,2013,3,11, 7 ,5016,915,803,6734
3/11/2013,2013,3,11, 8 ,5804,1050,921,7775
3/11/2013,2013,3,11, 9 ,6593,1243,1047,8883
3/11/2013,2013,3,11, 10 ,7101,1342,1133,9576
3/11/2013,2013,3,11, 11 ,7137,1409,1134,9680
3/11/2013,2013,3,11, 12 ,7172,1377,1114,9663
3/11/2013,2013,3,11, 13 ,7297,1383,1120,9800
3/11/2013,2013,3,11, 14 ,7422,1441,1130,9993
3/11/2013,2013,3,11, 15 ,7312,1423,1129,9864
3/11/2013,2013,3,11, 16 ,7278,1391,1125,9794
3/11/2013,2013,3,11, 17 ,6888,1319,1096,9303
3/11/2013,2013,3,11, 18 ,6683,1354,1133,9170
3/11/2013,2013,3,11, 19 ,7077,1480,1141,9698
3/11/2013,2013,3,11, 20 ,6921,1425,1139,9485
3/11/2013,2013,3,11, 21 ,6738,1373,1155,9266
3/11/2013,2013,3,11, 22 ,6384,1230,1111,8725
3/11/2013,2013,3,11, 23 ,5983,1119,997,8099
3/11/2013,2013,3,11, 24 ,5599,1042,931,7572
3/12/2013,2013,3,12, 1 ,5354,997,876,7227
3/12/2013,2013,3,12, 2 ,5135,960,849,6944
3/12/2013,2013,3,12, 3 ,4999,935,825,6759
3/12/2013,2013,3,12, 4 ,4988,929,816,6733
3/12/2013,2013,3,12, 5 ,5010,964,843,6817
3/12/2013,2013,3,12, 6 ,5180,995,893,7068
3/12/2013,2013,3,12, 7 ,5212,962,841,7015
3/12/2013,2013,3,12, 8 ,5980,1054,934,7968
3/12/2013,2013,3,12, 9 ,6714,1280,1072,9066
3/12/2013,2013,3,12, 10 ,7179,1367,1127,9673
3/12/2013,2013,3,12, 11 ,7430,1431,1151,10012
3/12/2013,2013,3,12, 12 ,7294,1405,1124,9823
3/12/2013,2013,3,12, 13 ,7296,1388,1142,9826
3/12/2013,2013,3,12, 14 ,7551,1435,1125,10111
3/12/2013,2013,3,12, 15 ,7467,1411,1110,9988
3/12/2013,2013,3,12, 16 ,7268,1373,1095,9736
3/12/2013,2013,3,12, 17 ,6985,1310,1102,9397
3/12/2013,2013,3,12, 18 ,6800,1366,1145,9311
3/12/2013,2013,3,12, 19 ,7192,1444,1130,9766
3/12/2013,2013,3,12, 20 ,6942,1393,1121,9456
3/12/2013,2013,3,12, 21 ,6756,1339,1129,9224
3/12/2013,2013,3,12, 22 ,6464,1219,1078,8761
3/12/2013,2013,3,12, 23 ,6028,1104,1001,8133
3/12/2013,2013,3,12, 24 ,5683,1018,934,7635
3/13/2013,2013,3,13, 1 ,5407,979,881,7267
3/13/2013,2013,3,13, 2 ,5252,949,853,7054
3/13/2013,2013,3,13, 3 ,5052,921,826,6799
3/13/2013,2013,3,13, 4 ,4966,909,821,6696
3/13/2013,2013,3,13, 5 ,5013,941,862,6816
3/13/2013,2013,3,13, 6 ,5162,977,890,7029
3/13/2013,2013,3,13, 7 ,5226,952,849,7027
3/13/2013,2013,3,13, 8 ,5964,1095,939,7998
3/13/2013,2013,3,13, 9 ,6740,1285,1048,9073
3/13/2013,2013,3,13, 10 ,7188,1374,1100,9662
3/13/2013,2013,3,13, 11 ,7512,1440,1102,10054
3/13/2013,2013,3,13, 12 ,7385,1411,1075,9871
3/13/2013,2013,3,13, 13 ,7380,1418,1122,9920
3/13/2013,2013,3,13, 14 ,7653,1463,1141,10257
3/13/2013,2013,3,13, 15 ,7525,1433,1109,10067
3/13/2013,2013,3,13, 16 ,7394,1412,1108,9914
3/13/2013,2013,3,13, 17 ,7013,1323,1091,9427
3/13/2013,2013,3,13, 18 ,6856,1344,1127,9327
3/13/2013,2013,3,13, 19 ,7174,1483,1117,9774
3/13/2013,2013,3,13, 20 ,7050,1428,1117,9595
3/13/2013,2013,3,13, 21 ,6885,1366,1127,9378
3/13/2013,2013,3,13, 22 ,6529,1246,1059,8834
3/13/2013,2013,3,13, 23 ,6151,1129,995,8275
3/13/2013,2013,3,13, 24 ,5751,1051,937,7739
3/14/2013,2013,3,14, 1 ,5474,997,896,7367
3/14/2013,2013,3,14, 2 ,5295,973,864,7132
3/14/2013,2013,3,14, 3 ,5150,943,833,6926
3/14/2013,2013,3,14, 4 ,5081,931,831,6843
3/14/2013,2013,3,14, 5 ,5187,955,861,7003
3/14/2013,2013,3,14, 6 ,5274,989,915,7178
3/14/2013,2013,3,14, 7 ,5344,961,866,7171
3/14/2013,2013,3,14, 8 ,6071,1093,983,8147
3/14/2013,2013,3,14, 9 ,6827,1286,1072,9185
3/14/2013,2013,3,14, 10 ,7264,1390,1109,9763
3/14/2013,2013,3,14, 11 ,7467,1431,1139,10037
3/14/2013,2013,3,14, 12 ,7351,1408,1137,9896
3/14/2013,2013,3,14, 13 ,7302,1413,1118,9833
3/14/2013,2013,3,14, 14 ,7542,1460,1150,10152
3/14/2013,2013,3,14, 15 ,7499,1431,1143,10073
3/14/2013,2013,3,14, 16 ,7331,1406,1141,9878
3/14/2013,2013,3,14, 17 ,6847,1300,1089,9236
3/14/2013,2013,3,14, 18 ,6686,1331,1143,9160
3/14/2013,2013,3,14, 19 ,7136,1482,1133,9751
3/14/2013,2013,3,14, 20 ,7035,1435,1132,9602
3/14/2013,2013,3,14, 21 ,6834,1385,1140,9359
3/14/2013,2013,3,14, 22 ,6475,1259,1109,8843
3/14/2013,2013,3,14, 23 ,6133,1119,995,8247
3/14/2013,2013,3,14, 24 ,5733,1049,937,7719
3/15/2013,2013,3,15, 1 ,5419,1003,882,7304
3/15/2013,2013,3,15, 2 ,5247,965,853,7065
3/15/2013,2013,3,15, 3 ,5070,938,821,6829
3/15/2013,2013,3,15, 4 ,5011,916,829,6756
3/15/2013,2013,3,15, 5 ,5060,949,854,6863
3/15/2013,2013,3,15, 6 ,5190,967,908,7065
3/15/2013,2013,3,15, 7 ,5280,951,859,7090
3/15/2013,2013,3,15, 8 ,5957,1083,958,7998
3/15/2013,2013,3,15, 9 ,6751,1275,1058,9084
3/15/2013,2013,3,15, 10 ,7091,1358,1112,9561
3/15/2013,2013,3,15, 11 ,7241,1408,1128,9777
3/15/2013,2013,3,15, 12 ,7138,1388,1090,9616
3/15/2013,2013,3,15, 13 ,7117,1398,1077,9592
3/15/2013,2013,3,15, 14 ,7289,1440,1122,9851
3/15/2013,2013,3,15, 15 ,7189,1412,1105,9706
3/15/2013,2013,3,15, 16 ,7082,1388,1106,9576
3/15/2013,2013,3,15, 17 ,6735,1296,1070,9101
3/15/2013,2013,3,15, 18 ,6509,1316,1091,8916
3/15/2013,2013,3,15, 19 ,6961,1453,1109,9523
3/15/2013,2013,3,15, 20 ,6846,1421,1103,9370
3/15/2013,2013,3,15, 21 ,6664,1378,1106,9148
3/15/2013,2013,3,15, 22 ,6333,1261,1075,8669
3/15/2013,2013,3,15, 23 ,5906,1140,1006,8052
3/15/2013,2013,3,15, 24 ,5600,1040,947,7587
3/16/2013,2013,3,16, 1 ,5291,978,866,7135
3/16/2013,2013,3,16, 2 ,5094,950,844,6888
3/16/2013,2013,3,16, 3 ,4914,922,825,6661
3/16/2013,2013,3,16, 4 ,4802,911,817,6530
3/16/2013,2013,3,16, 5 ,4849,925,833,6607
3/16/2013,2013,3,16, 6 ,4868,921,849,6638
3/16/2013,2013,3,16, 7 ,4839,934,852,6625
3/16/2013,2013,3,16, 8 ,5294,1023,882,7199
3/16/2013,2013,3,16, 9 ,5923,1154,954,8031
3/16/2013,2013,3,16, 10 ,6407,1229,985,8621
3/16/2013,2013,3,16, 11 ,6667,1274,1018,8959
3/16/2013,2013,3,16, 12 ,6564,1253,997,8814
3/16/2013,2013,3,16, 13 ,6464,1273,991,8728
3/16/2013,2013,3,16, 14 ,6635,1286,1011,8932
3/16/2013,2013,3,16, 15 ,6439,1189,980,8608
3/16/2013,2013,3,16, 16 ,6133,1219,973,8325
3/16/2013,2013,3,16, 17 ,6178,1190,972,8340
3/16/2013,2013,3,16, 18 ,6052,1248,1037,8337
3/16/2013,2013,3,16, 19 ,6613,1401,1026,9040
3/16/2013,2013,3,16, 20 ,6535,1376,1015,8926
3/16/2013,2013,3,16, 21 ,6403,1334,1029,8766
3/16/2013,2013,3,16, 22 ,6135,1236,1004,8375
3/16/2013,2013,3,16, 23 ,5691,1118,966,7775
3/16/2013,2013,3,16, 24 ,5406,1033,908,7347
3/17/2013,2013,3,17, 1 ,5105,977,877,6959
3/17/2013,2013,3,17, 2 ,4926,939,847,6712
3/17/2013,2013,3,17, 3 ,4757,918,833,6508
3/17/2013,2013,3,17, 4 ,4646,907,811,6364
3/17/2013,2013,3,17, 5 ,4587,910,822,6319
3/17/2013,2013,3,17, 6 ,4526,895,833,6254
3/17/2013,2013,3,17, 7 ,4432,889,782,6103
3/17/2013,2013,3,17, 8 ,4677,933,827,6437
3/17/2013,2013,3,17, 9 ,5111,1004,879,6994
3/17/2013,2013,3,17, 10 ,5612,1082,930,7624
3/17/2013,2013,3,17, 11 ,5786,1127,957,7870
3/17/2013,2013,3,17, 12 ,5753,1139,956,7848
3/17/2013,2013,3,17, 13 ,5796,1141,956,7893
3/17/2013,2013,3,17, 14 ,5863,1150,940,7953
3/17/2013,2013,3,17, 15 ,5772,1132,938,7842
3/17/2013,2013,3,17, 16 ,5633,1108,937,7678
3/17/2013,2013,3,17, 17 ,5532,1074,949,7555
3/17/2013,2013,3,17, 18 ,5615,1169,1054,7838
3/17/2013,2013,3,17, 19 ,6389,1360,1058,8807
3/17/2013,2013,3,17, 20 ,6296,1339,1052,8687
3/17/2013,2013,3,17, 21 ,6197,1281,1008,8486
3/17/2013,2013,3,17, 22 ,5917,1201,1012,8130
3/17/2013,2013,3,17, 23 ,5573,1100,945,7618
3/17/2013,2013,3,17, 24 ,5223,1011,891,7125
3/18/2013,2013,3,18, 1 ,4978,963,831,6772
3/18/2013,2013,3,18, 2 ,4758,933,790,6481
3/18/2013,2013,3,18, 3 ,4625,909,776,6310
3/18/2013,2013,3,18, 4 ,4551,897,766,6214
3/18/2013,2013,3,18, 5 ,4642,922,815,6379
3/18/2013,2013,3,18, 6 ,4789,946,858,6593
3/18/2013,2013,3,18, 7 ,4996,942,846,6784
3/18/2013,2013,3,18, 8 ,5747,1080,936,7763
3/18/2013,2013,3,18, 9 ,6591,1267,1053,8911
3/18/2013,2013,3,18, 10 ,7096,1379,1084,9559
3/18/2013,2013,3,18, 11 ,7365,1435,1100,9900
3/18/2013,2013,3,18, 12 ,7290,1399,1096,9785
3/18/2013,2013,3,18, 13 ,7270,1418,1102,9790
3/18/2013,2013,3,18, 14 ,7575,1462,1093,10130
3/18/2013,2013,3,18, 15 ,7490,1443,1081,10014
3/18/2013,2013,3,18, 16 ,7415,1398,1084,9897
3/18/2013,2013,3,18, 17 ,7045,1335,1059,9439
3/18/2013,2013,3,18, 18 ,6760,1378,1083,9221
3/18/2013,2013,3,18, 19 ,7211,1494,1085,9790
3/18/2013,2013,3,18, 20 ,7049,1449,1064,9562
3/18/2013,2013,3,18, 21 ,6879,1405,1077,9361
3/18/2013,2013,3,18, 22 ,6579,1298,1053,8930
3/18/2013,2013,3,18, 23 ,6079,1166,1004,8249
3/18/2013,2013,3,18, 24 ,5736,1088,948,7772
3/19/2013,2013,3,19, 1 ,5458,1031,916,7405
3/19/2013,2013,3,19, 2 ,5252,1005,875,7132
3/19/2013,2013,3,19, 3 ,5054,975,848,6877
3/19/2013,2013,3,19, 4 ,4985,963,842,6790
3/19/2013,2013,3,19, 5 ,5026,980,888,6894
3/19/2013,2013,3,19, 6 ,5109,998,907,7014
3/19/2013,2013,3,19, 7 ,5252,980,880,7112
3/19/2013,2013,3,19, 8 ,5984,1106,969,8059
3/19/2013,2013,3,19, 9 ,6760,1303,1036,9099
3/19/2013,2013,3,19, 10 ,7219,1406,1078,9703
3/19/2013,2013,3,19, 11 ,7521,1454,1108,10083
3/19/2013,2013,3,19, 12 ,7467,1430,1103,10000
3/19/2013,2013,3,19, 13 ,7409,1411,1087,9907
3/19/2013,2013,3,19, 14 ,7667,1479,1118,10264
3/19/2013,2013,3,19, 15 ,7579,1450,1114,10143
3/19/2013,2013,3,19, 16 ,7386,1426,1107,9919
3/19/2013,2013,3,19, 17 ,7097,1343,1044,9484
3/19/2013,2013,3,19, 18 ,6802,1348,1083,9233
3/19/2013,2013,3,19, 19 ,7298,1488,1088,9874
3/19/2013,2013,3,19, 20 ,7150,1446,1092,9688
3/19/2013,2013,3,19, 21 ,6947,1377,1093,9417
3/19/2013,2013,3,19, 22 ,6629,1252,1063,8944
3/19/2013,2013,3,19, 23 ,6182,1137,1035,8354
3/19/2013,2013,3,19, 24 ,5715,1060,969,7744
3/20/2013,2013,3,20, 1 ,5463,1009,904,7376
3/20/2013,2013,3,20, 2 ,5221,967,888,7076
3/20/2013,2013,3,20, 3 ,5070,948,868,6886
3/20/2013,2013,3,20, 4 ,4972,933,849,6754
3/20/2013,2013,3,20, 5 ,4975,950,869,6794
3/20/2013,2013,3,20, 6 ,5067,962,903,6932
3/20/2013,2013,3,20, 7 ,5172,954,894,7020
3/20/2013,2013,3,20, 8 ,5965,1085,998,8048
3/20/2013,2013,3,20, 9 ,6669,1282,1072,9023
3/20/2013,2013,3,20, 10 ,7179,1376,1119,9674
3/20/2013,2013,3,20, 11 ,7435,1448,1134,10017
3/20/2013,2013,3,20, 12 ,7344,1410,1120,9874
3/20/2013,2013,3,20, 13 ,7379,1417,1129,9925
3/20/2013,2013,3,20, 14 ,7632,1463,1142,10237
3/20/2013,2013,3,20, 15 ,7509,1441,1124,10074
3/20/2013,2013,3,20, 16 ,7393,1402,1129,9924
3/20/2013,2013,3,20, 17 ,6978,1316,1103,9397
3/20/2013,2013,3,20, 18 ,6669,1337,1124,9130
3/20/2013,2013,3,20, 19 ,7185,1469,1153,9807
3/20/2013,2013,3,20, 20 ,7084,1436,1143,9663
3/20/2013,2013,3,20, 21 ,6929,1380,1144,9453
3/20/2013,2013,3,20, 22 ,6517,1261,1105,8883
3/20/2013,2013,3,20, 23 ,6140,1148,1050,8338
3/20/2013,2013,3,20, 24 ,5798,1065,970,7833
3/21/2013,2013,3,21, 1 ,5450,1019,926,7395
3/21/2013,2013,3,21, 2 ,5277,993,891,7161
3/21/2013,2013,3,21, 3 ,5078,965,862,6905
3/21/2013,2013,3,21, 4 ,4955,949,853,6757
3/21/2013,2013,3,21, 5 ,4956,966,870,6792
3/21/2013,2013,3,21, 6 ,4986,987,911,6884
3/21/2013,2013,3,21, 7 ,5159,978,893,7030
3/21/2013,2013,3,21, 8 ,5879,1112,980,7971
3/21/2013,2013,3,21, 9 ,6630,1297,1067,8994
3/21/2013,2013,3,21, 10 ,7094,1384,1114,9592
3/21/2013,2013,3,21, 11 ,7454,1441,1151,10046
3/21/2013,2013,3,21, 12 ,7295,1440,1126,9861
3/21/2013,2013,3,21, 13 ,7306,1423,1115,9844
3/21/2013,2013,3,21, 14 ,7550,1417,1130,10097
3/21/2013,2013,3,21, 15 ,7384,1422,1101,9907
3/21/2013,2013,3,21, 16 ,7274,1412,1077,9763
3/21/2013,2013,3,21, 17 ,6906,1354,1055,9315
3/21/2013,2013,3,21, 18 ,6714,1425,1101,9240
3/21/2013,2013,3,21, 19 ,7141,1481,1086,9708
3/21/2013,2013,3,21, 20 ,6959,1445,1071,9475
3/21/2013,2013,3,21, 21 ,6816,1365,1056,9237
3/21/2013,2013,3,21, 22 ,6809,1301,1014,9124
3/21/2013,2013,3,21, 23 ,6114,1182,996,8292
3/21/2013,2013,3,21, 24 ,5753,1076,914,7743
3/22/2013,2013,3,22, 1 ,5461,1048,879,7388
3/22/2013,2013,3,22, 2 ,5256,1003,852,7111
3/22/2013,2013,3,22, 3 ,5119,987,833,6939
3/22/2013,2013,3,22, 4 ,5061,971,830,6862
3/22/2013,2013,3,22, 5 ,5087,977,848,6912
3/22/2013,2013,3,22, 6 ,5182,993,882,7057
3/22/2013,2013,3,22, 7 ,5306,996,886,7188
3/22/2013,2013,3,22, 8 ,5977,1141,961,8079
3/22/2013,2013,3,22, 9 ,6687,1320,1065,9072
3/22/2013,2013,3,22, 10 ,7207,1422,1093,9722
3/22/2013,2013,3,22, 11 ,7435,1488,1130,10053
3/22/2013,2013,3,22, 12 ,7299,1453,1140,9892
3/22/2013,2013,3,22, 13 ,7056,1466,1156,9678
3/22/2013,2013,3,22, 14 ,7177,1503,1137,9817
3/22/2013,2013,3,22, 15 ,7069,1470,1096,9635
3/22/2013,2013,3,22, 16 ,7018,1435,1085,9538
3/22/2013,2013,3,22, 17 ,6731,1345,1037,9113
3/22/2013,2013,3,22, 18 ,6614,1400,1123,9137
3/22/2013,2013,3,22, 19 ,7055,1522,1106,9683
3/22/2013,2013,3,22, 20 ,6877,1445,1098,9420
3/22/2013,2013,3,22, 21 ,6747,1388,1079,9214
3/22/2013,2013,3,22, 22 ,6396,1300,1029,8725
3/22/2013,2013,3,22, 23 ,5978,1193,968,8139
3/22/2013,2013,3,22, 24 ,5591,1114,916,7621
3/23/2013,2013,3,23, 1 ,5348,1070,877,7295
3/23/2013,2013,3,23, 2 ,5180,1029,831,7040
3/23/2013,2013,3,23, 3 ,5028,1006,821,6855
3/23/2013,2013,3,23, 4 ,4948,986,804,6738
3/23/2013,2013,3,23, 5 ,4922,997,804,6723
3/23/2013,2013,3,23, 6 ,4852,989,800,6641
3/23/2013,2013,3,23, 7 ,4990,976,830,6796
3/23/2013,2013,3,23, 8 ,5463,1077,905,7445
3/23/2013,2013,3,23, 9 ,6072,1219,1005,8296
3/23/2013,2013,3,23, 10 ,6548,1306,1095,8949
3/23/2013,2013,3,23, 11 ,6931,1362,1140,9433
3/23/2013,2013,3,23, 12 ,6716,1332,1116,9164
3/23/2013,2013,3,23, 13 ,6697,1356,1133,9186
3/23/2013,2013,3,23, 14 ,6852,1387,1135,9374
3/23/2013,2013,3,23, 15 ,6682,1352,1132,9166
3/23/2013,2013,3,23, 16 ,6443,1301,1112,8856
3/23/2013,2013,3,23, 17 ,6213,1230,1104,8547
3/23/2013,2013,3,23, 18 ,6167,1305,1173,8645
3/23/2013,2013,3,23, 19 ,6754,1444,1181,9379
3/23/2013,2013,3,23, 20 ,6691,1405,1163,9259
3/23/2013,2013,3,23, 21 ,6455,1349,1112,8916
3/23/2013,2013,3,23, 22 ,6304,1293,1087,8684
3/23/2013,2013,3,23, 23 ,6014,1181,1001,8196
3/23/2013,2013,3,23, 24 ,5648,1102,932,7682
3/24/2013,2013,3,24, 1 ,5359,1046,869,7274
3/24/2013,2013,3,24, 2 ,5168,1010,847,7025
3/24/2013,2013,3,24, 3 ,5025,981,812,6818
3/24/2013,2013,3,24, 4 ,4942,966,799,6707
3/24/2013,2013,3,24, 5 ,4824,965,809,6598
3/24/2013,2013,3,24, 6 ,4646,929,809,6384
3/24/2013,2013,3,24, 7 ,4642,925,792,6359
3/24/2013,2013,3,24, 8 ,4899,968,841,6708
3/24/2013,2013,3,24, 9 ,5323,1044,834,7201
3/24/2013,2013,3,24, 10 ,5724,1128,908,7760
3/24/2013,2013,3,24, 11 ,6052,1174,982,8208
3/24/2013,2013,3,24, 12 ,5975,1183,1003,8161
3/24/2013,2013,3,24, 13 ,6022,1202,1029,8253
3/24/2013,2013,3,24, 14 ,6104,1209,1041,8354
3/24/2013,2013,3,24, 15 ,6004,1201,1022,8227
3/24/2013,2013,3,24, 16 ,5864,1167,1008,8039
3/24/2013,2013,3,24, 17 ,5732,1125,987,7844
3/24/2013,2013,3,24, 18 ,5818,1217,1149,8184
3/24/2013,2013,3,24, 19 ,6497,1394,1220,9111
3/24/2013,2013,3,24, 20 ,6441,1358,1202,9001
3/24/2013,2013,3,24, 21 ,6283,1307,1167,8757
3/24/2013,2013,3,24, 22 ,5973,1234,1073,8280
3/24/2013,2013,3,24, 23 ,5765,1143,990,7898
3/24/2013,2013,3,24, 24 ,5374,1059,916,7349
3/25/2013,2013,3,25, 1 ,5158,1019,856,7033
3/25/2013,2013,3,25, 2 ,4958,980,841,6779
3/25/2013,2013,3,25, 3 ,4845,957,826,6628
3/25/2013,2013,3,25, 4 ,4745,940,808,6493
3/25/2013,2013,3,25, 5 ,4795,944,822,6561
3/25/2013,2013,3,25, 6 ,4854,958,844,6656
3/25/2013,2013,3,25, 7 ,5130,979,857,6966
3/25/2013,2013,3,25, 8 ,5935,1125,971,8031
3/25/2013,2013,3,25, 9 ,6706,1316,1100,9122
3/25/2013,2013,3,25, 10 ,7185,1426,1152,9763
3/25/2013,2013,3,25, 11 ,7478,1476,1173,10127
3/25/2013,2013,3,25, 12 ,7359,1461,1168,9988
3/25/2013,2013,3,25, 13 ,7244,1451,1182,9877
3/25/2013,2013,3,25, 14 ,7502,1485,1173,10160
3/25/2013,2013,3,25, 15 ,7358,1443,1153,9954
3/25/2013,2013,3,25, 16 ,7247,1416,1147,9810
3/25/2013,2013,3,25, 17 ,6904,1338,1115,9357
3/25/2013,2013,3,25, 18 ,6614,1387,1180,9181
3/25/2013,2013,3,25, 19 ,7009,1481,1184,9674
3/25/2013,2013,3,25, 20 ,6952,1458,1161,9571
3/25/2013,2013,3,25, 21 ,6794,1393,1137,9324
3/25/2013,2013,3,25, 22 ,6402,1275,1102,8779
3/25/2013,2013,3,25, 23 ,6041,1158,983,8182
3/25/2013,2013,3,25, 24 ,5639,1062,935,7636
3/26/2013,2013,3,26, 1 ,5394,1040,881,7315
3/26/2013,2013,3,26, 2 ,5174,1003,857,7034
3/26/2013,2013,3,26, 3 ,5052,972,831,6855
3/26/2013,2013,3,26, 4 ,4929,957,821,6707
3/26/2013,2013,3,26, 5 ,4960,967,839,6766
3/26/2013,2013,3,26, 6 ,4936,963,842,6741
3/26/2013,2013,3,26, 7 ,5183,976,859,7018
3/26/2013,2013,3,26, 8 ,5976,1127,976,8079
3/26/2013,2013,3,26, 9 ,6624,1313,1124,9061
3/26/2013,2013,3,26, 10 ,7083,1397,1164,9644
3/26/2013,2013,3,26, 11 ,7308,1456,1187,9951
3/26/2013,2013,3,26, 12 ,7222,1423,1173,9818
3/26/2013,2013,3,26, 13 ,7228,1430,1190,9848
3/26/2013,2013,3,26, 14 ,7417,1477,1200,10094
3/26/2013,2013,3,26, 15 ,7363,1455,1187,10005
3/26/2013,2013,3,26, 16 ,7155,1426,1178,9759
3/26/2013,2013,3,26, 17 ,6835,1327,1135,9297
3/26/2013,2013,3,26, 18 ,6603,1346,1181,9130
3/26/2013,2013,3,26, 19 ,7010,1486,1195,9691
3/26/2013,2013,3,26, 20 ,6809,1441,1220,9470
3/26/2013,2013,3,26, 21 ,6672,1370,1218,9260
3/26/2013,2013,3,26, 22 ,6342,1268,1151,8761
3/26/2013,2013,3,26, 23 ,5974,1189,1042,8205
3/26/2013,2013,3,26, 24 ,5661,1106,967,7734
3/27/2013,2013,3,27, 1 ,5369,1048,914,7331
3/27/2013,2013,3,27, 2 ,5155,1013,876,7044
3/27/2013,2013,3,27, 3 ,4980,991,863,6834
3/27/2013,2013,3,27, 4 ,4894,963,845,6702
3/27/2013,2013,3,27, 5 ,4871,978,858,6707
3/27/2013,2013,3,27, 6 ,4814,969,877,6660
3/27/2013,2013,3,27, 7 ,4954,968,874,6796
3/27/2013,2013,3,27, 8 ,5652,1112,990,7754
3/27/2013,2013,3,27, 9 ,6377,1298,1140,8815
3/27/2013,2013,3,27, 10 ,6841,1382,1164,9387
3/27/2013,2013,3,27, 11 ,7063,1432,1161,9656
3/27/2013,2013,3,27, 12 ,6962,1391,1129,9482
3/27/2013,2013,3,27, 13 ,6914,1358,1150,9422
3/27/2013,2013,3,27, 14 ,7111,1391,1132,9634
3/27/2013,2013,3,27, 15 ,6957,1333,1132,9422
3/27/2013,2013,3,27, 16 ,6748,1298,1125,9171
3/27/2013,2013,3,27, 17 ,6341,1227,1121,8689
3/27/2013,2013,3,27, 18 ,6212,1287,1148,8647
3/27/2013,2013,3,27, 19 ,6682,1396,1150,9228
3/27/2013,2013,3,27, 20 ,6546,1341,1183,9070
3/27/2013,2013,3,27, 21 ,6373,1297,1173,8843
3/27/2013,2013,3,27, 22 ,6052,1216,1065,8333
3/27/2013,2013,3,27, 23 ,5699,1107,990,7796
3/27/2013,2013,3,27, 24 ,5341,1051,913,7305
3/28/2013,2013,3,28, 1 ,5025,989,860,6874
3/28/2013,2013,3,28, 2 ,4854,951,827,6632
3/28/2013,2013,3,28, 3 ,4641,929,804,6374
3/28/2013,2013,3,28, 4 ,4536,909,788,6233
3/28/2013,2013,3,28, 5 ,4415,906,793,6114
3/28/2013,2013,3,28, 6 ,4165,861,779,5805
3/28/2013,2013,3,28, 7 ,3971,847,765,5583
3/28/2013,2013,3,28, 8 ,4128,899,802,5829
3/28/2013,2013,3,28, 9 ,4370,972,900,6242
3/28/2013,2013,3,28, 10 ,4591,1023,928,6542
3/28/2013,2013,3,28, 11 ,4819,1053,973,6845
3/28/2013,2013,3,28, 12 ,4792,1059,976,6827
3/28/2013,2013,3,28, 13 ,4811,1066,981,6858
3/28/2013,2013,3,28, 14 ,4944,1075,994,7013
3/28/2013,2013,3,28, 15 ,4854,1060,972,6886
3/28/2013,2013,3,28, 16 ,4743,1014,947,6704
3/28/2013,2013,3,28, 17 ,4542,983,921,6446
3/28/2013,2013,3,28, 18 ,4665,1089,1022,6776
3/28/2013,2013,3,28, 19 ,5350,1247,1073,7670
3/28/2013,2013,3,28, 20 ,5378,1241,1071,7690
3/28/2013,2013,3,28, 21 ,5389,1214,1058,7661
3/28/2013,2013,3,28, 22 ,5315,1147,1014,7476
3/28/2013,2013,3,28, 23 ,5095,1068,930,7093
3/28/2013,2013,3,28, 24 ,4770,995,864,6629
3/29/2013,2013,3,29, 1 ,4489,934,804,6227
3/29/2013,2013,3,29, 2 ,4328,910,780,6018
3/29/2013,2013,3,29, 3 ,4175,881,751,5807
3/29/2013,2013,3,29, 4 ,4042,865,727,5634
3/29/2013,2013,3,29, 5 ,3976,859,724,5559
3/29/2013,2013,3,29, 6 ,3745,810,704,5259
3/29/2013,2013,3,29, 7 ,3612,792,684,5088
3/29/2013,2013,3,29, 8 ,3697,818,702,5217
3/29/2013,2013,3,29, 9 ,3861,857,737,5455
3/29/2013,2013,3,29, 10 ,4035,880,778,5693
3/29/2013,2013,3,29, 11 ,4200,922,804,5926
3/29/2013,2013,3,29, 12 ,4196,930,835,5961
3/29/2013,2013,3,29, 13 ,4237,937,827,6001
3/29/2013,2013,3,29, 14 ,4335,950,844,6129
3/29/2013,2013,3,29, 15 ,4277,932,827,6036
3/29/2013,2013,3,29, 16 ,4181,898,799,5878
3/29/2013,2013,3,29, 17 ,4035,863,771,5669
3/29/2013,2013,3,29, 18 ,4161,960,931,6052
3/29/2013,2013,3,29, 19 ,4862,1132,1053,7047
3/29/2013,2013,3,29, 20 ,4973,1141,1048,7162
3/29/2013,2013,3,29, 21 ,5066,1120,1008,7194
3/29/2013,2013,3,29, 22 ,5044,1086,952,7082
3/29/2013,2013,3,29, 23 ,4817,1010,877,6704
3/29/2013,2013,3,29, 24 ,4576,959,823,6358
3/30/2013,2013,3,30, 1 ,4312,915,785,6012
3/30/2013,2013,3,30, 2 ,4141,885,756,5782
3/30/2013,2013,3,30, 3 ,4016,863,737,5616
3/30/2013,2013,3,30, 4 ,3937,851,726,5514
3/30/2013,2013,3,30, 5 ,3892,856,735,5483
3/30/2013,2013,3,30, 6 ,3777,829,724,5330
3/30/2013,2013,3,30, 7 ,3806,836,732,5374
3/30/2013,2013,3,30, 8 ,4163,912,797,5872
3/30/2013,2013,3,30, 9 ,4555,1030,899,6484
3/30/2013,2013,3,30, 10 ,4997,1086,987,7070
3/30/2013,2013,3,30, 11 ,5210,1134,1038,7382
3/30/2013,2013,3,30, 12 ,5143,1134,1036,7313
3/30/2013,2013,3,30, 13 ,5166,1141,1057,7364
3/30/2013,2013,3,30, 14 ,5252,1157,1057,7466
3/30/2013,2013,3,30, 15 ,5164,1148,1055,7367
3/30/2013,2013,3,30, 16 ,5092,1126,1048,7266
3/30/2013,2013,3,30, 17 ,4965,1091,1027,7083
3/30/2013,2013,3,30, 18 ,5058,1167,1113,7338
3/30/2013,2013,3,30, 19 ,5821,1333,1192,8346
3/30/2013,2013,3,30, 20 ,5753,1298,1168,8219
3/30/2013,2013,3,30, 21 ,5724,1236,1129,8089
3/30/2013,2013,3,30, 22 ,5567,1162,1060,7789
3/30/2013,2013,3,30, 23 ,5233,1073,975,7281
3/30/2013,2013,3,30, 24 ,4943,1006,897,6846
3/31/2013,2013,3,31, 1 ,4698,968,855,6521
3/31/2013,2013,3,31, 2 ,4594,937,831,6362
3/31/2013,2013,3,31, 3 ,4484,914,815,6213
3/31/2013,2013,3,31, 4 ,4329,893,798,6020
3/31/2013,2013,3,31, 5 ,4267,885,791,5943
3/31/2013,2013,3,31, 6 ,4125,856,780,5761
3/31/2013,2013,3,31, 7 ,4153,854,778,5785
3/31/2013,2013,3,31, 8 ,4429,898,824,6151
3/31/2013,2013,3,31, 9 ,4761,967,877,6605
3/31/2013,2013,3,31, 10 ,5187,1027,968,7182
3/31/2013,2013,3,31, 11 ,5470,1066,1010,7546
3/31/2013,2013,3,31, 12 ,5470,1060,1010,7540
3/31/2013,2013,3,31, 13 ,5521,1062,1017,7600
3/31/2013,2013,3,31, 14 ,5595,1070,1011,7676
3/31/2013,2013,3,31, 15 ,5592,1062,1009,7663
3/31/2013,2013,3,31, 16 ,5486,1031,998,7515
3/31/2013,2013,3,31, 17 ,5259,1021,1007,7287
3/31/2013,2013,3,31, 18 ,5366,1142,1114,7622
3/31/2013,2013,3,31, 19 ,6159,1318,1210,8687
3/31/2013,2013,3,31, 20 ,6113,1297,1183,8593
3/31/2013,2013,3,31, 21 ,6018,1240,1158,8416
3/31/2013,2013,3,31, 22 ,5878,1159,1059,8096
3/31/2013,2013,3,31, 23 ,5496,1077,953,7526
3/31/2013,2013,3,31, 24 ,5240,1012,894,7146
4/1/2013,2013,4,1, 1 ,4978,955,870,6803
4/1/2013,2013,4,1, 2 ,4764,928,830,6522
4/1/2013,2013,4,1, 3 ,4643,904,802,6349
4/1/2013,2013,4,1, 4 ,4593,891,793,6277
4/1/2013,2013,4,1, 5 ,4566,909,815,6290
4/1/2013,2013,4,1, 6 ,4615,912,831,6358
4/1/2013,2013,4,1, 7 ,4898,940,855,6693
4/1/2013,2013,4,1, 8 ,5744,1101,981,7826
4/1/2013,2013,4,1, 9 ,6514,1290,1083,8887
4/1/2013,2013,4,1, 10 ,6994,1377,1098,9469
4/1/2013,2013,4,1, 11 ,7346,1446,1149,9941
4/1/2013,2013,4,1, 12 ,7234,1421,1137,9792
4/1/2013,2013,4,1, 13 ,7258,1435,1107,9800
4/1/2013,2013,4,1, 14 ,7494,1483,1128,10105
4/1/2013,2013,4,1, 15 ,7380,1453,1112,9945
4/1/2013,2013,4,1, 16 ,7289,1425,1109,9823
4/1/2013,2013,4,1, 17 ,6946,1334,1109,9389
4/1/2013,2013,4,1, 18 ,6655,1350,1124,9129
4/1/2013,2013,4,1, 19 ,7055,1481,1105,9641
4/1/2013,2013,4,1, 20 ,6991,1440,1107,9538
4/1/2013,2013,4,1, 21 ,6754,1399,1072,9225
4/1/2013,2013,4,1, 22 ,6551,1302,1025,8878
4/1/2013,2013,4,1, 23 ,6215,1185,962,8362
4/1/2013,2013,4,1, 24 ,5836,1102,876,7814
4/2/2013,2013,4,2, 1 ,5645,1054,844,7543
4/2/2013,2013,4,2, 2 ,5458,1012,824,7294
4/2/2013,2013,4,2, 3 ,5250,983,809,7042
4/2/2013,2013,4,2, 4 ,5104,970,797,6871
4/2/2013,2013,4,2, 5 ,5143,975,814,6932
4/2/2013,2013,4,2, 6 ,5087,963,834,6884
4/2/2013,2013,4,2, 7 ,5333,972,848,7153
4/2/2013,2013,4,2, 8 ,6082,1121,968,8171
4/2/2013,2013,4,2, 9 ,6876,1321,1060,9257
4/2/2013,2013,4,2, 10 ,7319,1405,1103,9827
4/2/2013,2013,4,2, 11 ,7549,1468,1131,10148
4/2/2013,2013,4,2, 12 ,7493,1435,1116,10044
4/2/2013,2013,4,2, 13 ,7452,1433,1131,10016
4/2/2013,2013,4,2, 14 ,7686,1480,1170,10336
4/2/2013,2013,4,2, 15 ,7589,1458,1166,10213
4/2/2013,2013,4,2, 16 ,7425,1433,1130,9988
4/2/2013,2013,4,2, 17 ,7007,1320,1093,9420
4/2/2013,2013,4,2, 18 ,6752,1334,1145,9231
4/2/2013,2013,4,2, 19 ,7120,1451,1174,9745
4/2/2013,2013,4,2, 20 ,7039,1419,1173,9631
4/2/2013,2013,4,2, 21 ,6916,1361,1145,9422
4/2/2013,2013,4,2, 22 ,6587,1279,1150,9016
4/2/2013,2013,4,2, 23 ,6286,1161,1048,8495
4/2/2013,2013,4,2, 24 ,5973,1077,965,8015
4/3/2013,2013,4,3, 1 ,5664,1029,913,7606
4/3/2013,2013,4,3, 2 ,5502,998,889,7389
4/3/2013,2013,4,3, 3 ,5296,971,865,7132
4/3/2013,2013,4,3, 4 ,5157,957,841,6955
4/3/2013,2013,4,3, 5 ,5192,958,861,7011
4/3/2013,2013,4,3, 6 ,5134,955,896,6985
4/3/2013,2013,4,3, 7 ,5296,971,888,7155
4/3/2013,2013,4,3, 8 ,6041,1121,1023,8185
4/3/2013,2013,4,3, 9 ,6849,1328,1112,9289
4/3/2013,2013,4,3, 10 ,7277,1408,1159,9844
4/3/2013,2013,4,3, 11 ,7608,1462,1196,10266
4/3/2013,2013,4,3, 12 ,7420,1427,1183,10030
4/3/2013,2013,4,3, 13 ,7483,1432,1171,10086
4/3/2013,2013,4,3, 14 ,7712,1488,1206,10406
4/3/2013,2013,4,3, 15 ,7695,1460,1190,10345
4/3/2013,2013,4,3, 16 ,7574,1410,1164,10148
4/3/2013,2013,4,3, 17 ,7121,1320,1149,9590
4/3/2013,2013,4,3, 18 ,6839,1336,1178,9353
4/3/2013,2013,4,3, 19 ,7260,1465,1189,9914
4/3/2013,2013,4,3, 20 ,7163,1420,1197,9780
4/3/2013,2013,4,3, 21 ,6995,1374,1170,9539
4/3/2013,2013,4,3, 22 ,6764,1306,1143,9213
4/3/2013,2013,4,3, 23 ,6398,1192,1092,8682
4/3/2013,2013,4,3, 24 ,6007,1101,1017,8125
4/4/2013,2013,4,4, 1 ,5766,1051,979,7796
4/4/2013,2013,4,4, 2 ,5584,1017,948,7549
4/4/2013,2013,4,4, 3 ,5408,997,909,7314
4/4/2013,2013,4,4, 4 ,5274,987,890,7151
4/4/2013,2013,4,4, 5 ,5259,987,917,7163
4/4/2013,2013,4,4, 6 ,5153,979,915,7047
4/4/2013,2013,4,4, 7 ,5359,1001,924,7284
4/4/2013,2013,4,4, 8 ,6140,1154,1023,8317
4/4/2013,2013,4,4, 9 ,6934,1348,1114,9396
4/4/2013,2013,4,4, 10 ,7345,1436,1163,9944
4/4/2013,2013,4,4, 11 ,7570,1490,1163,10223
4/4/2013,2013,4,4, 12 ,7451,1461,1182,10094
4/4/2013,2013,4,4, 13 ,7555,1468,1181,10204
4/4/2013,2013,4,4, 14 ,7775,1504,1189,10468
4/4/2013,2013,4,4, 15 ,7702,1480,1181,10363
4/4/2013,2013,4,4, 16 ,7558,1471,1166,10195
4/4/2013,2013,4,4, 17 ,7193,1353,1111,9657
4/4/2013,2013,4,4, 18 ,6935,1386,1174,9495
4/4/2013,2013,4,4, 19 ,7345,1503,1170,10018
4/4/2013,2013,4,4, 20 ,7248,1468,1150,9866
4/4/2013,2013,4,4, 21 ,7065,1408,1148,9621
4/4/2013,2013,4,4, 22 ,6820,1323,1118,9261
4/4/2013,2013,4,4, 23 ,6535,1223,1068,8826
4/4/2013,2013,4,4, 24 ,6128,1154,990,8272
4/5/2013,2013,4,5, 1 ,5871,1091,940,7902
4/5/2013,2013,4,5, 2 ,5688,1057,904,7649
4/5/2013,2013,4,5, 3 ,5469,1011,873,7353
4/5/2013,2013,4,5, 4 ,5318,1004,864,7186
4/5/2013,2013,4,5, 5 ,5337,1024,878,7239
4/5/2013,2013,4,5, 6 ,5253,999,893,7145
4/5/2013,2013,4,5, 7 ,5409,1019,894,7322
4/5/2013,2013,4,5, 8 ,6233,1219,1026,8478
4/5/2013,2013,4,5, 9 ,6950,1361,1101,9412
4/5/2013,2013,4,5, 10 ,7359,1431,1144,9934
4/5/2013,2013,4,5, 11 ,7665,1467,1170,10302
4/5/2013,2013,4,5, 12 ,7519,1459,1173,10151
4/5/2013,2013,4,5, 13 ,7572,1412,1160,10144
4/5/2013,2013,4,5, 14 ,7861,1462,1176,10499
4/5/2013,2013,4,5, 15 ,7790,1444,1184,10418
4/5/2013,2013,4,5, 16 ,7612,1414,1170,10196
4/5/2013,2013,4,5, 17 ,7210,1333,1112,9655
4/5/2013,2013,4,5, 18 ,6833,1355,1171,9359
4/5/2013,2013,4,5, 19 ,7343,1457,1172,9972
4/5/2013,2013,4,5, 20 ,7242,1418,1168,9828
4/5/2013,2013,4,5, 21 ,7158,1381,1179,9718
4/5/2013,2013,4,5, 22 ,6881,1288,1134,9303
4/5/2013,2013,4,5, 23 ,6584,1189,1067,8840
4/5/2013,2013,4,5, 24 ,6265,1113,995,8373
4/6/2013,2013,4,6, 1 ,5913,1045,938,7896
4/6/2013,2013,4,6, 2 ,5750,1014,926,7690
4/6/2013,2013,4,6, 3 ,5573,990,891,7454
4/6/2013,2013,4,6, 4 ,5437,967,897,7301
4/6/2013,2013,4,6, 5 ,5346,972,886,7204
4/6/2013,2013,4,6, 6 ,5234,952,844,7030
4/6/2013,2013,4,6, 7 ,5280,965,884,7129
4/6/2013,2013,4,6, 8 ,5769,1061,963,7793
4/6/2013,2013,4,6, 9 ,6399,1200,1069,8668
4/6/2013,2013,4,6, 10 ,6868,1289,1156,9313
4/6/2013,2013,4,6, 11 ,7133,1334,1184,9651
4/6/2013,2013,4,6, 12 ,7045,1324,1158,9527
4/6/2013,2013,4,6, 13 ,7035,1323,1175,9533
4/6/2013,2013,4,6, 14 ,7219,1350,1180,9749
4/6/2013,2013,4,6, 15 ,7045,1314,1161,9520
4/6/2013,2013,4,6, 16 ,6823,1270,1175,9268
4/6/2013,2013,4,6, 17 ,6499,1111,1097,8707
4/6/2013,2013,4,6, 18 ,6384,1170,1169,8723
4/6/2013,2013,4,6, 19 ,6995,1329,1177,9501
4/6/2013,2013,4,6, 20 ,6955,1287,1207,9449
4/6/2013,2013,4,6, 21 ,6907,1321,1217,9445
4/6/2013,2013,4,6, 22 ,6765,1255,1186,9206
4/6/2013,2013,4,6, 23 ,6393,1185,1118,8696
4/6/2013,2013,4,6, 24 ,6086,1109,1041,8236
4/7/2013,2013,4,7, 1 ,5802,1049,972,7823
4/7/2013,2013,4,7, 2 ,5429,1018,947,7394
4/7/2013,2013,4,7, 3 ,5381,987,915,7283
4/7/2013,2013,4,7, 4 ,5208,975,906,7089
4/7/2013,2013,4,7, 5 ,5131,967,920,7018
4/7/2013,2013,4,7, 6 ,4843,926,891,6660
4/7/2013,2013,4,7, 7 ,4784,907,857,6548
4/7/2013,2013,4,7, 8 ,5084,960,861,6905
4/7/2013,2013,4,7, 9 ,5414,1040,903,7357
4/7/2013,2013,4,7, 10 ,5907,1126,988,8021
4/7/2013,2013,4,7, 11 ,6196,1198,1073,8467
4/7/2013,2013,4,7, 12 ,6324,1190,1093,8607
4/7/2013,2013,4,7, 13 ,6148,1200,1100,8448
4/7/2013,2013,4,7, 14 ,6246,1208,1101,8555
4/7/2013,2013,4,7, 15 ,6152,1185,1102,8439
4/7/2013,2013,4,7, 16 ,6050,1145,1048,8243
4/7/2013,2013,4,7, 17 ,5841,1117,1041,7999
4/7/2013,2013,4,7, 18 ,5908,1266,1179,8353
4/7/2013,2013,4,7, 19 ,6665,1392,1256,9313
4/7/2013,2013,4,7, 20 ,6658,1360,1236,9254
4/7/2013,2013,4,7, 21 ,6648,1307,1237,9192
4/7/2013,2013,4,7, 22 ,6484,1226,1131,8841
4/7/2013,2013,4,7, 23 ,6201,1144,1034,8379
4/7/2013,2013,4,7, 24 ,5936,1056,984,7976
4/8/2013,2013,4,8, 1 ,5622,1029,921,7572
4/8/2013,2013,4,8, 2 ,5429,1001,897,7327
4/8/2013,2013,4,8, 3 ,5237,964,865,7066
4/8/2013,2013,4,8, 4 ,5134,948,856,6938
4/8/2013,2013,4,8, 5 ,5084,959,866,6909
4/8/2013,2013,4,8, 6 ,5045,949,886,6880
4/8/2013,2013,4,8, 7 ,5286,966,897,7149
4/8/2013,2013,4,8, 8 ,6109,1111,1007,8227
4/8/2013,2013,4,8, 9 ,6928,1291,1141,9360
4/8/2013,2013,4,8, 10 ,7410,1388,1192,9990
4/8/2013,2013,4,8, 11 ,7679,1457,1234,10370
4/8/2013,2013,4,8, 12 ,7674,1436,1219,10329
4/8/2013,2013,4,8, 13 ,7618,1441,1202,10261
4/8/2013,2013,4,8, 14 ,7834,1471,1209,10514
4/8/2013,2013,4,8, 15 ,7724,1444,1164,10332
4/8/2013,2013,4,8, 16 ,7612,1415,1168,10195
4/8/2013,2013,4,8, 17 ,7156,1323,1144,9623
4/8/2013,2013,4,8, 18 ,6874,1367,1182,9423
4/8/2013,2013,4,8, 19 ,7350,1479,1183,10012
4/8/2013,2013,4,8, 20 ,7198,1441,1163,9802
4/8/2013,2013,4,8, 21 ,7098,1381,1150,9629
4/8/2013,2013,4,8, 22 ,6818,1291,1098,9207
4/8/2013,2013,4,8, 23 ,6569,1197,1041,8807
4/8/2013,2013,4,8, 24 ,6205,1125,974,8304
4/9/2013,2013,4,9, 1 ,5914,1068,912,7894
4/9/2013,2013,4,9, 2 ,5712,1027,895,7634
4/9/2013,2013,4,9, 3 ,5530,1003,864,7397
4/9/2013,2013,4,9, 4 ,5371,987,875,7233
4/9/2013,2013,4,9, 5 ,5291,983,869,7143
4/9/2013,2013,4,9, 6 ,5144,949,879,6972
4/9/2013,2013,4,9, 7 ,5131,960,863,6954
4/9/2013,2013,4,9, 8 ,5528,1040,915,7483
4/9/2013,2013,4,9, 9 ,6030,1173,1005,8208
4/9/2013,2013,4,9, 10 ,6480,1259,1052,8791
4/9/2013,2013,4,9, 11 ,6726,1326,1079,9131
4/9/2013,2013,4,9, 12 ,6720,1298,1068,9086
4/9/2013,2013,4,9, 13 ,6696,1314,1022,9032
4/9/2013,2013,4,9, 14 ,6753,1321,1038,9112
4/9/2013,2013,4,9, 15 ,6672,1302,1042,9016
4/9/2013,2013,4,9, 16 ,6543,1264,1059,8866
4/9/2013,2013,4,9, 17 ,6299,1215,1076,8590
4/9/2013,2013,4,9, 18 ,6303,1332,1163,8798
4/9/2013,2013,4,9, 19 ,6907,1440,1179,9526
4/9/2013,2013,4,9, 20 ,6929,1393,1157,9479
4/9/2013,2013,4,9, 21 ,6860,1356,1114,9330
4/9/2013,2013,4,9, 22 ,6633,1264,1019,8916
4/9/2013,2013,4,9, 23 ,6287,1168,960,8415
4/9/2013,2013,4,9, 24 ,5974,1098,872,7944
4/10/2013,2013,4,10, 1 ,5675,1043,822,7540
4/10/2013,2013,4,10, 2 ,5418,1005,797,7220
4/10/2013,2013,4,10, 3 ,5260,977,768,7005
4/10/2013,2013,4,10, 4 ,5176,955,780,6911
4/10/2013,2013,4,10, 5 ,5134,964,817,6915
4/10/2013,2013,4,10, 6 ,5175,952,836,6963
4/10/2013,2013,4,10, 7 ,5366,969,873,7208
4/10/2013,2013,4,10, 8 ,6205,1134,970,8309
4/10/2013,2013,4,10, 9 ,7108,1327,1109,9544
4/10/2013,2013,4,10, 10 ,7542,1414,1108,10064
4/10/2013,2013,4,10, 11 ,7831,1482,1148,10461
4/10/2013,2013,4,10, 12 ,7715,1446,1141,10302
4/10/2013,2013,4,10, 13 ,7733,1441,1145,10319
4/10/2013,2013,4,10, 14 ,7949,1469,1160,10578
4/10/2013,2013,4,10, 15 ,7798,1430,1152,10380
4/10/2013,2013,4,10, 16 ,7724,1423,1140,10287
4/10/2013,2013,4,10, 17 ,7327,1331,1083,9741
4/10/2013,2013,4,10, 18 ,6922,1361,1170,9453
4/10/2013,2013,4,10, 19 ,7370,1483,1182,10035
4/10/2013,2013,4,10, 20 ,7279,1434,1174,9887
4/10/2013,2013,4,10, 21 ,7142,1391,1160,9693
4/10/2013,2013,4,10, 22 ,6892,1279,1062,9233
4/10/2013,2013,4,10, 23 ,6521,1178,955,8654
4/10/2013,2013,4,10, 24 ,6108,1097,901,8106
4/11/2013,2013,4,11, 1 ,5831,1045,900,7776
4/11/2013,2013,4,11, 2 ,5670,1014,873,7557
4/11/2013,2013,4,11, 3 ,5439,990,861,7290
4/11/2013,2013,4,11, 4 ,5287,984,839,7110
4/11/2013,2013,4,11, 5 ,5264,988,845,7097
4/11/2013,2013,4,11, 6 ,5214,975,839,7028
4/11/2013,2013,4,11, 7 ,5410,989,849,7248
4/11/2013,2013,4,11, 8 ,6170,1113,991,8274
4/11/2013,2013,4,11, 9 ,6993,1295,1100,9388
4/11/2013,2013,4,11, 10 ,7373,1371,1136,9880
4/11/2013,2013,4,11, 11 ,7633,1435,1180,10248
4/11/2013,2013,4,11, 12 ,7559,1398,1181,10138
4/11/2013,2013,4,11, 13 ,7583,1402,1147,10132
4/11/2013,2013,4,11, 14 ,7819,1458,1179,10456
4/11/2013,2013,4,11, 15 ,7742,1421,1168,10331
4/11/2013,2013,4,11, 16 ,7585,1391,1153,10129
4/11/2013,2013,4,11, 17 ,7207,1298,1105,9610
4/11/2013,2013,4,11, 18 ,6885,1336,1132,9353
4/11/2013,2013,4,11, 19 ,7285,1453,1145,9883
4/11/2013,2013,4,11, 20 ,7177,1413,1131,9721
4/11/2013,2013,4,11, 21 ,7083,1356,1143,9582
4/11/2013,2013,4,11, 22 ,6778,1257,1109,9144
4/11/2013,2013,4,11, 23 ,6490,1164,1061,8715
4/11/2013,2013,4,11, 24 ,6144,1080,982,8206
4/12/2013,2013,4,12, 1 ,5782,1028,927,7737
4/12/2013,2013,4,12, 2 ,5576,1005,899,7480
4/12/2013,2013,4,12, 3 ,5305,977,885,7167
4/12/2013,2013,4,12, 4 ,5195,958,879,7032
4/12/2013,2013,4,12, 5 ,5181,969,900,7050
4/12/2013,2013,4,12, 6 ,5088,963,916,6967
4/12/2013,2013,4,12, 7 ,5339,981,913,7233
4/12/2013,2013,4,12, 8 ,6159,1141,1008,8308
4/12/2013,2013,4,12, 9 ,6834,1330,1107,9271
4/12/2013,2013,4,12, 10 ,7362,1420,1223,10005
4/12/2013,2013,4,12, 11 ,7534,1479,1248,10261
4/12/2013,2013,4,12, 12 ,7479,1445,1235,10159
4/12/2013,2013,4,12, 13 ,7557,1467,1232,10256
4/12/2013,2013,4,12, 14 ,7758,1506,1240,10504
4/12/2013,2013,4,12, 15 ,7657,1470,1215,10342
4/12/2013,2013,4,12, 16 ,7479,1435,1204,10118
4/12/2013,2013,4,12, 17 ,7090,1338,1158,9586
4/12/2013,2013,4,12, 18 ,6801,1352,1211,9364
4/12/2013,2013,4,12, 19 ,7208,1490,1211,9909
4/12/2013,2013,4,12, 20 ,7122,1471,1171,9764
4/12/2013,2013,4,12, 21 ,7060,1410,1187,9657
4/12/2013,2013,4,12, 22 ,6770,1312,1122,9204
4/12/2013,2013,4,12, 23 ,6430,1202,1060,8692
4/12/2013,2013,4,12, 24 ,6141,1121,985,8247
4/13/2013,2013,4,13, 1 ,5861,1071,932,7864
4/13/2013,2013,4,13, 2 ,5678,1026,906,7610
4/13/2013,2013,4,13, 3 ,5410,1005,878,7293
4/13/2013,2013,4,13, 4 ,5348,986,868,7202
4/13/2013,2013,4,13, 5 ,5285,990,883,7158
4/13/2013,2013,4,13, 6 ,5045,963,886,6894
4/13/2013,2013,4,13, 7 ,5107,977,876,6960
4/13/2013,2013,4,13, 8 ,5543,1078,938,7559
4/13/2013,2013,4,13, 9 ,6195,1238,1061,8494
4/13/2013,2013,4,13, 10 ,6633,1312,1155,9100
4/13/2013,2013,4,13, 11 ,6946,1365,1201,9512
4/13/2013,2013,4,13, 12 ,6760,1340,1189,9289
4/13/2013,2013,4,13, 13 ,6777,1350,1195,9322
4/13/2013,2013,4,13, 14 ,6923,1387,1219,9529
4/13/2013,2013,4,13, 15 ,6807,1344,1190,9341
4/13/2013,2013,4,13, 16 ,6567,1306,1157,9030
4/13/2013,2013,4,13, 17 ,6169,1217,1155,8541
4/13/2013,2013,4,13, 18 ,6096,1269,1220,8585
4/13/2013,2013,4,13, 19 ,6675,1433,1214,9322
4/13/2013,2013,4,13, 20 ,6714,1406,1220,9340
4/13/2013,2013,4,13, 21 ,6668,1369,1196,9233
4/13/2013,2013,4,13, 22 ,6450,1283,1132,8865
4/13/2013,2013,4,13, 23 ,6138,1184,1035,8357
4/13/2013,2013,4,13, 24 ,5880,1111,989,7980
4/14/2013,2013,4,14, 1 ,5594,1045,930,7569
4/14/2013,2013,4,14, 2 ,5408,1017,894,7319
4/14/2013,2013,4,14, 3 ,5200,990,883,7073
4/14/2013,2013,4,14, 4 ,5038,972,859,6869
4/14/2013,2013,4,14, 5 ,4982,967,869,6818
4/14/2013,2013,4,14, 6 ,4679,927,851,6457
4/14/2013,2013,4,14, 7 ,4755,929,840,6524
4/14/2013,2013,4,14, 8 ,5048,972,881,6901
4/14/2013,2013,4,14, 9 ,5459,1044,921,7424
4/14/2013,2013,4,14, 10 ,5897,1141,1003,8041
4/14/2013,2013,4,14, 11 ,6166,1180,1062,8408
4/14/2013,2013,4,14, 12 ,6211,1213,1080,8504
4/14/2013,2013,4,14, 13 ,6229,1221,1072,8522
4/14/2013,2013,4,14, 14 ,6222,1196,1044,8462
4/14/2013,2013,4,14, 15 ,6157,1186,1054,8397
4/14/2013,2013,4,14, 16 ,5947,1146,1014,8107
4/14/2013,2013,4,14, 17 ,5818,1111,1019,7948
4/14/2013,2013,4,14, 18 ,5958,1205,1149,8312
4/14/2013,2013,4,14, 19 ,6636,1373,1184,9193
4/14/2013,2013,4,14, 20 ,6711,1353,1182,9246
4/14/2013,2013,4,14, 21 ,6663,1285,1144,9092
4/14/2013,2013,4,14, 22 ,6400,1215,1080,8695
4/14/2013,2013,4,14, 23 ,6211,1145,1013,8369
4/14/2013,2013,4,14, 24 ,5890,1081,925,7896
4/15/2013,2013,4,15, 1 ,5632,1024,861,7517
4/15/2013,2013,4,15, 2 ,5290,967,820,7077
4/15/2013,2013,4,15, 3 ,5176,945,822,6943
4/15/2013,2013,4,15, 4 ,5028,934,800,6762
4/15/2013,2013,4,15, 5 ,5051,940,820,6811
4/15/2013,2013,4,15, 6 ,5003,936,828,6767
4/15/2013,2013,4,15, 7 ,5360,969,855,7184
4/15/2013,2013,4,15, 8 ,6199,1141,1002,8342
4/15/2013,2013,4,15, 9 ,6966,1349,1037,9352
4/15/2013,2013,4,15, 10 ,7490,1437,1073,10000
4/15/2013,2013,4,15, 11 ,7709,1483,1106,10298
4/15/2013,2013,4,15, 12 ,7698,1458,1132,10288
4/15/2013,2013,4,15, 13 ,7695,1467,1159,10321
4/15/2013,2013,4,15, 14 ,7932,1535,1172,10639
4/15/2013,2013,4,15, 15 ,7805,1499,1154,10458
4/15/2013,2013,4,15, 16 ,7690,1456,1162,10308
4/15/2013,2013,4,15, 17 ,7245,1360,1124,9729
4/15/2013,2013,4,15, 18 ,7005,1389,1160,9554
4/15/2013,2013,4,15, 19 ,7391,1503,1185,10079
4/15/2013,2013,4,15, 20 ,7318,1455,1191,9964
4/15/2013,2013,4,15, 21 ,7184,1414,1198,9796
4/15/2013,2013,4,15, 22 ,6908,1315,1153,9376
4/15/2013,2013,4,15, 23 ,6558,1214,1090,8862
4/15/2013,2013,4,15, 24 ,6227,1118,1022,8367
4/16/2013,2013,4,16, 1 ,5906,1067,955,7928
4/16/2013,2013,4,16, 2 ,5679,1033,922,7634
4/16/2013,2013,4,16, 3 ,5545,1006,904,7455
4/16/2013,2013,4,16, 4 ,5401,987,886,7274
4/16/2013,2013,4,16, 5 ,5374,999,890,7263
4/16/2013,2013,4,16, 6 ,5264,980,917,7161
4/16/2013,2013,4,16, 7 ,5457,1006,920,7383
4/16/2013,2013,4,16, 8 ,6243,1167,1050,8460
4/16/2013,2013,4,16, 9 ,6983,1374,1110,9467
4/16/2013,2013,4,16, 10 ,7436,1473,1171,10080
4/16/2013,2013,4,16, 11 ,7710,1509,1191,10410
4/16/2013,2013,4,16, 12 ,7626,1485,1177,10288
4/16/2013,2013,4,16, 13 ,7684,1489,1204,10377
4/16/2013,2013,4,16, 14 ,7958,1545,1186,10689
4/16/2013,2013,4,16, 15 ,7832,1495,1167,10494
4/16/2013,2013,4,16, 16 ,7686,1470,1160,10316
4/16/2013,2013,4,16, 17 ,7234,1360,1138,9732
4/16/2013,2013,4,16, 18 ,7003,1374,1163,9540
4/16/2013,2013,4,16, 19 ,7506,1498,1155,10159
4/16/2013,2013,4,16, 20 ,7348,1449,1194,9991
4/16/2013,2013,4,16, 21 ,7305,1404,1193,9902
4/16/2013,2013,4,16, 22 ,7043,1307,1156,9506
4/16/2013,2013,4,16, 23 ,6742,1219,1097,9058
4/16/2013,2013,4,16, 24 ,6381,1139,1022,8542
4/17/2013,2013,4,17, 1 ,6064,1084,975,8123
4/17/2013,2013,4,17, 2 ,5861,1050,946,7857
4/17/2013,2013,4,17, 3 ,5699,1021,913,7633
4/17/2013,2013,4,17, 4 ,5552,993,900,7445
4/17/2013,2013,4,17, 5 ,5523,1004,909,7436
4/17/2013,2013,4,17, 6 ,5383,979,917,7279
4/17/2013,2013,4,17, 7 ,5590,998,911,7499
4/17/2013,2013,4,17, 8 ,6376,1167,1027,8570
4/17/2013,2013,4,17, 9 ,7125,1364,1107,9596
4/17/2013,2013,4,17, 10 ,7512,1453,1141,10106
4/17/2013,2013,4,17, 11 ,7867,1492,1180,10539
4/17/2013,2013,4,17, 12 ,7743,1456,1161,10360
4/17/2013,2013,4,17, 13 ,7826,1484,1150,10460
4/17/2013,2013,4,17, 14 ,8083,1548,1192,10823
4/17/2013,2013,4,17, 15 ,7920,1501,1160,10581
4/17/2013,2013,4,17, 16 ,7741,1476,1150,10367
4/17/2013,2013,4,17, 17 ,7344,1374,1133,9851
4/17/2013,2013,4,17, 18 ,7081,1380,1165,9626
4/17/2013,2013,4,17, 19 ,7557,1508,1157,10222
4/17/2013,2013,4,17, 20 ,7415,1466,1144,10025
4/17/2013,2013,4,17, 21 ,7345,1412,1139,9896
4/17/2013,2013,4,17, 22 ,7084,1317,1080,9481
4/17/2013,2013,4,17, 23 ,6764,1213,1051,9028
4/17/2013,2013,4,17, 24 ,6414,1143,980,8537
4/18/2013,2013,4,18, 1 ,6073,1073,943,8089
4/18/2013,2013,4,18, 2 ,5885,1041,907,7833
4/18/2013,2013,4,18, 3 ,5685,1008,885,7578
4/18/2013,2013,4,18, 4 ,5623,993,882,7498
4/18/2013,2013,4,18, 5 ,5509,1000,893,7402
4/18/2013,2013,4,18, 6 ,5420,977,926,7323
4/18/2013,2013,4,18, 7 ,5634,994,907,7535
4/18/2013,2013,4,18, 8 ,6450,1166,996,8612
4/18/2013,2013,4,18, 9 ,7164,1369,1097,9630
4/18/2013,2013,4,18, 10 ,7608,1453,1110,10171
4/18/2013,2013,4,18, 11 ,7826,1507,1163,10496
4/18/2013,2013,4,18, 12 ,7810,1483,1148,10441
4/18/2013,2013,4,18, 13 ,7852,1485,1174,10511
4/18/2013,2013,4,18, 14 ,8089,1537,1133,10759
4/18/2013,2013,4,18, 15 ,7870,1497,1154,10521
4/18/2013,2013,4,18, 16 ,7729,1464,1120,10313
4/18/2013,2013,4,18, 17 ,7332,1369,1120,9821
4/18/2013,2013,4,18, 18 ,7104,1389,1157,9650
4/18/2013,2013,4,18, 19 ,7619,1518,1177,10314
4/18/2013,2013,4,18, 20 ,7470,1481,1212,10163
4/18/2013,2013,4,18, 21 ,7381,1413,1211,10005
4/18/2013,2013,4,18, 22 ,7135,1313,1167,9615
4/18/2013,2013,4,18, 23 ,6862,1214,1102,9178
4/18/2013,2013,4,18, 24 ,6479,1154,1024,8657
4/19/2013,2013,4,19, 1 ,6165,1096,944,8205
4/19/2013,2013,4,19, 2 ,5939,1058,918,7915
4/19/2013,2013,4,19, 3 ,5767,1028,901,7696
4/19/2013,2013,4,19, 4 ,5612,1008,880,7500
4/19/2013,2013,4,19, 5 ,5503,1017,881,7401
4/19/2013,2013,4,19, 6 ,5405,997,902,7304
4/19/2013,2013,4,19, 7 ,5691,1015,925,7631
4/19/2013,2013,4,19, 8 ,6468,1184,1029,8681
4/19/2013,2013,4,19, 9 ,7187,1369,1148,9704
4/19/2013,2013,4,19, 10 ,7619,1461,1158,10238
4/19/2013,2013,4,19, 11 ,7857,1506,1161,10524
4/19/2013,2013,4,19, 12 ,7699,1494,1182,10375
4/19/2013,2013,4,19, 13 ,7759,1499,1187,10445
4/19/2013,2013,4,19, 14 ,8033,1536,1198,10767
4/19/2013,2013,4,19, 15 ,7896,1496,1200,10592
4/19/2013,2013,4,19, 16 ,7723,1466,1154,10343
4/19/2013,2013,4,19, 17 ,7357,1381,1144,9882
4/19/2013,2013,4,19, 18 ,7087,1417,1175,9679
4/19/2013,2013,4,19, 19 ,7409,1525,1162,10096
4/19/2013,2013,4,19, 20 ,7352,1486,1160,9998
4/19/2013,2013,4,19, 21 ,7272,1428,1129,9829
4/19/2013,2013,4,19, 22 ,7026,1329,1098,9453
4/19/2013,2013,4,19, 23 ,6736,1232,1034,9002
4/19/2013,2013,4,19, 24 ,6300,1157,1013,8470
4/20/2013,2013,4,20, 1 ,6109,1115,961,8185
4/20/2013,2013,4,20, 2 ,5901,1076,917,7894
4/20/2013,2013,4,20, 3 ,5716,1043,905,7664
4/20/2013,2013,4,20, 4 ,5563,1016,878,7457
4/20/2013,2013,4,20, 5 ,5495,1017,881,7393
4/20/2013,2013,4,20, 6 ,5267,990,901,7158
4/20/2013,2013,4,20, 7 ,5378,995,886,7259
4/20/2013,2013,4,20, 8 ,5835,1057,955,7847
4/20/2013,2013,4,20, 9 ,6451,1223,1003,8677
4/20/2013,2013,4,20, 10 ,6873,1308,1096,9277
4/20/2013,2013,4,20, 11 ,7101,1355,1119,9575
4/20/2013,2013,4,20, 12 ,6974,1323,1117,9414
4/20/2013,2013,4,20, 13 ,7036,1312,1123,9471
4/20/2013,2013,4,20, 14 ,7182,1334,1129,9645
4/20/2013,2013,4,20, 15 ,7046,1285,1092,9423
4/20/2013,2013,4,20, 16 ,6909,1244,1085,9238
4/20/2013,2013,4,20, 17 ,6567,1209,1088,8864
4/20/2013,2013,4,20, 18 ,6528,1315,1145,8988
4/20/2013,2013,4,20, 19 ,7012,1401,1112,9525
4/20/2013,2013,4,20, 20 ,7041,1372,1097,9510
4/20/2013,2013,4,20, 21 ,7063,1313,1070,9446
4/20/2013,2013,4,20, 22 ,6854,1234,1050,9138
4/20/2013,2013,4,20, 23 ,6602,1145,992,8739
4/20/2013,2013,4,20, 24 ,6302,1074,907,8283
4/21/2013,2013,4,21, 1 ,6031,1025,882,7938
4/21/2013,2013,4,21, 2 ,5785,978,863,7626
4/21/2013,2013,4,21, 3 ,5627,949,831,7407
4/21/2013,2013,4,21, 4 ,5496,936,833,7265
4/21/2013,2013,4,21, 5 ,5505,941,827,7273
4/21/2013,2013,4,21, 6 ,5272,904,838,7014
4/21/2013,2013,4,21, 7 ,5072,908,822,6802
4/21/2013,2013,4,21, 8 ,5300,938,849,7087
4/21/2013,2013,4,21, 9 ,5683,1008,862,7553
4/21/2013,2013,4,21, 10 ,6051,1091,984,8126
4/21/2013,2013,4,21, 11 ,6322,1142,1030,8494
4/21/2013,2013,4,21, 12 ,6255,1163,1049,8467
4/21/2013,2013,4,21, 13 ,6352,1143,1057,8552
4/21/2013,2013,4,21, 14 ,6374,1133,1061,8568
4/21/2013,2013,4,21, 15 ,6282,1115,1032,8429
4/21/2013,2013,4,21, 16 ,6117,1081,1013,8211
4/21/2013,2013,4,21, 17 ,5887,1062,1006,7955
4/21/2013,2013,4,21, 18 ,5980,1217,1151,8348
4/21/2013,2013,4,21, 19 ,6614,1352,1198,9164
4/21/2013,2013,4,21, 20 ,6618,1333,1202,9153
4/21/2013,2013,4,21, 21 ,6575,1268,1121,8964
4/21/2013,2013,4,21, 22 ,6474,1174,1059,8707
4/21/2013,2013,4,21, 23 ,6223,1098,959,8280
4/21/2013,2013,4,21, 24 ,5996,1032,915,7943
4/22/2013,2013,4,22, 1 ,5694,976,847,7517
4/22/2013,2013,4,22, 2 ,5448,945,827,7220
4/22/2013,2013,4,22, 3 ,5258,910,811,6979
4/22/2013,2013,4,22, 4 ,5174,891,788,6853
4/22/2013,2013,4,22, 5 ,5141,918,812,6871
4/22/2013,2013,4,22, 6 ,5136,916,840,6892
4/22/2013,2013,4,22, 7 ,5392,958,855,7205
4/22/2013,2013,4,22, 8 ,6257,1122,978,8357
4/22/2013,2013,4,22, 9 ,7037,1328,1063,9428
4/22/2013,2013,4,22, 10 ,7555,1424,1154,10133
4/22/2013,2013,4,22, 11 ,7844,1472,1221,10537
4/22/2013,2013,4,22, 12 ,7713,1434,1159,10306
4/22/2013,2013,4,22, 13 ,7771,1449,1166,10386
4/22/2013,2013,4,22, 14 ,7987,1504,1203,10694
4/22/2013,2013,4,22, 15 ,7784,1477,1205,10466
4/22/2013,2013,4,22, 16 ,7612,1456,1183,10251
4/22/2013,2013,4,22, 17 ,7247,1355,1167,9769
4/22/2013,2013,4,22, 18 ,6888,1382,1177,9447
4/22/2013,2013,4,22, 19 ,7402,1495,1228,10125
4/22/2013,2013,4,22, 20 ,7247,1439,1220,9906
4/22/2013,2013,4,22, 21 ,7135,1379,1202,9716
4/22/2013,2013,4,22, 22 ,6906,1293,1135,9334
4/22/2013,2013,4,22, 23 ,6583,1175,1069,8827
4/22/2013,2013,4,22, 24 ,6266,1106,984,8356
4/23/2013,2013,4,23, 1 ,6004,1058,930,7992
4/23/2013,2013,4,23, 2 ,5805,1027,913,7745
4/23/2013,2013,4,23, 3 ,5630,999,887,7516
4/23/2013,2013,4,23, 4 ,5570,975,859,7404
4/23/2013,2013,4,23, 5 ,5525,985,883,7393
4/23/2013,2013,4,23, 6 ,5434,972,873,7279
4/23/2013,2013,4,23, 7 ,5629,983,900,7512
4/23/2013,2013,4,23, 8 ,6456,1144,990,8590
4/23/2013,2013,4,23, 9 ,7202,1362,1122,9686
4/23/2013,2013,4,23, 10 ,7602,1431,1151,10184
4/23/2013,2013,4,23, 11 ,7877,1503,1187,10567
4/23/2013,2013,4,23, 12 ,7731,1467,1189,10387
4/23/2013,2013,4,23, 13 ,7768,1470,1194,10432
4/23/2013,2013,4,23, 14 ,8100,1520,1211,10831
4/23/2013,2013,4,23, 15 ,7956,1495,1182,10633
4/23/2013,2013,4,23, 16 ,7853,1467,1165,10485
4/23/2013,2013,4,23, 17 ,7410,1378,1142,9930
4/23/2013,2013,4,23, 18 ,7074,1376,1162,9612
4/23/2013,2013,4,23, 19 ,7449,1508,1206,10163
4/23/2013,2013,4,23, 20 ,7438,1468,1197,10103
4/23/2013,2013,4,23, 21 ,7313,1407,1192,9912
4/23/2013,2013,4,23, 22 ,7023,1312,1146,9481
4/23/2013,2013,4,23, 23 ,6759,1209,1079,9047
4/23/2013,2013,4,23, 24 ,6377,1119,977,8473
4/24/2013,2013,4,24, 1 ,6096,1067,948,8111
4/24/2013,2013,4,24, 2 ,5938,1034,911,7883
4/24/2013,2013,4,24, 3 ,5757,1009,879,7645
4/24/2013,2013,4,24, 4 ,5578,986,864,7428
4/24/2013,2013,4,24, 5 ,5573,994,882,7449
4/24/2013,2013,4,24, 6 ,5382,972,874,7228
4/24/2013,2013,4,24, 7 ,5680,1002,871,7553
4/24/2013,2013,4,24, 8 ,6467,1164,989,8620
4/24/2013,2013,4,24, 9 ,7303,1369,1056,9728
4/24/2013,2013,4,24, 10 ,7642,1461,1143,10246
4/24/2013,2013,4,24, 11 ,7958,1500,1176,10634
4/24/2013,2013,4,24, 12 ,7810,1471,1153,10434
4/24/2013,2013,4,24, 13 ,7893,1483,1174,10550
4/24/2013,2013,4,24, 14 ,8135,1506,1186,10827
4/24/2013,2013,4,24, 15 ,8065,1494,1162,10721
4/24/2013,2013,4,24, 16 ,7930,1463,1169,10562
4/24/2013,2013,4,24, 17 ,7498,1373,1125,9996
4/24/2013,2013,4,24, 18 ,7180,1386,1155,9721
4/24/2013,2013,4,24, 19 ,7665,1523,1155,10343
4/24/2013,2013,4,24, 20 ,7503,1479,1154,10136
4/24/2013,2013,4,24, 21 ,7429,1413,1158,10000
4/24/2013,2013,4,24, 22 ,7215,1327,1141,9683
4/24/2013,2013,4,24, 23 ,6840,1215,1091,9146
4/24/2013,2013,4,24, 24 ,6535,1136,1001,8672
4/25/2013,2013,4,25, 1 ,6176,1078,936,8190
4/25/2013,2013,4,25, 2 ,5964,1050,908,7922
4/25/2013,2013,4,25, 3 ,5837,1020,909,7766
4/25/2013,2013,4,25, 4 ,5706,1006,873,7585
4/25/2013,2013,4,25, 5 ,5647,1010,891,7548
4/25/2013,2013,4,25, 6 ,5490,982,897,7369
4/25/2013,2013,4,25, 7 ,5664,1013,891,7568
4/25/2013,2013,4,25, 8 ,6654,1187,1011,8852
4/25/2013,2013,4,25, 9 ,7310,1363,1072,9745
4/25/2013,2013,4,25, 10 ,7770,1411,1113,10294
4/25/2013,2013,4,25, 11 ,8014,1475,1158,10647
4/25/2013,2013,4,25, 12 ,7877,1450,1148,10475
4/25/2013,2013,4,25, 13 ,7968,1473,1167,10608
4/25/2013,2013,4,25, 14 ,8148,1509,1188,10845
4/25/2013,2013,4,25, 15 ,8058,1474,1161,10693
4/25/2013,2013,4,25, 16 ,7959,1443,1141,10543
4/25/2013,2013,4,25, 17 ,7536,1358,1130,10024
4/25/2013,2013,4,25, 18 ,7074,1399,1174,9647
4/25/2013,2013,4,25, 19 ,7575,1520,1193,10288
4/25/2013,2013,4,25, 20 ,7454,1486,1152,10092
4/25/2013,2013,4,25, 21 ,7440,1430,1162,10032
4/25/2013,2013,4,25, 22 ,7103,1341,1123,9567
4/25/2013,2013,4,25, 23 ,6799,1229,1025,9053
4/25/2013,2013,4,25, 24 ,6433,1151,973,8557
4/26/2013,2013,4,26, 1 ,6176,1085,922,8183
4/26/2013,2013,4,26, 2 ,5955,1055,898,7908
4/26/2013,2013,4,26, 3 ,5792,1027,870,7689
4/26/2013,2013,4,26, 4 ,5616,1004,849,7469
4/26/2013,2013,4,26, 5 ,5576,1015,880,7471
4/26/2013,2013,4,26, 6 ,5411,995,897,7303
4/26/2013,2013,4,26, 7 ,5648,1026,894,7568
4/26/2013,2013,4,26, 8 ,6399,1176,1067,8642
4/26/2013,2013,4,26, 9 ,7183,1373,1131,9687
4/26/2013,2013,4,26, 10 ,7691,1457,1184,10332
4/26/2013,2013,4,26, 11 ,7921,1497,1198,10616
4/26/2013,2013,4,26, 12 ,7820,1466,1177,10463
4/26/2013,2013,4,26, 13 ,7950,1441,1204,10595
4/26/2013,2013,4,26, 14 ,8143,1489,1180,10812
4/26/2013,2013,4,26, 15 ,7895,1450,1176,10521
4/26/2013,2013,4,26, 16 ,7731,1418,1135,10284
4/26/2013,2013,4,26, 17 ,7284,1332,1119,9735
4/26/2013,2013,4,26, 18 ,6910,1351,1206,9467
4/26/2013,2013,4,26, 19 ,7450,1476,1156,10082
4/26/2013,2013,4,26, 20 ,7456,1441,1148,10045
4/26/2013,2013,4,26, 21 ,7313,1380,1164,9857
4/26/2013,2013,4,26, 22 ,7151,1277,1143,9571
4/26/2013,2013,4,26, 23 ,6529,1183,1061,8773
4/26/2013,2013,4,26, 24 ,6163,1128,992,8283
4/27/2013,2013,4,27, 1 ,5944,1078,951,7973
4/27/2013,2013,4,27, 2 ,5749,1044,916,7709
4/27/2013,2013,4,27, 3 ,5529,1014,898,7441
4/27/2013,2013,4,27, 4 ,5420,991,879,7290
4/27/2013,2013,4,27, 5 ,5291,998,897,7186
4/27/2013,2013,4,27, 6 ,5107,959,900,6966
4/27/2013,2013,4,27, 7 ,5221,970,860,7051
4/27/2013,2013,4,27, 8 ,5701,1076,948,7725
4/27/2013,2013,4,27, 9 ,6245,1204,1082,8531
4/27/2013,2013,4,27, 10 ,6841,1283,1158,9282
4/27/2013,2013,4,27, 11 ,7155,1327,1155,9637
4/27/2013,2013,4,27, 12 ,6994,1289,1149,9432
4/27/2013,2013,4,27, 13 ,7037,1269,1165,9471
4/27/2013,2013,4,27, 14 ,7168,1303,1146,9617
4/27/2013,2013,4,27, 15 ,6713,1247,1116,9076
4/27/2013,2013,4,27, 16 ,6527,1221,1089,8837
4/27/2013,2013,4,27, 17 ,6291,1196,1080,8567
4/27/2013,2013,4,27, 18 ,6214,1317,1176,8707
4/27/2013,2013,4,27, 19 ,6922,1442,1154,9518
4/27/2013,2013,4,27, 20 ,6739,1395,1128,9262
4/27/2013,2013,4,27, 21 ,6908,1305,1160,9373
4/27/2013,2013,4,27, 22 ,6638,1204,1108,8950
4/27/2013,2013,4,27, 23 ,6281,1144,1037,8462
4/27/2013,2013,4,27, 24 ,5944,1079,951,7974
4/28/2013,2013,4,28, 1 ,5679,1031,911,7621
4/28/2013,2013,4,28, 2 ,5484,996,872,7352
4/28/2013,2013,4,28, 3 ,5379,965,857,7201
4/28/2013,2013,4,28, 4 ,5198,947,822,6967
4/28/2013,2013,4,28, 5 ,5127,948,852,6927
4/28/2013,2013,4,28, 6 ,4839,909,826,6574
4/28/2013,2013,4,28, 7 ,4761,918,821,6500
4/28/2013,2013,4,28, 8 ,5020,968,835,6823
4/28/2013,2013,4,28, 9 ,5386,1055,947,7388
4/28/2013,2013,4,28, 10 ,5826,1127,1024,7977
4/28/2013,2013,4,28, 11 ,6222,1181,1050,8453
4/28/2013,2013,4,28, 12 ,6185,1186,1075,8446
4/28/2013,2013,4,28, 13 ,6171,1199,1087,8457
4/28/2013,2013,4,28, 14 ,6276,1198,1072,8546
4/28/2013,2013,4,28, 15 ,6155,1188,1051,8394
4/28/2013,2013,4,28, 16 ,5909,1156,1035,8100
4/28/2013,2013,4,28, 17 ,5784,1138,1029,7951
4/28/2013,2013,4,28, 18 ,5843,1229,1115,8187
4/28/2013,2013,4,28, 19 ,6587,1399,1104,9090
4/28/2013,2013,4,28, 20 ,6621,1388,1110,9119
4/28/2013,2013,4,28, 21 ,6665,1335,1115,9115
4/28/2013,2013,4,28, 22 ,6400,1248,1065,8713
4/28/2013,2013,4,28, 23 ,6105,1160,1024,8289
4/28/2013,2013,4,28, 24 ,5819,1077,961,7857
4/29/2013,2013,4,29, 1 ,5547,1023,898,7468
4/29/2013,2013,4,29, 2 ,5350,991,872,7213
4/29/2013,2013,4,29, 3 ,5180,964,846,6990
4/29/2013,2013,4,29, 4 ,5052,944,840,6836
4/29/2013,2013,4,29, 5 ,4965,956,859,6780
4/29/2013,2013,4,29, 6 ,4951,941,849,6741
4/29/2013,2013,4,29, 7 ,5328,975,874,7177
4/29/2013,2013,4,29, 8 ,6225,1160,992,8377
4/29/2013,2013,4,29, 9 ,7015,1374,1084,9473
4/29/2013,2013,4,29, 10 ,7505,1474,1131,10110
4/29/2013,2013,4,29, 11 ,7810,1532,1156,10498
4/29/2013,2013,4,29, 12 ,7723,1496,1141,10360
4/29/2013,2013,4,29, 13 ,7717,1498,1165,10380
4/29/2013,2013,4,29, 14 ,8060,1527,1161,10748
4/29/2013,2013,4,29, 15 ,7922,1501,1151,10574
4/29/2013,2013,4,29, 16 ,7795,1471,1156,10422
4/29/2013,2013,4,29, 17 ,7369,1376,1125,9870
4/29/2013,2013,4,29, 18 ,6989,1397,1169,9555
4/29/2013,2013,4,29, 19 ,7361,1528,1145,10034
4/29/2013,2013,4,29, 20 ,7402,1498,1165,10065
4/29/2013,2013,4,29, 21 ,7305,1429,1208,9942
4/29/2013,2013,4,29, 22 ,7062,1337,1118,9517
4/29/2013,2013,4,29, 23 ,6680,1223,1069,8972
4/29/2013,2013,4,29, 24 ,6358,1137,1020,8515
4/30/2013,2013,4,30, 1 ,6070,1085,981,8136
4/30/2013,2013,4,30, 2 ,5893,1048,930,7871
4/30/2013,2013,4,30, 3 ,5653,1016,909,7578
4/30/2013,2013,4,30, 4 ,5539,997,904,7440
4/30/2013,2013,4,30, 5 ,5410,998,926,7334
4/30/2013,2013,4,30, 6 ,5290,973,911,7174
4/30/2013,2013,4,30, 7 ,5518,997,928,7443
4/30/2013,2013,4,30, 8 ,6395,1166,1050,8611
4/30/2013,2013,4,30, 9 ,7206,1388,1108,9702
4/30/2013,2013,4,30, 10 ,7629,1456,1112,10197
4/30/2013,2013,4,30, 11 ,7904,1514,1112,10530
4/30/2013,2013,4,30, 12 ,7790,1472,1131,10393
4/30/2013,2013,4,30, 13 ,7857,1481,1122,10460
4/30/2013,2013,4,30, 14 ,8013,1528,1110,10651
4/30/2013,2013,4,30, 15 ,7974,1502,1147,10623
4/30/2013,2013,4,30, 16 ,7835,1455,1102,10392
4/30/2013,2013,4,30, 17 ,7434,1378,1123,9935
4/30/2013,2013,4,30, 18 ,7056,1364,1154,9574
4/30/2013,2013,4,30, 19 ,7492,1504,1163,10159
4/30/2013,2013,4,30, 20 ,7464,1473,1188,10125
4/30/2013,2013,4,30, 21 ,7378,1430,1172,9980
4/30/2013,2013,4,30, 22 ,7171,1330,1143,9644
4/30/2013,2013,4,30, 23 ,6714,1228,1065,9007
4/30/2013,2013,4,30, 24 ,6406,1146,1020,8572
5/1/2013,2013,5,1, 1 ,6183,1094,964,8241
5/1/2013,2013,5,1, 2 ,5947,1050,937,7934
5/1/2013,2013,5,1, 3 ,5798,1017,912,7727
5/1/2013,2013,5,1, 4 ,5602,995,901,7498
5/1/2013,2013,5,1, 5 ,5423,990,899,7312
5/1/2013,2013,5,1, 6 ,5013,946,881,6840
5/1/2013,2013,5,1, 7 ,4988,953,851,6792
5/1/2013,2013,5,1, 8 ,5323,1032,926,7281
5/1/2013,2013,5,1, 9 ,5682,1159,1054,7895
5/1/2013,2013,5,1, 10 ,6161,1256,1083,8500
5/1/2013,2013,5,1, 11 ,6561,1313,1113,8987
5/1/2013,2013,5,1, 12 ,6556,1294,1104,8954
5/1/2013,2013,5,1, 13 ,6617,1295,1112,9024
5/1/2013,2013,5,1, 14 ,6682,1329,1137,9148
5/1/2013,2013,5,1, 15 ,6535,1300,1076,8911
5/1/2013,2013,5,1, 16 ,6346,1257,1109,8712
5/1/2013,2013,5,1, 17 ,6133,1215,1091,8439
5/1/2013,2013,5,1, 18 ,6003,1299,1182,8484
5/1/2013,2013,5,1, 19 ,6833,1466,1172,9471
5/1/2013,2013,5,1, 20 ,6909,1434,1176,9519
5/1/2013,2013,5,1, 21 ,6881,1395,1169,9445
5/1/2013,2013,5,1, 22 ,6667,1308,1124,9099
5/1/2013,2013,5,1, 23 ,6399,1190,1035,8624
5/1/2013,2013,5,1, 24 ,6033,1135,974,8142
5/2/2013,2013,5,2, 1 ,5805,1073,925,7803
5/2/2013,2013,5,2, 2 ,5618,1046,899,7563
5/2/2013,2013,5,2, 3 ,5433,1020,870,7323
5/2/2013,2013,5,2, 4 ,5283,1000,857,7140
5/2/2013,2013,5,2, 5 ,5257,1007,880,7144
5/2/2013,2013,5,2, 6 ,5131,984,869,6984
5/2/2013,2013,5,2, 7 ,5487,1014,880,7381
5/2/2013,2013,5,2, 8 ,6348,1196,1021,8565
5/2/2013,2013,5,2, 9 ,7077,1393,1094,9564
5/2/2013,2013,5,2, 10 ,7608,1494,1148,10250
5/2/2013,2013,5,2, 11 ,7805,1543,1157,10505
5/2/2013,2013,5,2, 12 ,7750,1510,1147,10407
5/2/2013,2013,5,2, 13 ,7795,1524,1190,10509
5/2/2013,2013,5,2, 14 ,8012,1554,1174,10740
5/2/2013,2013,5,2, 15 ,7920,1526,1166,10612
5/2/2013,2013,5,2, 16 ,7687,1496,1160,10343
5/2/2013,2013,5,2, 17 ,7355,1397,1146,9898
5/2/2013,2013,5,2, 18 ,7059,1424,1197,9680
5/2/2013,2013,5,2, 19 ,7416,1542,1194,10152
5/2/2013,2013,5,2, 20 ,7309,1485,1211,10005
5/2/2013,2013,5,2, 21 ,7214,1451,1194,9859
5/2/2013,2013,5,2, 22 ,7032,1351,1162,9545
5/2/2013,2013,5,2, 23 ,6751,1243,1073,9067
5/2/2013,2013,5,2, 24 ,6360,1155,1005,8520
5/3/2013,2013,5,3, 1 ,6143,1104,976,8223
5/3/2013,2013,5,3, 2 ,5894,1079,948,7921
5/3/2013,2013,5,3, 3 ,5709,1044,918,7671
5/3/2013,2013,5,3, 4 ,5618,1026,910,7554
5/3/2013,2013,5,3, 5 ,5558,1032,916,7506
5/3/2013,2013,5,3, 6 ,5351,1004,921,7276
5/3/2013,2013,5,3, 7 ,5649,1030,913,7592
5/3/2013,2013,5,3, 8 ,6448,1188,1040,8676
5/3/2013,2013,5,3, 9 ,7251,1383,1154,9788
5/3/2013,2013,5,3, 10 ,7684,1501,1153,10338
5/3/2013,2013,5,3, 11 ,7947,1540,1154,10641
5/3/2013,2013,5,3, 12 ,7857,1506,1045,10408
5/3/2013,2013,5,3, 13 ,7858,1494,1081,10433
5/3/2013,2013,5,3, 14 ,8087,1551,1170,10808
5/3/2013,2013,5,3, 15 ,7933,1516,1183,10632
5/3/2013,2013,5,3, 16 ,7675,1478,1180,10333
5/3/2013,2013,5,3, 17 ,7240,1394,1156,9790
5/3/2013,2013,5,3, 18 ,6950,1409,1218,9577
5/3/2013,2013,5,3, 19 ,7355,1536,1221,10112
5/3/2013,2013,5,3, 20 ,7254,1496,1195,9945
5/3/2013,2013,5,3, 21 ,7267,1443,1210,9920
5/3/2013,2013,5,3, 22 ,7006,1356,1146,9508
5/3/2013,2013,5,3, 23 ,6640,1243,1088,8971
5/3/2013,2013,5,3, 24 ,6333,1171,1006,8510
5/4/2013,2013,5,4, 1 ,6042,1120,978,8140
5/4/2013,2013,5,4, 2 ,5921,1088,951,7960
5/4/2013,2013,5,4, 3 ,5739,1057,932,7728
5/4/2013,2013,5,4, 4 ,5581,1032,894,7507
5/4/2013,2013,5,4, 5 ,5488,1026,894,7408
5/4/2013,2013,5,4, 6 ,5201,968,880,7049
5/4/2013,2013,5,4, 7 ,5341,997,842,7180
5/4/2013,2013,5,4, 8 ,5874,1105,967,7946
5/4/2013,2013,5,4, 9 ,6486,1251,1054,8791
5/4/2013,2013,5,4, 10 ,6915,1330,1118,9363
5/4/2013,2013,5,4, 11 ,7196,1377,1144,9717
5/4/2013,2013,5,4, 12 ,7091,1363,1079,9533
5/4/2013,2013,5,4, 13 ,7136,1379,1140,9655
5/4/2013,2013,5,4, 14 ,7256,1411,1171,9838
5/4/2013,2013,5,4, 15 ,6853,1366,1163,9382
5/4/2013,2013,5,4, 16 ,6636,1326,1144,9106
5/4/2013,2013,5,4, 17 ,6398,1260,1106,8764
5/4/2013,2013,5,4, 18 ,6306,1304,1181,8791
5/4/2013,2013,5,4, 19 ,6983,1474,1208,9665
5/4/2013,2013,5,4, 20 ,7021,1456,1224,9701
5/4/2013,2013,5,4, 21 ,6977,1425,1241,9643
5/4/2013,2013,5,4, 22 ,6810,1338,1186,9334
5/4/2013,2013,5,4, 23 ,6499,1255,1092,8846
5/4/2013,2013,5,4, 24 ,6206,1171,1003,8380
5/5/2013,2013,5,5, 1 ,5942,1114,950,8006
5/5/2013,2013,5,5, 2 ,5696,1078,922,7696
5/5/2013,2013,5,5, 3 ,5545,1030,874,7449
5/5/2013,2013,5,5, 4 ,5383,1015,862,7260
5/5/2013,2013,5,5, 5 ,5260,1003,871,7134
5/5/2013,2013,5,5, 6 ,4896,952,830,6678
5/5/2013,2013,5,5, 7 ,4933,956,743,6632
5/5/2013,2013,5,5, 8 ,5219,1011,852,7082
5/5/2013,2013,5,5, 9 ,5609,1095,935,7639
5/5/2013,2013,5,5, 10 ,6016,1180,1021,8217
5/5/2013,2013,5,5, 11 ,6288,1222,1058,8568
5/5/2013,2013,5,5, 12 ,6294,1225,1065,8584
5/5/2013,2013,5,5, 13 ,6427,1232,1093,8752
5/5/2013,2013,5,5, 14 ,6368,1212,1087,8667
5/5/2013,2013,5,5, 15 ,6360,1192,1057,8609
5/5/2013,2013,5,5, 16 ,6107,1156,1032,8295
5/5/2013,2013,5,5, 17 ,5944,1129,984,8057
5/5/2013,2013,5,5, 18 ,5970,1207,1117,8294
5/5/2013,2013,5,5, 19 ,6714,1398,1171,9283
5/5/2013,2013,5,5, 20 ,6752,1386,1141,9279
5/5/2013,2013,5,5, 21 ,6679,1343,1154,9176
5/5/2013,2013,5,5, 22 ,6556,1266,1100,8922
5/5/2013,2013,5,5, 23 ,6307,1186,1052,8545
5/5/2013,2013,5,5, 24 ,5981,1110,968,8059
5/6/2013,2013,5,6, 1 ,5714,1061,942,7717
5/6/2013,2013,5,6, 2 ,5502,1026,900,7428
5/6/2013,2013,5,6, 3 ,5345,991,881,7217
5/6/2013,2013,5,6, 4 ,5206,977,856,7039
5/6/2013,2013,5,6, 5 ,5208,976,874,7058
5/6/2013,2013,5,6, 6 ,5125,963,867,6955
5/6/2013,2013,5,6, 7 ,5444,999,885,7328
5/6/2013,2013,5,6, 8 ,6380,1186,1013,8579
5/6/2013,2013,5,6, 9 ,7145,1382,1151,9678
5/6/2013,2013,5,6, 10 ,7636,1474,1194,10304
5/6/2013,2013,5,6, 11 ,7900,1485,1235,10620
5/6/2013,2013,5,6, 12 ,7828,1502,1208,10538
5/6/2013,2013,5,6, 13 ,7822,1512,1239,10573
5/6/2013,2013,5,6, 14 ,8150,1567,1283,11000
5/6/2013,2013,5,6, 15 ,7979,1535,1206,10720
5/6/2013,2013,5,6, 16 ,7843,1498,1198,10539
5/6/2013,2013,5,6, 17 ,7374,1389,1212,9975
5/6/2013,2013,5,6, 18 ,6987,1400,1237,9624
5/6/2013,2013,5,6, 19 ,7423,1543,1223,10189
5/6/2013,2013,5,6, 20 ,7288,1514,1231,10033
5/6/2013,2013,5,6, 21 ,7265,1471,1227,9963
5/6/2013,2013,5,6, 22 ,7011,1396,1164,9571
5/6/2013,2013,5,6, 23 ,6745,1288,1098,9131
5/6/2013,2013,5,6, 24 ,6349,1202,1017,8568
5/7/2013,2013,5,7, 1 ,6088,1144,973,8205
5/7/2013,2013,5,7, 2 ,5883,1113,937,7933
5/7/2013,2013,5,7, 3 ,5697,1083,921,7701
5/7/2013,2013,5,7, 4 ,5554,1064,913,7531
5/7/2013,2013,5,7, 5 ,5531,1054,930,7515
5/7/2013,2013,5,7, 6 ,5353,1037,914,7304
5/7/2013,2013,5,7, 7 ,5638,1058,912,7608
5/7/2013,2013,5,7, 8 ,6503,1220,1065,8788
5/7/2013,2013,5,7, 9 ,7300,1434,1217,9951
5/7/2013,2013,5,7, 10 ,7862,1528,1241,10631
5/7/2013,2013,5,7, 11 ,8122,1551,1244,10917
5/7/2013,2013,5,7, 12 ,7966,1506,1220,10692
5/7/2013,2013,5,7, 13 ,8028,1517,1233,10778
5/7/2013,2013,5,7, 14 ,8221,1557,1241,11019
5/7/2013,2013,5,7, 15 ,8106,1535,1207,10848
5/7/2013,2013,5,7, 16 ,7999,1492,1221,10712
5/7/2013,2013,5,7, 17 ,7566,1412,1189,10167
5/7/2013,2013,5,7, 18 ,7140,1411,1230,9781
5/7/2013,2013,5,7, 19 ,7626,1541,1201,10368
5/7/2013,2013,5,7, 20 ,7516,1513,1169,10198
5/7/2013,2013,5,7, 21 ,7363,1469,1174,10006
5/7/2013,2013,5,7, 22 ,7173,1373,1124,9670
5/7/2013,2013,5,7, 23 ,6821,1279,1029,9129
5/7/2013,2013,5,7, 24 ,6476,1195,968,8639
5/8/2013,2013,5,8, 1 ,6209,1131,927,8267
5/8/2013,2013,5,8, 2 ,6079,1090,899,8068
5/8/2013,2013,5,8, 3 ,5871,1065,883,7819
5/8/2013,2013,5,8, 4 ,5681,1047,869,7597
5/8/2013,2013,5,8, 5 ,5602,1049,891,7542
5/8/2013,2013,5,8, 6 ,5429,1020,912,7361
5/8/2013,2013,5,8, 7 ,5740,1038,899,7677
5/8/2013,2013,5,8, 8 ,6588,1190,1017,8795
5/8/2013,2013,5,8, 9 ,7387,1390,1173,9950
5/8/2013,2013,5,8, 10 ,7794,1458,1212,10464
5/8/2013,2013,5,8, 11 ,8157,1510,1251,10918
5/8/2013,2013,5,8, 12 ,8059,1495,1225,10779
5/8/2013,2013,5,8, 13 ,8082,1487,1239,10808
5/8/2013,2013,5,8, 14 ,4638,1541,1249,7428
5/8/2013,2013,5,8, 15 ,4900,1506,1226,7632
5/8/2013,2013,5,8, 16 ,5254,1473,1220,7947
5/8/2013,2013,5,8, 17 ,5627,1359,1193,8179
5/8/2013,2013,5,8, 18 ,5729,1443,1228,8400
5/8/2013,2013,5,8, 19 ,6002,1513,1223,8738
5/8/2013,2013,5,8, 20 ,6225,1470,1218,8913
5/8/2013,2013,5,8, 21 ,6438,1416,1212,9066
5/8/2013,2013,5,8, 22 ,6886,1274,1147,9307
5/8/2013,2013,5,8, 23 ,6624,1208,1052,8884
5/8/2013,2013,5,8, 24 ,6323,1155,978,8456
5/9/2013,2013,5,9, 1 ,6067,1102,922,8091
5/9/2013,2013,5,9, 2 ,5880,1069,893,7842
5/9/2013,2013,5,9, 3 ,5714,1036,876,7626
5/9/2013,2013,5,9, 4 ,5637,1022,867,7526
5/9/2013,2013,5,9, 5 ,5583,1019,893,7495
5/9/2013,2013,5,9, 6 ,5484,1003,907,7394
5/9/2013,2013,5,9, 7 ,5745,1026,906,7677
5/9/2013,2013,5,9, 8 ,6486,1185,994,8665
5/9/2013,2013,5,9, 9 ,7265,1390,1155,9810
5/9/2013,2013,5,9, 10 ,7700,1483,1197,10380
5/9/2013,2013,5,9, 11 ,7926,1522,1234,10682
5/9/2013,2013,5,9, 12 ,7910,1490,1212,10612
5/9/2013,2013,5,9, 13 ,7873,1481,1213,10567
5/9/2013,2013,5,9, 14 ,8108,1549,1244,10901
5/9/2013,2013,5,9, 15 ,8031,1516,1231,10778
5/9/2013,2013,5,9, 16 ,7850,1485,1217,10552
5/9/2013,2013,5,9, 17 ,7489,1394,1202,10085
5/9/2013,2013,5,9, 18 ,7199,1438,1256,9893
5/9/2013,2013,5,9, 19 ,7545,1533,1273,10351
5/9/2013,2013,5,9, 20 ,7436,1492,1263,10191
5/9/2013,2013,5,9, 21 ,7327,1439,1231,9997
5/9/2013,2013,5,9, 22 ,7018,1349,1140,9507
5/9/2013,2013,5,9, 23 ,6791,1246,1037,9074
5/9/2013,2013,5,9, 24 ,6431,1164,984,8579
5/10/2013,2013,5,10, 1 ,6222,1107,945,8274
5/10/2013,2013,5,10, 2 ,5967,1076,915,7958
5/10/2013,2013,5,10, 3 ,5828,1047,880,7755
5/10/2013,2013,5,10, 4 ,5666,1032,863,7561
5/10/2013,2013,5,10, 5 ,5654,1036,883,7573
5/10/2013,2013,5,10, 6 ,5496,1010,902,7408
5/10/2013,2013,5,10, 7 ,5735,1027,902,7664
5/10/2013,2013,5,10, 8 ,6560,1165,1024,8749
5/10/2013,2013,5,10, 9 ,7291,1372,1185,9848
5/10/2013,2013,5,10, 10 ,7796,1458,1250,10504
5/10/2013,2013,5,10, 11 ,8055,1461,1285,10801
5/10/2013,2013,5,10, 12 ,7891,1476,1273,10640
5/10/2013,2013,5,10, 13 ,7954,1483,1281,10718
5/10/2013,2013,5,10, 14 ,8202,1538,1322,11062
5/10/2013,2013,5,10, 15 ,8071,1510,1275,10856
5/10/2013,2013,5,10, 16 ,7853,1478,1182,10513
5/10/2013,2013,5,10, 17 ,7479,1386,1158,10023
5/10/2013,2013,5,10, 18 ,7077,1427,1244,9748
5/10/2013,2013,5,10, 19 ,7481,1533,1291,10305
5/10/2013,2013,5,10, 20 ,7270,1487,1258,10015
5/10/2013,2013,5,10, 21 ,7292,1444,1207,9943
5/10/2013,2013,5,10, 22 ,7066,1356,1107,9529
5/10/2013,2013,5,10, 23 ,6771,1261,1034,9066
5/10/2013,2013,5,10, 24 ,6431,1177,967,8575
5/11/2013,2013,5,11, 1 ,6062,1123,925,8110
5/11/2013,2013,5,11, 2 ,5901,1086,898,7885
5/11/2013,2013,5,11, 3 ,5746,1049,877,7672
5/11/2013,2013,5,11, 4 ,5587,1040,865,7492
5/11/2013,2013,5,11, 5 ,5496,1035,867,7398
5/11/2013,2013,5,11, 6 ,5305,990,865,7160
5/11/2013,2013,5,11, 7 ,5382,1000,878,7260
5/11/2013,2013,5,11, 8 ,5889,1105,945,7939
5/11/2013,2013,5,11, 9 ,6377,1263,1068,8708
5/11/2013,2013,5,11, 10 ,6873,1360,1164,9397
5/11/2013,2013,5,11, 11 ,7197,1420,1216,9833
5/11/2013,2013,5,11, 12 ,7107,1388,1203,9698
5/11/2013,2013,5,11, 13 ,7070,1388,1222,9680
5/11/2013,2013,5,11, 14 ,7208,1427,1230,9865
5/11/2013,2013,5,11, 15 ,7019,1364,1206,9589
5/11/2013,2013,5,11, 16 ,6819,1300,1163,9282
5/11/2013,2013,5,11, 17 ,6499,1259,1140,8898
5/11/2013,2013,5,11, 18 ,6440,1346,1232,9018
5/11/2013,2013,5,11, 19 ,7010,1470,1293,9773
5/11/2013,2013,5,11, 20 ,6989,1428,1276,9693
5/11/2013,2013,5,11, 21 ,6970,1382,1237,9589
5/11/2013,2013,5,11, 22 ,6737,1322,1159,9218
5/11/2013,2013,5,11, 23 ,6436,1240,1068,8744
5/11/2013,2013,5,11, 24 ,6155,1137,981,8273
5/12/2013,2013,5,12, 1 ,5861,1084,931,7876
5/12/2013,2013,5,12, 2 ,5625,1060,897,7582
5/12/2013,2013,5,12, 3 ,5480,1019,877,7376
5/12/2013,2013,5,12, 4 ,5285,989,861,7135
5/12/2013,2013,5,12, 5 ,5275,973,868,7116
5/12/2013,2013,5,12, 6 ,4898,936,835,6669
5/12/2013,2013,5,12, 7 ,4905,926,822,6653
5/12/2013,2013,5,12, 8 ,5244,963,858,7065
5/12/2013,2013,5,12, 9 ,5649,1052,943,7644
5/12/2013,2013,5,12, 10 ,6073,1117,1019,8209
5/12/2013,2013,5,12, 11 ,6339,1160,1067,8566
5/12/2013,2013,5,12, 12 ,6300,1146,1059,8505
5/12/2013,2013,5,12, 13 ,6301,1149,1049,8499
5/12/2013,2013,5,12, 14 ,6268,1155,1063,8486
5/12/2013,2013,5,12, 15 ,6150,1134,1033,8317
5/12/2013,2013,5,12, 16 ,5989,1105,1035,8129
5/12/2013,2013,5,12, 17 ,5828,1120,1046,7994
5/12/2013,2013,5,12, 18 ,6005,1240,1169,8414
5/12/2013,2013,5,12, 19 ,6525,1347,1203,9075
5/12/2013,2013,5,12, 20 ,6602,1333,1161,9096
5/12/2013,2013,5,12, 21 ,6538,1269,1140,8947
5/12/2013,2013,5,12, 22 ,6280,1193,1038,8511
5/12/2013,2013,5,12, 23 ,6057,1112,966,8135
5/12/2013,2013,5,12, 24 ,5700,1036,899,7635
5/13/2013,2013,5,13, 1 ,5449,993,861,7303
5/13/2013,2013,5,13, 2 ,5198,958,834,6990
5/13/2013,2013,5,13, 3 ,5086,931,816,6833
5/13/2013,2013,5,13, 4 ,4968,923,794,6685
5/13/2013,2013,5,13, 5 ,4991,932,837,6760
5/13/2013,2013,5,13, 6 ,4669,878,796,6343
5/13/2013,2013,5,13, 7 ,4575,866,777,6218
5/13/2013,2013,5,13, 8 ,4633,884,792,6309
5/13/2013,2013,5,13, 9 ,4783,936,836,6555
5/13/2013,2013,5,13, 10 ,5212,962,888,7062
5/13/2013,2013,5,13, 11 ,5312,1012,954,7278
5/13/2013,2013,5,13, 12 ,5438,1053,975,7466
5/13/2013,2013,5,13, 13 ,5511,1072,998,7581
5/13/2013,2013,5,13, 14 ,5403,1088,1004,7495
5/13/2013,2013,5,13, 15 ,5377,1061,979,7417
5/13/2013,2013,5,13, 16 ,5251,1046,917,7214
5/13/2013,2013,5,13, 17 ,5234,1075,987,7296
5/13/2013,2013,5,13, 18 ,5493,1221,1123,7837
5/13/2013,2013,5,13, 19 ,6138,1310,1175,8623
5/13/2013,2013,5,13, 20 ,6185,1285,1158,8628
5/13/2013,2013,5,13, 21 ,6136,1266,1113,8515
5/13/2013,2013,5,13, 22 ,5991,1170,1038,8199
5/13/2013,2013,5,13, 23 ,5698,1086,952,7736
5/13/2013,2013,5,13, 24 ,5401,1023,895,7319
5/14/2013,2013,5,14, 1 ,5155,973,853,6981
5/14/2013,2013,5,14, 2 ,4961,934,829,6724
5/14/2013,2013,5,14, 3 ,4797,909,790,6496
5/14/2013,2013,5,14, 4 ,4657,900,803,6360
5/14/2013,2013,5,14, 5 ,4706,910,818,6434
5/14/2013,2013,5,14, 6 ,4718,914,828,6460
5/14/2013,2013,5,14, 7 ,5174,942,848,6964
5/14/2013,2013,5,14, 8 ,6027,1086,965,8078
5/14/2013,2013,5,14, 9 ,6855,1292,1138,9285
5/14/2013,2013,5,14, 10 ,7385,1389,1240,10014
5/14/2013,2013,5,14, 11 ,7703,1440,1300,10443
5/14/2013,2013,5,14, 12 ,7677,1430,1289,10396
5/14/2013,2013,5,14, 13 ,7726,1425,1289,10440
5/14/2013,2013,5,14, 14 ,7801,1482,1320,10603
5/14/2013,2013,5,14, 15 ,7693,1455,1286,10434
5/14/2013,2013,5,14, 16 ,7506,1427,1270,10203
5/14/2013,2013,5,14, 17 ,7195,1359,1222,9776
5/14/2013,2013,5,14, 18 ,7021,1391,1263,9675
5/14/2013,2013,5,14, 19 ,7193,1496,1264,9953
5/14/2013,2013,5,14, 20 ,7073,1455,1212,9740
5/14/2013,2013,5,14, 21 ,6853,1398,1183,9434
5/14/2013,2013,5,14, 22 ,6505,1290,1101,8896
5/14/2013,2013,5,14, 23 ,6134,1150,1019,8303
5/14/2013,2013,5,14, 24 ,5816,1078,939,7833
5/15/2013,2013,5,15, 1 ,5541,1026,916,7483
5/15/2013,2013,5,15, 2 ,5358,1005,889,7252
5/15/2013,2013,5,15, 3 ,5182,982,859,7023
5/15/2013,2013,5,15, 4 ,5146,974,856,6976
5/15/2013,2013,5,15, 5 ,5167,985,867,7019
5/15/2013,2013,5,15, 6 ,5113,963,882,6958
5/15/2013,2013,5,15, 7 ,5371,998,897,7266
5/15/2013,2013,5,15, 8 ,6182,1145,1022,8349
5/15/2013,2013,5,15, 9 ,6998,1368,1195,9561
5/15/2013,2013,5,15, 10 ,7438,1460,1294,10192
5/15/2013,2013,5,15, 11 ,7660,1516,1331,10507
5/15/2013,2013,5,15, 12 ,7651,1478,1323,10452
5/15/2013,2013,5,15, 13 ,7590,1438,1322,10350
5/15/2013,2013,5,15, 14 ,7756,1493,1345,10594
5/15/2013,2013,5,15, 15 ,7568,1461,1333,10362
5/15/2013,2013,5,15, 16 ,7524,1441,1319,10284
5/15/2013,2013,5,15, 17 ,7180,1375,1244,9799
5/15/2013,2013,5,15, 18 ,7006,1409,1295,9710
5/15/2013,2013,5,15, 19 ,7282,1511,1364,10157
5/15/2013,2013,5,15, 20 ,7275,1460,1321,10056
5/15/2013,2013,5,15, 21 ,7081,1421,1289,9791
5/15/2013,2013,5,15, 22 ,6872,1325,1173,9370
5/15/2013,2013,5,15, 23 ,6425,1212,1070,8707
5/15/2013,2013,5,15, 24 ,6146,1140,1009,8295
5/16/2013,2013,5,16, 1 ,5760,1080,960,7800
5/16/2013,2013,5,16, 2 ,5641,1048,926,7615
5/16/2013,2013,5,16, 3 ,5488,1028,898,7414
5/16/2013,2013,5,16, 4 ,5342,1009,883,7234
5/16/2013,2013,5,16, 5 ,5348,1017,899,7264
5/16/2013,2013,5,16, 6 ,5253,993,869,7115
5/16/2013,2013,5,16, 7 ,5519,1019,907,7445
5/16/2013,2013,5,16, 8 ,6390,1183,1038,8611
5/16/2013,2013,5,16, 9 ,7234,1384,1207,9825
5/16/2013,2013,5,16, 10 ,7703,1489,1287,10479
5/16/2013,2013,5,16, 11 ,7928,1537,1360,10825
5/16/2013,2013,5,16, 12 ,7777,1495,1336,10608
5/16/2013,2013,5,16, 13 ,7909,1471,1309,10689
5/16/2013,2013,5,16, 14 ,8036,1536,1357,10929
5/16/2013,2013,5,16, 15 ,7825,1502,1347,10674
5/16/2013,2013,5,16, 16 ,7676,1495,1316,10487
5/16/2013,2013,5,16, 17 ,7358,1405,1263,10026
5/16/2013,2013,5,16, 18 ,7153,1424,1317,9894
5/16/2013,2013,5,16, 19 ,7493,1558,1339,10390
5/16/2013,2013,5,16, 20 ,7399,1499,1317,10215
5/16/2013,2013,5,16, 21 ,7276,1458,1253,9987
5/16/2013,2013,5,16, 22 ,7085,1353,1155,9593
5/16/2013,2013,5,16, 23 ,6671,1248,1023,8942
5/16/2013,2013,5,16, 24 ,6317,1172,972,8461
5/17/2013,2013,5,17, 1 ,6019,1103,934,8056
5/17/2013,2013,5,17, 2 ,5807,1078,909,7794
5/17/2013,2013,5,17, 3 ,5681,1051,888,7620
5/17/2013,2013,5,17, 4 ,5566,1033,883,7482
5/17/2013,2013,5,17, 5 ,5443,1033,900,7376
5/17/2013,2013,5,17, 6 ,5353,1003,889,7245
5/17/2013,2013,5,17, 7 ,5679,1033,893,7605
5/17/2013,2013,5,17, 8 ,6596,1200,1012,8808
5/17/2013,2013,5,17, 9 ,7294,1400,1196,9890
5/17/2013,2013,5,17, 10 ,7800,1487,1281,10568
5/17/2013,2013,5,17, 11 ,8008,1528,1361,10897
5/17/2013,2013,5,17, 12 ,7927,1487,1325,10739
5/17/2013,2013,5,17, 13 ,7921,1502,1329,10752
5/17/2013,2013,5,17, 14 ,8066,1558,1375,10999
5/17/2013,2013,5,17, 15 ,7930,1519,1363,10812
5/17/2013,2013,5,17, 16 ,7723,1482,1310,10515
5/17/2013,2013,5,17, 17 ,7274,1387,1263,9924
5/17/2013,2013,5,17, 18 ,7045,1408,1329,9782
5/17/2013,2013,5,17, 19 ,7540,1547,1372,10459
5/17/2013,2013,5,17, 20 ,7523,1525,1331,10379
5/17/2013,2013,5,17, 21 ,7464,1471,1300,10235
5/17/2013,2013,5,17, 22 ,7123,1361,1175,9659
5/17/2013,2013,5,17, 23 ,6757,1270,1091,9118
5/17/2013,2013,5,17, 24 ,6347,1155,1016,8518
5/18/2013,2013,5,18, 1 ,6051,1095,984,8130
5/18/2013,2013,5,18, 2 ,5834,1060,937,7831
5/18/2013,2013,5,18, 3 ,5694,1036,923,7653
5/18/2013,2013,5,18, 4 ,5872,1017,902,7791
5/18/2013,2013,5,18, 5 ,5456,1014,926,7396
5/18/2013,2013,5,18, 6 ,5353,975,887,7215
5/18/2013,2013,5,18, 7 ,5412,983,897,7292
5/18/2013,2013,5,18, 8 ,5873,1090,959,7922
5/18/2013,2013,5,18, 9 ,6403,1252,1082,8737
5/18/2013,2013,5,18, 10 ,6961,1338,1182,9481
5/18/2013,2013,5,18, 11 ,7251,1410,1240,9901
5/18/2013,2013,5,18, 12 ,7112,1393,1248,9753
5/18/2013,2013,5,18, 13 ,7111,1397,1242,9750
5/18/2013,2013,5,18, 14 ,7265,1434,1258,9957
5/18/2013,2013,5,18, 15 ,7091,1395,1217,9703
5/18/2013,2013,5,18, 16 ,6833,1341,1178,9352
5/18/2013,2013,5,18, 17 ,6460,1260,1166,8886
5/18/2013,2013,5,18, 18 ,6541,1318,1257,9116
5/18/2013,2013,5,18, 19 ,6997,1492,1315,9804
5/18/2013,2013,5,18, 20 ,7023,1455,1295,9773
5/18/2013,2013,5,18, 21 ,7078,1423,1270,9771
5/18/2013,2013,5,18, 22 ,6704,1348,1156,9208
5/18/2013,2013,5,18, 23 ,6591,1248,1083,8922
5/18/2013,2013,5,18, 24 ,6168,1152,983,8303
5/19/2013,2013,5,19, 1 ,5914,1097,958,7969
5/19/2013,2013,5,19, 2 ,5695,1068,919,7682
5/19/2013,2013,5,19, 3 ,5527,1038,881,7446
5/19/2013,2013,5,19, 4 ,5321,1012,857,7190
5/19/2013,2013,5,19, 5 ,5257,994,883,7134
5/19/2013,2013,5,19, 6 ,5006,935,843,6784
5/19/2013,2013,5,19, 7 ,5014,941,846,6801
5/19/2013,2013,5,19, 8 ,5228,998,895,7121
5/19/2013,2013,5,19, 9 ,5622,1073,972,7667
5/19/2013,2013,5,19, 10 ,6101,1150,1022,8273
5/19/2013,2013,5,19, 11 ,6375,1195,1097,8667
5/19/2013,2013,5,19, 12 ,6347,1207,1101,8655
5/19/2013,2013,5,19, 13 ,6386,1213,1098,8697
5/19/2013,2013,5,19, 14 ,6384,1206,1100,8690
5/19/2013,2013,5,19, 15 ,6384,1183,1092,8659
5/19/2013,2013,5,19, 16 ,6127,1142,1060,8329
5/19/2013,2013,5,19, 17 ,5992,1148,1070,8210
5/19/2013,2013,5,19, 18 ,6092,1259,1162,8513
5/19/2013,2013,5,19, 19 ,6705,1400,1243,9348
5/19/2013,2013,5,19, 20 ,6756,1388,1198,9342
5/19/2013,2013,5,19, 21 ,6695,1339,1170,9204
5/19/2013,2013,5,19, 22 ,6509,1271,1086,8866
5/19/2013,2013,5,19, 23 ,6152,1170,1018,8340
5/19/2013,2013,5,19, 24 ,5841,1105,947,7893
5/20/2013,2013,5,20, 1 ,5651,1050,894,7595
5/20/2013,2013,5,20, 2 ,5422,1005,869,7296
5/20/2013,2013,5,20, 3 ,6140,981,836,7957
5/20/2013,2013,5,20, 4 ,5227,967,833,7027
5/20/2013,2013,5,20, 5 ,5182,970,854,7006
5/20/2013,2013,5,20, 6 ,5124,953,859,6936
5/20/2013,2013,5,20, 7 ,5486,984,871,7341
5/20/2013,2013,5,20, 8 ,6410,1138,1002,8550
5/20/2013,2013,5,20, 9 ,7134,1347,1213,9694
5/20/2013,2013,5,20, 10 ,7690,1430,1300,10420
5/20/2013,2013,5,20, 11 ,7963,1497,1366,10826
5/20/2013,2013,5,20, 12 ,7827,1469,1339,10635
5/20/2013,2013,5,20, 13 ,7791,1453,1347,10591
5/20/2013,2013,5,20, 14 ,7954,1481,1384,10819
5/20/2013,2013,5,20, 15 ,7832,1443,1337,10612
5/20/2013,2013,5,20, 16 ,7709,1428,1284,10421
5/20/2013,2013,5,20, 17 ,7378,1363,1259,10000
5/20/2013,2013,5,20, 18 ,7001,1394,1285,9680
5/20/2013,2013,5,20, 19 ,7445,1495,1316,10256
5/20/2013,2013,5,20, 20 ,7413,1446,1287,10146
5/20/2013,2013,5,20, 21 ,7299,1403,1229,9931
5/20/2013,2013,5,20, 22 ,7066,1284,1146,9496
5/20/2013,2013,5,20, 23 ,6653,1178,1033,8864
5/20/2013,2013,5,20, 24 ,6255,1099,984,8338
5/21/2013,2013,5,21, 1 ,5928,1043,947,7918
5/21/2013,2013,5,21, 2 ,5698,1011,918,7627
5/21/2013,2013,5,21, 3 ,5551,987,891,7429
5/21/2013,2013,5,21, 4 ,5496,974,878,7348
5/21/2013,2013,5,21, 5 ,5445,978,889,7312
5/21/2013,2013,5,21, 6 ,5271,961,887,7119
5/21/2013,2013,5,21, 7 ,5693,1000,915,7608
5/21/2013,2013,5,21, 8 ,6544,1162,1059,8765
5/21/2013,2013,5,21, 9 ,7299,1369,1227,9895
5/21/2013,2013,5,21, 10 ,7778,1464,1313,10555
5/21/2013,2013,5,21, 11 ,7996,1507,1337,10840
5/21/2013,2013,5,21, 12 ,7891,1471,1341,10703
5/21/2013,2013,5,21, 13 ,7779,1485,1341,10605
5/21/2013,2013,5,21, 14 ,7865,1530,1359,10754
5/21/2013,2013,5,21, 15 ,7597,1512,1364,10473
5/21/2013,2013,5,21, 16 ,7488,1478,1336,10302
5/21/2013,2013,5,21, 17 ,7218,1370,1290,9878
5/21/2013,2013,5,21, 18 ,7055,1410,1312,9777
5/21/2013,2013,5,21, 19 ,7369,1490,1383,10242
5/21/2013,2013,5,21, 20 ,7261,1468,1342,10071
5/21/2013,2013,5,21, 21 ,7138,1399,1314,9851
5/21/2013,2013,5,21, 22 ,6886,1314,1214,9414
5/21/2013,2013,5,21, 23 ,6446,1212,1103,8761
5/21/2013,2013,5,21, 24 ,6089,1138,1029,8256
5/22/2013,2013,5,22, 1 ,5743,1087,959,7789
5/22/2013,2013,5,22, 2 ,5635,1060,935,7630
5/22/2013,2013,5,22, 3 ,5455,1026,917,7398
5/22/2013,2013,5,22, 4 ,5311,1000,890,7201
5/22/2013,2013,5,22, 5 ,5320,1007,914,7241
5/22/2013,2013,5,22, 6 ,5176,988,899,7063
5/22/2013,2013,5,22, 7 ,5526,1014,904,7444
5/22/2013,2013,5,22, 8 ,6413,1185,1069,8667
5/22/2013,2013,5,22, 9 ,7210,1391,1242,9843
5/22/2013,2013,5,22, 10 ,7721,1487,1331,10539
5/22/2013,2013,5,22, 11 ,7943,1533,1376,10852
5/22/2013,2013,5,22, 12 ,7902,1485,1358,10745
5/22/2013,2013,5,22, 13 ,7919,1513,1341,10773
5/22/2013,2013,5,22, 14 ,8164,1562,1291,11017
5/22/2013,2013,5,22, 15 ,7932,1541,1317,10790
5/22/2013,2013,5,22, 16 ,7805,1508,1259,10572
5/22/2013,2013,5,22, 17 ,7376,1421,1220,10017
5/22/2013,2013,5,22, 18 ,7076,1408,1261,9745
5/22/2013,2013,5,22, 19 ,7403,1543,1331,10277
5/22/2013,2013,5,22, 20 ,7294,1506,1310,10110
5/22/2013,2013,5,22, 21 ,7203,1460,1253,9916
5/22/2013,2013,5,22, 22 ,6903,1356,1169,9428
5/22/2013,2013,5,22, 23 ,6516,1249,1049,8814
5/22/2013,2013,5,22, 24 ,6187,1170,974,8331
5/23/2013,2013,5,23, 1 ,5928,1112,933,7973
5/23/2013,2013,5,23, 2 ,5763,1099,898,7760
5/23/2013,2013,5,23, 3 ,5592,1081,881,7554
5/23/2013,2013,5,23, 4 ,5459,1060,872,7391
5/23/2013,2013,5,23, 5 ,5428,1065,886,7379
5/23/2013,2013,5,23, 6 ,5320,1007,894,7221
5/23/2013,2013,5,23, 7 ,5600,1024,891,7515
5/23/2013,2013,5,23, 8 ,6495,1115,1019,8629
5/23/2013,2013,5,23, 9 ,7087,1310,1211,9608
5/23/2013,2013,5,23, 10 ,7683,1438,1298,10419
5/23/2013,2013,5,23, 11 ,7975,1498,1365,10838
5/23/2013,2013,5,23, 12 ,7795,1474,1358,10627
5/23/2013,2013,5,23, 13 ,7868,1477,1356,10701
5/23/2013,2013,5,23, 14 ,8163,1532,1363,11058
5/23/2013,2013,5,23, 15 ,8042,1510,1359,10911
5/23/2013,2013,5,23, 16 ,7886,1476,1335,10697
5/23/2013,2013,5,23, 17 ,7432,1376,1251,10059
5/23/2013,2013,5,23, 18 ,7138,1399,1287,9824
5/23/2013,2013,5,23, 19 ,7403,1512,1358,10273
5/23/2013,2013,5,23, 20 ,7366,1484,1345,10195
5/23/2013,2013,5,23, 21 ,7255,1443,1282,9980
5/23/2013,2013,5,23, 22 ,7005,1351,1187,9543
5/23/2013,2013,5,23, 23 ,6602,1234,1094,8930
5/23/2013,2013,5,23, 24 ,6291,1165,1022,8478
5/24/2013,2013,5,24, 1 ,5952,1104,964,8020
5/24/2013,2013,5,24, 2 ,5738,1069,928,7735
5/24/2013,2013,5,24, 3 ,5616,1044,902,7562
5/24/2013,2013,5,24, 4 ,5496,1024,884,7404
5/24/2013,2013,5,24, 5 ,5434,1023,908,7365
5/24/2013,2013,5,24, 6 ,5318,996,893,7207
5/24/2013,2013,5,24, 7 ,5647,1024,897,7568
5/24/2013,2013,5,24, 8 ,6454,1193,1062,8709
5/24/2013,2013,5,24, 9 ,7266,1394,1217,9877
5/24/2013,2013,5,24, 10 ,7665,1487,1307,10459
5/24/2013,2013,5,24, 11 ,7980,1533,1337,10850
5/24/2013,2013,5,24, 12 ,7893,1500,1344,10737
5/24/2013,2013,5,24, 13 ,7896,1495,1327,10718
5/24/2013,2013,5,24, 14 ,8081,1496,1348,10925
5/24/2013,2013,5,24, 15 ,7700,1476,1349,10525
5/24/2013,2013,5,24, 16 ,7385,1454,1315,10154
5/24/2013,2013,5,24, 17 ,6980,1377,1217,9574
5/24/2013,2013,5,24, 18 ,6770,1391,1293,9454
5/24/2013,2013,5,24, 19 ,7077,1505,1347,9929
5/24/2013,2013,5,24, 20 ,6999,1475,1317,9791
5/24/2013,2013,5,24, 21 ,6960,1414,1251,9625
5/24/2013,2013,5,24, 22 ,6698,1329,1149,9176
5/24/2013,2013,5,24, 23 ,6285,1216,1062,8563
5/24/2013,2013,5,24, 24 ,5990,1137,995,8122
5/25/2013,2013,5,25, 1 ,5690,1079,920,7689
5/25/2013,2013,5,25, 2 ,5526,1047,880,7453
5/25/2013,2013,5,25, 3 ,5323,1016,863,7202
5/25/2013,2013,5,25, 4 ,5209,987,868,7064
5/25/2013,2013,5,25, 5 ,5164,986,875,7025
5/25/2013,2013,5,25, 6 ,4948,954,870,6772
5/25/2013,2013,5,25, 7 ,5100,984,884,6968
5/25/2013,2013,5,25, 8 ,5650,1068,953,7671
5/25/2013,2013,5,25, 9 ,6281,1232,1062,8575
5/25/2013,2013,5,25, 10 ,6780,1349,1154,9283
5/25/2013,2013,5,25, 11 ,7072,1394,1211,9677
5/25/2013,2013,5,25, 12 ,6924,1347,1184,9455
5/25/2013,2013,5,25, 13 ,7006,1363,1205,9574
5/25/2013,2013,5,25, 14 ,7140,1405,1232,9777
5/25/2013,2013,5,25, 15 ,7040,1374,1191,9605
5/25/2013,2013,5,25, 16 ,6728,1319,1153,9200
5/25/2013,2013,5,25, 17 ,6536,1262,1134,8932
5/25/2013,2013,5,25, 18 ,6556,1309,1240,9105
5/25/2013,2013,5,25, 19 ,6740,1454,1330,9524
5/25/2013,2013,5,25, 20 ,6695,1424,1307,9426
5/25/2013,2013,5,25, 21 ,6713,1375,1258,9346
5/25/2013,2013,5,25, 22 ,6448,1295,1158,8901
5/25/2013,2013,5,25, 23 ,6159,1201,1080,8440
5/25/2013,2013,5,25, 24 ,5815,1131,1004,7950
5/26/2013,2013,5,26, 1 ,5566,1078,937,7581
5/26/2013,2013,5,26, 2 ,5363,1050,900,7313
5/26/2013,2013,5,26, 3 ,5182,1024,885,7091
5/26/2013,2013,5,26, 4 ,5137,1005,861,7003
5/26/2013,2013,5,26, 5 ,5013,978,875,6866
5/26/2013,2013,5,26, 6 ,4737,940,844,6521
5/26/2013,2013,5,26, 7 ,4737,945,824,6506
5/26/2013,2013,5,26, 8 ,5012,1007,876,6895
5/26/2013,2013,5,26, 9 ,5443,1067,960,7470
5/26/2013,2013,5,26, 10 ,5953,1149,1043,8145
5/26/2013,2013,5,26, 11 ,6167,1201,1087,8455
5/26/2013,2013,5,26, 12 ,6146,1208,1103,8457
5/26/2013,2013,5,26, 13 ,6120,1215,1082,8417
5/26/2013,2013,5,26, 14 ,6101,1218,1111,8430
5/26/2013,2013,5,26, 15 ,5953,1202,1080,8235
5/26/2013,2013,5,26, 16 ,5678,1171,1053,7902
5/26/2013,2013,5,26, 17 ,5636,1148,1026,7810
5/26/2013,2013,5,26, 18 ,5880,1242,1120,8242
5/26/2013,2013,5,26, 19 ,6269,1395,1240,8904
5/26/2013,2013,5,26, 20 ,6314,1375,1232,8921
5/26/2013,2013,5,26, 21 ,6197,1326,1190,8713
5/26/2013,2013,5,26, 22 ,5823,1236,1088,8147
5/26/2013,2013,5,26, 23 ,5590,1159,1006,7755
5/26/2013,2013,5,26, 24 ,5293,1079,934,7306
5/27/2013,2013,5,27, 1 ,5042,1027,912,6981
5/27/2013,2013,5,27, 2 ,4883,999,857,6739
5/27/2013,2013,5,27, 3 ,4760,973,838,6571
5/27/2013,2013,5,27, 4 ,4607,960,828,6395
5/27/2013,2013,5,27, 5 ,4628,960,843,6431
5/27/2013,2013,5,27, 6 ,4829,948,833,6610
5/27/2013,2013,5,27, 7 ,5093,990,865,6948
5/27/2013,2013,5,27, 8 ,5977,1155,1020,8152
5/27/2013,2013,5,27, 9 ,6835,1374,1183,9392
5/27/2013,2013,5,27, 10 ,7427,1467,1262,10156
5/27/2013,2013,5,27, 11 ,7685,1511,1292,10488
5/27/2013,2013,5,27, 12 ,7620,1478,1256,10354
5/27/2013,2013,5,27, 13 ,7631,1486,1288,10405
5/27/2013,2013,5,27, 14 ,7785,1518,1295,10598
5/27/2013,2013,5,27, 15 ,7521,1501,1285,10307
5/27/2013,2013,5,27, 16 ,7366,1475,1274,10115
5/27/2013,2013,5,27, 17 ,6959,1384,1228,9571
5/27/2013,2013,5,27, 18 ,6701,1382,1255,9338
5/27/2013,2013,5,27, 19 ,6988,1531,1288,9807
5/27/2013,2013,5,27, 20 ,6959,1484,1256,9699
5/27/2013,2013,5,27, 21 ,6787,1432,1253,9472
5/27/2013,2013,5,27, 22 ,6456,1317,1172,8945
5/27/2013,2013,5,27, 23 ,6070,1238,1079,8387
5/27/2013,2013,5,27, 24 ,5720,1159,1003,7882
5/28/2013,2013,5,28, 1 ,5492,1104,955,7551
5/28/2013,2013,5,28, 2 ,5310,1064,924,7298
5/28/2013,2013,5,28, 3 ,5143,1038,885,7066
5/28/2013,2013,5,28, 4 ,4997,1013,884,6894
5/28/2013,2013,5,28, 5 ,5000,1021,896,6917
5/28/2013,2013,5,28, 6 ,5004,999,894,6897
5/28/2013,2013,5,28, 7 ,5336,1022,907,7265
5/28/2013,2013,5,28, 8 ,6191,1175,1019,8385
5/28/2013,2013,5,28, 9 ,7017,1342,1163,9522
5/28/2013,2013,5,28, 10 ,7439,1424,1236,10099
5/28/2013,2013,5,28, 11 ,7773,1456,1260,10489
5/28/2013,2013,5,28, 12 ,7681,1364,1246,10291
5/28/2013,2013,5,28, 13 ,7655,1312,1247,10214
5/28/2013,2013,5,28, 14 ,7851,1369,1282,10502
5/28/2013,2013,5,28, 15 ,7589,1347,1274,10210
5/28/2013,2013,5,28, 16 ,7393,1353,1250,9996
5/28/2013,2013,5,28, 17 ,7070,1303,1213,9586
5/28/2013,2013,5,28, 18 ,6804,1328,1267,9399
5/28/2013,2013,5,28, 19 ,7196,1450,1295,9941
5/28/2013,2013,5,28, 20 ,7060,1398,1273,9731
5/28/2013,2013,5,28, 21 ,6965,1326,1218,9509
5/28/2013,2013,5,28, 22 ,6735,1220,1132,9087
5/28/2013,2013,5,28, 23 ,6258,1103,1018,8379
5/28/2013,2013,5,28, 24 ,6015,1038,940,7993
5/29/2013,2013,5,29, 1 ,5644,992,895,7531
5/29/2013,2013,5,29, 2 ,5488,965,877,7330
5/29/2013,2013,5,29, 3 ,5274,943,855,7072
5/29/2013,2013,5,29, 4 ,5114,931,836,6881
5/29/2013,2013,5,29, 5 ,5171,946,871,6988
5/29/2013,2013,5,29, 6 ,5090,931,879,6900
5/29/2013,2013,5,29, 7 ,5393,971,882,7246
5/29/2013,2013,5,29, 8 ,6283,1139,1012,8434
5/29/2013,2013,5,29, 9 ,7017,1358,1175,9550
5/29/2013,2013,5,29, 10 ,7572,1440,1229,10241
5/29/2013,2013,5,29, 11 ,7807,1475,1262,10544
5/29/2013,2013,5,29, 12 ,7715,1434,1219,10368
5/29/2013,2013,5,29, 13 ,7724,1438,1237,10399
5/29/2013,2013,5,29, 14 ,7930,1501,1247,10678
5/29/2013,2013,5,29, 15 ,7781,1480,1197,10458
5/29/2013,2013,5,29, 16 ,7591,1460,1214,10265
5/29/2013,2013,5,29, 17 ,7234,1379,1194,9807
5/29/2013,2013,5,29, 18 ,6875,1395,1222,9492
5/29/2013,2013,5,29, 19 ,7260,1509,1270,10039
5/29/2013,2013,5,29, 20 ,7293,1465,1235,9993
5/29/2013,2013,5,29, 21 ,7125,1412,1199,9736
5/29/2013,2013,5,29, 22 ,6877,1309,1100,9286
5/29/2013,2013,5,29, 23 ,6511,1197,990,8698
5/29/2013,2013,5,29, 24 ,6162,1124,936,8222
5/30/2013,2013,5,30, 1 ,5856,1056,885,7797
5/30/2013,2013,5,30, 2 ,5670,1029,866,7565
5/30/2013,2013,5,30, 3 ,5509,999,830,7338
5/30/2013,2013,5,30, 4 ,5404,975,823,7202
5/30/2013,2013,5,30, 5 ,5368,974,834,7176
5/30/2013,2013,5,30, 6 ,5246,963,859,7068
5/30/2013,2013,5,30, 7 ,5514,983,885,7382
5/30/2013,2013,5,30, 8 ,6176,1139,1027,8342
5/30/2013,2013,5,30, 9 ,6931,1349,1160,9440
5/30/2013,2013,5,30, 10 ,7239,1452,1217,9908
5/30/2013,2013,5,30, 11 ,7398,1517,1249,10164
5/30/2013,2013,5,30, 12 ,7074,1462,1241,9777
5/30/2013,2013,5,30, 13 ,7097,1458,1275,9830
5/30/2013,2013,5,30, 14 ,7314,1485,1267,10066
5/30/2013,2013,5,30, 15 ,7222,1444,1233,9899
5/30/2013,2013,5,30, 16 ,7068,1418,1219,9705
5/30/2013,2013,5,30, 17 ,6880,1346,1176,9402
5/30/2013,2013,5,30, 18 ,6641,1362,1210,9213
5/30/2013,2013,5,30, 19 ,7040,1485,1244,9769
5/30/2013,2013,5,30, 20 ,6964,1441,1230,9635
5/30/2013,2013,5,30, 21 ,6840,1355,1195,9390
5/30/2013,2013,5,30, 22 ,6619,1271,1137,9027
5/30/2013,2013,5,30, 23 ,6229,1169,1041,8439
5/30/2013,2013,5,30, 24 ,5826,1090,978,7894
5/31/2013,2013,5,31, 1 ,5529,1038,926,7493
5/31/2013,2013,5,31, 2 ,5325,1005,884,7214
5/31/2013,2013,5,31, 3 ,5163,981,873,7017
5/31/2013,2013,5,31, 4 ,5093,962,869,6924
5/31/2013,2013,5,31, 5 ,5058,974,887,6919
5/31/2013,2013,5,31, 6 ,4958,951,868,6777
5/31/2013,2013,5,31, 7 ,5253,984,878,7115
5/31/2013,2013,5,31, 8 ,6109,1140,1017,8266
5/31/2013,2013,5,31, 9 ,6916,1368,1158,9442
5/31/2013,2013,5,31, 10 ,7375,1444,1240,10059
5/31/2013,2013,5,31, 11 ,7683,1489,1292,10464
5/31/2013,2013,5,31, 12 ,7553,1445,1285,10283
5/31/2013,2013,5,31, 13 ,7574,1422,1269,10265
5/31/2013,2013,5,31, 14 ,7440,1440,1303,10183
5/31/2013,2013,5,31, 15 ,7620,1386,1263,10269
5/31/2013,2013,5,31, 16 ,7381,1378,1225,9984
5/31/2013,2013,5,31, 17 ,7025,1305,1169,9499
5/31/2013,2013,5,31, 18 ,6668,1360,1220,9248
5/31/2013,2013,5,31, 19 ,7139,1447,1223,9809
5/31/2013,2013,5,31, 20 ,7084,1401,1220,9705
5/31/2013,2013,5,31, 21 ,6973,1356,1188,9517
5/31/2013,2013,5,31, 22 ,6789,1237,1109,9135
5/31/2013,2013,5,31, 23 ,6447,1134,1013,8594
5/31/2013,2013,5,31, 24 ,6071,1059,960,8090
6/1/2013,2013,6,1, 1 ,5713,1008,915,7636
6/1/2013,2013,6,1, 2 ,5573,968,882,7423
6/1/2013,2013,6,1, 3 ,5326,943,862,7131
6/1/2013,2013,6,1, 4 ,5207,917,854,6978
6/1/2013,2013,6,1, 5 ,5160,910,854,6924
6/1/2013,2013,6,1, 6 ,4910,881,851,6642
6/1/2013,2013,6,1, 7 ,5064,913,831,6808
6/1/2013,2013,6,1, 8 ,5632,1026,907,7565
6/1/2013,2013,6,1, 9 ,6255,1176,1029,8460
6/1/2013,2013,6,1, 10 ,6699,1252,1134,9085
6/1/2013,2013,6,1, 11 ,7009,1315,1221,9545
6/1/2013,2013,6,1, 12 ,6913,1314,1194,9421
6/1/2013,2013,6,1, 13 ,6953,1330,1214,9497
6/1/2013,2013,6,1, 14 ,7087,1375,1240,9702
6/1/2013,2013,6,1, 15 ,6999,1334,1210,9543
6/1/2013,2013,6,1, 16 ,6690,1252,1141,9083
6/1/2013,2013,6,1, 17 ,6353,1198,1103,8654
6/1/2013,2013,6,1, 18 ,6272,1272,1182,8726
6/1/2013,2013,6,1, 19 ,6889,1443,1293,9625
6/1/2013,2013,6,1, 20 ,6945,1421,1284,9650
6/1/2013,2013,6,1, 21 ,6924,1384,1247,9555
6/1/2013,2013,6,1, 22 ,6773,1297,1151,9221
6/1/2013,2013,6,1, 23 ,6418,1214,1070,8702
6/1/2013,2013,6,1, 24 ,6008,1107,974,8089
6/2/2013,2013,6,2, 1 ,5739,1050,910,7699
6/2/2013,2013,6,2, 2 ,5562,1004,880,7446
6/2/2013,2013,6,2, 3 ,5327,969,851,7147
6/2/2013,2013,6,2, 4 ,5212,956,838,7006
6/2/2013,2013,6,2, 5 ,5128,953,839,6920
6/2/2013,2013,6,2, 6 ,4806,909,805,6520
6/2/2013,2013,6,2, 7 ,4861,895,795,6551
6/2/2013,2013,6,2, 8 ,5137,966,849,6952
6/2/2013,2013,6,2, 9 ,5587,1067,927,7581
6/2/2013,2013,6,2, 10 ,6079,1159,1020,8258
6/2/2013,2013,6,2, 11 ,6313,1209,1065,8587
6/2/2013,2013,6,2, 12 ,6290,1215,1066,8571
6/2/2013,2013,6,2, 13 ,6257,1197,1047,8501
6/2/2013,2013,6,2, 14 ,6322,1198,1050,8570
6/2/2013,2013,6,2, 15 ,6213,1163,1007,8383
6/2/2013,2013,6,2, 16 ,5991,1135,1002,8128
6/2/2013,2013,6,2, 17 ,5818,1117,1041,7976
6/2/2013,2013,6,2, 18 ,5811,1194,1140,8145
6/2/2013,2013,6,2, 19 ,6553,1367,1180,9100
6/2/2013,2013,6,2, 20 ,6678,1349,1177,9204
6/2/2013,2013,6,2, 21 ,6637,1299,1143,9079
6/2/2013,2013,6,2, 22 ,6467,1224,1064,8755
6/2/2013,2013,6,2, 23 ,6257,1131,978,8366
6/2/2013,2013,6,2, 24 ,5917,1047,898,7862
6/3/2013,2013,6,3, 1 ,5581,1004,848,7433
6/3/2013,2013,6,3, 2 ,5339,963,823,7125
6/3/2013,2013,6,3, 3 ,5199,942,796,6937
6/3/2013,2013,6,3, 4 ,5076,934,783,6793
6/3/2013,2013,6,3, 5 ,5110,973,852,6935
6/3/2013,2013,6,3, 6 ,5065,954,829,6848
6/3/2013,2013,6,3, 7 ,5397,947,794,7138
6/3/2013,2013,6,3, 8 ,6256,1120,940,8316
6/3/2013,2013,6,3, 9 ,7058,1318,1136,9512
6/3/2013,2013,6,3, 10 ,7508,1415,1229,10152
6/3/2013,2013,6,3, 11 ,7791,1466,1283,10540
6/3/2013,2013,6,3, 12 ,7726,1460,1284,10470
6/3/2013,2013,6,3, 13 ,7751,1460,1290,10501
6/3/2013,2013,6,3, 14 ,7967,1507,1320,10794
6/3/2013,2013,6,3, 15 ,7783,1483,1298,10564
6/3/2013,2013,6,3, 16 ,7718,1443,1276,10437
6/3/2013,2013,6,3, 17 ,7372,1353,1167,9892
6/3/2013,2013,6,3, 18 ,7026,1382,1272,9680
6/3/2013,2013,6,3, 19 ,7413,1516,1316,10245
6/3/2013,2013,6,3, 20 ,7335,1462,1291,10088
6/3/2013,2013,6,3, 21 ,7266,1414,1207,9887
6/3/2013,2013,6,3, 22 ,6954,1316,1115,9385
6/3/2013,2013,6,3, 23 ,6549,1199,1010,8758
6/3/2013,2013,6,3, 24 ,6255,1136,953,8344
6/4/2013,2013,6,4, 1 ,5997,1075,903,7975
6/4/2013,2013,6,4, 2 ,5720,1040,886,7646
6/4/2013,2013,6,4, 3 ,5538,1016,864,7418
6/4/2013,2013,6,4, 4 ,5431,1010,847,7288
6/4/2013,2013,6,4, 5 ,5561,1033,903,7497
6/4/2013,2013,6,4, 6 ,5298,1006,896,7200
6/4/2013,2013,6,4, 7 ,5537,996,846,7379
6/4/2013,2013,6,4, 8 ,6371,1108,987,8466
6/4/2013,2013,6,4, 9 ,7242,1377,1167,9786
6/4/2013,2013,6,4, 10 ,7754,1474,1252,10480
6/4/2013,2013,6,4, 11 ,8029,1520,1307,10856
6/4/2013,2013,6,4, 12 ,7908,1485,1283,10676
6/4/2013,2013,6,4, 13 ,7882,1492,1289,10663
6/4/2013,2013,6,4, 14 ,8148,1503,1340,10991
6/4/2013,2013,6,4, 15 ,8022,1476,1297,10795
6/4/2013,2013,6,4, 16 ,7828,1473,1276,10577
6/4/2013,2013,6,4, 17 ,7440,1389,1230,10059
6/4/2013,2013,6,4, 18 ,7053,1383,1265,9701
6/4/2013,2013,6,4, 19 ,7448,1552,1289,10289
6/4/2013,2013,6,4, 20 ,7465,1513,1261,10239
6/4/2013,2013,6,4, 21 ,7323,1471,1216,10010
6/4/2013,2013,6,4, 22 ,7040,1348,1117,9505
6/4/2013,2013,6,4, 23 ,6629,1221,988,8838
6/4/2013,2013,6,4, 24 ,6270,1160,915,8345
6/5/2013,2013,6,5, 1 ,5915,1111,870,7896
6/5/2013,2013,6,5, 2 ,5739,1067,858,7664
6/5/2013,2013,6,5, 3 ,5544,1025,833,7402
6/5/2013,2013,6,5, 4 ,5446,1010,816,7272
6/5/2013,2013,6,5, 5 ,5483,1036,884,7403
6/5/2013,2013,6,5, 6 ,5256,1019,885,7160
6/5/2013,2013,6,5, 7 ,5509,972,846,7327
6/5/2013,2013,6,5, 8 ,6328,1117,988,8433
6/5/2013,2013,6,5, 9 ,7195,1348,1153,9696
6/5/2013,2013,6,5, 10 ,7714,1451,1251,10416
6/5/2013,2013,6,5, 11 ,7945,1478,1306,10729
6/5/2013,2013,6,5, 12 ,7802,1439,1257,10498
6/5/2013,2013,6,5, 13 ,7850,1424,1271,10545
6/5/2013,2013,6,5, 14 ,8090,1480,1271,10841
6/5/2013,2013,6,5, 15 ,7968,1430,1275,10673
6/5/2013,2013,6,5, 16 ,7725,1402,1262,10389
6/5/2013,2013,6,5, 17 ,7355,1347,1229,9931
6/5/2013,2013,6,5, 18 ,7016,1381,1250,9647
6/5/2013,2013,6,5, 19 ,7444,1497,1305,10246
6/5/2013,2013,6,5, 20 ,7408,1441,1177,10026
6/5/2013,2013,6,5, 21 ,7308,1374,1145,9827
6/5/2013,2013,6,5, 22 ,7098,1267,1083,9448
6/5/2013,2013,6,5, 23 ,6667,1152,994,8813
6/5/2013,2013,6,5, 24 ,6306,1072,931,8309
6/6/2013,2013,6,6, 1 ,6007,1025,889,7921
6/6/2013,2013,6,6, 2 ,5738,1005,848,7591
6/6/2013,2013,6,6, 3 ,5552,982,831,7365
6/6/2013,2013,6,6, 4 ,5453,974,828,7255
6/6/2013,2013,6,6, 5 ,5524,1007,883,7414
6/6/2013,2013,6,6, 6 ,5352,993,891,7236
6/6/2013,2013,6,6, 7 ,5577,969,870,7416
6/6/2013,2013,6,6, 8 ,6471,1124,952,8547
6/6/2013,2013,6,6, 9 ,7263,1334,1087,9684
6/6/2013,2013,6,6, 10 ,7718,1419,1198,10335
6/6/2013,2013,6,6, 11 ,7947,1462,1218,10627
6/6/2013,2013,6,6, 12 ,7887,1428,1220,10535
6/6/2013,2013,6,6, 13 ,7894,1419,1210,10523
6/6/2013,2013,6,6, 14 ,8072,1449,1246,10767
6/6/2013,2013,6,6, 15 ,7975,1443,1226,10644
6/6/2013,2013,6,6, 16 ,7875,1418,1223,10516
6/6/2013,2013,6,6, 17 ,7561,1354,1182,10097
6/6/2013,2013,6,6, 18 ,7122,1379,1251,9752
6/6/2013,2013,6,6, 19 ,7570,1520,1308,10398
6/6/2013,2013,6,6, 20 ,7562,1479,1265,10306
6/6/2013,2013,6,6, 21 ,7452,1439,1221,10112
6/6/2013,2013,6,6, 22 ,7231,1303,1109,9643
6/6/2013,2013,6,6, 23 ,6465,1184,1025,8674
6/6/2013,2013,6,6, 24 ,6141,1101,942,8184
6/7/2013,2013,6,7, 1 ,5654,1026,896,7576
6/7/2013,2013,6,7, 2 ,5856,1006,878,7740
6/7/2013,2013,6,7, 3 ,5609,978,850,7437
6/7/2013,2013,6,7, 4 ,5546,969,849,7364
6/7/2013,2013,6,7, 5 ,5596,994,892,7482
6/7/2013,2013,6,7, 6 ,5359,987,910,7256
6/7/2013,2013,6,7, 7 ,5554,964,873,7391
6/7/2013,2013,6,7, 8 ,6358,1100,1012,8470
6/7/2013,2013,6,7, 9 ,7227,1347,1161,9735
6/7/2013,2013,6,7, 10 ,7730,1463,1258,10451
6/7/2013,2013,6,7, 11 ,7994,1500,1321,10815
6/7/2013,2013,6,7, 12 ,7889,1470,1279,10638
6/7/2013,2013,6,7, 13 ,7917,1459,1304,10680
6/7/2013,2013,6,7, 14 ,8208,1479,1313,11000
6/7/2013,2013,6,7, 15 ,8061,1450,1258,10769
6/7/2013,2013,6,7, 16 ,7871,1421,1246,10538
6/7/2013,2013,6,7, 17 ,7401,1365,1225,9991
6/7/2013,2013,6,7, 18 ,7119,1390,1257,9766
6/7/2013,2013,6,7, 19 ,7469,1470,1296,10235
6/7/2013,2013,6,7, 20 ,7394,1426,1250,10070
6/7/2013,2013,6,7, 21 ,7337,1352,1159,9848
6/7/2013,2013,6,7, 22 ,6989,1243,1070,9302
6/7/2013,2013,6,7, 23 ,6567,1136,973,8676
6/7/2013,2013,6,7, 24 ,6204,1063,925,8192
6/8/2013,2013,6,8, 1 ,5998,1011,887,7896
6/8/2013,2013,6,8, 2 ,5786,981,850,7617
6/8/2013,2013,6,8, 3 ,5622,955,839,7416
6/8/2013,2013,6,8, 4 ,5477,926,835,7238
6/8/2013,2013,6,8, 5 ,5432,939,854,7225
6/8/2013,2013,6,8, 6 ,5193,937,827,6957
6/8/2013,2013,6,8, 7 ,5346,951,827,7124
6/8/2013,2013,6,8, 8 ,5887,1041,903,7831
6/8/2013,2013,6,8, 9 ,6458,1183,981,8622
6/8/2013,2013,6,8, 10 ,6977,1258,1063,9298
6/8/2013,2013,6,8, 11 ,7224,1319,1107,9650
6/8/2013,2013,6,8, 12 ,7144,1262,1101,9507
6/8/2013,2013,6,8, 13 ,7136,1241,1114,9491
6/8/2013,2013,6,8, 14 ,7236,1291,1124,9651
6/8/2013,2013,6,8, 15 ,7070,1244,1082,9396
6/8/2013,2013,6,8, 16 ,6863,1215,1000,9078
6/8/2013,2013,6,8, 17 ,6604,1194,1106,8904
6/8/2013,2013,6,8, 18 ,6546,1288,1173,9007
6/8/2013,2013,6,8, 19 ,7039,1376,1242,9657
6/8/2013,2013,6,8, 20 ,7057,1346,1193,9596
6/8/2013,2013,6,8, 21 ,6945,1318,1152,9415
6/8/2013,2013,6,8, 22 ,6735,1207,1059,9001
6/8/2013,2013,6,8, 23 ,6418,1098,968,8484
6/8/2013,2013,6,8, 24 ,6074,1023,869,7966
6/9/2013,2013,6,9, 1 ,5804,981,835,7620
6/9/2013,2013,6,9, 2 ,5686,953,802,7441
6/9/2013,2013,6,9, 3 ,5446,919,772,7137
6/9/2013,2013,6,9, 4 ,5255,902,757,6914
6/9/2013,2013,6,9, 5 ,5159,902,792,6853
6/9/2013,2013,6,9, 6 ,4912,880,780,6572
6/9/2013,2013,6,9, 7 ,4940,898,773,6611
6/9/2013,2013,6,9, 8 ,5199,949,828,6976
6/9/2013,2013,6,9, 9 ,5639,1033,882,7554
6/9/2013,2013,6,9, 10 ,6094,1109,967,8170
6/9/2013,2013,6,9, 11 ,6319,1162,981,8462
6/9/2013,2013,6,9, 12 ,6352,1169,1021,8542
6/9/2013,2013,6,9, 13 ,6381,1172,1019,8572
6/9/2013,2013,6,9, 14 ,6418,1138,1024,8580
6/9/2013,2013,6,9, 15 ,6313,1116,1019,8448
6/9/2013,2013,6,9, 16 ,6154,1092,1009,8255
6/9/2013,2013,6,9, 17 ,5986,1099,992,8077
6/9/2013,2013,6,9, 18 ,6104,1210,1122,8436
6/9/2013,2013,6,9, 19 ,6642,1351,1242,9235
6/9/2013,2013,6,9, 20 ,6716,1329,1221,9266
6/9/2013,2013,6,9, 21 ,6538,1271,1157,8966
6/9/2013,2013,6,9, 22 ,6348,1167,1079,8594
6/9/2013,2013,6,9, 23 ,6076,1083,961,8120
6/9/2013,2013,6,9, 24 ,5785,1006,921,7712
6/10/2013,2013,6,10, 1 ,5438,959,875,7272
6/10/2013,2013,6,10, 2 ,5236,922,837,6995
6/10/2013,2013,6,10, 3 ,5132,895,803,6830
6/10/2013,2013,6,10, 4 ,5037,882,792,6711
6/10/2013,2013,6,10, 5 ,5219,948,865,7032
6/10/2013,2013,6,10, 6 ,5063,935,869,6867
6/10/2013,2013,6,10, 7 ,5273,913,805,6991
6/10/2013,2013,6,10, 8 ,6272,1077,963,8312
6/10/2013,2013,6,10, 9 ,7081,1294,1148,9523
6/10/2013,2013,6,10, 10 ,7579,1406,1249,10234
6/10/2013,2013,6,10, 11 ,7805,1445,1301,10551
6/10/2013,2013,6,10, 12 ,7642,1391,1247,10280
6/10/2013,2013,6,10, 13 ,7664,1396,1256,10316
6/10/2013,2013,6,10, 14 ,7901,1434,1324,10659
6/10/2013,2013,6,10, 15 ,7803,1397,1298,10498
6/10/2013,2013,6,10, 16 ,7624,1376,1279,10279
6/10/2013,2013,6,10, 17 ,7353,1322,1249,9924
6/10/2013,2013,6,10, 18 ,7016,1369,1288,9673
6/10/2013,2013,6,10, 19 ,7455,1431,1351,10237
6/10/2013,2013,6,10, 20 ,7320,1401,1303,10024
6/10/2013,2013,6,10, 21 ,7274,1312,1249,9835
6/10/2013,2013,6,10, 22 ,6960,1210,1136,9306
6/10/2013,2013,6,10, 23 ,6565,1136,1013,8714
6/10/2013,2013,6,10, 24 ,6185,1054,963,8202
6/11/2013,2013,6,11, 1 ,5826,1014,920,7760
6/11/2013,2013,6,11, 2 ,5653,983,901,7537
6/11/2013,2013,6,11, 3 ,5505,963,861,7329
6/11/2013,2013,6,11, 4 ,5433,954,870,7257
6/11/2013,2013,6,11, 5 ,5519,996,916,7431
6/11/2013,2013,6,11, 6 ,5367,992,925,7284
6/11/2013,2013,6,11, 7 ,5508,957,860,7325
6/11/2013,2013,6,11, 8 ,6344,1107,1000,8451
6/11/2013,2013,6,11, 9 ,7038,1308,1168,9514
6/11/2013,2013,6,11, 10 ,7485,1381,1252,10118
6/11/2013,2013,6,11, 11 ,7743,1422,1332,10497
6/11/2013,2013,6,11, 12 ,7638,1394,1310,10342
6/11/2013,2013,6,11, 13 ,7651,1404,1326,10381
6/11/2013,2013,6,11, 14 ,7977,1438,1349,10764
6/11/2013,2013,6,11, 15 ,7973,1409,1309,10691
6/11/2013,2013,6,11, 16 ,7630,1383,1264,10277
6/11/2013,2013,6,11, 17 ,7290,1311,1239,9840
6/11/2013,2013,6,11, 18 ,6983,1328,1293,9604
6/11/2013,2013,6,11, 19 ,7317,1463,1289,10069
6/11/2013,2013,6,11, 20 ,7170,1421,1274,9865
6/11/2013,2013,6,11, 21 ,6838,1373,1252,9463
6/11/2013,2013,6,11, 22 ,6525,1257,1118,8900
6/11/2013,2013,6,11, 23 ,6174,1145,1014,8333
6/11/2013,2013,6,11, 24 ,5811,1063,927,7801
6/12/2013,2013,6,12, 1 ,5582,1021,902,7505
6/12/2013,2013,6,12, 2 ,5484,989,877,7350
6/12/2013,2013,6,12, 3 ,5274,964,835,7073
6/12/2013,2013,6,12, 4 ,5176,944,829,6949
6/12/2013,2013,6,12, 5 ,5106,957,872,6935
6/12/2013,2013,6,12, 6 ,4878,937,836,6651
6/12/2013,2013,6,12, 7 ,4949,940,849,6738
6/12/2013,2013,6,12, 8 ,5350,1016,919,7285
6/12/2013,2013,6,12, 9 ,5776,1137,1034,7947
6/12/2013,2013,6,12, 10 ,6362,1224,1151,8737
6/12/2013,2013,6,12, 11 ,6679,1272,1190,9141
6/12/2013,2013,6,12, 12 ,6565,1248,1167,8980
6/12/2013,2013,6,12, 13 ,6579,1262,1164,9005
6/12/2013,2013,6,12, 14 ,6654,1285,1185,9124
6/12/2013,2013,6,12, 15 ,6532,1264,1133,8929
6/12/2013,2013,6,12, 16 ,6374,1233,1115,8722
6/12/2013,2013,6,12, 17 ,6225,1207,1088,8520
6/12/2013,2013,6,12, 18 ,6260,1261,1205,8726
6/12/2013,2013,6,12, 19 ,6770,1439,1263,9472
6/12/2013,2013,6,12, 20 ,6663,1384,1235,9282
6/12/2013,2013,6,12, 21 ,6789,1256,1193,9238
6/12/2013,2013,6,12, 22 ,6488,1182,1070,8740
6/12/2013,2013,6,12, 23 ,6095,1097,986,8178
6/12/2013,2013,6,12, 24 ,5703,1024,911,7638
6/13/2013,2013,6,13, 1 ,5402,980,873,7255
6/13/2013,2013,6,13, 2 ,5222,952,839,7013
6/13/2013,2013,6,13, 3 ,5024,932,826,6782
6/13/2013,2013,6,13, 4 ,4990,937,835,6762
6/13/2013,2013,6,13, 5 ,5139,972,888,6999
6/13/2013,2013,6,13, 6 ,5040,984,871,6895
6/13/2013,2013,6,13, 7 ,5288,952,837,7077
6/13/2013,2013,6,13, 8 ,6143,1092,977,8212
6/13/2013,2013,6,13, 9 ,6957,1304,1146,9407
6/13/2013,2013,6,13, 10 ,7378,1364,1221,9963
6/13/2013,2013,6,13, 11 ,7668,1413,1269,10350
6/13/2013,2013,6,13, 12 ,7561,1372,1252,10185
6/13/2013,2013,6,13, 13 ,7607,1377,1240,10224
6/13/2013,2013,6,13, 14 ,7781,1426,1270,10477
6/13/2013,2013,6,13, 15 ,7430,1387,1238,10055
6/13/2013,2013,6,13, 16 ,7269,1361,1239,9869
6/13/2013,2013,6,13, 17 ,7147,1344,1241,9732
6/13/2013,2013,6,13, 18 ,6982,1379,1270,9631
6/13/2013,2013,6,13, 19 ,7183,1463,1300,9946
6/13/2013,2013,6,13, 20 ,7034,1409,1236,9679
6/13/2013,2013,6,13, 21 ,6885,1350,1169,9404
6/13/2013,2013,6,13, 22 ,6638,1225,1063,8926
6/13/2013,2013,6,13, 23 ,6132,1114,953,8199
6/13/2013,2013,6,13, 24 ,5784,1037,864,7685
6/14/2013,2013,6,14, 1 ,5489,995,859,7343
6/14/2013,2013,6,14, 2 ,5396,965,843,7204
6/14/2013,2013,6,14, 3 ,5196,944,819,6959
6/14/2013,2013,6,14, 4 ,5177,943,806,6926
6/14/2013,2013,6,14, 5 ,5292,980,865,7137
6/14/2013,2013,6,14, 6 ,5258,983,864,7105
6/14/2013,2013,6,14, 7 ,5415,949,814,7178
6/14/2013,2013,6,14, 8 ,6223,1109,946,8278
6/14/2013,2013,6,14, 9 ,7000,1327,1095,9422
6/14/2013,2013,6,14, 10 ,7542,1411,1191,10144
6/14/2013,2013,6,14, 11 ,7821,1449,1226,10496
6/14/2013,2013,6,14, 12 ,7665,1413,1202,10280
6/14/2013,2013,6,14, 13 ,7622,1414,1209,10245
6/14/2013,2013,6,14, 14 ,7792,1444,1262,10498
6/14/2013,2013,6,14, 15 ,7664,1420,1229,10313
6/14/2013,2013,6,14, 16 ,7558,1398,1222,10178
6/14/2013,2013,6,14, 17 ,7177,1331,1194,9702
6/14/2013,2013,6,14, 18 ,6904,1366,1241,9511
6/14/2013,2013,6,14, 19 ,7239,1491,1327,10057
6/14/2013,2013,6,14, 20 ,7142,1439,1258,9839
6/14/2013,2013,6,14, 21 ,6972,1373,1217,9562
6/14/2013,2013,6,14, 22 ,6738,1287,1130,9155
6/14/2013,2013,6,14, 23 ,6333,1176,1016,8525
6/14/2013,2013,6,14, 24 ,5941,1078,940,7959
6/15/2013,2013,6,15, 1 ,5631,1028,910,7569
6/15/2013,2013,6,15, 2 ,5448,1002,872,7322
6/15/2013,2013,6,15, 3 ,5332,974,837,7143
6/15/2013,2013,6,15, 4 ,5190,968,834,6992
6/15/2013,2013,6,15, 5 ,5166,973,831,6970
6/15/2013,2013,6,15, 6 ,4962,951,852,6765
6/15/2013,2013,6,15, 7 ,5139,968,797,6904
6/15/2013,2013,6,15, 8 ,5777,1049,874,7700
6/15/2013,2013,6,15, 9 ,6353,1194,979,8526
6/15/2013,2013,6,15, 10 ,6826,1275,1067,9168
6/15/2013,2013,6,15, 11 ,7099,1320,1128,9547
6/15/2013,2013,6,15, 12 ,7011,1292,1106,9409
6/15/2013,2013,6,15, 13 ,7032,1293,1120,9445
6/15/2013,2013,6,15, 14 ,7179,1308,1152,9639
6/15/2013,2013,6,15, 15 ,6992,1278,1116,9386
6/15/2013,2013,6,15, 16 ,6769,1244,1096,9109
6/15/2013,2013,6,15, 17 ,6469,1212,1090,8771
6/15/2013,2013,6,15, 18 ,6365,1302,1198,8865
6/15/2013,2013,6,15, 19 ,6929,1398,1253,9580
6/15/2013,2013,6,15, 20 ,6947,1350,1169,9466
6/15/2013,2013,6,15, 21 ,6933,1305,1126,9364
6/15/2013,2013,6,15, 22 ,6800,1216,1027,9043
6/15/2013,2013,6,15, 23 ,6431,1117,919,8467
6/15/2013,2013,6,15, 24 ,6113,1042,860,8015
6/16/2013,2013,6,16, 1 ,5752,985,820,7557
6/16/2013,2013,6,16, 2 ,5560,956,788,7304
6/16/2013,2013,6,16, 3 ,5338,924,774,7036
6/16/2013,2013,6,16, 4 ,5227,911,763,6901
6/16/2013,2013,6,16, 5 ,5166,911,801,6878
6/16/2013,2013,6,16, 6 ,4861,885,792,6538
6/16/2013,2013,6,16, 7 ,4872,881,781,6534
6/16/2013,2013,6,16, 8 ,5176,917,843,6936
6/16/2013,2013,6,16, 9 ,5633,1005,899,7537
6/16/2013,2013,6,16, 10 ,6014,1072,975,8061
6/16/2013,2013,6,16, 11 ,6178,1112,1028,8318
6/16/2013,2013,6,16, 12 ,6179,1117,1007,8303
6/16/2013,2013,6,16, 13 ,6224,1120,1002,8346
6/16/2013,2013,6,16, 14 ,6287,1116,995,8398
6/16/2013,2013,6,16, 15 ,6198,1079,996,8273
6/16/2013,2013,6,16, 16 ,5925,1068,997,7990
6/16/2013,2013,6,16, 17 ,5783,1086,1017,7886
6/16/2013,2013,6,16, 18 ,5876,1192,1132,8200
6/16/2013,2013,6,16, 19 ,6559,1336,1210,9105
6/16/2013,2013,6,16, 20 ,6596,1304,1171,9071
6/16/2013,2013,6,16, 21 ,6535,1238,1099,8872
6/16/2013,2013,6,16, 22 ,6333,1150,1027,8510
6/16/2013,2013,6,16, 23 ,5981,1042,930,7953
6/16/2013,2013,6,16, 24 ,5704,981,858,7543
6/17/2013,2013,6,17, 1 ,5324,938,831,7093
6/17/2013,2013,6,17, 2 ,5150,910,805,6865
6/17/2013,2013,6,17, 3 ,5049,889,771,6709
6/17/2013,2013,6,17, 4 ,4934,884,786,6604
6/17/2013,2013,6,17, 5 ,5114,925,853,6892
6/17/2013,2013,6,17, 6 ,5075,955,842,6872
6/17/2013,2013,6,17, 7 ,5300,895,812,7007
6/17/2013,2013,6,17, 8 ,6128,1051,862,8041
6/17/2013,2013,6,17, 9 ,7114,1245,1141,9500
6/17/2013,2013,6,17, 10 ,7531,1341,1241,10113
6/17/2013,2013,6,17, 11 ,7780,1372,1271,10423
6/17/2013,2013,6,17, 12 ,7679,1325,1270,10274
6/17/2013,2013,6,17, 13 ,7628,1316,1246,10190
6/17/2013,2013,6,17, 14 ,7841,1362,1291,10494
6/17/2013,2013,6,17, 15 ,7720,1332,1269,10321
6/17/2013,2013,6,17, 16 ,7550,1304,1260,10114
6/17/2013,2013,6,17, 17 ,7267,1268,1234,9769
6/17/2013,2013,6,17, 18 ,7003,1315,1251,9569
6/17/2013,2013,6,17, 19 ,7218,1424,1350,9992
6/17/2013,2013,6,17, 20 ,6966,1380,1304,9650
6/17/2013,2013,6,17, 21 ,6801,1304,1245,9350
6/17/2013,2013,6,17, 22 ,6404,1191,1114,8709
6/17/2013,2013,6,17, 23 ,6038,1079,1018,8135
6/17/2013,2013,6,17, 24 ,5692,998,959,7649
6/18/2013,2013,6,18, 1 ,5390,961,913,7264
6/18/2013,2013,6,18, 2 ,5244,942,872,7058
6/18/2013,2013,6,18, 3 ,5086,916,857,6859
6/18/2013,2013,6,18, 4 ,5089,910,850,6849
6/18/2013,2013,6,18, 5 ,5273,942,918,7133
6/18/2013,2013,6,18, 6 ,5186,966,919,7071
6/18/2013,2013,6,18, 7 ,5417,932,853,7202
6/18/2013,2013,6,18, 8 ,6204,1070,987,8261
6/18/2013,2013,6,18, 9 ,6958,1250,1137,9345
6/18/2013,2013,6,18, 10 ,7422,1344,1235,10001
6/18/2013,2013,6,18, 11 ,7659,1379,1309,10347
6/18/2013,2013,6,18, 12 ,7442,1350,1274,10066
6/18/2013,2013,6,18, 13 ,7382,1351,1239,9972
6/18/2013,2013,6,18, 14 ,7560,1372,1314,10246
6/18/2013,2013,6,18, 15 ,7325,1186,1290,9801
6/18/2013,2013,6,18, 16 ,7160,1254,1260,9674
6/18/2013,2013,6,18, 17 ,6920,1236,1214,9370
6/18/2013,2013,6,18, 18 ,6747,1317,1272,9336
6/18/2013,2013,6,18, 19 ,7036,1424,1362,9822
6/18/2013,2013,6,18, 20 ,6942,1384,1316,9642
6/18/2013,2013,6,18, 21 ,6747,1302,1244,9293
6/18/2013,2013,6,18, 22 ,6454,1190,1153,8797
6/18/2013,2013,6,18, 23 ,5999,1075,1059,8133
6/18/2013,2013,6,18, 24 ,5623,1014,956,7593
6/19/2013,2013,6,19, 1 ,5362,964,915,7241
6/19/2013,2013,6,19, 2 ,5143,942,888,6973
6/19/2013,2013,6,19, 3 ,5115,923,875,6913
6/19/2013,2013,6,19, 4 ,5047,922,875,6844
6/19/2013,2013,6,19, 5 ,5256,964,921,7141
6/19/2013,2013,6,19, 6 ,5170,974,920,7064
6/19/2013,2013,6,19, 7 ,5313,946,864,7123
6/19/2013,2013,6,19, 8 ,5998,1103,989,8090
6/19/2013,2013,6,19, 9 ,6767,1313,1147,9227
6/19/2013,2013,6,19, 10 ,7230,1421,1248,9899
6/19/2013,2013,6,19, 11 ,7575,1479,1312,10366
6/19/2013,2013,6,19, 12 ,7342,1432,1299,10073
6/19/2013,2013,6,19, 13 ,7245,1411,1267,9923
6/19/2013,2013,6,19, 14 ,7418,1465,1316,10199
6/19/2013,2013,6,19, 15 ,7201,1441,1250,9892
6/19/2013,2013,6,19, 16 ,7040,1408,1240,9688
6/19/2013,2013,6,19, 17 ,6879,1350,1181,9410
6/19/2013,2013,6,19, 18 ,6816,1384,1299,9499
6/19/2013,2013,6,19, 19 ,7045,1487,1346,9878
6/19/2013,2013,6,19, 20 ,6897,1428,1289,9614
6/19/2013,2013,6,19, 21 ,6577,1359,1224,9160
6/19/2013,2013,6,19, 22 ,6269,1233,1111,8613
6/19/2013,2013,6,19, 23 ,5876,1124,993,7993
6/19/2013,2013,6,19, 24 ,5524,1053,954,7531
6/20/2013,2013,6,20, 1 ,5258,1002,909,7169
6/20/2013,2013,6,20, 2 ,5073,968,875,6916
6/20/2013,2013,6,20, 3 ,4946,948,838,6732
6/20/2013,2013,6,20, 4 ,4954,943,853,6750
6/20/2013,2013,6,20, 5 ,5080,985,905,6970
6/20/2013,2013,6,20, 6 ,5107,1005,914,7026
6/20/2013,2013,6,20, 7 ,5321,963,862,7146
6/20/2013,2013,6,20, 8 ,6148,1103,970,8221
6/20/2013,2013,6,20, 9 ,6841,1310,1134,9285
6/20/2013,2013,6,20, 10 ,7339,1403,1209,9951
6/20/2013,2013,6,20, 11 ,7541,1452,1287,10280
6/20/2013,2013,6,20, 12 ,7425,1417,1284,10126
6/20/2013,2013,6,20, 13 ,7447,1415,1251,10113
6/20/2013,2013,6,20, 14 ,7678,1474,1303,10455
6/20/2013,2013,6,20, 15 ,7484,1466,1284,10234
6/20/2013,2013,6,20, 16 ,7138,1417,1247,9802
6/20/2013,2013,6,20, 17 ,6945,1338,1206,9489
6/20/2013,2013,6,20, 18 ,6775,1357,1251,9383
6/20/2013,2013,6,20, 19 ,7086,1456,1337,9879
6/20/2013,2013,6,20, 20 ,6881,1414,1302,9597
6/20/2013,2013,6,20, 21 ,6709,1354,1247,9310
6/20/2013,2013,6,20, 22 ,6403,1230,1123,8756
6/20/2013,2013,6,20, 23 ,5972,1122,1022,8116
6/20/2013,2013,6,20, 24 ,5640,1043,940,7623
6/21/2013,2013,6,21, 1 ,5278,993,888,7159
6/21/2013,2013,6,21, 2 ,5082,963,880,6925
6/21/2013,2013,6,21, 3 ,4959,950,845,6754
6/21/2013,2013,6,21, 4 ,4933,940,845,6718
6/21/2013,2013,6,21, 5 ,5087,991,913,6991
6/21/2013,2013,6,21, 6 ,5080,987,925,6992
6/21/2013,2013,6,21, 7 ,5237,962,860,7059
6/21/2013,2013,6,21, 8 ,6031,1121,979,8131
6/21/2013,2013,6,21, 9 ,6763,1347,1158,9268
6/21/2013,2013,6,21, 10 ,7381,1448,1258,10087
6/21/2013,2013,6,21, 11 ,7636,1513,1319,10468
6/21/2013,2013,6,21, 12 ,7416,1440,1273,10129
6/21/2013,2013,6,21, 13 ,7374,1435,1290,10099
6/21/2013,2013,6,21, 14 ,7517,1498,1330,10345
6/21/2013,2013,6,21, 15 ,7233,1450,1307,9990
6/21/2013,2013,6,21, 16 ,7038,1411,1280,9729
6/21/2013,2013,6,21, 17 ,6860,1350,1230,9440
6/21/2013,2013,6,21, 18 ,6730,1375,1258,9363
6/21/2013,2013,6,21, 19 ,6952,1506,1327,9785
6/21/2013,2013,6,21, 20 ,6854,1452,1259,9565
6/21/2013,2013,6,21, 21 ,6730,1384,1222,9336
6/21/2013,2013,6,21, 22 ,6439,1266,1112,8817
6/21/2013,2013,6,21, 23 ,6028,1166,1018,8212
6/21/2013,2013,6,21, 24 ,5582,1084,952,7618
6/22/2013,2013,6,22, 1 ,5360,1028,886,7274
6/22/2013,2013,6,22, 2 ,5199,1001,860,7060
6/22/2013,2013,6,22, 3 ,5027,987,843,6857
6/22/2013,2013,6,22, 4 ,4893,975,835,6703
6/22/2013,2013,6,22, 5 ,4907,969,840,6716
6/22/2013,2013,6,22, 6 ,4786,957,848,6591
6/22/2013,2013,6,22, 7 ,5040,976,827,6843
6/22/2013,2013,6,22, 8 ,5619,1066,915,7600
6/22/2013,2013,6,22, 9 ,6185,1213,985,8383
6/22/2013,2013,6,22, 10 ,6727,1290,1097,9114
6/22/2013,2013,6,22, 11 ,6982,1350,1172,9504
6/22/2013,2013,6,22, 12 ,6805,1323,1174,9302
6/22/2013,2013,6,22, 13 ,6753,1313,1187,9253
6/22/2013,2013,6,22, 14 ,7005,1369,1215,9589
6/22/2013,2013,6,22, 15 ,6760,1337,1197,9294
6/22/2013,2013,6,22, 16 ,6495,1289,1154,8938
6/22/2013,2013,6,22, 17 ,6352,1244,1116,8712
6/22/2013,2013,6,22, 18 ,6307,1295,1191,8793
6/22/2013,2013,6,22, 19 ,6692,1456,1304,9452
6/22/2013,2013,6,22, 20 ,6612,1445,1273,9330
6/22/2013,2013,6,22, 21 ,6544,1385,1249,9178
6/22/2013,2013,6,22, 22 ,6197,1293,1157,8647
6/22/2013,2013,6,22, 23 ,5781,1171,1042,7994
6/22/2013,2013,6,22, 24 ,5383,1098,959,7440
6/23/2013,2013,6,23, 1 ,5178,1036,923,7137
6/23/2013,2013,6,23, 2 ,4986,1003,873,6862
6/23/2013,2013,6,23, 3 ,4869,978,847,6694
6/23/2013,2013,6,23, 4 ,4798,961,835,6594
6/23/2013,2013,6,23, 5 ,4690,958,837,6485
6/23/2013,2013,6,23, 6 ,4539,920,820,6279
6/23/2013,2013,6,23, 7 ,4575,919,775,6269
6/23/2013,2013,6,23, 8 ,4801,958,819,6578
6/23/2013,2013,6,23, 9 ,5212,1022,894,7128
6/23/2013,2013,6,23, 10 ,5649,1102,976,7727
6/23/2013,2013,6,23, 11 ,5866,1152,1036,8054
6/23/2013,2013,6,23, 12 ,5833,1149,1044,8026
6/23/2013,2013,6,23, 13 ,5856,1162,1056,8074
6/23/2013,2013,6,23, 14 ,5925,1164,1034,8123
6/23/2013,2013,6,23, 15 ,5841,1146,1014,8001
6/23/2013,2013,6,23, 16 ,5699,1118,975,7792
6/23/2013,2013,6,23, 17 ,5671,1124,971,7766
6/23/2013,2013,6,23, 18 ,5827,1220,1093,8140
6/23/2013,2013,6,23, 19 ,6411,1401,1223,9035
6/23/2013,2013,6,23, 20 ,6435,1393,1192,9020
6/23/2013,2013,6,23, 21 ,6365,1333,1150,8848
6/23/2013,2013,6,23, 22 ,6004,1229,1038,8271
6/23/2013,2013,6,23, 23 ,5537,1105,926,7568
6/23/2013,2013,6,23, 24 ,5266,1022,872,7160
6/24/2013,2013,6,24, 1 ,4988,975,840,6803
6/24/2013,2013,6,24, 2 ,4817,945,811,6573
6/24/2013,2013,6,24, 3 ,4715,925,783,6423
6/24/2013,2013,6,24, 4 ,4645,923,783,6351
6/24/2013,2013,6,24, 5 ,4791,964,847,6602
6/24/2013,2013,6,24, 6 ,4778,966,877,6621
6/24/2013,2013,6,24, 7 ,5030,942,812,6784
6/24/2013,2013,6,24, 8 ,5910,1102,954,7966
6/24/2013,2013,6,24, 9 ,6746,1325,1127,9198
6/24/2013,2013,6,24, 10 ,7210,1420,1235,9865
6/24/2013,2013,6,24, 11 ,7467,1471,1285,10223
6/24/2013,2013,6,24, 12 ,7420,1436,1244,10100
6/24/2013,2013,6,24, 13 ,7370,1438,1269,10077
6/24/2013,2013,6,24, 14 ,7648,1503,1318,10469
6/24/2013,2013,6,24, 15 ,7505,1488,1305,10298
6/24/2013,2013,6,24, 16 ,7417,1454,1258,10129
6/24/2013,2013,6,24, 17 ,7116,1369,1224,9709
6/24/2013,2013,6,24, 18 ,6870,1368,1232,9470
6/24/2013,2013,6,24, 19 ,7280,1554,1362,10196
6/24/2013,2013,6,24, 20 ,7307,1515,1320,10142
6/24/2013,2013,6,24, 21 ,7160,1441,1278,9879
6/24/2013,2013,6,24, 22 ,6819,1314,1161,9294
6/24/2013,2013,6,24, 23 ,6414,1209,1036,8659
6/24/2013,2013,6,24, 24 ,6011,1116,960,8087
6/25/2013,2013,6,25, 1 ,5680,1061,917,7658
6/25/2013,2013,6,25, 2 ,5489,1029,929,7447
6/25/2013,2013,6,25, 3 ,5308,1004,887,7199
6/25/2013,2013,6,25, 4 ,5243,994,890,7127
6/25/2013,2013,6,25, 5 ,5284,1031,911,7226
6/25/2013,2013,6,25, 6 ,5229,1015,935,7179
6/25/2013,2013,6,25, 7 ,5442,988,876,7306
6/25/2013,2013,6,25, 8 ,6310,1134,984,8428
6/25/2013,2013,6,25, 9 ,7095,1348,1114,9557
6/25/2013,2013,6,25, 10 ,7616,1442,1179,10237
6/25/2013,2013,6,25, 11 ,7873,1476,1236,10585
6/25/2013,2013,6,25, 12 ,7708,1431,1178,10317
6/25/2013,2013,6,25, 13 ,7740,1435,1182,10357
6/25/2013,2013,6,25, 14 ,8005,1476,1217,10698
6/25/2013,2013,6,25, 15 ,7925,1446,1214,10585
6/25/2013,2013,6,25, 16 ,7725,1428,1204,10357
6/25/2013,2013,6,25, 17 ,7342,1361,1201,9904
6/25/2013,2013,6,25, 18 ,6977,1383,1253,9613
6/25/2013,2013,6,25, 19 ,7435,1536,1331,10302
6/25/2013,2013,6,25, 20 ,7486,1493,1275,10254
6/25/2013,2013,6,25, 21 ,7324,1428,1208,9960
6/25/2013,2013,6,25, 22 ,7057,1299,1119,9475
6/25/2013,2013,6,25, 23 ,6538,1187,983,8708
6/25/2013,2013,6,25, 24 ,6155,1099,910,8164
6/26/2013,2013,6,26, 1 ,5765,1044,882,7691
6/26/2013,2013,6,26, 2 ,5578,1014,848,7440
6/26/2013,2013,6,26, 3 ,5434,994,848,7276
6/26/2013,2013,6,26, 4 ,5334,983,845,7162
6/26/2013,2013,6,26, 5 ,5469,1020,887,7376
6/26/2013,2013,6,26, 6 ,5251,1009,934,7194
6/26/2013,2013,6,26, 7 ,5418,983,854,7255
6/26/2013,2013,6,26, 8 ,6266,1158,967,8391
6/26/2013,2013,6,26, 9 ,6943,1342,1142,9427
6/26/2013,2013,6,26, 10 ,7525,1423,1229,10177
6/26/2013,2013,6,26, 11 ,7762,1469,1272,10503
6/26/2013,2013,6,26, 12 ,7650,1423,1250,10323
6/26/2013,2013,6,26, 13 ,7620,1412,1256,10288
6/26/2013,2013,6,26, 14 ,7898,1477,1272,10647
6/26/2013,2013,6,26, 15 ,7808,1449,1258,10515
6/26/2013,2013,6,26, 16 ,7622,1426,1234,10282
6/26/2013,2013,6,26, 17 ,7276,1352,1225,9853
6/26/2013,2013,6,26, 18 ,6946,1377,1252,9575
6/26/2013,2013,6,26, 19 ,7398,1517,1342,10257
6/26/2013,2013,6,26, 20 ,7405,1456,1300,10161
6/26/2013,2013,6,26, 21 ,7316,1406,1239,9961
6/26/2013,2013,6,26, 22 ,7037,1284,1151,9472
6/26/2013,2013,6,26, 23 ,6573,1172,1026,8771
6/26/2013,2013,6,26, 24 ,6213,1086,967,8266
6/27/2013,2013,6,27, 1 ,5905,1041,914,7860
6/27/2013,2013,6,27, 2 ,5671,1007,893,7571
6/27/2013,2013,6,27, 3 ,5483,979,872,7334
6/27/2013,2013,6,27, 4 ,5409,978,866,7253
6/27/2013,2013,6,27, 5 ,5443,1011,919,7373
6/27/2013,2013,6,27, 6 ,5307,1000,927,7234
6/27/2013,2013,6,27, 7 ,5541,973,864,7378
6/27/2013,2013,6,27, 8 ,6402,1125,939,8466
6/27/2013,2013,6,27, 9 ,7134,1331,1136,9601
6/27/2013,2013,6,27, 10 ,7581,1413,1241,10235
6/27/2013,2013,6,27, 11 ,7866,1448,1288,10602
6/27/2013,2013,6,27, 12 ,7681,1427,1285,10393
6/27/2013,2013,6,27, 13 ,7703,1418,1273,10394
6/27/2013,2013,6,27, 14 ,8030,1457,1289,10776
6/27/2013,2013,6,27, 15 ,7846,1417,1283,10546
6/27/2013,2013,6,27, 16 ,7712,1387,1259,10358
6/27/2013,2013,6,27, 17 ,7383,1342,1228,9953
6/27/2013,2013,6,27, 18 ,7095,1355,1227,9677
6/27/2013,2013,6,27, 19 ,7483,1510,1312,10305
6/27/2013,2013,6,27, 20 ,7537,1458,1258,10253
6/27/2013,2013,6,27, 21 ,7471,1341,1210,10022
6/27/2013,2013,6,27, 22 ,7128,1237,1106,9471
6/27/2013,2013,6,27, 23 ,6635,1132,991,8758
6/27/2013,2013,6,27, 24 ,6177,1055,918,8150
6/28/2013,2013,6,28, 1 ,5913,1008,875,7796
6/28/2013,2013,6,28, 2 ,5702,982,864,7548
6/28/2013,2013,6,28, 3 ,5542,964,824,7330
6/28/2013,2013,6,28, 4 ,5450,958,836,7244
6/28/2013,2013,6,28, 5 ,5545,996,887,7428
6/28/2013,2013,6,28, 6 ,5361,989,852,7202
6/28/2013,2013,6,28, 7 ,5586,969,781,7336
6/28/2013,2013,6,28, 8 ,6413,1096,934,8443
6/28/2013,2013,6,28, 9 ,7218,1299,1074,9591
6/28/2013,2013,6,28, 10 ,7646,1377,1120,10143
6/28/2013,2013,6,28, 11 ,7879,1417,1187,10483
6/28/2013,2013,6,28, 12 ,7742,1321,1157,10220
6/28/2013,2013,6,28, 13 ,7727,1321,1140,10188
6/28/2013,2013,6,28, 14 ,8012,1357,1190,10559
6/28/2013,2013,6,28, 15 ,7810,1307,1131,10248
6/28/2013,2013,6,28, 16 ,7582,1297,1155,10034
6/28/2013,2013,6,28, 17 ,7227,1265,1150,9642
6/28/2013,2013,6,28, 18 ,6955,1284,1181,9420
6/28/2013,2013,6,28, 19 ,7386,1399,1243,10028
6/28/2013,2013,6,28, 20 ,7383,1369,1171,9923
6/28/2013,2013,6,28, 21 ,7296,1312,1101,9709
6/28/2013,2013,6,28, 22 ,6962,1214,1029,9205
6/28/2013,2013,6,28, 23 ,6587,1094,925,8606
6/28/2013,2013,6,28, 24 ,6150,1009,846,8005
6/29/2013,2013,6,29, 1 ,5916,967,818,7701
6/29/2013,2013,6,29, 2 ,5726,934,786,7446
6/29/2013,2013,6,29, 3 ,5512,909,751,7172
6/29/2013,2013,6,29, 4 ,5359,896,755,7010
6/29/2013,2013,6,29, 5 ,5255,912,784,6951
6/29/2013,2013,6,29, 6 ,5110,918,804,6832
6/29/2013,2013,6,29, 7 ,5311,927,814,7052
6/29/2013,2013,6,29, 8 ,5758,1000,893,7651
6/29/2013,2013,6,29, 9 ,6296,1115,968,8379
6/29/2013,2013,6,29, 10 ,6792,1179,1044,9015
6/29/2013,2013,6,29, 11 ,7010,1202,1043,9255
6/29/2013,2013,6,29, 12 ,6872,1162,1058,9092
6/29/2013,2013,6,29, 13 ,6745,1149,1100,8994
6/29/2013,2013,6,29, 14 ,6915,1174,1106,9195
6/29/2013,2013,6,29, 15 ,6718,1148,1071,8937
6/29/2013,2013,6,29, 16 ,6482,1133,1057,8672
6/29/2013,2013,6,29, 17 ,6312,1121,1055,8488
6/29/2013,2013,6,29, 18 ,6326,1200,1156,8682
6/29/2013,2013,6,29, 19 ,6618,1329,1207,9154
6/29/2013,2013,6,29, 20 ,6633,1293,1167,9093
6/29/2013,2013,6,29, 21 ,6564,1222,1098,8884
6/29/2013,2013,6,29, 22 ,6207,1135,1019,8361
6/29/2013,2013,6,29, 23 ,5840,1022,920,7782
6/29/2013,2013,6,29, 24 ,5476,952,857,7285
6/30/2013,2013,6,30, 1 ,5158,909,806,6873
6/30/2013,2013,6,30, 2 ,4965,891,794,6650
6/30/2013,2013,6,30, 3 ,4823,870,757,6450
6/30/2013,2013,6,30, 4 ,4650,858,745,6253
6/30/2013,2013,6,30, 5 ,4601,863,772,6236
6/30/2013,2013,6,30, 6 ,4472,844,772,6088
6/30/2013,2013,6,30, 7 ,4463,854,763,6080
6/30/2013,2013,6,30, 8 ,4705,898,798,6401
6/30/2013,2013,6,30, 9 ,5030,976,899,6905
6/30/2013,2013,6,30, 10 ,5374,1048,934,7356
6/30/2013,2013,6,30, 11 ,5584,1098,981,7663
6/30/2013,2013,6,30, 12 ,5637,1097,997,7731
6/30/2013,2013,6,30, 13 ,5682,1095,997,7774
6/30/2013,2013,6,30, 14 ,5717,1101,1015,7833
6/30/2013,2013,6,30, 15 ,5545,1087,1010,7642
6/30/2013,2013,6,30, 16 ,5444,1061,994,7499
6/30/2013,2013,6,30, 17 ,5445,1073,1006,7524
6/30/2013,2013,6,30, 18 ,5639,1156,1097,7892
6/30/2013,2013,6,30, 19 ,6176,1322,1203,8701
6/30/2013,2013,6,30, 20 ,6257,1287,1166,8710
6/30/2013,2013,6,30, 21 ,6212,1233,1122,8567
6/30/2013,2013,6,30, 22 ,5857,1138,1019,8014
6/30/2013,2013,6,30, 23 ,5467,1036,943,7446
6/30/2013,2013,6,30, 24 ,5140,968,862,6970
7/1/2013,2013,7,1, 1 ,4848,931,820,6599
7/1/2013,2013,7,1, 2 ,4701,890,785,6376
7/1/2013,2013,7,1, 3 ,4590,867,758,6215
7/1/2013,2013,7,1, 4 ,4558,857,769,6184
7/1/2013,2013,7,1, 5 ,4730,906,832,6468
7/1/2013,2013,7,1, 6 ,4777,922,828,6527
7/1/2013,2013,7,1, 7 ,5010,902,788,6700
7/1/2013,2013,7,1, 8 ,5903,1056,936,7895
7/1/2013,2013,7,1, 9 ,6737,1261,1097,9095
7/1/2013,2013,7,1, 10 ,7317,1351,1183,9851
7/1/2013,2013,7,1, 11 ,7534,1413,1244,10191
7/1/2013,2013,7,1, 12 ,7435,1402,1249,10086
7/1/2013,2013,7,1, 13 ,7444,1404,1244,10092
7/1/2013,2013,7,1, 14 ,7761,1466,1272,10499
7/1/2013,2013,7,1, 15 ,7703,1432,1255,10390
7/1/2013,2013,7,1, 16 ,7461,1402,1239,10102
7/1/2013,2013,7,1, 17 ,7105,1334,1188,9627
7/1/2013,2013,7,1, 18 ,6824,1332,1193,9349
7/1/2013,2013,7,1, 19 ,7255,1516,1330,10101
7/1/2013,2013,7,1, 20 ,7249,1471,1307,10027
7/1/2013,2013,7,1, 21 ,7146,1395,1265,9806
7/1/2013,2013,7,1, 22 ,6784,1277,1143,9204
7/1/2013,2013,7,1, 23 ,6279,1152,1035,8466
7/1/2013,2013,7,1, 24 ,5817,1079,958,7854
7/2/2013,2013,7,2, 1 ,5583,1023,897,7503
7/2/2013,2013,7,2, 2 ,5363,997,868,7228
7/2/2013,2013,7,2, 3 ,5183,976,853,7012
7/2/2013,2013,7,2, 4 ,5119,966,834,6919
7/2/2013,2013,7,2, 5 ,5270,1004,905,7179
7/2/2013,2013,7,2, 6 ,5150,999,903,7052
7/2/2013,2013,7,2, 7 ,5274,967,850,7091
7/2/2013,2013,7,2, 8 ,6241,1130,969,8340
7/2/2013,2013,7,2, 9 ,7034,1329,1127,9490
7/2/2013,2013,7,2, 10 ,7493,1413,1216,10122
7/2/2013,2013,7,2, 11 ,7735,1446,1281,10462
7/2/2013,2013,7,2, 12 ,7603,1396,1274,10273
7/2/2013,2013,7,2, 13 ,7589,1376,1259,10224
7/2/2013,2013,7,2, 14 ,7760,1416,1265,10441
7/2/2013,2013,7,2, 15 ,7583,1395,1219,10197
7/2/2013,2013,7,2, 16 ,7368,1388,1200,9956
7/2/2013,2013,7,2, 17 ,7081,1329,1204,9614
7/2/2013,2013,7,2, 18 ,6834,1360,1166,9360
7/2/2013,2013,7,2, 19 ,6358,1474,1229,9061
7/2/2013,2013,7,2, 20 ,7260,1421,1213,9894
7/2/2013,2013,7,2, 21 ,7169,1349,1120,9638
7/2/2013,2013,7,2, 22 ,6824,1247,1051,9122
7/2/2013,2013,7,2, 23 ,6315,1121,943,8379
7/2/2013,2013,7,2, 24 ,5930,1019,878,7827
7/3/2013,2013,7,3, 1 ,5668,967,841,7476
7/3/2013,2013,7,3, 2 ,5525,946,827,7298
7/3/2013,2013,7,3, 3 ,5280,922,816,7018
7/3/2013,2013,7,3, 4 ,5275,918,807,7000
7/3/2013,2013,7,3, 5 ,5335,961,870,7166
7/3/2013,2013,7,3, 6 ,5384,966,899,7249
7/3/2013,2013,7,3, 7 ,5561,949,854,7364
7/3/2013,2013,7,3, 8 ,6272,1097,957,8326
7/3/2013,2013,7,3, 9 ,6869,1282,1092,9243
7/3/2013,2013,7,3, 10 ,7178,1359,1180,9717
7/3/2013,2013,7,3, 11 ,7317,1399,1245,9961
7/3/2013,2013,7,3, 12 ,7166,1362,1232,9760
7/3/2013,2013,7,3, 13 ,7098,1357,1229,9684
7/3/2013,2013,7,3, 14 ,7392,1408,1246,10046
7/3/2013,2013,7,3, 15 ,7286,1379,1223,9888
7/3/2013,2013,7,3, 16 ,7212,1373,1212,9797
7/3/2013,2013,7,3, 17 ,7026,1330,1168,9524
7/3/2013,2013,7,3, 18 ,6798,1386,1248,9432
7/3/2013,2013,7,3, 19 ,7141,1480,1294,9915
7/3/2013,2013,7,3, 20 ,7113,1402,1257,9772
7/3/2013,2013,7,3, 21 ,6931,1341,1194,9466
7/3/2013,2013,7,3, 22 ,6552,1233,1076,8861
7/3/2013,2013,7,3, 23 ,6164,1121,977,8262
7/3/2013,2013,7,3, 24 ,5812,1041,901,7754
7/4/2013,2013,7,4, 1 ,5484,992,865,7341
7/4/2013,2013,7,4, 2 ,5282,964,834,7080
7/4/2013,2013,7,4, 3 ,5098,948,818,6864
7/4/2013,2013,7,4, 4 ,5116,947,834,6897
7/4/2013,2013,7,4, 5 ,5227,988,879,7094
7/4/2013,2013,7,4, 6 ,5237,998,888,7123
7/4/2013,2013,7,4, 7 ,5346,966,808,7120
7/4/2013,2013,7,4, 8 ,6194,1118,936,8248
7/4/2013,2013,7,4, 9 ,7013,1311,1112,9436
7/4/2013,2013,7,4, 10 ,7424,1394,1206,10024
7/4/2013,2013,7,4, 11 ,7594,1441,1259,10294
7/4/2013,2013,7,4, 12 ,7465,1400,1250,10115
7/4/2013,2013,7,4, 13 ,7455,1404,1237,10096
7/4/2013,2013,7,4, 14 ,7702,1436,1254,10392
7/4/2013,2013,7,4, 15 ,7609,1399,1231,10239
7/4/2013,2013,7,4, 16 ,7471,1383,1220,10074
7/4/2013,2013,7,4, 17 ,7189,1320,1179,9688
7/4/2013,2013,7,4, 18 ,6879,1364,1229,9472
7/4/2013,2013,7,4, 19 ,7284,1401,1262,9947
7/4/2013,2013,7,4, 20 ,7203,1337,1251,9791
7/4/2013,2013,7,4, 21 ,6978,1268,1188,9434
7/4/2013,2013,7,4, 22 ,6597,1169,1085,8851
7/4/2013,2013,7,4, 23 ,6109,1057,967,8133
7/4/2013,2013,7,4, 24 ,5685,998,897,7580
7/5/2013,2013,7,5, 1 ,5453,962,840,7255
7/5/2013,2013,7,5, 2 ,5329,951,824,7104
7/5/2013,2013,7,5, 3 ,5088,925,799,6812
7/5/2013,2013,7,5, 4 ,5009,918,795,6722
7/5/2013,2013,7,5, 5 ,5165,952,867,6984
7/5/2013,2013,7,5, 6 ,5179,961,869,7009
7/5/2013,2013,7,5, 7 ,5246,936,816,6998
7/5/2013,2013,7,5, 8 ,5894,1080,947,7921
7/5/2013,2013,7,5, 9 ,6624,1274,1123,9021
7/5/2013,2013,7,5, 10 ,7094,1362,1209,9665
7/5/2013,2013,7,5, 11 ,7344,1405,1261,10010
7/5/2013,2013,7,5, 12 ,7271,1390,1232,9893
7/5/2013,2013,7,5, 13 ,7322,1380,1226,9928
7/5/2013,2013,7,5, 14 ,7640,1431,1264,10335
7/5/2013,2013,7,5, 15 ,7507,1404,1245,10156
7/5/2013,2013,7,5, 16 ,7242,1388,1226,9856
7/5/2013,2013,7,5, 17 ,6983,1287,1195,9465
7/5/2013,2013,7,5, 18 ,6813,1300,1219,9332
7/5/2013,2013,7,5, 19 ,7144,1474,1270,9888
7/5/2013,2013,7,5, 20 ,7122,1434,1253,9809
7/5/2013,2013,7,5, 21 ,6986,1369,1199,9554
7/5/2013,2013,7,5, 22 ,6293,1272,1124,8689
7/5/2013,2013,7,5, 23 ,6195,1158,981,8334
7/5/2013,2013,7,5, 24 ,5842,1055,935,7832
7/6/2013,2013,7,6, 1 ,5531,999,867,7397
7/6/2013,2013,7,6, 2 ,5308,945,851,7104
7/6/2013,2013,7,6, 3 ,5149,938,821,6908
7/6/2013,2013,7,6, 4 ,5046,919,803,6768
7/6/2013,2013,7,6, 5 ,5003,928,840,6771
7/6/2013,2013,7,6, 6 ,4838,920,841,6599
7/6/2013,2013,7,6, 7 ,4994,941,832,6767
7/6/2013,2013,7,6, 8 ,5627,1038,923,7588
7/6/2013,2013,7,6, 9 ,6140,1172,1043,8355
7/6/2013,2013,7,6, 10 ,6638,1251,1090,8979
7/6/2013,2013,7,6, 11 ,6900,1315,1150,9365
7/6/2013,2013,7,6, 12 ,6812,1292,1146,9250
7/6/2013,2013,7,6, 13 ,6811,1299,1153,9263
7/6/2013,2013,7,6, 14 ,6919,1327,1176,9422
7/6/2013,2013,7,6, 15 ,6712,1304,1138,9154
7/6/2013,2013,7,6, 16 ,6489,1256,1116,8861
7/6/2013,2013,7,6, 17 ,6274,1210,1117,8601
7/6/2013,2013,7,6, 18 ,6149,1265,1186,8600
7/6/2013,2013,7,6, 19 ,6723,1426,1255,9404
7/6/2013,2013,7,6, 20 ,6752,1408,1213,9373
7/6/2013,2013,7,6, 21 ,6703,1355,1134,9192
7/6/2013,2013,7,6, 22 ,6526,1253,1079,8858
7/6/2013,2013,7,6, 23 ,6156,1149,966,8271
7/6/2013,2013,7,6, 24 ,5718,1066,879,7663
7/7/2013,2013,7,7, 1 ,5412,1010,842,7264
7/7/2013,2013,7,7, 2 ,5241,979,807,7027
7/7/2013,2013,7,7, 3 ,5040,956,787,6783
7/7/2013,2013,7,7, 4 ,4930,942,780,6652
7/7/2013,2013,7,7, 5 ,4813,939,791,6543
7/7/2013,2013,7,7, 6 ,4661,908,786,6355
7/7/2013,2013,7,7, 7 ,4616,911,781,6308
7/7/2013,2013,7,7, 8 ,4852,964,820,6636
7/7/2013,2013,7,7, 9 ,5225,1036,881,7142
7/7/2013,2013,7,7, 10 ,5645,1116,966,7727
7/7/2013,2013,7,7, 11 ,5879,1157,1017,8053
7/7/2013,2013,7,7, 12 ,5857,1151,1022,8030
7/7/2013,2013,7,7, 13 ,5811,1156,1030,7997
7/7/2013,2013,7,7, 14 ,5747,1144,1023,7914
7/7/2013,2013,7,7, 15 ,5708,1137,1028,7873
7/7/2013,2013,7,7, 16 ,5535,1113,1011,7659
7/7/2013,2013,7,7, 17 ,5481,1082,1021,7584
7/7/2013,2013,7,7, 18 ,5600,1193,1081,7874
7/7/2013,2013,7,7, 19 ,6265,1371,1199,8835
7/7/2013,2013,7,7, 20 ,6493,1332,1162,8987
7/7/2013,2013,7,7, 21 ,6323,1274,1118,8715
7/7/2013,2013,7,7, 22 ,6030,1180,1021,8231
7/7/2013,2013,7,7, 23 ,5590,1070,925,7585
7/7/2013,2013,7,7, 24 ,5232,999,867,7098
7/8/2013,2013,7,8, 1 ,4988,957,830,6775
7/8/2013,2013,7,8, 2 ,4796,928,806,6530
7/8/2013,2013,7,8, 3 ,4739,909,768,6416
7/8/2013,2013,7,8, 4 ,4675,908,765,6348
7/8/2013,2013,7,8, 5 ,4806,952,844,6602
7/8/2013,2013,7,8, 6 ,4800,975,870,6645
7/8/2013,2013,7,8, 7 ,5026,944,805,6775
7/8/2013,2013,7,8, 8 ,5982,1103,951,8036
7/8/2013,2013,7,8, 9 ,6797,1311,1094,9202
7/8/2013,2013,7,8, 10 ,7318,1396,1210,9924
7/8/2013,2013,7,8, 11 ,7519,1460,1272,10251
7/8/2013,2013,7,8, 12 ,7495,1422,1258,10175
7/8/2013,2013,7,8, 13 ,7516,1414,1261,10191
7/8/2013,2013,7,8, 14 ,7822,1467,1302,10591
7/8/2013,2013,7,8, 15 ,7664,1441,1265,10370
7/8/2013,2013,7,8, 16 ,7563,1417,1204,10184
7/8/2013,2013,7,8, 17 ,7159,1358,1217,9734
7/8/2013,2013,7,8, 18 ,6780,1349,1236,9365
7/8/2013,2013,7,8, 19 ,7209,1527,1331,10067
7/8/2013,2013,7,8, 20 ,7141,1476,1292,9909
7/8/2013,2013,7,8, 21 ,6996,1402,1200,9598
7/8/2013,2013,7,8, 22 ,6647,1269,1085,9001
7/8/2013,2013,7,8, 23 ,6243,1152,993,8388
7/8/2013,2013,7,8, 24 ,5722,1073,907,7702
7/9/2013,2013,7,9, 1 ,5501,1023,878,7402
7/9/2013,2013,7,9, 2 ,5295,983,851,7129
7/9/2013,2013,7,9, 3 ,5108,959,825,6892
7/9/2013,2013,7,9, 4 ,5050,949,831,6830
7/9/2013,2013,7,9, 5 ,5169,992,887,7048
7/9/2013,2013,7,9, 6 ,5100,985,892,6977
7/9/2013,2013,7,9, 7 ,5305,951,829,7085
7/9/2013,2013,7,9, 8 ,6154,1126,944,8224
7/9/2013,2013,7,9, 9 ,6929,1325,1138,9392
7/9/2013,2013,7,9, 10 ,7384,1420,1222,10026
7/9/2013,2013,7,9, 11 ,7619,1441,1294,10354
7/9/2013,2013,7,9, 12 ,7510,1433,1264,10207
7/9/2013,2013,7,9, 13 ,7461,1423,1263,10147
7/9/2013,2013,7,9, 14 ,7696,1453,1299,10448
7/9/2013,2013,7,9, 15 ,7632,1465,1297,10394
7/9/2013,2013,7,9, 16 ,7426,1431,1299,10156
7/9/2013,2013,7,9, 17 ,7088,1352,1245,9685
7/9/2013,2013,7,9, 18 ,6862,1385,1280,9527
7/9/2013,2013,7,9, 19 ,7246,1506,1344,10096
7/9/2013,2013,7,9, 20 ,7154,1470,1287,9911
7/9/2013,2013,7,9, 21 ,6982,1399,1242,9623
7/9/2013,2013,7,9, 22 ,6512,1291,1124,8927
7/9/2013,2013,7,9, 23 ,6038,1156,983,8177
7/9/2013,2013,7,9, 24 ,5701,1078,932,7711
7/10/2013,2013,7,10, 1 ,5485,1027,902,7414
7/10/2013,2013,7,10, 2 ,5274,992,867,7133
7/10/2013,2013,7,10, 3 ,5129,973,867,6969
7/10/2013,2013,7,10, 4 ,5051,958,850,6859
7/10/2013,2013,7,10, 5 ,5190,991,907,7088
7/10/2013,2013,7,10, 6 ,5189,995,900,7084
7/10/2013,2013,7,10, 7 ,5337,960,850,7147
7/10/2013,2013,7,10, 8 ,6176,1114,965,8255
7/10/2013,2013,7,10, 9 ,6940,1321,1147,9408
7/10/2013,2013,7,10, 10 ,7480,1422,1240,10142
7/10/2013,2013,7,10, 11 ,7718,1467,1284,10469
7/10/2013,2013,7,10, 12 ,7559,1435,1278,10272
7/10/2013,2013,7,10, 13 ,7493,1447,1291,10231
7/10/2013,2013,7,10, 14 ,7775,1500,1326,10601
7/10/2013,2013,7,10, 15 ,7591,1457,1280,10328
7/10/2013,2013,7,10, 16 ,7350,1435,1274,10059
7/10/2013,2013,7,10, 17 ,7150,1374,1248,9772
7/10/2013,2013,7,10, 18 ,6857,1363,1265,9485
7/10/2013,2013,7,10, 19 ,7146,1434,1316,9896
7/10/2013,2013,7,10, 20 ,7071,1422,1298,9791
7/10/2013,2013,7,10, 21 ,6937,1328,1241,9506
7/10/2013,2013,7,10, 22 ,6562,1244,1133,8939
7/10/2013,2013,7,10, 23 ,6093,1113,1022,8228
7/10/2013,2013,7,10, 24 ,5751,1045,951,7747
7/11/2013,2013,7,11, 1 ,5431,997,914,7342
7/11/2013,2013,7,11, 2 ,5263,966,890,7119
7/11/2013,2013,7,11, 3 ,5117,945,867,6929
7/11/2013,2013,7,11, 4 ,5063,937,858,6858
7/11/2013,2013,7,11, 5 ,5173,980,900,7053
7/11/2013,2013,7,11, 6 ,5139,987,917,7043
7/11/2013,2013,7,11, 7 ,5314,957,855,7126
7/11/2013,2013,7,11, 8 ,6189,1112,998,8299
7/11/2013,2013,7,11, 9 ,6938,1294,1157,9389
7/11/2013,2013,7,11, 10 ,7412,1379,1259,10050
7/11/2013,2013,7,11, 11 ,7708,1456,1314,10478
7/11/2013,2013,7,11, 12 ,7512,1410,1296,10218
7/11/2013,2013,7,11, 13 ,7556,1412,1300,10268
7/11/2013,2013,7,11, 14 ,7837,1486,1346,10669
7/11/2013,2013,7,11, 15 ,7704,1451,1283,10438
7/11/2013,2013,7,11, 16 ,7507,1426,1281,10214
7/11/2013,2013,7,11, 17 ,7129,1365,1221,9715
7/11/2013,2013,7,11, 18 ,6794,1361,1264,9419
7/11/2013,2013,7,11, 19 ,7237,1453,1332,10022
7/11/2013,2013,7,11, 20 ,7229,1405,1312,9946
7/11/2013,2013,7,11, 21 ,7093,1332,1262,9687
7/11/2013,2013,7,11, 22 ,6766,1251,1117,9134
7/11/2013,2013,7,11, 23 ,6266,1129,1010,8405
7/11/2013,2013,7,11, 24 ,5925,1055,949,7929
7/12/2013,2013,7,12, 1 ,5667,1014,907,7588
7/12/2013,2013,7,12, 2 ,5492,981,872,7345
7/12/2013,2013,7,12, 3 ,5329,957,870,7156
7/12/2013,2013,7,12, 4 ,5241,953,853,7047
7/12/2013,2013,7,12, 5 ,5275,988,884,7147
7/12/2013,2013,7,12, 6 ,5221,994,894,7109
7/12/2013,2013,7,12, 7 ,5366,964,833,7163
7/12/2013,2013,7,12, 8 ,6219,1124,948,8291
7/12/2013,2013,7,12, 9 ,6883,1325,1157,9365
7/12/2013,2013,7,12, 10 ,7353,1411,1229,9993
7/12/2013,2013,7,12, 11 ,7639,1457,1294,10390
7/12/2013,2013,7,12, 12 ,7553,1422,1294,10269
7/12/2013,2013,7,12, 13 ,7499,1428,1259,10186
7/12/2013,2013,7,12, 14 ,7768,1494,1324,10586
7/12/2013,2013,7,12, 15 ,7672,1448,1262,10382
7/12/2013,2013,7,12, 16 ,7529,1395,1226,10150
7/12/2013,2013,7,12, 17 ,7092,1338,1218,9648
7/12/2013,2013,7,12, 18 ,6793,1342,1255,9390
7/12/2013,2013,7,12, 19 ,7252,1478,1314,10044
7/12/2013,2013,7,12, 20 ,7217,1451,1289,9957
7/12/2013,2013,7,12, 21 ,7075,1373,1248,9696
7/12/2013,2013,7,12, 22 ,6752,1279,1130,9161
7/12/2013,2013,7,12, 23 ,6345,1151,1011,8507
7/12/2013,2013,7,12, 24 ,5896,1071,942,7909
7/13/2013,2013,7,13, 1 ,5663,1027,889,7579
7/13/2013,2013,7,13, 2 ,5510,993,865,7368
7/13/2013,2013,7,13, 3 ,5327,968,854,7149
7/13/2013,2013,7,13, 4 ,5191,950,838,6979
7/13/2013,2013,7,13, 5 ,5168,965,849,6982
7/13/2013,2013,7,13, 6 ,5043,946,830,6819
7/13/2013,2013,7,13, 7 ,5158,959,797,6914
7/13/2013,2013,7,13, 8 ,5676,1055,893,7624
7/13/2013,2013,7,13, 9 ,6208,1186,1002,8396
7/13/2013,2013,7,13, 10 ,6717,1269,1106,9092
7/13/2013,2013,7,13, 11 ,6968,1312,1152,9432
7/13/2013,2013,7,13, 12 ,6822,1298,1143,9263
7/13/2013,2013,7,13, 13 ,6731,1306,1167,9204
7/13/2013,2013,7,13, 14 ,6794,1333,1192,9319
7/13/2013,2013,7,13, 15 ,6663,1298,1169,9130
7/13/2013,2013,7,13, 16 ,6436,1255,1155,8846
7/13/2013,2013,7,13, 17 ,6228,1229,1144,8601
7/13/2013,2013,7,13, 18 ,6229,1271,1200,8700
7/13/2013,2013,7,13, 19 ,6628,1446,1295,9369
7/13/2013,2013,7,13, 20 ,6698,1417,1280,9395
7/13/2013,2013,7,13, 21 ,6682,1358,1195,9235
7/13/2013,2013,7,13, 22 ,6435,1253,1099,8787
7/13/2013,2013,7,13, 23 ,6021,1133,962,8116
7/13/2013,2013,7,13, 24 ,5713,1057,923,7693
7/14/2013,2013,7,14, 1 ,5369,999,881,7249
7/14/2013,2013,7,14, 2 ,5192,969,863,7024
7/14/2013,2013,7,14, 3 ,5060,942,835,6837
7/14/2013,2013,7,14, 4 ,4938,924,822,6684
7/14/2013,2013,7,14, 5 ,4837,922,822,6581
7/14/2013,2013,7,14, 6 ,4631,890,808,6329
7/14/2013,2013,7,14, 7 ,4683,891,774,6348
7/14/2013,2013,7,14, 8 ,4920,932,833,6685
7/14/2013,2013,7,14, 9 ,5241,1009,881,7131
7/14/2013,2013,7,14, 10 ,5707,1079,960,7746
7/14/2013,2013,7,14, 11 ,6062,1125,1016,8203
7/14/2013,2013,7,14, 12 ,6012,1136,1016,8164
7/14/2013,2013,7,14, 13 ,5947,1130,1002,8079
7/14/2013,2013,7,14, 14 ,5898,1134,1007,8039
7/14/2013,2013,7,14, 15 ,5834,1114,994,7942
7/14/2013,2013,7,14, 16 ,5697,1082,1000,7779
7/14/2013,2013,7,14, 17 ,5623,1088,1005,7716
7/14/2013,2013,7,14, 18 ,5753,1181,1100,8034
7/14/2013,2013,7,14, 19 ,6374,1369,1208,8951
7/14/2013,2013,7,14, 20 ,6468,1355,1178,9001
7/14/2013,2013,7,14, 21 ,6414,1285,1124,8823
7/14/2013,2013,7,14, 22 ,6090,1192,1024,8306
7/14/2013,2013,7,14, 23 ,5708,1082,940,7730
7/14/2013,2013,7,14, 24 ,5400,1002,868,7270
7/15/2013,2013,7,15, 1 ,5142,949,825,6916
7/15/2013,2013,7,15, 2 ,4891,914,801,6606
7/15/2013,2013,7,15, 3 ,4803,890,805,6498
7/15/2013,2013,7,15, 4 ,4757,884,792,6433
7/15/2013,2013,7,15, 5 ,4895,927,831,6653
7/15/2013,2013,7,15, 6 ,4961,957,873,6791
7/15/2013,2013,7,15, 7 ,5141,930,820,6891
7/15/2013,2013,7,15, 8 ,5903,1057,940,7900
7/15/2013,2013,7,15, 9 ,6649,1273,1093,9015
7/15/2013,2013,7,15, 10 ,7100,1342,1195,9637
7/15/2013,2013,7,15, 11 ,7368,1387,1235,9990
7/15/2013,2013,7,15, 12 ,7214,1356,1268,9838
7/15/2013,2013,7,15, 13 ,7142,1349,1244,9735
7/15/2013,2013,7,15, 14 ,7385,1414,1285,10084
7/15/2013,2013,7,15, 15 ,7331,1396,1250,9977
7/15/2013,2013,7,15, 16 ,7261,1360,1248,9869
7/15/2013,2013,7,15, 17 ,6972,1298,1215,9485
7/15/2013,2013,7,15, 18 ,6750,1352,1259,9361
7/15/2013,2013,7,15, 19 ,7086,1448,1284,9818
7/15/2013,2013,7,15, 20 ,7054,1397,1256,9707
7/15/2013,2013,7,15, 21 ,6890,1319,1200,9409
7/15/2013,2013,7,15, 22 ,6566,1191,1102,8859
7/15/2013,2013,7,15, 23 ,6092,1085,971,8148
7/15/2013,2013,7,15, 24 ,5639,1005,908,7552
7/16/2013,2013,7,16, 1 ,5400,961,862,7223
7/16/2013,2013,7,16, 2 ,5176,932,834,6942
7/16/2013,2013,7,16, 3 ,5011,915,846,6772
7/16/2013,2013,7,16, 4 ,5047,910,811,6768
7/16/2013,2013,7,16, 5 ,5156,948,860,6964
7/16/2013,2013,7,16, 6 ,5120,974,875,6969
7/16/2013,2013,7,16, 7 ,5308,938,829,7075
7/16/2013,2013,7,16, 8 ,6164,1072,949,8185
7/16/2013,2013,7,16, 9 ,6983,1267,1143,9393
7/16/2013,2013,7,16, 10 ,7374,1334,1215,9923
7/16/2013,2013,7,16, 11 ,7637,1370,1237,10244
7/16/2013,2013,7,16, 12 ,7491,1332,1217,10040
7/16/2013,2013,7,16, 13 ,7469,1324,1233,10026
7/16/2013,2013,7,16, 14 ,7664,1381,1233,10278
7/16/2013,2013,7,16, 15 ,7521,1343,1238,10102
7/16/2013,2013,7,16, 16 ,7347,1325,1227,9899
7/16/2013,2013,7,16, 17 ,7146,1290,1181,9617
7/16/2013,2013,7,16, 18 ,6944,1316,1231,9491
7/16/2013,2013,7,16, 19 ,7160,1442,1263,9865
7/16/2013,2013,7,16, 20 ,7023,1370,1257,9650
7/16/2013,2013,7,16, 21 ,6757,1298,1187,9242
7/16/2013,2013,7,16, 22 ,6390,1168,1065,8623
7/16/2013,2013,7,16, 23 ,5868,1047,975,7890
7/16/2013,2013,7,16, 24 ,5505,976,897,7378
7/17/2013,2013,7,17, 1 ,5268,944,877,7089
7/17/2013,2013,7,17, 2 ,5132,917,856,6905
7/17/2013,2013,7,17, 3 ,4996,892,833,6721
7/17/2013,2013,7,17, 4 ,5016,888,816,6720
7/17/2013,2013,7,17, 5 ,5118,937,868,6923
7/17/2013,2013,7,17, 6 ,5199,959,888,7046
7/17/2013,2013,7,17, 7 ,5378,922,838,7138
7/17/2013,2013,7,17, 8 ,6118,1077,940,8135
7/17/2013,2013,7,17, 9 ,6747,1279,1125,9151
7/17/2013,2013,7,17, 10 ,7239,1386,1198,9823
7/17/2013,2013,7,17, 11 ,7472,1438,1262,10172
7/17/2013,2013,7,17, 12 ,7272,1401,1261,9934
7/17/2013,2013,7,17, 13 ,7209,1409,1251,9869
7/17/2013,2013,7,17, 14 ,7368,1474,1314,10156
7/17/2013,2013,7,17, 15 ,7281,1457,1286,10024
7/17/2013,2013,7,17, 16 ,7162,1417,1288,9867
7/17/2013,2013,7,17, 17 ,6949,1348,1243,9540
7/17/2013,2013,7,17, 18 ,6823,1360,1254,9437
7/17/2013,2013,7,17, 19 ,7198,1507,1372,10077
7/17/2013,2013,7,17, 20 ,7096,1472,1332,9900
7/17/2013,2013,7,17, 21 ,6946,1411,1272,9629
7/17/2013,2013,7,17, 22 ,6595,1287,1156,9038
7/17/2013,2013,7,17, 23 ,6104,1151,1016,8271
7/17/2013,2013,7,17, 24 ,5631,1075,953,7659
7/18/2013,2013,7,18, 1 ,5431,1020,926,7377
7/18/2013,2013,7,18, 2 ,5262,993,889,7144
7/18/2013,2013,7,18, 3 ,5136,966,873,6975
7/18/2013,2013,7,18, 4 ,5052,951,871,6874
7/18/2013,2013,7,18, 5 ,5194,987,891,7072
7/18/2013,2013,7,18, 6 ,5156,991,905,7052
7/18/2013,2013,7,18, 7 ,5303,965,839,7107
7/18/2013,2013,7,18, 8 ,6145,1121,981,8247
7/18/2013,2013,7,18, 9 ,6943,1322,1161,9426
7/18/2013,2013,7,18, 10 ,7386,1418,1249,10053
7/18/2013,2013,7,18, 11 ,7706,1475,1303,10484
7/18/2013,2013,7,18, 12 ,7554,1450,1280,10284
7/18/2013,2013,7,18, 13 ,7580,1442,1290,10312
7/18/2013,2013,7,18, 14 ,7914,1506,1338,10758
7/18/2013,2013,7,18, 15 ,7746,1469,1302,10517
7/18/2013,2013,7,18, 16 ,7580,1444,1267,10291
7/18/2013,2013,7,18, 17 ,7205,1362,1257,9824
7/18/2013,2013,7,18, 18 ,6903,1364,1264,9531
7/18/2013,2013,7,18, 19 ,7357,1531,1332,10220
7/18/2013,2013,7,18, 20 ,7345,1495,1299,10139
7/18/2013,2013,7,18, 21 ,7218,1434,1224,9876
7/18/2013,2013,7,18, 22 ,6907,1295,1115,9317
7/18/2013,2013,7,18, 23 ,6398,1176,1004,8578
7/18/2013,2013,7,18, 24 ,5984,1096,930,8010
7/19/2013,2013,7,19, 1 ,5655,1041,894,7590
7/19/2013,2013,7,19, 2 ,5480,1005,871,7356
7/19/2013,2013,7,19, 3 ,5310,973,848,7131
7/19/2013,2013,7,19, 4 ,5216,967,842,7025
7/19/2013,2013,7,19, 5 ,5317,997,887,7201
7/19/2013,2013,7,19, 6 ,5328,995,877,7200
7/19/2013,2013,7,19, 7 ,5482,972,850,7304
7/19/2013,2013,7,19, 8 ,6231,1133,955,8319
7/19/2013,2013,7,19, 9 ,7059,1345,1154,9558
7/19/2013,2013,7,19, 10 ,7515,1439,1243,10197
7/19/2013,2013,7,19, 11 ,7747,1462,1281,10490
7/19/2013,2013,7,19, 12 ,7616,1420,1264,10300
7/19/2013,2013,7,19, 13 ,7610,1339,1250,10199
7/19/2013,2013,7,19, 14 ,7822,1436,1245,10503
7/19/2013,2013,7,19, 15 ,7612,1420,1223,10255
7/19/2013,2013,7,19, 16 ,7356,1384,1214,9954
7/19/2013,2013,7,19, 17 ,7057,1329,1195,9581
7/19/2013,2013,7,19, 18 ,6789,1336,1250,9375
7/19/2013,2013,7,19, 19 ,7066,1466,1280,9812
7/19/2013,2013,7,19, 20 ,6994,1424,1250,9668
7/19/2013,2013,7,19, 21 ,6958,1351,1189,9498
7/19/2013,2013,7,19, 22 ,6602,1257,1072,8931
7/19/2013,2013,7,19, 23 ,6184,1115,954,8253
7/19/2013,2013,7,19, 24 ,5818,1031,887,7736
7/20/2013,2013,7,20, 1 ,5519,968,850,7337
7/20/2013,2013,7,20, 2 ,5347,936,834,7117
7/20/2013,2013,7,20, 3 ,5183,909,837,6929
7/20/2013,2013,7,20, 4 ,5060,903,818,6781
7/20/2013,2013,7,20, 5 ,5034,899,819,6752
7/20/2013,2013,7,20, 6 ,4883,912,813,6608
7/20/2013,2013,7,20, 7 ,5027,929,799,6755
7/20/2013,2013,7,20, 8 ,5601,1029,868,7498
7/20/2013,2013,7,20, 9 ,6184,1163,997,8344
7/20/2013,2013,7,20, 10 ,6691,1242,1065,8998
7/20/2013,2013,7,20, 11 ,6963,1299,1117,9379
7/20/2013,2013,7,20, 12 ,6859,1279,1100,9238
7/20/2013,2013,7,20, 13 ,6896,1289,1144,9329
7/20/2013,2013,7,20, 14 ,7051,1335,1133,9519
7/20/2013,2013,7,20, 15 ,6902,1284,1086,9272
7/20/2013,2013,7,20, 16 ,6576,1233,1064,8873
7/20/2013,2013,7,20, 17 ,6278,1132,1057,8467
7/20/2013,2013,7,20, 18 ,6278,1253,1122,8653
7/20/2013,2013,7,20, 19 ,6747,1367,1178,9292
7/20/2013,2013,7,20, 20 ,6726,1302,1148,9176
7/20/2013,2013,7,20, 21 ,6695,1241,1106,9042
7/20/2013,2013,7,20, 22 ,6425,1154,1043,8622
7/20/2013,2013,7,20, 23 ,6077,1053,951,8081
7/20/2013,2013,7,20, 24 ,5806,981,881,7668
7/21/2013,2013,7,21, 1 ,5415,935,845,7195
7/21/2013,2013,7,21, 2 ,5205,907,816,6928
7/21/2013,2013,7,21, 3 ,5062,888,813,6763
7/21/2013,2013,7,21, 4 ,4929,872,794,6595
7/21/2013,2013,7,21, 5 ,4881,873,784,6538
7/21/2013,2013,7,21, 6 ,4622,853,762,6237
7/21/2013,2013,7,21, 7 ,4630,841,701,6172
7/21/2013,2013,7,21, 8 ,4955,887,729,6571
7/21/2013,2013,7,21, 9 ,5262,969,818,7049
7/21/2013,2013,7,21, 10 ,5713,1034,903,7650
7/21/2013,2013,7,21, 11 ,5985,1091,928,8004
7/21/2013,2013,7,21, 12 ,5924,1051,940,7915
7/21/2013,2013,7,21, 13 ,5901,1046,959,7906
7/21/2013,2013,7,21, 14 ,6042,1091,951,8084
7/21/2013,2013,7,21, 15 ,5899,1066,970,7935
7/21/2013,2013,7,21, 16 ,5786,1052,976,7814
7/21/2013,2013,7,21, 17 ,5673,1060,1008,7741
7/21/2013,2013,7,21, 18 ,5808,1135,1076,8019
7/21/2013,2013,7,21, 19 ,6433,1291,1183,8907
7/21/2013,2013,7,21, 20 ,6522,1253,1153,8928
7/21/2013,2013,7,21, 21 ,6444,1191,1084,8719
7/21/2013,2013,7,21, 22 ,6131,1089,986,8206
7/21/2013,2013,7,21, 23 ,5815,977,900,7692
7/21/2013,2013,7,21, 24 ,5439,911,831,7181
7/22/2013,2013,7,22, 1 ,5088,867,798,6753
7/22/2013,2013,7,22, 2 ,4932,844,781,6557
7/22/2013,2013,7,22, 3 ,4848,830,772,6450
7/22/2013,2013,7,22, 4 ,4750,836,753,6339
7/22/2013,2013,7,22, 5 ,4891,880,810,6581
7/22/2013,2013,7,22, 6 ,4940,925,850,6715
7/22/2013,2013,7,22, 7 ,5169,916,815,6900
7/22/2013,2013,7,22, 8 ,5965,1049,881,7895
7/22/2013,2013,7,22, 9 ,6743,1232,1089,9064
7/22/2013,2013,7,22, 10 ,7337,1337,1161,9835
7/22/2013,2013,7,22, 11 ,7561,1395,1200,10156
7/22/2013,2013,7,22, 12 ,7435,1363,1183,9981
7/22/2013,2013,7,22, 13 ,7424,1334,1174,9932
7/22/2013,2013,7,22, 14 ,7584,1339,1201,10124
7/22/2013,2013,7,22, 15 ,7421,1307,1190,9918
7/22/2013,2013,7,22, 16 ,7195,1301,1191,9687
7/22/2013,2013,7,22, 17 ,6916,1286,1180,9382
7/22/2013,2013,7,22, 18 ,6691,1295,1227,9213
7/22/2013,2013,7,22, 19 ,7034,1388,1268,9690
7/22/2013,2013,7,22, 20 ,6979,1331,1209,9519
7/22/2013,2013,7,22, 21 ,6845,1274,1126,9245
7/22/2013,2013,7,22, 22 ,6479,1164,1028,8671
7/22/2013,2013,7,22, 23 ,6003,1029,933,7965
7/22/2013,2013,7,22, 24 ,5628,951,867,7446
7/23/2013,2013,7,23, 1 ,5365,904,823,7092
7/23/2013,2013,7,23, 2 ,5186,881,808,6875
7/23/2013,2013,7,23, 3 ,5012,850,787,6649
7/23/2013,2013,7,23, 4 ,4960,844,783,6587
7/23/2013,2013,7,23, 5 ,5093,893,832,6818
7/23/2013,2013,7,23, 6 ,5141,949,885,6975
7/23/2013,2013,7,23, 7 ,5390,921,819,7130
7/23/2013,2013,7,23, 8 ,5976,1013,918,7907
7/23/2013,2013,7,23, 9 ,6690,1175,1082,8947
7/23/2013,2013,7,23, 10 ,7179,1260,1178,9617
7/23/2013,2013,7,23, 11 ,7523,1306,1217,10046
7/23/2013,2013,7,23, 12 ,7359,1276,1210,9845
7/23/2013,2013,7,23, 13 ,7251,1265,1209,9725
7/23/2013,2013,7,23, 14 ,7333,1341,1257,9931
7/23/2013,2013,7,23, 15 ,7200,1314,1240,9754
7/23/2013,2013,7,23, 16 ,6972,1305,1232,9509
7/23/2013,2013,7,23, 17 ,6873,1257,1196,9326
7/23/2013,2013,7,23, 18 ,6783,1305,1241,9329
7/23/2013,2013,7,23, 19 ,6958,1430,1312,9700
7/23/2013,2013,7,23, 20 ,6769,1366,1264,9399
7/23/2013,2013,7,23, 21 ,6541,1291,1196,9028
7/23/2013,2013,7,23, 22 ,6094,1174,1111,8379
7/23/2013,2013,7,23, 23 ,5622,1027,997,7646
7/23/2013,2013,7,23, 24 ,5311,960,917,7188
7/24/2013,2013,7,24, 1 ,5048,922,879,6849
7/24/2013,2013,7,24, 2 ,4901,899,854,6654
7/24/2013,2013,7,24, 3 ,4755,882,841,6478
7/24/2013,2013,7,24, 4 ,4765,879,827,6471
7/24/2013,2013,7,24, 5 ,4915,918,864,6697
7/24/2013,2013,7,24, 6 ,4988,946,880,6814
7/24/2013,2013,7,24, 7 ,5147,911,815,6873
7/24/2013,2013,7,24, 8 ,5911,1068,958,7937
7/24/2013,2013,7,24, 9 ,6605,1264,1164,9033
7/24/2013,2013,7,24, 10 ,7114,1366,1206,9686
7/24/2013,2013,7,24, 11 ,7358,1423,1269,10050
7/24/2013,2013,7,24, 12 ,7211,1387,1247,9845
7/24/2013,2013,7,24, 13 ,7265,1383,1292,9940
7/24/2013,2013,7,24, 14 ,7526,1452,1319,10297
7/24/2013,2013,7,24, 15 ,7354,1407,1310,10071
7/24/2013,2013,7,24, 16 ,7179,1381,1296,9856
7/24/2013,2013,7,24, 17 ,6962,1304,1236,9502
7/24/2013,2013,7,24, 18 ,6817,1323,1242,9382
7/24/2013,2013,7,24, 19 ,7088,1471,1337,9896
7/24/2013,2013,7,24, 20 ,6910,1427,1260,9597
7/24/2013,2013,7,24, 21 ,6717,1374,1200,9291
7/24/2013,2013,7,24, 22 ,6337,1264,1119,8720
7/24/2013,2013,7,24, 23 ,5785,1112,952,7849
7/24/2013,2013,7,24, 24 ,5463,1030,929,7422
7/25/2013,2013,7,25, 1 ,5191,961,905,7057
7/25/2013,2013,7,25, 2 ,5030,934,864,6828
7/25/2013,2013,7,25, 3 ,4899,916,853,6668
7/25/2013,2013,7,25, 4 ,4860,915,852,6627
7/25/2013,2013,7,25, 5 ,4995,954,872,6821
7/25/2013,2013,7,25, 6 ,5040,958,900,6898
7/25/2013,2013,7,25, 7 ,5191,928,841,6960
7/25/2013,2013,7,25, 8 ,5883,1092,979,7954
7/25/2013,2013,7,25, 9 ,6642,1308,1169,9119
7/25/2013,2013,7,25, 10 ,7164,1405,1258,9827
7/25/2013,2013,7,25, 11 ,7487,1441,1313,10241
7/25/2013,2013,7,25, 12 ,7355,1398,1292,10045
7/25/2013,2013,7,25, 13 ,7353,1411,1298,10062
7/25/2013,2013,7,25, 14 ,7675,1460,1343,10478
7/25/2013,2013,7,25, 15 ,7564,1405,1292,10261
7/25/2013,2013,7,25, 16 ,7371,1397,1277,10045
7/25/2013,2013,7,25, 17 ,7058,1337,1244,9639
7/25/2013,2013,7,25, 18 ,6864,1343,1246,9453
7/25/2013,2013,7,25, 19 ,7266,1486,1343,10095
7/25/2013,2013,7,25, 20 ,7192,1448,1291,9931
7/25/2013,2013,7,25, 21 ,7057,1375,1222,9654
7/25/2013,2013,7,25, 22 ,6501,1273,1150,8924
7/25/2013,2013,7,25, 23 ,6211,1120,1024,8355
7/25/2013,2013,7,25, 24 ,5782,1031,938,7751
7/26/2013,2013,7,26, 1 ,5465,985,899,7349
7/26/2013,2013,7,26, 2 ,5373,951,876,7200
7/26/2013,2013,7,26, 3 ,5192,936,867,6995
7/26/2013,2013,7,26, 4 ,5082,941,855,6878
7/26/2013,2013,7,26, 5 ,5203,967,859,7029
7/26/2013,2013,7,26, 6 ,5206,983,886,7075
7/26/2013,2013,7,26, 7 ,5359,958,835,7152
7/26/2013,2013,7,26, 8 ,6113,1097,934,8144
7/26/2013,2013,7,26, 9 ,6921,1283,1118,9322
7/26/2013,2013,7,26, 10 ,7329,1367,1152,9848
7/26/2013,2013,7,26, 11 ,7580,1417,1187,10184
7/26/2013,2013,7,26, 12 ,7473,1372,1171,10016
7/26/2013,2013,7,26, 13 ,7524,1376,1149,10049
7/26/2013,2013,7,26, 14 ,7735,1431,1191,10357
7/26/2013,2013,7,26, 15 ,7587,1424,1172,10183
7/26/2013,2013,7,26, 16 ,7462,1359,1141,9962
7/26/2013,2013,7,26, 17 ,7068,1293,1166,9527
7/26/2013,2013,7,26, 18 ,6946,1304,1200,9450
7/26/2013,2013,7,26, 19 ,6992,1450,1236,9678
7/26/2013,2013,7,26, 20 ,6837,1392,1197,9426
7/26/2013,2013,7,26, 21 ,6721,1325,1128,9174
7/26/2013,2013,7,26, 22 ,6373,1235,1043,8651
7/26/2013,2013,7,26, 23 ,5928,1112,925,7965
7/26/2013,2013,7,26, 24 ,5587,1039,871,7497
7/27/2013,2013,7,27, 1 ,5253,988,843,7084
7/27/2013,2013,7,27, 2 ,5123,959,809,6891
7/27/2013,2013,7,27, 3 ,4990,942,800,6732
7/27/2013,2013,7,27, 4 ,4887,926,785,6598
7/27/2013,2013,7,27, 5 ,4845,931,803,6579
7/27/2013,2013,7,27, 6 ,4795,924,813,6532
7/27/2013,2013,7,27, 7 ,4976,930,814,6720
7/27/2013,2013,7,27, 8 ,5526,1010,888,7424
7/27/2013,2013,7,27, 9 ,6065,1117,974,8156
7/27/2013,2013,7,27, 10 ,6614,1173,1058,8845
7/27/2013,2013,7,27, 11 ,6915,1217,1103,9235
7/27/2013,2013,7,27, 12 ,6774,1195,1086,9055
7/27/2013,2013,7,27, 13 ,6743,1206,1089,9038
7/27/2013,2013,7,27, 14 ,6861,1229,1102,9192
7/27/2013,2013,7,27, 15 ,6543,1198,1095,8836
7/27/2013,2013,7,27, 16 ,6315,1175,1049,8539
7/27/2013,2013,7,27, 17 ,6175,1152,1089,8416
7/27/2013,2013,7,27, 18 ,6131,1221,1168,8520
7/27/2013,2013,7,27, 19 ,6643,1360,1195,9198
7/27/2013,2013,7,27, 20 ,6608,1301,1173,9082
7/27/2013,2013,7,27, 21 ,6562,1231,1074,8867
7/27/2013,2013,7,27, 22 ,6166,1147,1007,8320
7/27/2013,2013,7,27, 23 ,5709,1041,888,7638
7/27/2013,2013,7,27, 24 ,5451,961,847,7259
7/28/2013,2013,7,28, 1 ,5143,922,803,6868
7/28/2013,2013,7,28, 2 ,4910,896,790,6596
7/28/2013,2013,7,28, 3 ,4799,880,771,6450
7/28/2013,2013,7,28, 4 ,4718,865,753,6336
7/28/2013,2013,7,28, 5 ,4661,869,760,6290
7/28/2013,2013,7,28, 6 ,4538,873,769,6180
7/28/2013,2013,7,28, 7 ,4535,871,770,6176
7/28/2013,2013,7,28, 8 ,4782,902,802,6486
7/28/2013,2013,7,28, 9 ,5247,959,837,7043
7/28/2013,2013,7,28, 10 ,5665,1016,904,7585
7/28/2013,2013,7,28, 11 ,5942,1055,958,7955
7/28/2013,2013,7,28, 12 ,5941,1060,977,7978
7/28/2013,2013,7,28, 13 ,5885,1037,972,7894
7/28/2013,2013,7,28, 14 ,5754,1037,978,7769
7/28/2013,2013,7,28, 15 ,5615,1041,967,7623
7/28/2013,2013,7,28, 16 ,5502,1038,974,7514
7/28/2013,2013,7,28, 17 ,5491,1056,958,7505
7/28/2013,2013,7,28, 18 ,5612,1168,1117,7897
7/28/2013,2013,7,28, 19 ,6155,1288,1174,8617
7/28/2013,2013,7,28, 20 ,6221,1249,1148,8618
7/28/2013,2013,7,28, 21 ,6036,1178,1099,8313
7/28/2013,2013,7,28, 22 ,5747,1093,1006,7846
7/28/2013,2013,7,28, 23 ,5429,987,904,7320
7/28/2013,2013,7,28, 24 ,4991,907,838,6736
7/29/2013,2013,7,29, 1 ,4701,871,804,6376
7/29/2013,2013,7,29, 2 ,4546,848,780,6174
7/29/2013,2013,7,29, 3 ,4498,826,773,6097
7/29/2013,2013,7,29, 4 ,4393,831,773,5997
7/29/2013,2013,7,29, 5 ,4625,877,831,6333
7/29/2013,2013,7,29, 6 ,4740,931,867,6538
7/29/2013,2013,7,29, 7 ,4959,897,810,6666
7/29/2013,2013,7,29, 8 ,5688,1018,905,7611
7/29/2013,2013,7,29, 9 ,6453,1193,1040,8686
7/29/2013,2013,7,29, 10 ,6907,1275,1081,9263
7/29/2013,2013,7,29, 11 ,7230,1305,1136,9671
7/29/2013,2013,7,29, 12 ,7114,1198,1126,9438
7/29/2013,2013,7,29, 13 ,7083,1257,1135,9475
7/29/2013,2013,7,29, 14 ,7310,1320,1154,9784
7/29/2013,2013,7,29, 15 ,7146,1303,1155,9604
7/29/2013,2013,7,29, 16 ,7041,1299,1150,9490
7/29/2013,2013,7,29, 17 ,6877,1245,1128,9250
7/29/2013,2013,7,29, 18 ,6696,1301,1166,9163
7/29/2013,2013,7,29, 19 ,7020,1420,1206,9646
7/29/2013,2013,7,29, 20 ,6947,1365,1185,9497
7/29/2013,2013,7,29, 21 ,6707,1300,1148,9155
7/29/2013,2013,7,29, 22 ,6266,1184,1072,8522
7/29/2013,2013,7,29, 23 ,5814,1052,968,7834
7/29/2013,2013,7,29, 24 ,5425,975,900,7300
7/30/2013,2013,7,30, 1 ,5162,933,864,6959
7/30/2013,2013,7,30, 2 ,5053,913,847,6813
7/30/2013,2013,7,30, 3 ,4918,891,826,6635
7/30/2013,2013,7,30, 4 ,4860,882,823,6565
7/30/2013,2013,7,30, 5 ,5049,923,861,6833
7/30/2013,2013,7,30, 6 ,5129,960,901,6990
7/30/2013,2013,7,30, 7 ,5238,923,834,6995
7/30/2013,2013,7,30, 8 ,5963,1025,949,7937
7/30/2013,2013,7,30, 9 ,6710,1206,1096,9012
7/30/2013,2013,7,30, 10 ,7147,1282,1178,9607
7/30/2013,2013,7,30, 11 ,7346,1328,1211,9885
7/30/2013,2013,7,30, 12 ,7152,1288,1184,9624
7/30/2013,2013,7,30, 13 ,7018,1293,1185,9496
7/30/2013,2013,7,30, 14 ,7240,1345,1221,9806
7/30/2013,2013,7,30, 15 ,7148,1334,1215,9697
7/30/2013,2013,7,30, 16 ,6996,1331,1200,9527
7/30/2013,2013,7,30, 17 ,6790,1268,1147,9205
7/30/2013,2013,7,30, 18 ,6581,1296,1180,9057
7/30/2013,2013,7,30, 19 ,6981,1417,1274,9672
7/30/2013,2013,7,30, 20 ,6884,1372,1238,9494
7/30/2013,2013,7,30, 21 ,6723,1275,1185,9183
7/30/2013,2013,7,30, 22 ,6339,1179,1119,8637
7/30/2013,2013,7,30, 23 ,5817,1044,997,7858
7/30/2013,2013,7,30, 24 ,5457,964,912,7333
7/31/2013,2013,7,31, 1 ,5256,936,878,7070
7/31/2013,2013,7,31, 2 ,5075,900,851,6826
7/31/2013,2013,7,31, 3 ,4950,881,837,6668
7/31/2013,2013,7,31, 4 ,4871,878,821,6570
7/31/2013,2013,7,31, 5 ,5020,915,861,6796
7/31/2013,2013,7,31, 6 ,5122,948,897,6967
7/31/2013,2013,7,31, 7 ,5210,905,843,6958
7/31/2013,2013,7,31, 8 ,5901,1039,946,7886
7/31/2013,2013,7,31, 9 ,6595,1208,1064,8867
7/31/2013,2013,7,31, 10 ,7070,1261,1181,9512
7/31/2013,2013,7,31, 11 ,7084,1322,1231,9637
7/31/2013,2013,7,31, 12 ,6832,1306,1235,9373
7/31/2013,2013,7,31, 13 ,6614,1315,1222,9151
7/31/2013,2013,7,31, 14 ,6806,1363,1268,9437
7/31/2013,2013,7,31, 15 ,6729,1348,1253,9330
7/31/2013,2013,7,31, 16 ,6701,1328,1236,9265
7/31/2013,2013,7,31, 17 ,6570,1281,1197,9048
7/31/2013,2013,7,31, 18 ,6503,1306,1235,9044
7/31/2013,2013,7,31, 19 ,6776,1430,1313,9519
7/31/2013,2013,7,31, 20 ,6619,1357,1257,9233
7/31/2013,2013,7,31, 21 ,6406,1278,1223,8907
7/31/2013,2013,7,31, 22 ,6132,1171,1129,8432
7/31/2013,2013,7,31, 23 ,5543,1035,991,7569
7/31/2013,2013,7,31, 24 ,5208,970,916,7094
8/1/2013,2013,8,1, 1 ,4992,926,885,6803
8/1/2013,2013,8,1, 2 ,4814,896,873,6583
8/1/2013,2013,8,1, 3 ,4679,879,848,6406
8/1/2013,2013,8,1, 4 ,4700,876,840,6416
8/1/2013,2013,8,1, 5 ,4890,915,873,6678
8/1/2013,2013,8,1, 6 ,4986,947,909,6842
8/1/2013,2013,8,1, 7 ,5050,913,843,6806
8/1/2013,2013,8,1, 8 ,5791,1053,955,7799
8/1/2013,2013,8,1, 9 ,6492,1267,1118,8877
8/1/2013,2013,8,1, 10 ,6993,1354,1180,9527
8/1/2013,2013,8,1, 11 ,7178,1416,1225,9819
8/1/2013,2013,8,1, 12 ,7015,1372,1214,9601
8/1/2013,2013,8,1, 13 ,7003,1367,1222,9592
8/1/2013,2013,8,1, 14 ,7282,1420,1274,9976
8/1/2013,2013,8,1, 15 ,7210,1393,1219,9822
8/1/2013,2013,8,1, 16 ,7079,1365,1248,9692
8/1/2013,2013,8,1, 17 ,6889,1311,1223,9423
8/1/2013,2013,8,1, 18 ,6623,1355,1266,9244
8/1/2013,2013,8,1, 19 ,6957,1464,1297,9718
8/1/2013,2013,8,1, 20 ,6755,1412,1198,9365
8/1/2013,2013,8,1, 21 ,6628,1356,1192,9176
8/1/2013,2013,8,1, 22 ,6221,1258,1116,8595
8/1/2013,2013,8,1, 23 ,5722,1120,988,7830
8/1/2013,2013,8,1, 24 ,5418,1037,926,7381
8/2/2013,2013,8,2, 1 ,5118,989,883,6990
8/2/2013,2013,8,2, 2 ,4948,960,863,6771
8/2/2013,2013,8,2, 3 ,4822,928,855,6605
8/2/2013,2013,8,2, 4 ,4754,928,839,6521
8/2/2013,2013,8,2, 5 ,4928,964,876,6768
8/2/2013,2013,8,2, 6 ,4985,989,913,6887
8/2/2013,2013,8,2, 7 ,5077,947,856,6880
8/2/2013,2013,8,2, 8 ,5849,1081,990,7920
8/2/2013,2013,8,2, 9 ,6623,1287,1155,9065
8/2/2013,2013,8,2, 10 ,7077,1400,1232,9709
8/2/2013,2013,8,2, 11 ,7359,1441,1281,10081
8/2/2013,2013,8,2, 12 ,7251,1403,1264,9918
8/2/2013,2013,8,2, 13 ,7266,1407,1280,9953
8/2/2013,2013,8,2, 14 ,7556,1495,1314,10365
8/2/2013,2013,8,2, 15 ,7389,1458,1277,10124
8/2/2013,2013,8,2, 16 ,7203,1410,1240,9853
8/2/2013,2013,8,2, 17 ,6889,1335,1197,9421
8/2/2013,2013,8,2, 18 ,6662,1357,1237,9256
8/2/2013,2013,8,2, 19 ,7049,1452,1286,9787
8/2/2013,2013,8,2, 20 ,7007,1411,1267,9685
8/2/2013,2013,8,2, 21 ,6863,1355,1223,9441
8/2/2013,2013,8,2, 22 ,6589,1197,1137,8923
8/2/2013,2013,8,2, 23 ,6136,1053,1058,8247
8/2/2013,2013,8,2, 24 ,5710,1031,941,7682
8/3/2013,2013,8,3, 1 ,5372,979,898,7249
8/3/2013,2013,8,3, 2 ,5244,948,872,7064
8/3/2013,2013,8,3, 3 ,5099,936,861,6896
8/3/2013,2013,8,3, 4 ,4923,927,830,6680
8/3/2013,2013,8,3, 5 ,4920,937,831,6688
8/3/2013,2013,8,3, 6 ,4841,952,844,6637
8/3/2013,2013,8,3, 7 ,5035,959,813,6807
8/3/2013,2013,8,3, 8 ,5521,988,879,7388
8/3/2013,2013,8,3, 9 ,6079,1101,972,8152
8/3/2013,2013,8,3, 10 ,6467,1174,1043,8684
8/3/2013,2013,8,3, 11 ,6782,1216,1100,9098
8/3/2013,2013,8,3, 12 ,6609,1197,1081,8887
8/3/2013,2013,8,3, 13 ,6666,1206,1093,8965
8/3/2013,2013,8,3, 14 ,6721,1261,1111,9093
8/3/2013,2013,8,3, 15 ,6456,1231,1077,8764
8/3/2013,2013,8,3, 16 ,6155,1210,1072,8437
8/3/2013,2013,8,3, 17 ,5977,1193,1091,8261
8/3/2013,2013,8,3, 18 ,5958,1280,1199,8437
8/3/2013,2013,8,3, 19 ,6495,1359,1219,9073
8/3/2013,2013,8,3, 20 ,6485,1312,1162,8959
8/3/2013,2013,8,3, 21 ,6408,1248,1110,8766
8/3/2013,2013,8,3, 22 ,6117,1158,1027,8302
8/3/2013,2013,8,3, 23 ,5794,1035,921,7750
8/3/2013,2013,8,3, 24 ,5444,952,846,7242
8/4/2013,2013,8,4, 1 ,5158,918,807,6883
8/4/2013,2013,8,4, 2 ,4947,884,791,6622
8/4/2013,2013,8,4, 3 ,4838,871,785,6494
8/4/2013,2013,8,4, 4 ,4703,851,766,6320
8/4/2013,2013,8,4, 5 ,4635,850,758,6243
8/4/2013,2013,8,4, 6 ,4450,857,766,6073
8/4/2013,2013,8,4, 7 ,4469,867,767,6103
8/4/2013,2013,8,4, 8 ,4730,906,797,6433
8/4/2013,2013,8,4, 9 ,5067,967,811,6845
8/4/2013,2013,8,4, 10 ,5469,1022,863,7354
8/4/2013,2013,8,4, 11 ,5771,1056,936,7763
8/4/2013,2013,8,4, 12 ,5743,1061,959,7763
8/4/2013,2013,8,4, 13 ,5740,1055,965,7760
8/4/2013,2013,8,4, 14 ,5749,1063,977,7789
8/4/2013,2013,8,4, 15 ,5602,1043,964,7609
8/4/2013,2013,8,4, 16 ,5521,1025,961,7507
8/4/2013,2013,8,4, 17 ,5455,1054,932,7441
8/4/2013,2013,8,4, 18 ,5588,1161,1022,7771
8/4/2013,2013,8,4, 19 ,6244,1319,1177,8740
8/4/2013,2013,8,4, 20 ,6338,1263,1132,8733
8/4/2013,2013,8,4, 21 ,6249,1217,1078,8544
8/4/2013,2013,8,4, 22 ,5917,1120,997,8034
8/4/2013,2013,8,4, 23 ,5539,1008,905,7452
8/4/2013,2013,8,4, 24 ,5195,935,837,6967
8/5/2013,2013,8,5, 1 ,4908,875,805,6588
8/5/2013,2013,8,5, 2 ,4706,859,786,6351
8/5/2013,2013,8,5, 3 ,4638,836,777,6251
8/5/2013,2013,8,5, 4 ,4581,832,756,6169
8/5/2013,2013,8,5, 5 ,4795,880,797,6472
8/5/2013,2013,8,5, 6 ,4894,950,843,6687
8/5/2013,2013,8,5, 7 ,5022,922,807,6751
8/5/2013,2013,8,5, 8 ,5728,1016,915,7659
8/5/2013,2013,8,5, 9 ,6579,1204,1050,8833
8/5/2013,2013,8,5, 10 ,7150,1305,1136,9591
8/5/2013,2013,8,5, 11 ,7314,1359,1231,9904
8/5/2013,2013,8,5, 12 ,7202,1314,1217,9733
8/5/2013,2013,8,5, 13 ,7155,1336,1187,9678
8/5/2013,2013,8,5, 14 ,7395,1399,1236,10030
8/5/2013,2013,8,5, 15 ,7362,1385,1217,9964
8/5/2013,2013,8,5, 16 ,7207,1362,1221,9790
8/5/2013,2013,8,5, 17 ,6870,1314,1209,9393
8/5/2013,2013,8,5, 18 ,6629,1350,1247,9226
8/5/2013,2013,8,5, 19 ,7151,1460,1248,9859
8/5/2013,2013,8,5, 20 ,7094,1401,1209,9704
8/5/2013,2013,8,5, 21 ,6968,1345,1171,9484
8/5/2013,2013,8,5, 22 ,6602,1227,1087,8916
8/5/2013,2013,8,5, 23 ,6090,1097,954,8141
8/5/2013,2013,8,5, 24 ,5697,1016,889,7602
8/6/2013,2013,8,6, 1 ,5357,968,854,7179
8/6/2013,2013,8,6, 2 ,5226,941,838,7005
8/6/2013,2013,8,6, 3 ,5020,920,828,6768
8/6/2013,2013,8,6, 4 ,5024,906,811,6741
8/6/2013,2013,8,6, 5 ,5113,924,857,6894
8/6/2013,2013,8,6, 6 ,5211,960,890,7061
8/6/2013,2013,8,6, 7 ,5298,936,826,7060
8/6/2013,2013,8,6, 8 ,5968,1035,938,7941
8/6/2013,2013,8,6, 9 ,6529,1191,1116,8836
8/6/2013,2013,8,6, 10 ,6903,1276,1216,9395
8/6/2013,2013,8,6, 11 ,7085,1319,1240,9644
8/6/2013,2013,8,6, 12 ,6935,1294,1228,9457
8/6/2013,2013,8,6, 13 ,6868,1293,1242,9403
8/6/2013,2013,8,6, 14 ,7039,1369,1261,9669
8/6/2013,2013,8,6, 15 ,6953,1284,1253,9490
8/6/2013,2013,8,6, 16 ,6861,1288,1192,9341
8/6/2013,2013,8,6, 17 ,6889,1260,1212,9361
8/6/2013,2013,8,6, 18 ,6536,1300,1245,9081
8/6/2013,2013,8,6, 19 ,6931,1407,1282,9620
8/6/2013,2013,8,6, 20 ,6862,1360,1252,9474
8/6/2013,2013,8,6, 21 ,6677,1311,1153,9141
8/6/2013,2013,8,6, 22 ,6318,1216,1058,8592
8/6/2013,2013,8,6, 23 ,5834,1070,947,7851
8/6/2013,2013,8,6, 24 ,5451,987,869,7307
8/7/2013,2013,8,7, 1 ,5148,951,843,6942
8/7/2013,2013,8,7, 2 ,5030,915,828,6773
8/7/2013,2013,8,7, 3 ,4847,898,817,6562
8/7/2013,2013,8,7, 4 ,4798,891,807,6496
8/7/2013,2013,8,7, 5 ,4940,925,849,6714
8/7/2013,2013,8,7, 6 ,5005,957,880,6842
8/7/2013,2013,8,7, 7 ,5177,920,828,6925
8/7/2013,2013,8,7, 8 ,6001,1083,963,8047
8/7/2013,2013,8,7, 9 ,6693,1288,1089,9070
8/7/2013,2013,8,7, 10 ,7137,1369,1164,9670
8/7/2013,2013,8,7, 11 ,7360,1431,1221,10012
8/7/2013,2013,8,7, 12 ,7242,1398,1170,9810
8/7/2013,2013,8,7, 13 ,7155,1390,1159,9704
8/7/2013,2013,8,7, 14 ,7408,1456,1191,10055
8/7/2013,2013,8,7, 15 ,7378,1419,1182,9979
8/7/2013,2013,8,7, 16 ,7225,1351,1177,9753
8/7/2013,2013,8,7, 17 ,6896,1290,1159,9345
8/7/2013,2013,8,7, 18 ,6731,1325,1226,9282
8/7/2013,2013,8,7, 19 ,7095,1444,1241,9780
8/7/2013,2013,8,7, 20 ,7110,1345,1191,9646
8/7/2013,2013,8,7, 21 ,6949,1287,1115,9351
8/7/2013,2013,8,7, 22 ,6584,1186,1011,8781
8/7/2013,2013,8,7, 23 ,6049,1068,923,8040
8/7/2013,2013,8,7, 24 ,5676,980,856,7512
8/8/2013,2013,8,8, 1 ,5455,987,822,7264
8/8/2013,2013,8,8, 2 ,5227,953,810,6990
8/8/2013,2013,8,8, 3 ,5055,932,799,6786
8/8/2013,2013,8,8, 4 ,4988,925,800,6713
8/8/2013,2013,8,8, 5 ,5165,964,848,6977
8/8/2013,2013,8,8, 6 ,5110,986,888,6984
8/8/2013,2013,8,8, 7 ,5224,953,828,7005
8/8/2013,2013,8,8, 8 ,5994,1067,950,8011
8/8/2013,2013,8,8, 9 ,6691,1237,1070,8998
8/8/2013,2013,8,8, 10 ,7198,1307,1133,9638
8/8/2013,2013,8,8, 11 ,7429,1342,1208,9979
8/8/2013,2013,8,8, 12 ,7351,1313,1196,9860
8/8/2013,2013,8,8, 13 ,7243,1317,1161,9721
8/8/2013,2013,8,8, 14 ,7515,1355,1227,10097
8/8/2013,2013,8,8, 15 ,7447,1338,1205,9990
8/8/2013,2013,8,8, 16 ,7278,1325,1193,9796
8/8/2013,2013,8,8, 17 ,6964,1287,1172,9423
8/8/2013,2013,8,8, 18 ,6847,1353,1247,9447
8/8/2013,2013,8,8, 19 ,7127,1338,1268,9733
8/8/2013,2013,8,8, 20 ,7036,1339,1219,9594
8/8/2013,2013,8,8, 21 ,6830,1269,1141,9240
8/8/2013,2013,8,8, 22 ,6456,1172,1033,8661
8/8/2013,2013,8,8, 23 ,6011,1053,930,7994
8/8/2013,2013,8,8, 24 ,5680,988,862,7530
8/9/2013,2013,8,9, 1 ,5340,950,826,7116
8/9/2013,2013,8,9, 2 ,5207,915,791,6913
8/9/2013,2013,8,9, 3 ,5007,898,777,6682
8/9/2013,2013,8,9, 4 ,4897,872,775,6544
8/9/2013,2013,8,9, 5 ,4882,890,803,6575
8/9/2013,2013,8,9, 6 ,4817,899,820,6536
8/9/2013,2013,8,9, 7 ,4839,909,815,6563
8/9/2013,2013,8,9, 8 ,5096,979,874,6949
8/9/2013,2013,8,9, 9 ,5594,1095,997,7686
8/9/2013,2013,8,9, 10 ,6030,1183,1076,8289
8/9/2013,2013,8,9, 11 ,6223,1228,1135,8586
8/9/2013,2013,8,9, 12 ,6117,1217,1124,8458
8/9/2013,2013,8,9, 13 ,6107,1240,1120,8467
8/9/2013,2013,8,9, 14 ,6190,1267,1156,8613
8/9/2013,2013,8,9, 15 ,6105,1239,1132,8476
8/9/2013,2013,8,9, 16 ,6040,1205,1109,8354
8/9/2013,2013,8,9, 17 ,5810,1200,1096,8106
8/9/2013,2013,8,9, 18 ,5906,1312,1200,8418
8/9/2013,2013,8,9, 19 ,6554,1394,1241,9189
8/9/2013,2013,8,9, 20 ,6563,1353,1216,9132
8/9/2013,2013,8,9, 21 ,6512,1297,1144,8953
8/9/2013,2013,8,9, 22 ,6232,1205,1069,8506
8/9/2013,2013,8,9, 23 ,5838,1078,989,7905
8/9/2013,2013,8,9, 24 ,5423,1000,906,7329
8/10/2013,2013,8,10, 1 ,5157,954,848,6959
8/10/2013,2013,8,10, 2 ,4932,925,820,6677
8/10/2013,2013,8,10, 3 ,4829,903,805,6537
8/10/2013,2013,8,10, 4 ,4692,886,799,6377
8/10/2013,2013,8,10, 5 ,4706,906,819,6431
8/10/2013,2013,8,10, 6 ,4592,900,817,6309
8/10/2013,2013,8,10, 7 ,4712,910,830,6452
8/10/2013,2013,8,10, 8 ,5134,1010,894,7038
8/10/2013,2013,8,10, 9 ,5652,1149,1011,7812
8/10/2013,2013,8,10, 10 ,6172,1225,1075,8472
8/10/2013,2013,8,10, 11 ,6511,1277,1143,8931
8/10/2013,2013,8,10, 12 ,6468,1257,1144,8869
8/10/2013,2013,8,10, 13 ,6514,1267,1153,8934
8/10/2013,2013,8,10, 14 ,6639,1289,1175,9103
8/10/2013,2013,8,10, 15 ,6488,1246,1141,8875
8/10/2013,2013,8,10, 16 ,6214,1219,1115,8548
8/10/2013,2013,8,10, 17 ,6036,1203,1100,8339
8/10/2013,2013,8,10, 18 ,6079,1277,1175,8531
8/10/2013,2013,8,10, 19 ,6505,1422,1250,9177
8/10/2013,2013,8,10, 20 ,6469,1371,1196,9036
8/10/2013,2013,8,10, 21 ,6408,1305,1147,8860
8/10/2013,2013,8,10, 22 ,6096,1232,1067,8395
8/10/2013,2013,8,10, 23 ,5688,1112,976,7776
8/10/2013,2013,8,10, 24 ,5358,1022,898,7278
8/11/2013,2013,8,11, 1 ,5078,977,862,6917
8/11/2013,2013,8,11, 2 ,4878,945,835,6658
8/11/2013,2013,8,11, 3 ,4725,927,811,6463
8/11/2013,2013,8,11, 4 ,4571,907,799,6277
8/11/2013,2013,8,11, 5 ,4569,906,809,6284
8/11/2013,2013,8,11, 6 ,4381,894,808,6083
8/11/2013,2013,8,11, 7 ,4421,891,805,6117
8/11/2013,2013,8,11, 8 ,4739,927,818,6484
8/11/2013,2013,8,11, 9 ,5128,1008,886,7022
8/11/2013,2013,8,11, 10 ,5487,1077,957,7521
8/11/2013,2013,8,11, 11 ,5765,1126,1013,7904
8/11/2013,2013,8,11, 12 ,5732,1122,1027,7881
8/11/2013,2013,8,11, 13 ,5651,1119,1028,7798
8/11/2013,2013,8,11, 14 ,5642,1100,1028,7770
8/11/2013,2013,8,11, 15 ,5578,1092,1012,7682
8/11/2013,2013,8,11, 16 ,5472,1083,990,7545
8/11/2013,2013,8,11, 17 ,5479,1112,1000,7591
8/11/2013,2013,8,11, 18 ,5772,1216,1112,8100
8/11/2013,2013,8,11, 19 ,6145,1334,1194,8673
8/11/2013,2013,8,11, 20 ,6175,1304,1151,8630
8/11/2013,2013,8,11, 21 ,5984,1236,1103,8323
8/11/2013,2013,8,11, 22 ,5504,1137,983,7624
8/11/2013,2013,8,11, 23 ,5190,1035,908,7133
8/11/2013,2013,8,11, 24 ,4950,966,834,6750
8/12/2013,2013,8,12, 1 ,4647,925,811,6383
8/12/2013,2013,8,12, 2 ,4466,898,792,6156
8/12/2013,2013,8,12, 3 ,4401,874,766,6041
8/12/2013,2013,8,12, 4 ,4344,862,778,5984
8/12/2013,2013,8,12, 5 ,4438,904,825,6167
8/12/2013,2013,8,12, 6 ,4548,966,885,6399
8/12/2013,2013,8,12, 7 ,4879,933,823,6635
8/12/2013,2013,8,12, 8 ,5568,1046,949,7563
8/12/2013,2013,8,12, 9 ,6301,1210,1100,8611
8/12/2013,2013,8,12, 10 ,6642,1315,1169,9126
8/12/2013,2013,8,12, 11 ,6796,1351,1238,9385
8/12/2013,2013,8,12, 12 ,6701,1305,1226,9232
8/12/2013,2013,8,12, 13 ,6499,1312,1209,9020
8/12/2013,2013,8,12, 14 ,6633,1359,1255,9247
8/12/2013,2013,8,12, 15 ,6519,1347,1232,9098
8/12/2013,2013,8,12, 16 ,6433,1338,1215,8986
8/12/2013,2013,8,12, 17 ,6352,1304,1206,8862
8/12/2013,2013,8,12, 18 ,6244,1367,1263,8874
8/12/2013,2013,8,12, 19 ,6490,1449,1234,9173
8/12/2013,2013,8,12, 20 ,6279,1395,1214,8888
8/12/2013,2013,8,12, 21 ,6008,1305,1104,8417
8/12/2013,2013,8,12, 22 ,5607,1188,1017,7812
8/12/2013,2013,8,12, 23 ,5148,1060,923,7131
8/12/2013,2013,8,12, 24 ,4861,982,857,6700
8/13/2013,2013,8,13, 1 ,4664,933,829,6426
8/13/2013,2013,8,13, 2 ,4611,910,812,6333
8/13/2013,2013,8,13, 3 ,4490,890,803,6183
8/13/2013,2013,8,13, 4 ,4434,889,800,6123
8/13/2013,2013,8,13, 5 ,4653,922,859,6434
8/13/2013,2013,8,13, 6 ,4843,981,921,6745
8/13/2013,2013,8,13, 7 ,4955,941,865,6761
8/13/2013,2013,8,13, 8 ,5670,1065,941,7676
8/13/2013,2013,8,13, 9 ,6411,1248,1079,8738
8/13/2013,2013,8,13, 10 ,6817,1338,1169,9324
8/13/2013,2013,8,13, 11 ,7104,1397,1231,9732
8/13/2013,2013,8,13, 12 ,6918,1349,1207,9474
8/13/2013,2013,8,13, 13 ,6844,1365,1192,9401
8/13/2013,2013,8,13, 14 ,7152,1427,1228,9807
8/13/2013,2013,8,13, 15 ,7067,1387,1225,9679
8/13/2013,2013,8,13, 16 ,6934,1328,1211,9473
8/13/2013,2013,8,13, 17 ,6685,1275,1204,9164
8/13/2013,2013,8,13, 18 ,6587,1325,1270,9182
8/13/2013,2013,8,13, 19 ,6982,1439,1312,9733
8/13/2013,2013,8,13, 20 ,6822,1379,1262,9463
8/13/2013,2013,8,13, 21 ,6532,1318,1147,8997
8/13/2013,2013,8,13, 22 ,6211,1219,1058,8488
8/13/2013,2013,8,13, 23 ,5707,1083,956,7746
8/13/2013,2013,8,13, 24 ,5370,1005,896,7271
8/14/2013,2013,8,14, 1 ,5119,924,841,6884
8/14/2013,2013,8,14, 2 ,4942,894,822,6658
8/14/2013,2013,8,14, 3 ,4806,881,805,6492
8/14/2013,2013,8,14, 4 ,4792,885,808,6485
8/14/2013,2013,8,14, 5 ,4892,923,849,6664
8/14/2013,2013,8,14, 6 ,5040,973,910,6923
8/14/2013,2013,8,14, 7 ,5134,935,833,6902
8/14/2013,2013,8,14, 8 ,5293,1078,957,7328
8/14/2013,2013,8,14, 9 ,6593,1279,1104,8976
8/14/2013,2013,8,14, 10 ,7093,1370,1213,9676
8/14/2013,2013,8,14, 11 ,7353,1406,1270,10029
8/14/2013,2013,8,14, 12 ,7220,1390,1239,9849
8/14/2013,2013,8,14, 13 ,7161,1400,1257,9818
8/14/2013,2013,8,14, 14 ,7484,1451,1311,10246
8/14/2013,2013,8,14, 15 ,7360,1417,1304,10081
8/14/2013,2013,8,14, 16 ,7218,1389,1259,9866
8/14/2013,2013,8,14, 17 ,6912,1345,1241,9498
8/14/2013,2013,8,14, 18 ,6760,1394,1274,9428
8/14/2013,2013,8,14, 19 ,7117,1485,1316,9918
8/14/2013,2013,8,14, 20 ,7051,1424,1271,9746
8/14/2013,2013,8,14, 21 ,6862,1362,1203,9427
8/14/2013,2013,8,14, 22 ,6552,1269,1125,8946
8/14/2013,2013,8,14, 23 ,6054,1128,982,8164
8/14/2013,2013,8,14, 24 ,5664,1063,925,7652
8/15/2013,2013,8,15, 1 ,5368,1007,879,7254
8/15/2013,2013,8,15, 2 ,5255,973,851,7079
8/15/2013,2013,8,15, 3 ,5061,954,835,6850
8/15/2013,2013,8,15, 4 ,4998,943,826,6767
8/15/2013,2013,8,15, 5 ,5116,979,876,6971
8/15/2013,2013,8,15, 6 ,5132,997,917,7046
8/15/2013,2013,8,15, 7 ,5260,963,860,7083
8/15/2013,2013,8,15, 8 ,6082,1110,982,8174
8/15/2013,2013,8,15, 9 ,6795,1286,1121,9202
8/15/2013,2013,8,15, 10 ,7264,1366,1216,9846
8/15/2013,2013,8,15, 11 ,7485,1430,1265,10180
8/15/2013,2013,8,15, 12 ,7385,1396,1251,10032
8/15/2013,2013,8,15, 13 ,7391,1414,1258,10063
8/15/2013,2013,8,15, 14 ,7642,1475,1314,10431
8/15/2013,2013,8,15, 15 ,7513,1438,1267,10218
8/15/2013,2013,8,15, 16 ,7348,1407,1254,10009
8/15/2013,2013,8,15, 17 ,7036,1327,1191,9554
8/15/2013,2013,8,15, 18 ,6827,1391,1243,9461
8/15/2013,2013,8,15, 19 ,7248,1499,1279,10026
8/15/2013,2013,8,15, 20 ,7190,1454,1268,9912
8/15/2013,2013,8,15, 21 ,7010,1396,1223,9629
8/15/2013,2013,8,15, 22 ,6684,1307,1143,9134
8/15/2013,2013,8,15, 23 ,6270,1187,1006,8463
8/15/2013,2013,8,15, 24 ,5856,1083,948,7887
8/16/2013,2013,8,16, 1 ,5578,1046,875,7499
8/16/2013,2013,8,16, 2 ,5394,1014,843,7251
8/16/2013,2013,8,16, 3 ,5247,979,826,7052
8/16/2013,2013,8,16, 4 ,5207,974,826,7007
8/16/2013,2013,8,16, 5 ,5285,999,865,7149
8/16/2013,2013,8,16, 6 ,5294,1023,870,7187
8/16/2013,2013,8,16, 7 ,5339,985,849,7173
8/16/2013,2013,8,16, 8 ,6184,1131,963,8278
8/16/2013,2013,8,16, 9 ,6934,1332,1115,9381
8/16/2013,2013,8,16, 10 ,7350,1410,1188,9948
8/16/2013,2013,8,16, 11 ,7603,1457,1246,10306
8/16/2013,2013,8,16, 12 ,7467,1419,1215,10101
8/16/2013,2013,8,16, 13 ,7439,1426,1221,10086
8/16/2013,2013,8,16, 14 ,7617,1482,1251,10350
8/16/2013,2013,8,16, 15 ,7446,1441,1230,10117
8/16/2013,2013,8,16, 16 ,7353,1398,1188,9939
8/16/2013,2013,8,16, 17 ,6999,1334,1168,9501
8/16/2013,2013,8,16, 18 ,6820,1367,1228,9415
8/16/2013,2013,8,16, 19 ,7156,1494,1241,9891
8/16/2013,2013,8,16, 20 ,7101,1450,1230,9781
8/16/2013,2013,8,16, 21 ,6927,1386,1183,9496
8/16/2013,2013,8,16, 22 ,6748,1301,1098,9147
8/16/2013,2013,8,16, 23 ,6240,1173,984,8397
8/16/2013,2013,8,16, 24 ,5919,1069,914,7902
8/17/2013,2013,8,17, 1 ,5625,1029,860,7514
8/17/2013,2013,8,17, 2 ,5441,1003,836,7280
8/17/2013,2013,8,17, 3 ,5314,974,822,7110
8/17/2013,2013,8,17, 4 ,5134,962,802,6898
8/17/2013,2013,8,17, 5 ,5176,978,829,6983
8/17/2013,2013,8,17, 6 ,5030,967,842,6839
8/17/2013,2013,8,17, 7 ,5189,974,822,6985
8/17/2013,2013,8,17, 8 ,5562,1071,888,7521
8/17/2013,2013,8,17, 9 ,6127,1204,988,8319
8/17/2013,2013,8,17, 10 ,6606,1264,1064,8934
8/17/2013,2013,8,17, 11 ,6710,1324,1124,9158
8/17/2013,2013,8,17, 12 ,6508,1293,1108,8909
8/17/2013,2013,8,17, 13 ,6368,1301,1119,8788
8/17/2013,2013,8,17, 14 ,6441,1306,1147,8894
8/17/2013,2013,8,17, 15 ,6025,1236,1124,8385
8/17/2013,2013,8,17, 16 ,6044,1236,1096,8376
8/17/2013,2013,8,17, 17 ,5972,1195,1085,8252
8/17/2013,2013,8,17, 18 ,6131,1269,1192,8592
8/17/2013,2013,8,17, 19 ,6478,1434,1202,9114
8/17/2013,2013,8,17, 20 ,6361,1399,1191,8951
8/17/2013,2013,8,17, 21 ,6227,1342,1183,8752
8/17/2013,2013,8,17, 22 ,5928,1240,1094,8262
8/17/2013,2013,8,17, 23 ,5555,1136,998,7689
8/17/2013,2013,8,17, 24 ,5254,1064,917,7235
8/18/2013,2013,8,18, 1 ,5041,1006,860,6907
8/18/2013,2013,8,18, 2 ,4930,975,820,6725
8/18/2013,2013,8,18, 3 ,4808,949,816,6573
8/18/2013,2013,8,18, 4 ,4701,942,798,6441
8/18/2013,2013,8,18, 5 ,4631,943,807,6381
8/18/2013,2013,8,18, 6 ,4584,915,820,6319
8/18/2013,2013,8,18, 7 ,4569,914,799,6282
8/18/2013,2013,8,18, 8 ,4793,960,830,6583
8/18/2013,2013,8,18, 9 ,5039,1018,884,6941
8/18/2013,2013,8,18, 10 ,5429,1080,961,7470
8/18/2013,2013,8,18, 11 ,5665,1127,1021,7813
8/18/2013,2013,8,18, 12 ,5470,1141,1017,7628
8/18/2013,2013,8,18, 13 ,5353,1134,1016,7503
8/18/2013,2013,8,18, 14 ,5328,1131,1025,7484
8/18/2013,2013,8,18, 15 ,5274,1115,1016,7405
8/18/2013,2013,8,18, 16 ,5259,1110,999,7368
8/18/2013,2013,8,18, 17 ,5329,1035,1001,7365
8/18/2013,2013,8,18, 18 ,5640,1146,1126,7912
8/18/2013,2013,8,18, 19 ,5831,1339,1187,8357
8/18/2013,2013,8,18, 20 ,5794,1342,1170,8306
8/18/2013,2013,8,18, 21 ,5533,1258,1126,7917
8/18/2013,2013,8,18, 22 ,5113,1187,1036,7336
8/18/2013,2013,8,18, 23 ,4827,1080,945,6852
8/18/2013,2013,8,18, 24 ,4514,1007,879,6400
8/19/2013,2013,8,19, 1 ,4308,958,829,6095
8/19/2013,2013,8,19, 2 ,4148,920,801,5869
8/19/2013,2013,8,19, 3 ,4052,902,785,5739
8/19/2013,2013,8,19, 4 ,3967,897,772,5636
8/19/2013,2013,8,19, 5 ,4094,945,827,5866
8/19/2013,2013,8,19, 6 ,4315,974,861,6150
8/19/2013,2013,8,19, 7 ,4470,922,810,6202
8/19/2013,2013,8,19, 8 ,4858,1063,941,6862
8/19/2013,2013,8,19, 9 ,5337,1270,1103,7710
8/19/2013,2013,8,19, 10 ,5614,1362,1184,8160
8/19/2013,2013,8,19, 11 ,5800,1396,1221,8417
8/19/2013,2013,8,19, 12 ,5670,1397,1202,8269
8/19/2013,2013,8,19, 13 ,5568,1393,1197,8158
8/19/2013,2013,8,19, 14 ,5666,1457,1236,8359
8/19/2013,2013,8,19, 15 ,5523,1415,1215,8153
8/19/2013,2013,8,19, 16 ,5428,1388,1221,8037
8/19/2013,2013,8,19, 17 ,5489,1340,1189,8018
8/19/2013,2013,8,19, 18 ,5613,1430,1245,8288
8/19/2013,2013,8,19, 19 ,5845,1506,1204,8555
8/19/2013,2013,8,19, 20 ,5670,1446,1182,8298
8/19/2013,2013,8,19, 21 ,5424,1379,1205,8008
8/19/2013,2013,8,19, 22 ,5147,1268,1124,7539
8/19/2013,2013,8,19, 23 ,4751,1129,1020,6900
8/19/2013,2013,8,19, 24 ,4398,1052,914,6364
8/20/2013,2013,8,20, 1 ,4223,998,884,6105
8/20/2013,2013,8,20, 2 ,4123,971,866,5960
8/20/2013,2013,8,20, 3 ,4027,951,834,5812
8/20/2013,2013,8,20, 4 ,3982,940,837,5759
8/20/2013,2013,8,20, 5 ,4119,970,880,5969
8/20/2013,2013,8,20, 6 ,4287,1000,895,6182
8/20/2013,2013,8,20, 7 ,4515,953,846,6314
8/20/2013,2013,8,20, 8 ,4846,1108,994,6948
8/20/2013,2013,8,20, 9 ,5179,1310,1101,7590
8/20/2013,2013,8,20, 10 ,5499,1400,1184,8083
8/20/2013,2013,8,20, 11 ,5602,1432,1206,8240
8/20/2013,2013,8,20, 12 ,5437,1392,1183,8012
8/20/2013,2013,8,20, 13 ,5323,1396,1194,7913
8/20/2013,2013,8,20, 14 ,5355,1449,1205,8009
8/20/2013,2013,8,20, 15 ,5228,1435,1200,7863
8/20/2013,2013,8,20, 16 ,5168,1401,1188,7757
8/20/2013,2013,8,20, 17 ,5103,1333,1185,7621
8/20/2013,2013,8,20, 18 ,5221,1383,1221,7825
8/20/2013,2013,8,20, 19 ,5475,1470,1186,8131
8/20/2013,2013,8,20, 20 ,5318,1407,1180,7905
8/20/2013,2013,8,20, 21 ,5089,1335,1157,7581
8/20/2013,2013,8,20, 22 ,4836,1221,1115,7172
8/20/2013,2013,8,20, 23 ,4497,1133,1005,6635
8/20/2013,2013,8,20, 24 ,4253,1064,929,6246
8/21/2013,2013,8,21, 1 ,4079,1015,875,5969
8/21/2013,2013,8,21, 2 ,3995,982,852,5829
8/21/2013,2013,8,21, 3 ,3886,957,834,5677
8/21/2013,2013,8,21, 4 ,3860,947,836,5643
8/21/2013,2013,8,21, 5 ,3891,956,845,5692
8/21/2013,2013,8,21, 6 ,3949,951,857,5757
8/21/2013,2013,8,21, 7 ,4152,947,847,5946
8/21/2013,2013,8,21, 8 ,4442,1026,921,6389
8/21/2013,2013,8,21, 9 ,4800,1179,1033,7012
8/21/2013,2013,8,21, 10 ,5242,1246,1077,7565
8/21/2013,2013,8,21, 11 ,5504,1309,1130,7943
8/21/2013,2013,8,21, 12 ,5417,1286,1120,7823
8/21/2013,2013,8,21, 13 ,5280,1295,1107,7682
8/21/2013,2013,8,21, 14 ,5326,1316,1149,7791
8/21/2013,2013,8,21, 15 ,5251,1312,1118,7681
8/21/2013,2013,8,21, 16 ,5191,1261,1074,7526
8/21/2013,2013,8,21, 17 ,5232,1297,1094,7623
8/21/2013,2013,8,21, 18 ,5530,1347,1147,8024
8/21/2013,2013,8,21, 19 ,5899,1457,1134,8490
8/21/2013,2013,8,21, 20 ,5769,1411,1125,8305
8/21/2013,2013,8,21, 21 ,5531,1344,1127,8002
8/21/2013,2013,8,21, 22 ,5197,1244,1000,7441
8/21/2013,2013,8,21, 23 ,4806,1108,921,6835
8/21/2013,2013,8,21, 24 ,4524,1038,906,6468
8/22/2013,2013,8,22, 1 ,4370,990,856,6216
8/22/2013,2013,8,22, 2 ,4240,963,810,6013
8/22/2013,2013,8,22, 3 ,4174,934,802,5910
8/22/2013,2013,8,22, 4 ,4157,929,796,5882
8/22/2013,2013,8,22, 5 ,4290,968,844,6102
8/22/2013,2013,8,22, 6 ,4466,984,899,6349
8/22/2013,2013,8,22, 7 ,4730,941,842,6513
8/22/2013,2013,8,22, 8 ,5320,1091,948,7359
8/22/2013,2013,8,22, 9 ,5971,1294,1056,8321
8/22/2013,2013,8,22, 10 ,6382,1389,1112,8883
8/22/2013,2013,8,22, 11 ,6675,1445,1158,9278
8/22/2013,2013,8,22, 12 ,6531,1413,1132,9076
8/22/2013,2013,8,22, 13 ,6469,1418,1122,9009
8/22/2013,2013,8,22, 14 ,6686,1463,1166,9315
8/22/2013,2013,8,22, 15 ,6561,1429,1146,9136
8/22/2013,2013,8,22, 16 ,6470,1403,1132,9005
8/22/2013,2013,8,22, 17 ,6236,1352,1150,8738
8/22/2013,2013,8,22, 18 ,6229,1416,1192,8837
8/22/2013,2013,8,22, 19 ,6503,1450,1170,9123
8/22/2013,2013,8,22, 20 ,6302,1420,1179,8901
8/22/2013,2013,8,22, 21 ,6077,1353,1161,8591
8/22/2013,2013,8,22, 22 ,5711,1243,1064,8018
8/22/2013,2013,8,22, 23 ,5242,1123,936,7301
8/22/2013,2013,8,22, 24 ,4939,1034,847,6820
8/23/2013,2013,8,23, 1 ,4688,988,848,6524
8/23/2013,2013,8,23, 2 ,4558,957,824,6339
8/23/2013,2013,8,23, 3 ,4418,933,802,6153
8/23/2013,2013,8,23, 4 ,4374,932,806,6112
8/23/2013,2013,8,23, 5 ,4555,966,854,6375
8/23/2013,2013,8,23, 6 ,4691,988,912,6591
8/23/2013,2013,8,23, 7 ,4871,954,834,6659
8/23/2013,2013,8,23, 8 ,5525,1073,966,7564
8/23/2013,2013,8,23, 9 ,6209,1280,1087,8576
8/23/2013,2013,8,23, 10 ,6682,1377,1140,9199
8/23/2013,2013,8,23, 11 ,6942,1441,1154,9537
8/23/2013,2013,8,23, 12 ,6791,1403,1120,9314
8/23/2013,2013,8,23, 13 ,6792,1398,1119,9309
8/23/2013,2013,8,23, 14 ,7019,1448,1180,9647
8/23/2013,2013,8,23, 15 ,6877,1424,1177,9478
8/23/2013,2013,8,23, 16 ,6746,1388,1161,9295
8/23/2013,2013,8,23, 17 ,6461,1345,1137,8943
8/23/2013,2013,8,23, 18 ,6444,1410,1205,9059
8/23/2013,2013,8,23, 19 ,6714,1473,1161,9348
8/23/2013,2013,8,23, 20 ,6548,1372,1136,9056
8/23/2013,2013,8,23, 21 ,6283,1329,1132,8744
8/23/2013,2013,8,23, 22 ,5964,1237,1068,8269
8/23/2013,2013,8,23, 23 ,5469,1090,914,7473
8/23/2013,2013,8,23, 24 ,5129,1021,877,7027
8/24/2013,2013,8,24, 1 ,4850,972,853,6675
8/24/2013,2013,8,24, 2 ,4695,939,819,6453
8/24/2013,2013,8,24, 3 ,4557,912,793,6262
8/24/2013,2013,8,24, 4 ,4528,899,775,6202
8/24/2013,2013,8,24, 5 ,4468,917,798,6183
8/24/2013,2013,8,24, 6 ,4501,920,800,6221
8/24/2013,2013,8,24, 7 ,4641,926,812,6379
8/24/2013,2013,8,24, 8 ,5078,1001,883,6962
8/24/2013,2013,8,24, 9 ,5750,1137,959,7846
8/24/2013,2013,8,24, 10 ,6188,1202,1023,8413
8/24/2013,2013,8,24, 11 ,6450,1249,1039,8738
8/24/2013,2013,8,24, 12 ,6332,1237,1017,8586
8/24/2013,2013,8,24, 13 ,6307,1206,1020,8533
8/24/2013,2013,8,24, 14 ,6390,1235,1039,8664
8/24/2013,2013,8,24, 15 ,6225,1209,1023,8457
8/24/2013,2013,8,24, 16 ,6091,1173,998,8262
8/24/2013,2013,8,24, 17 ,5959,1161,1019,8139
8/24/2013,2013,8,24, 18 ,6128,1281,1137,8546
8/24/2013,2013,8,24, 19 ,6399,1352,1168,8919
8/24/2013,2013,8,24, 20 ,6200,1293,1118,8611
8/24/2013,2013,8,24, 21 ,6023,1213,1059,8295
8/24/2013,2013,8,24, 22 ,5434,1125,934,7493
8/24/2013,2013,8,24, 23 ,4887,1020,854,6761
8/24/2013,2013,8,24, 24 ,5012,951,806,6769
8/25/2013,2013,8,25, 1 ,4775,912,763,6450
8/25/2013,2013,8,25, 2 ,4618,882,740,6240
8/25/2013,2013,8,25, 3 ,4453,864,715,6032
8/25/2013,2013,8,25, 4 ,4380,862,708,5950
8/25/2013,2013,8,25, 5 ,4343,866,726,5935
8/25/2013,2013,8,25, 6 ,4207,852,752,5811
8/25/2013,2013,8,25, 7 ,4248,860,751,5859
8/25/2013,2013,8,25, 8 ,4489,903,777,6169
8/25/2013,2013,8,25, 9 ,4775,981,841,6597
8/25/2013,2013,8,25, 10 ,5182,1033,909,7124
8/25/2013,2013,8,25, 11 ,5491,1072,931,7494
8/25/2013,2013,8,25, 12 ,5460,1061,922,7443
8/25/2013,2013,8,25, 13 ,5390,1039,909,7338
8/25/2013,2013,8,25, 14 ,5443,1047,918,7408
8/25/2013,2013,8,25, 15 ,5362,1031,889,7282
8/25/2013,2013,8,25, 16 ,5252,1023,899,7174
8/25/2013,2013,8,25, 17 ,5191,1063,915,7169
8/25/2013,2013,8,25, 18 ,5349,1189,1045,7583
8/25/2013,2013,8,25, 19 ,5985,1264,1135,8384
8/25/2013,2013,8,25, 20 ,5897,1212,1083,8192
8/25/2013,2013,8,25, 21 ,5712,1131,1027,7870
8/25/2013,2013,8,25, 22 ,5383,1029,935,7347
8/25/2013,2013,8,25, 23 ,5058,957,854,6869
8/25/2013,2013,8,25, 24 ,4807,893,781,6481
8/26/2013,2013,8,26, 1 ,4575,849,743,6167
8/26/2013,2013,8,26, 2 ,4376,823,719,5918
8/26/2013,2013,8,26, 3 ,4230,807,707,5744
8/26/2013,2013,8,26, 4 ,4215,803,703,5721
8/26/2013,2013,8,26, 5 ,4153,813,725,5691
8/26/2013,2013,8,26, 6 ,4125,822,729,5676
8/26/2013,2013,8,26, 7 ,4153,845,736,5734
8/26/2013,2013,8,26, 8 ,4475,908,807,6190
8/26/2013,2013,8,26, 9 ,4943,1014,925,6882
8/26/2013,2013,8,26, 10 ,5399,1095,980,7474
8/26/2013,2013,8,26, 11 ,5646,1140,1053,7839
8/26/2013,2013,8,26, 12 ,5569,1138,1041,7748
8/26/2013,2013,8,26, 13 ,5527,1130,1022,7679
8/26/2013,2013,8,26, 14 ,5562,1146,1072,7780
8/26/2013,2013,8,26, 15 ,5458,1136,1060,7654
8/26/2013,2013,8,26, 16 ,5336,1112,1050,7498
8/26/2013,2013,8,26, 17 ,5353,1108,1034,7495
8/26/2013,2013,8,26, 18 ,5612,1261,1156,8029
8/26/2013,2013,8,26, 19 ,6042,1352,1223,8617
8/26/2013,2013,8,26, 20 ,6050,1310,1194,8554
8/26/2013,2013,8,26, 21 ,5793,1230,1136,8159
8/26/2013,2013,8,26, 22 ,5469,1110,994,7573
8/26/2013,2013,8,26, 23 ,5093,1007,921,7021
8/26/2013,2013,8,26, 24 ,4679,937,848,6464
8/27/2013,2013,8,27, 1 ,4509,894,805,6208
8/27/2013,2013,8,27, 2 ,4388,867,783,6038
8/27/2013,2013,8,27, 3 ,4273,841,758,5872
8/27/2013,2013,8,27, 4 ,4249,834,758,5841
8/27/2013,2013,8,27, 5 ,4526,879,802,6207
8/27/2013,2013,8,27, 6 ,4705,920,834,6459
8/27/2013,2013,8,27, 7 ,4888,888,803,6579
8/27/2013,2013,8,27, 8 ,5596,1037,950,7583
8/27/2013,2013,8,27, 9 ,6369,1240,1074,8683
8/27/2013,2013,8,27, 10 ,6784,1342,1156,9282
8/27/2013,2013,8,27, 11 ,7004,1402,1202,9608
8/27/2013,2013,8,27, 12 ,6855,1380,1189,9424
8/27/2013,2013,8,27, 13 ,6740,1376,1188,9304
8/27/2013,2013,8,27, 14 ,6852,1443,1203,9498
8/27/2013,2013,8,27, 15 ,6666,1417,1171,9254
8/27/2013,2013,8,27, 16 ,6580,1385,1165,9130
8/27/2013,2013,8,27, 17 ,6476,1319,1157,8952
8/27/2013,2013,8,27, 18 ,6540,1379,1211,9130
8/27/2013,2013,8,27, 19 ,6721,1474,1199,9394
8/27/2013,2013,8,27, 20 ,6543,1413,1189,9145
8/27/2013,2013,8,27, 21 ,6289,1342,1158,8789
8/27/2013,2013,8,27, 22 ,5871,1219,1028,8118
8/27/2013,2013,8,27, 23 ,5423,1094,943,7460
8/27/2013,2013,8,27, 24 ,5130,1017,909,7056
8/28/2013,2013,8,28, 1 ,4813,975,878,6666
8/28/2013,2013,8,28, 2 ,4745,940,853,6538
8/28/2013,2013,8,28, 3 ,4635,917,834,6386
8/28/2013,2013,8,28, 4 ,4592,908,825,6325
8/28/2013,2013,8,28, 5 ,4737,944,851,6532
8/28/2013,2013,8,28, 6 ,4930,967,888,6785
8/28/2013,2013,8,28, 7 ,5037,941,846,6824
8/28/2013,2013,8,28, 8 ,5693,1094,963,7750
8/28/2013,2013,8,28, 9 ,6403,1300,1084,8787
8/28/2013,2013,8,28, 10 ,6880,1402,1153,9435
8/28/2013,2013,8,28, 11 ,7076,1457,1191,9724
8/28/2013,2013,8,28, 12 ,6945,1425,1170,9540
8/28/2013,2013,8,28, 13 ,6904,1424,1175,9503
8/28/2013,2013,8,28, 14 ,7126,1462,1160,9748
8/28/2013,2013,8,28, 15 ,7005,1432,1147,9584
8/28/2013,2013,8,28, 16 ,6930,1407,1146,9483
8/28/2013,2013,8,28, 17 ,6677,1334,1119,9130
8/28/2013,2013,8,28, 18 ,6660,1406,1183,9249
8/28/2013,2013,8,28, 19 ,6961,1495,1173,9629
8/28/2013,2013,8,28, 20 ,6739,1445,1163,9347
8/28/2013,2013,8,28, 21 ,6536,1361,1120,9017
8/28/2013,2013,8,28, 22 ,6188,1249,1025,8462
8/28/2013,2013,8,28, 23 ,5782,1123,928,7833
8/28/2013,2013,8,28, 24 ,5298,1047,884,7229
8/29/2013,2013,8,29, 1 ,5044,1012,853,6909
8/29/2013,2013,8,29, 2 ,4913,975,835,6723
8/29/2013,2013,8,29, 3 ,4821,943,815,6579
8/29/2013,2013,8,29, 4 ,4745,941,810,6496
8/29/2013,2013,8,29, 5 ,4894,972,856,6722
8/29/2013,2013,8,29, 6 ,5009,991,857,6857
8/29/2013,2013,8,29, 7 ,5078,961,853,6892
8/29/2013,2013,8,29, 8 ,5901,1125,946,7972
8/29/2013,2013,8,29, 9 ,6623,1318,1090,9031
8/29/2013,2013,8,29, 10 ,7160,1425,1154,9739
8/29/2013,2013,8,29, 11 ,7387,1467,1170,10024
8/29/2013,2013,8,29, 12 ,7261,1439,1134,9834
8/29/2013,2013,8,29, 13 ,7240,1434,1137,9811
8/29/2013,2013,8,29, 14 ,7530,1486,1168,10184
8/29/2013,2013,8,29, 15 ,7432,1459,1157,10048
8/29/2013,2013,8,29, 16 ,7329,1416,1159,9904
8/29/2013,2013,8,29, 17 ,6935,1353,1131,9419
8/29/2013,2013,8,29, 18 ,6768,1439,1172,9379
8/29/2013,2013,8,29, 19 ,7232,1520,1150,9902
8/29/2013,2013,8,29, 20 ,7081,1471,1126,9678
8/29/2013,2013,8,29, 21 ,6856,1387,1090,9333
8/29/2013,2013,8,29, 22 ,6550,1289,1029,8868
8/29/2013,2013,8,29, 23 ,6054,1161,947,8162
8/29/2013,2013,8,29, 24 ,5663,1075,887,7625
8/30/2013,2013,8,30, 1 ,5376,1032,850,7258
8/30/2013,2013,8,30, 2 ,5152,980,825,6957
8/30/2013,2013,8,30, 3 ,4960,950,811,6721
8/30/2013,2013,8,30, 4 ,4916,943,810,6669
8/30/2013,2013,8,30, 5 ,5015,983,857,6855
8/30/2013,2013,8,30, 6 ,5086,992,882,6960
8/30/2013,2013,8,30, 7 ,5219,965,852,7036
8/30/2013,2013,8,30, 8 ,5955,1108,957,8020
8/30/2013,2013,8,30, 9 ,6748,1304,1088,9140
8/30/2013,2013,8,30, 10 ,7190,1405,1112,9707
8/30/2013,2013,8,30, 11 ,7504,1452,1151,10107
8/30/2013,2013,8,30, 12 ,7377,1415,1131,9923
8/30/2013,2013,8,30, 13 ,7358,1420,1123,9901
8/30/2013,2013,8,30, 14 ,7638,1439,1135,10212
8/30/2013,2013,8,30, 15 ,7502,1369,1122,9993
8/30/2013,2013,8,30, 16 ,7357,1353,1091,9801
8/30/2013,2013,8,30, 17 ,7006,1309,1090,9405
8/30/2013,2013,8,30, 18 ,6809,1408,1118,9335
8/30/2013,2013,8,30, 19 ,7269,1506,1111,9886
8/30/2013,2013,8,30, 20 ,7125,1463,1102,9690
8/30/2013,2013,8,30, 21 ,7022,1392,1089,9503
8/30/2013,2013,8,30, 22 ,6686,1269,1006,8961
8/30/2013,2013,8,30, 23 ,6278,1178,955,8411
8/30/2013,2013,8,30, 24 ,5871,1074,900,7845
8/31/2013,2013,8,31, 1 ,5594,1025,863,7482
8/31/2013,2013,8,31, 2 ,5343,990,835,7168
8/31/2013,2013,8,31, 3 ,5209,958,812,6979
8/31/2013,2013,8,31, 4 ,5010,943,806,6759
8/31/2013,2013,8,31, 5 ,5037,952,850,6839
8/31/2013,2013,8,31, 6 ,4952,947,847,6746
8/31/2013,2013,8,31, 7 ,5028,951,836,6815
8/31/2013,2013,8,31, 8 ,5533,1062,917,7512
8/31/2013,2013,8,31, 9 ,6106,1220,1010,8336
8/31/2013,2013,8,31, 10 ,6549,1294,1103,8946
8/31/2013,2013,8,31, 11 ,6774,1352,1121,9247
8/31/2013,2013,8,31, 12 ,6729,1335,1110,9174
8/31/2013,2013,8,31, 13 ,6709,1360,1111,9180
8/31/2013,2013,8,31, 14 ,6825,1393,1117,9335
8/31/2013,2013,8,31, 15 ,6707,1344,1124,9175
8/31/2013,2013,8,31, 16 ,6448,1301,1084,8833
8/31/2013,2013,8,31, 17 ,6131,1237,1070,8438
8/31/2013,2013,8,31, 18 ,6214,1345,1137,8696
8/31/2013,2013,8,31, 19 ,6723,1476,1129,9328
8/31/2013,2013,8,31, 20 ,6656,1438,1136,9230
8/31/2013,2013,8,31, 21 ,6618,1400,1118,9136
8/31/2013,2013,8,31, 22 ,6381,1291,1051,8723
8/31/2013,2013,8,31, 23 ,6028,1182,991,8201
8/31/2013,2013,8,31, 24 ,5655,1104,945,7704
9/1/2013,2013,9,1, 1 ,5395,1043,895,7333
9/1/2013,2013,9,1, 2 ,5198,1010,856,7064
9/1/2013,2013,9,1, 3 ,4970,974,832,6776
9/1/2013,2013,9,1, 4 ,4894,955,810,6659
9/1/2013,2013,9,1, 5 ,4795,933,815,6543
9/1/2013,2013,9,1, 6 ,4613,893,794,6300
9/1/2013,2013,9,1, 7 ,4610,913,804,6327
9/1/2013,2013,9,1, 8 ,4838,988,852,6678
9/1/2013,2013,9,1, 9 ,5171,1073,918,7162
9/1/2013,2013,9,1, 10 ,5604,1132,992,7728
9/1/2013,2013,9,1, 11 ,5921,1192,1041,8154
9/1/2013,2013,9,1, 12 ,5904,1200,1032,8136
9/1/2013,2013,9,1, 13 ,5943,1213,1032,8188
9/1/2013,2013,9,1, 14 ,5976,1214,1050,8240
9/1/2013,2013,9,1, 15 ,5964,1200,1045,8209
9/1/2013,2013,9,1, 16 ,5770,1164,1014,7948
9/1/2013,2013,9,1, 17 ,5662,1147,961,7770
9/1/2013,2013,9,1, 18 ,5775,1257,1046,8078
9/1/2013,2013,9,1, 19 ,6378,1427,1073,8878
9/1/2013,2013,9,1, 20 ,6355,1407,1055,8817
9/1/2013,2013,9,1, 21 ,6316,1339,1080,8735
9/1/2013,2013,9,1, 22 ,5979,1234,1000,8213
9/1/2013,2013,9,1, 23 ,5615,1140,935,7690
9/1/2013,2013,9,1, 24 ,5239,1062,874,7175
9/2/2013,2013,9,2, 1 ,5032,1015,837,6884
9/2/2013,2013,9,2, 2 ,4828,974,802,6604
9/2/2013,2013,9,2, 3 ,4679,940,781,6400
9/2/2013,2013,9,2, 4 ,4685,938,786,6409
9/2/2013,2013,9,2, 5 ,4832,974,826,6632
9/2/2013,2013,9,2, 6 ,4962,986,859,6807
9/2/2013,2013,9,2, 7 ,5041,955,799,6795
9/2/2013,2013,9,2, 8 ,5826,1123,967,7916
9/2/2013,2013,9,2, 9 ,6722,1343,1088,9153
9/2/2013,2013,9,2, 10 ,7240,1451,1127,9818
9/2/2013,2013,9,2, 11 ,7518,1517,1145,10180
9/2/2013,2013,9,2, 12 ,7422,1500,1150,10072
9/2/2013,2013,9,2, 13 ,7455,1490,1151,10096
9/2/2013,2013,9,2, 14 ,7772,1532,1192,10496
9/2/2013,2013,9,2, 15 ,7649,1515,1161,10325
9/2/2013,2013,9,2, 16 ,7456,1474,1146,10076
9/2/2013,2013,9,2, 17 ,7075,1392,1137,9604
9/2/2013,2013,9,2, 18 ,6879,1459,1163,9501
9/2/2013,2013,9,2, 19 ,7300,1543,1153,9996
9/2/2013,2013,9,2, 20 ,7148,1492,1141,9781
9/2/2013,2013,9,2, 21 ,6947,1435,1131,9513
9/2/2013,2013,9,2, 22 ,6596,1302,1045,8943
9/2/2013,2013,9,2, 23 ,6217,1167,986,8370
9/2/2013,2013,9,2, 24 ,5767,1104,925,7796
9/3/2013,2013,9,3, 1 ,5503,1049,819,7371
9/3/2013,2013,9,3, 2 ,5261,1014,827,7102
9/3/2013,2013,9,3, 3 ,5135,987,822,6944
9/3/2013,2013,9,3, 4 ,5064,972,833,6869
9/3/2013,2013,9,3, 5 ,5185,1015,870,7070
9/3/2013,2013,9,3, 6 ,5158,1011,841,7010
9/3/2013,2013,9,3, 7 ,5262,977,825,7064
9/3/2013,2013,9,3, 8 ,6080,1133,982,8195
9/3/2013,2013,9,3, 9 ,6886,1347,1048,9281
9/3/2013,2013,9,3, 10 ,7419,1438,1104,9961
9/3/2013,2013,9,3, 11 ,7714,1482,1138,10334
9/3/2013,2013,9,3, 12 ,7636,1452,1129,10217
9/3/2013,2013,9,3, 13 ,7663,1435,1125,10223
9/3/2013,2013,9,3, 14 ,7919,1463,1158,10540
9/3/2013,2013,9,3, 15 ,7776,1432,1158,10366
9/3/2013,2013,9,3, 16 ,7619,1420,1128,10167
9/3/2013,2013,9,3, 17 ,7245,1353,1127,9725
9/3/2013,2013,9,3, 18 ,7119,1450,1166,9735
9/3/2013,2013,9,3, 19 ,7447,1518,1134,10099
9/3/2013,2013,9,3, 20 ,7339,1479,1130,9948
9/3/2013,2013,9,3, 21 ,6974,1345,1123,9442
9/3/2013,2013,9,3, 22 ,6486,1267,1045,8798
9/3/2013,2013,9,3, 23 ,6059,1151,994,8204
9/3/2013,2013,9,3, 24 ,5647,1080,936,7663
9/4/2013,2013,9,4, 1 ,5413,1037,895,7345
9/4/2013,2013,9,4, 2 ,5231,1001,866,7098
9/4/2013,2013,9,4, 3 ,5167,975,851,6993
9/4/2013,2013,9,4, 4 ,5083,965,842,6890
9/4/2013,2013,9,4, 5 ,5180,999,896,7075
9/4/2013,2013,9,4, 6 ,5276,1012,868,7156
9/4/2013,2013,9,4, 7 ,5292,979,837,7108
9/4/2013,2013,9,4, 8 ,6064,1135,974,8173
9/4/2013,2013,9,4, 9 ,6788,1366,1069,9223
9/4/2013,2013,9,4, 10 ,7149,1448,1110,9707
9/4/2013,2013,9,4, 11 ,7462,1482,1142,10086
9/4/2013,2013,9,4, 12 ,7360,1458,1127,9945
9/4/2013,2013,9,4, 13 ,7278,1458,1087,9823
9/4/2013,2013,9,4, 14 ,7441,1468,1091,10000
9/4/2013,2013,9,4, 15 ,7272,1434,1111,9817
9/4/2013,2013,9,4, 16 ,7123,1413,1120,9656
9/4/2013,2013,9,4, 17 ,6965,1367,1102,9434
9/4/2013,2013,9,4, 18 ,7013,1435,1127,9575
9/4/2013,2013,9,4, 19 ,7200,1474,1138,9812
9/4/2013,2013,9,4, 20 ,6945,1418,1126,9489
9/4/2013,2013,9,4, 21 ,6814,1355,1121,9290
9/4/2013,2013,9,4, 22 ,6402,1236,1065,8703
9/4/2013,2013,9,4, 23 ,5930,1114,996,8040
9/4/2013,2013,9,4, 24 ,5578,1041,936,7555
9/5/2013,2013,9,5, 1 ,5309,995,890,7194
9/5/2013,2013,9,5, 2 ,5104,966,856,6926
9/5/2013,2013,9,5, 3 ,4988,939,834,6761
9/5/2013,2013,9,5, 4 ,4952,938,821,6711
9/5/2013,2013,9,5, 5 ,5010,974,868,6852
9/5/2013,2013,9,5, 6 ,5170,993,904,7067
9/5/2013,2013,9,5, 7 ,5193,953,858,7004
9/5/2013,2013,9,5, 8 ,5959,1101,980,8040
9/5/2013,2013,9,5, 9 ,6743,1310,1103,9156
9/5/2013,2013,9,5, 10 ,7283,1413,1156,9852
9/5/2013,2013,9,5, 11 ,7533,1466,1178,10177
9/5/2013,2013,9,5, 12 ,7428,1423,1167,10018
9/5/2013,2013,9,5, 13 ,7350,1281,1163,9794
9/5/2013,2013,9,5, 14 ,7454,1307,1185,9946
9/5/2013,2013,9,5, 15 ,7240,1313,1156,9709
9/5/2013,2013,9,5, 16 ,7013,1317,1149,9479
9/5/2013,2013,9,5, 17 ,6833,1288,1134,9255
9/5/2013,2013,9,5, 18 ,6792,1390,1150,9332
9/5/2013,2013,9,5, 19 ,7053,1443,1072,9568
9/5/2013,2013,9,5, 20 ,6885,1406,1065,9356
9/5/2013,2013,9,5, 21 ,6662,1313,1078,9053
9/5/2013,2013,9,5, 22 ,6275,1213,1006,8494
9/5/2013,2013,9,5, 23 ,5827,1100,951,7878
9/5/2013,2013,9,5, 24 ,5398,1034,899,7331
9/6/2013,2013,9,6, 1 ,5131,976,871,6978
9/6/2013,2013,9,6, 2 ,4953,942,841,6736
9/6/2013,2013,9,6, 3 ,4795,921,822,6538
9/6/2013,2013,9,6, 4 ,4757,918,803,6478
9/6/2013,2013,9,6, 5 ,4922,954,859,6735
9/6/2013,2013,9,6, 6 ,4982,968,877,6827
9/6/2013,2013,9,6, 7 ,5069,949,834,6852
9/6/2013,2013,9,6, 8 ,5914,1086,982,7982
9/6/2013,2013,9,6, 9 ,6661,1302,1115,9078
9/6/2013,2013,9,6, 10 ,7201,1398,1145,9744
9/6/2013,2013,9,6, 11 ,7494,1469,1174,10137
9/6/2013,2013,9,6, 12 ,7393,1437,1166,9996
9/6/2013,2013,9,6, 13 ,7332,1435,1170,9937
9/6/2013,2013,9,6, 14 ,7309,1470,1221,10000
9/6/2013,2013,9,6, 15 ,7255,1442,1201,9898
9/6/2013,2013,9,6, 16 ,7140,1401,1166,9707
9/6/2013,2013,9,6, 17 ,6837,1318,1144,9299
9/6/2013,2013,9,6, 18 ,6786,1425,1233,9444
9/6/2013,2013,9,6, 19 ,7078,1477,1207,9762
9/6/2013,2013,9,6, 20 ,6964,1415,1213,9592
9/6/2013,2013,9,6, 21 ,6726,1337,1175,9238
9/6/2013,2013,9,6, 22 ,6389,1223,1067,8679
9/6/2013,2013,9,6, 23 ,5975,1105,989,8069
9/6/2013,2013,9,6, 24 ,5570,1040,929,7539
9/7/2013,2013,9,7, 1 ,5262,994,882,7138
9/7/2013,2013,9,7, 2 ,5099,966,851,6916
9/7/2013,2013,9,7, 3 ,4957,937,839,6733
9/7/2013,2013,9,7, 4 ,4856,923,831,6610
9/7/2013,2013,9,7, 5 ,4825,926,859,6610
9/7/2013,2013,9,7, 6 ,4815,929,869,6613
9/7/2013,2013,9,7, 7 ,4927,935,859,6721
9/7/2013,2013,9,7, 8 ,5447,1029,946,7422
9/7/2013,2013,9,7, 9 ,6082,1154,1048,8284
9/7/2013,2013,9,7, 10 ,6591,1257,1123,8971
9/7/2013,2013,9,7, 11 ,6846,1302,1171,9319
9/7/2013,2013,9,7, 12 ,6753,1283,1175,9211
9/7/2013,2013,9,7, 13 ,6729,1299,1168,9196
9/7/2013,2013,9,7, 14 ,6887,1322,1189,9398
9/7/2013,2013,9,7, 15 ,6597,1277,1145,9019
9/7/2013,2013,9,7, 16 ,6398,1250,1127,8775
9/7/2013,2013,9,7, 17 ,6220,1214,1125,8559
9/7/2013,2013,9,7, 18 ,6282,1351,1246,8879
9/7/2013,2013,9,7, 19 ,6769,1421,1253,9443
9/7/2013,2013,9,7, 20 ,6679,1407,1222,9308
9/7/2013,2013,9,7, 21 ,6581,1327,1203,9111
9/7/2013,2013,9,7, 22 ,6303,1215,1061,8579
9/7/2013,2013,9,7, 23 ,5915,1120,965,8000
9/7/2013,2013,9,7, 24 ,5588,1050,893,7531
9/8/2013,2013,9,8, 1 ,5288,1002,830,7120
9/8/2013,2013,9,8, 2 ,5142,973,822,6937
9/8/2013,2013,9,8, 3 ,4970,941,800,6711
9/8/2013,2013,9,8, 4 ,4852,937,797,6586
9/8/2013,2013,9,8, 5 ,4769,929,799,6497
9/8/2013,2013,9,8, 6 ,4603,905,806,6314
9/8/2013,2013,9,8, 7 ,4657,907,770,6334
9/8/2013,2013,9,8, 8 ,4830,953,810,6593
9/8/2013,2013,9,8, 9 ,5191,1034,912,7137
9/8/2013,2013,9,8, 10 ,5621,1114,976,7711
9/8/2013,2013,9,8, 11 ,5827,1164,1018,8009
9/8/2013,2013,9,8, 12 ,5843,1156,1000,7999
9/8/2013,2013,9,8, 13 ,5781,1150,994,7925
9/8/2013,2013,9,8, 14 ,5750,1134,984,7868
9/8/2013,2013,9,8, 15 ,5692,1100,978,7770
9/8/2013,2013,9,8, 16 ,5642,1092,968,7702
9/8/2013,2013,9,8, 17 ,5741,1106,985,7832
9/8/2013,2013,9,8, 18 ,6032,1270,1142,8444
9/8/2013,2013,9,8, 19 ,6389,1351,1185,8925
9/8/2013,2013,9,8, 20 ,6320,1322,1143,8785
9/8/2013,2013,9,8, 21 ,6176,1230,1076,8482
9/8/2013,2013,9,8, 22 ,5750,1143,960,7853
9/8/2013,2013,9,8, 23 ,5371,1047,904,7322
9/8/2013,2013,9,8, 24 ,5073,971,836,6880
9/9/2013,2013,9,9, 1 ,4740,930,787,6457
9/9/2013,2013,9,9, 2 ,4673,905,770,6348
9/9/2013,2013,9,9, 3 ,4500,895,746,6141
9/9/2013,2013,9,9, 4 ,4482,872,750,6104
9/9/2013,2013,9,9, 5 ,4682,903,819,6404
9/9/2013,2013,9,9, 6 ,4840,927,843,6610
9/9/2013,2013,9,9, 7 ,4976,908,809,6693
9/9/2013,2013,9,9, 8 ,5776,1005,921,7702
9/9/2013,2013,9,9, 9 ,6572,1180,1078,8830
9/9/2013,2013,9,9, 10 ,7162,1277,1142,9581
9/9/2013,2013,9,9, 11 ,7369,1346,1195,9910
9/9/2013,2013,9,9, 12 ,7242,1333,1174,9749
9/9/2013,2013,9,9, 13 ,7173,1314,1153,9640
9/9/2013,2013,9,9, 14 ,7389,1354,1174,9917
9/9/2013,2013,9,9, 15 ,7204,1318,1189,9711
9/9/2013,2013,9,9, 16 ,7071,1286,1171,9528
9/9/2013,2013,9,9, 17 ,6834,1258,1145,9237
9/9/2013,2013,9,9, 18 ,6815,1392,1269,9476
9/9/2013,2013,9,9, 19 ,7041,1436,1263,9740
9/9/2013,2013,9,9, 20 ,6861,1377,1231,9469
9/9/2013,2013,9,9, 21 ,6555,1301,1166,9022
9/9/2013,2013,9,9, 22 ,6220,1188,1027,8435
9/9/2013,2013,9,9, 23 ,5798,1086,933,7817
9/9/2013,2013,9,9, 24 ,5375,1014,880,7269
9/10/2013,2013,9,10, 1 ,5115,965,837,6917
9/10/2013,2013,9,10, 2 ,5004,938,814,6756
9/10/2013,2013,9,10, 3 ,4851,918,795,6564
9/10/2013,2013,9,10, 4 ,4813,918,796,6527
9/10/2013,2013,9,10, 5 ,4964,951,840,6755
9/10/2013,2013,9,10, 6 ,5065,978,875,6918
9/10/2013,2013,9,10, 7 ,5118,950,819,6887
9/10/2013,2013,9,10, 8 ,5962,1098,927,7987
9/10/2013,2013,9,10, 9 ,6723,1305,1092,9120
9/10/2013,2013,9,10, 10 ,7171,1403,1186,9760
9/10/2013,2013,9,10, 11 ,7427,1457,1233,10117
9/10/2013,2013,9,10, 12 ,7341,1424,1219,9984
9/10/2013,2013,9,10, 13 ,7315,1419,1204,9938
9/10/2013,2013,9,10, 14 ,7597,1455,1233,10285
9/10/2013,2013,9,10, 15 ,7434,1427,1213,10074
9/10/2013,2013,9,10, 16 ,7261,1411,1197,9869
9/10/2013,2013,9,10, 17 ,6980,1350,1193,9523
9/10/2013,2013,9,10, 18 ,6935,1468,1275,9678
9/10/2013,2013,9,10, 19 ,7004,1495,1214,9713
9/10/2013,2013,9,10, 20 ,6794,1420,1211,9425
9/10/2013,2013,9,10, 21 ,6543,1348,1163,9054
9/10/2013,2013,9,10, 22 ,6178,1224,1036,8438
9/10/2013,2013,9,10, 23 ,5801,1109,937,7847
9/10/2013,2013,9,10, 24 ,5432,1036,879,7347
9/11/2013,2013,9,11, 1 ,5167,987,835,6989
9/11/2013,2013,9,11, 2 ,5088,956,807,6851
9/11/2013,2013,9,11, 3 ,4937,939,792,6668
9/11/2013,2013,9,11, 4 ,4899,935,795,6629
9/11/2013,2013,9,11, 5 ,5031,972,840,6843
9/11/2013,2013,9,11, 6 ,5129,993,876,6998
9/11/2013,2013,9,11, 7 ,5246,957,829,7032
9/11/2013,2013,9,11, 8 ,6068,1119,935,8122
9/11/2013,2013,9,11, 9 ,6728,1310,1108,9146
9/11/2013,2013,9,11, 10 ,7213,1384,1207,9804
9/11/2013,2013,9,11, 11 ,7419,1438,1263,10120
9/11/2013,2013,9,11, 12 ,7299,1381,1247,9927
9/11/2013,2013,9,11, 13 ,7245,1394,1236,9875
9/11/2013,2013,9,11, 14 ,7492,1436,1270,10198
9/11/2013,2013,9,11, 15 ,7341,1386,1234,9961
9/11/2013,2013,9,11, 16 ,7235,1357,1222,9814
9/11/2013,2013,9,11, 17 ,6978,1334,1211,9523
9/11/2013,2013,9,11, 18 ,7035,1466,1262,9763
9/11/2013,2013,9,11, 19 ,7160,1453,1245,9858
9/11/2013,2013,9,11, 20 ,6964,1377,1214,9555
9/11/2013,2013,9,11, 21 ,6660,1307,1169,9136
9/11/2013,2013,9,11, 22 ,6312,1184,1033,8529
9/11/2013,2013,9,11, 23 ,5853,1079,929,7861
9/11/2013,2013,9,11, 24 ,5528,1007,878,7413
9/12/2013,2013,9,12, 1 ,5253,964,838,7055
9/12/2013,2013,9,12, 2 ,5116,933,816,6865
9/12/2013,2013,9,12, 3 ,4968,918,805,6691
9/12/2013,2013,9,12, 4 ,4924,907,801,6632
9/12/2013,2013,9,12, 5 ,5055,952,857,6864
9/12/2013,2013,9,12, 6 ,5124,979,889,6992
9/12/2013,2013,9,12, 7 ,5176,956,846,6978
9/12/2013,2013,9,12, 8 ,5852,1091,946,7889
9/12/2013,2013,9,12, 9 ,6549,1285,1122,8956
9/12/2013,2013,9,12, 10 ,6996,1375,1190,9561
9/12/2013,2013,9,12, 11 ,7140,1438,1238,9816
9/12/2013,2013,9,12, 12 ,7035,1406,1210,9651
9/12/2013,2013,9,12, 13 ,6955,1394,1228,9577
9/12/2013,2013,9,12, 14 ,7145,1431,1219,9795
9/12/2013,2013,9,12, 15 ,7025,1413,1201,9639
9/12/2013,2013,9,12, 16 ,6947,1401,1200,9548
9/12/2013,2013,9,12, 17 ,6786,1342,1175,9303
9/12/2013,2013,9,12, 18 ,6858,1464,1234,9556
9/12/2013,2013,9,12, 19 ,7030,1496,1222,9748
9/12/2013,2013,9,12, 20 ,6809,1427,1209,9445
9/12/2013,2013,9,12, 21 ,6574,1361,1178,9113
9/12/2013,2013,9,12, 22 ,6129,1221,1055,8405
9/12/2013,2013,9,12, 23 ,5630,1107,959,7696
9/12/2013,2013,9,12, 24 ,5226,1027,906,7159
9/13/2013,2013,9,13, 1 ,5015,992,860,6867
9/13/2013,2013,9,13, 2 ,4846,956,837,6639
9/13/2013,2013,9,13, 3 ,4804,935,828,6567
9/13/2013,2013,9,13, 4 ,4831,929,808,6568
9/13/2013,2013,9,13, 5 ,4957,961,864,6782
9/13/2013,2013,9,13, 6 ,5040,983,888,6911
9/13/2013,2013,9,13, 7 ,5137,953,848,6938
9/13/2013,2013,9,13, 8 ,5891,1132,960,7983
9/13/2013,2013,9,13, 9 ,6665,1341,1133,9139
9/13/2013,2013,9,13, 10 ,7122,1437,1221,9780
9/13/2013,2013,9,13, 11 ,7388,1475,1254,10117
9/13/2013,2013,9,13, 12 ,7285,1442,1247,9974
9/13/2013,2013,9,13, 13 ,7134,1451,1273,9858
9/13/2013,2013,9,13, 14 ,7289,1468,1300,10057
9/13/2013,2013,9,13, 15 ,7110,1469,1260,9839
9/13/2013,2013,9,13, 16 ,7019,1438,1235,9692
9/13/2013,2013,9,13, 17 ,6750,1346,1191,9287
9/13/2013,2013,9,13, 18 ,6840,1461,1258,9559
9/13/2013,2013,9,13, 19 ,7043,1494,1231,9768
9/13/2013,2013,9,13, 20 ,6854,1449,1243,9546
9/13/2013,2013,9,13, 21 ,6649,1394,1197,9240
9/13/2013,2013,9,13, 22 ,6333,1267,1106,8706
9/13/2013,2013,9,13, 23 ,5864,1161,1012,8037
9/13/2013,2013,9,13, 24 ,5529,1092,955,7576
9/14/2013,2013,9,14, 1 ,5236,1026,901,7163
9/14/2013,2013,9,14, 2 ,5055,999,869,6923
9/14/2013,2013,9,14, 3 ,4968,965,843,6776
9/14/2013,2013,9,14, 4 ,4842,956,828,6626
9/14/2013,2013,9,14, 5 ,4808,964,847,6619
9/14/2013,2013,9,14, 6 ,4850,951,836,6637
9/14/2013,2013,9,14, 7 ,4934,976,846,6756
9/14/2013,2013,9,14, 8 ,5469,1059,944,7472
9/14/2013,2013,9,14, 9 ,6064,1217,1058,8339
9/14/2013,2013,9,14, 10 ,6479,1305,1149,8933
9/14/2013,2013,9,14, 11 ,6690,1376,1197,9263
9/14/2013,2013,9,14, 12 ,6512,1331,1169,9012
9/14/2013,2013,9,14, 13 ,6439,1342,1187,8968
9/14/2013,2013,9,14, 14 ,6525,1391,1224,9140
9/14/2013,2013,9,14, 15 ,6381,1342,1187,8910
9/14/2013,2013,9,14, 16 ,6199,1288,1138,8625
9/14/2013,2013,9,14, 17 ,6140,1247,1129,8516
9/14/2013,2013,9,14, 18 ,6370,1411,1258,9039
9/14/2013,2013,9,14, 19 ,6548,1464,1283,9295
9/14/2013,2013,9,14, 20 ,6390,1420,1253,9063
9/14/2013,2013,9,14, 21 ,6223,1383,1202,8808
9/14/2013,2013,9,14, 22 ,5957,1273,1095,8325
9/14/2013,2013,9,14, 23 ,5576,1172,1028,7776
9/14/2013,2013,9,14, 24 ,5171,1100,937,7208
9/15/2013,2013,9,15, 1 ,4927,1046,875,6848
9/15/2013,2013,9,15, 2 ,4813,1005,845,6663
9/15/2013,2013,9,15, 3 ,4664,972,816,6452
9/15/2013,2013,9,15, 4 ,4569,950,803,6322
9/15/2013,2013,9,15, 5 ,4562,961,820,6343
9/15/2013,2013,9,15, 6 ,4469,924,811,6204
9/15/2013,2013,9,15, 7 ,4490,933,780,6203
9/15/2013,2013,9,15, 8 ,4750,970,834,6554
9/15/2013,2013,9,15, 9 ,5027,1035,906,6968
9/15/2013,2013,9,15, 10 ,5552,1112,1000,7664
9/15/2013,2013,9,15, 11 ,5763,1159,1063,7985
9/15/2013,2013,9,15, 12 ,5613,1174,1072,7859
9/15/2013,2013,9,15, 13 ,5547,1169,1071,7787
9/15/2013,2013,9,15, 14 ,5494,1159,1078,7731
9/15/2013,2013,9,15, 15 ,5452,1149,1067,7668
9/15/2013,2013,9,15, 16 ,5345,1124,1033,7502
9/15/2013,2013,9,15, 17 ,5408,1134,1016,7558
9/15/2013,2013,9,15, 18 ,5728,1334,1164,8226
9/15/2013,2013,9,15, 19 ,5907,1406,1218,8531
9/15/2013,2013,9,15, 20 ,5869,1374,1206,8449
9/15/2013,2013,9,15, 21 ,5651,1292,1150,8093
9/15/2013,2013,9,15, 22 ,5330,1192,1045,7567
9/15/2013,2013,9,15, 23 ,4910,1104,987,7001
9/15/2013,2013,9,15, 24 ,4668,1028,906,6602
9/16/2013,2013,9,16, 1 ,4440,985,861,6286
9/16/2013,2013,9,16, 2 ,4317,957,825,6099
9/16/2013,2013,9,16, 3 ,4250,928,809,5987
9/16/2013,2013,9,16, 4 ,4251,929,790,5970
9/16/2013,2013,9,16, 5 ,4456,963,836,6255
9/16/2013,2013,9,16, 6 ,4748,994,873,6615
9/16/2013,2013,9,16, 7 ,4882,963,833,6678
9/16/2013,2013,9,16, 8 ,5486,1109,973,7568
9/16/2013,2013,9,16, 9 ,6253,1317,1126,8696
9/16/2013,2013,9,16, 10 ,6835,1394,1199,9428
9/16/2013,2013,9,16, 11 ,6944,1451,1241,9636
9/16/2013,2013,9,16, 12 ,6820,1431,1220,9471
9/16/2013,2013,9,16, 13 ,6736,1422,1244,9402
9/16/2013,2013,9,16, 14 ,6994,1454,1275,9723
9/16/2013,2013,9,16, 15 ,6877,1408,1243,9528
9/16/2013,2013,9,16, 16 ,6794,1408,1236,9438
9/16/2013,2013,9,16, 17 ,6664,1354,1211,9229
9/16/2013,2013,9,16, 18 ,6765,1497,1270,9532
9/16/2013,2013,9,16, 19 ,6815,1483,1116,9414
9/16/2013,2013,9,16, 20 ,6616,1442,1239,9297
9/16/2013,2013,9,16, 21 ,6322,1375,1222,8919
9/16/2013,2013,9,16, 22 ,5931,1251,1106,8288
9/16/2013,2013,9,16, 23 ,5491,1135,1022,7648
9/16/2013,2013,9,16, 24 ,5118,1046,937,7101
9/17/2013,2013,9,17, 1 ,4830,1022,908,6760
9/17/2013,2013,9,17, 2 ,4757,981,847,6585
9/17/2013,2013,9,17, 3 ,4650,961,837,6448
9/17/2013,2013,9,17, 4 ,4672,958,835,6465
9/17/2013,2013,9,17, 5 ,4827,987,848,6662
9/17/2013,2013,9,17, 6 ,4925,1010,878,6813
9/17/2013,2013,9,17, 7 ,5088,971,882,6941
9/17/2013,2013,9,17, 8 ,5756,1103,991,7850
9/17/2013,2013,9,17, 9 ,6454,1290,1160,8904
9/17/2013,2013,9,17, 10 ,6966,1379,1217,9562
9/17/2013,2013,9,17, 11 ,7174,1424,1265,9863
9/17/2013,2013,9,17, 12 ,7034,1403,1263,9700
9/17/2013,2013,9,17, 13 ,6992,1400,1267,9659
9/17/2013,2013,9,17, 14 ,7259,1475,1263,9997
9/17/2013,2013,9,17, 15 ,7162,1454,1222,9838
9/17/2013,2013,9,17, 16 ,7049,1424,1219,9692
9/17/2013,2013,9,17, 17 ,6738,1375,1197,9310
9/17/2013,2013,9,17, 18 ,6894,1502,1331,9727
9/17/2013,2013,9,17, 19 ,7074,1527,1298,9899
9/17/2013,2013,9,17, 20 ,6908,1468,1257,9633
9/17/2013,2013,9,17, 21 ,6666,1385,1195,9246
9/17/2013,2013,9,17, 22 ,6239,1271,1065,8575
9/17/2013,2013,9,17, 23 ,5828,1153,975,7956
9/17/2013,2013,9,17, 24 ,5339,1084,946,7369
9/18/2013,2013,9,18, 1 ,5069,1031,890,6990
9/18/2013,2013,9,18, 2 ,4945,994,857,6796
9/18/2013,2013,9,18, 3 ,4848,977,841,6666
9/18/2013,2013,9,18, 4 ,4797,970,826,6593
9/18/2013,2013,9,18, 5 ,4935,996,890,6821
9/18/2013,2013,9,18, 6 ,5039,1043,921,7003
9/18/2013,2013,9,18, 7 ,5147,987,859,6993
9/18/2013,2013,9,18, 8 ,5875,1137,968,7980
9/18/2013,2013,9,18, 9 ,6605,1330,1120,9055
9/18/2013,2013,9,18, 10 ,7066,1418,1190,9674
9/18/2013,2013,9,18, 11 ,7358,1474,1208,10040
9/18/2013,2013,9,18, 12 ,7216,1442,1198,9856
9/18/2013,2013,9,18, 13 ,7230,1431,1215,9876
9/18/2013,2013,9,18, 14 ,7379,1486,1229,10094
9/18/2013,2013,9,18, 15 ,7226,1458,1230,9914
9/18/2013,2013,9,18, 16 ,7130,1427,1237,9794
9/18/2013,2013,9,18, 17 ,6888,1354,1211,9453
9/18/2013,2013,9,18, 18 ,6998,1510,1301,9809
9/18/2013,2013,9,18, 19 ,6981,1533,1307,9821
9/18/2013,2013,9,18, 20 ,6845,1471,1285,9601
9/18/2013,2013,9,18, 21 ,6619,1408,1224,9251
9/18/2013,2013,9,18, 22 ,6206,1293,1088,8587
9/18/2013,2013,9,18, 23 ,5782,1169,999,7950
9/18/2013,2013,9,18, 24 ,5368,1096,939,7403
9/19/2013,2013,9,19, 1 ,5084,1048,897,7029
9/19/2013,2013,9,19, 2 ,4969,1015,868,6852
9/19/2013,2013,9,19, 3 ,4835,982,834,6651
9/19/2013,2013,9,19, 4 ,4904,980,837,6721
9/19/2013,2013,9,19, 5 ,5005,1007,896,6908
9/19/2013,2013,9,19, 6 ,5080,1028,919,7027
9/19/2013,2013,9,19, 7 ,5140,988,871,6999
9/19/2013,2013,9,19, 8 ,5808,1114,1005,7927
9/19/2013,2013,9,19, 9 ,6586,1299,1134,9019
9/19/2013,2013,9,19, 10 ,7065,1385,1223,9673
9/19/2013,2013,9,19, 11 ,7271,1420,1266,9957
9/19/2013,2013,9,19, 12 ,7165,1371,1229,9765
9/19/2013,2013,9,19, 13 ,7127,1380,1227,9734
9/19/2013,2013,9,19, 14 ,7346,1430,1257,10033
9/19/2013,2013,9,19, 15 ,7182,1411,1250,9843
9/19/2013,2013,9,19, 16 ,7064,1394,1240,9698
9/19/2013,2013,9,19, 17 ,6772,1341,1210,9323
9/19/2013,2013,9,19, 18 ,6879,1487,1310,9676
9/19/2013,2013,9,19, 19 ,7088,1481,1267,9836
9/19/2013,2013,9,19, 20 ,6863,1411,1255,9529
9/19/2013,2013,9,19, 21 ,6650,1350,1190,9190
9/19/2013,2013,9,19, 22 ,6206,1227,1062,8495
9/19/2013,2013,9,19, 23 ,5793,1133,985,7911
9/19/2013,2013,9,19, 24 ,5403,1059,930,7392
9/20/2013,2013,9,20, 1 ,5141,1021,879,7041
9/20/2013,2013,9,20, 2 ,5006,1000,859,6865
9/20/2013,2013,9,20, 3 ,4946,983,850,6779
9/20/2013,2013,9,20, 4 ,4906,973,847,6726
9/20/2013,2013,9,20, 5 ,5054,999,889,6942
9/20/2013,2013,9,20, 6 ,5159,1003,907,7069
9/20/2013,2013,9,20, 7 ,5290,988,853,7131
9/20/2013,2013,9,20, 8 ,5892,1125,995,8012
9/20/2013,2013,9,20, 9 ,6620,1300,1172,9092
9/20/2013,2013,9,20, 10 ,7065,1375,1246,9686
9/20/2013,2013,9,20, 11 ,7284,1379,1276,9939
9/20/2013,2013,9,20, 12 ,7085,1344,1239,9668
9/20/2013,2013,9,20, 13 ,6999,1320,1257,9576
9/20/2013,2013,9,20, 14 ,7245,1319,1270,9834
9/20/2013,2013,9,20, 15 ,7102,1325,1240,9667
9/20/2013,2013,9,20, 16 ,6999,1315,1233,9547
9/20/2013,2013,9,20, 17 ,6750,1273,1116,9139
9/20/2013,2013,9,20, 18 ,6860,1385,1210,9455
9/20/2013,2013,9,20, 19 ,6940,1414,1191,9545
9/20/2013,2013,9,20, 20 ,6720,1350,1160,9230
9/20/2013,2013,9,20, 21 ,6533,1268,1153,8954
9/20/2013,2013,9,20, 22 ,6184,1150,1075,8409
9/20/2013,2013,9,20, 23 ,5817,1070,997,7884
9/20/2013,2013,9,20, 24 ,5339,1006,924,7269
9/21/2013,2013,9,21, 1 ,5105,965,861,6931
9/21/2013,2013,9,21, 2 ,4941,943,852,6736
9/21/2013,2013,9,21, 3 ,4832,917,829,6578
9/21/2013,2013,9,21, 4 ,4721,918,830,6469
9/21/2013,2013,9,21, 5 ,4761,945,862,6568
9/21/2013,2013,9,21, 6 ,4783,932,856,6571
9/21/2013,2013,9,21, 7 ,4896,939,842,6677
9/21/2013,2013,9,21, 8 ,5372,1031,932,7335
9/21/2013,2013,9,21, 9 ,5844,1155,1037,8036
9/21/2013,2013,9,21, 10 ,6260,1248,1125,8633
9/21/2013,2013,9,21, 11 ,6489,1276,1151,8916
9/21/2013,2013,9,21, 12 ,6296,1241,1123,8660
9/21/2013,2013,9,21, 13 ,6281,1259,1127,8667
9/21/2013,2013,9,21, 14 ,6368,1276,1168,8812
9/21/2013,2013,9,21, 15 ,6258,1228,1145,8631
9/21/2013,2013,9,21, 16 ,6133,1191,1102,8426
9/21/2013,2013,9,21, 17 ,6068,1184,1113,8365
9/21/2013,2013,9,21, 18 ,6360,1351,1197,8908
9/21/2013,2013,9,21, 19 ,6458,1397,1199,9054
9/21/2013,2013,9,21, 20 ,6353,1336,1178,8867
9/21/2013,2013,9,21, 21 ,6207,1276,1146,8629
9/21/2013,2013,9,21, 22 ,5848,1169,1090,8107
9/21/2013,2013,9,21, 23 ,5471,1080,1010,7561
9/21/2013,2013,9,21, 24 ,5234,1009,947,7190
9/22/2013,2013,9,22, 1 ,5005,966,897,6868
9/22/2013,2013,9,22, 2 ,4802,940,863,6605
9/22/2013,2013,9,22, 3 ,4722,917,822,6461
9/22/2013,2013,9,22, 4 ,4600,912,824,6336
9/22/2013,2013,9,22, 5 ,4573,917,838,6328
9/22/2013,2013,9,22, 6 ,4453,890,816,6159
9/22/2013,2013,9,22, 7 ,4475,901,797,6173
9/22/2013,2013,9,22, 8 ,4766,956,847,6569
9/22/2013,2013,9,22, 9 ,5033,1019,866,6918
9/22/2013,2013,9,22, 10 ,5351,1088,936,7375
9/22/2013,2013,9,22, 11 ,5519,1128,1006,7653
9/22/2013,2013,9,22, 12 ,5420,1120,1007,7547
9/22/2013,2013,9,22, 13 ,5287,1109,998,7394
9/22/2013,2013,9,22, 14 ,5257,1112,1004,7373
9/22/2013,2013,9,22, 15 ,5235,1103,999,7337
9/22/2013,2013,9,22, 16 ,5188,1093,977,7258
9/22/2013,2013,9,22, 17 ,5265,1122,996,7383
9/22/2013,2013,9,22, 18 ,5750,1322,1205,8277
9/22/2013,2013,9,22, 19 ,5916,1365,1220,8501
9/22/2013,2013,9,22, 20 ,5839,1317,1218,8374
9/22/2013,2013,9,22, 21 ,5589,1248,1184,8021
9/22/2013,2013,9,22, 22 ,5228,1171,1099,7498
9/22/2013,2013,9,22, 23 ,4871,1071,998,6940
9/22/2013,2013,9,22, 24 ,4597,993,926,6516
9/23/2013,2013,9,23, 1 ,4350,943,864,6157
9/23/2013,2013,9,23, 2 ,4194,914,831,5939
9/23/2013,2013,9,23, 3 ,4091,884,815,5790
9/23/2013,2013,9,23, 4 ,4091,886,807,5784
9/23/2013,2013,9,23, 5 ,4270,934,854,6058
9/23/2013,2013,9,23, 6 ,4489,972,866,6327
9/23/2013,2013,9,23, 7 ,4698,942,826,6466
9/23/2013,2013,9,23, 8 ,5263,1085,963,7311
9/23/2013,2013,9,23, 9 ,5797,1297,1173,8267
9/23/2013,2013,9,23, 10 ,6180,1387,1218,8785
9/23/2013,2013,9,23, 11 ,6339,1451,1242,9032
9/23/2013,2013,9,23, 12 ,6202,1373,1230,8805
9/23/2013,2013,9,23, 13 ,6056,1402,1224,8682
9/23/2013,2013,9,23, 14 ,6169,1454,1234,8857
9/23/2013,2013,9,23, 15 ,6183,1436,1221,8840
9/23/2013,2013,9,23, 16 ,6065,1412,1209,8686
9/23/2013,2013,9,23, 17 ,6071,1330,1203,8604
9/23/2013,2013,9,23, 18 ,6273,1502,1266,9041
9/23/2013,2013,9,23, 19 ,6354,1494,1254,9102
9/23/2013,2013,9,23, 20 ,6139,1449,1164,8752
9/23/2013,2013,9,23, 21 ,5854,1364,1144,8362
9/23/2013,2013,9,23, 22 ,5418,1243,1114,7775
9/23/2013,2013,9,23, 23 ,5002,1127,1019,7148
9/23/2013,2013,9,23, 24 ,4706,1064,950,6720
9/24/2013,2013,9,24, 1 ,4494,1022,852,6368
9/24/2013,2013,9,24, 2 ,4366,995,840,6201
9/24/2013,2013,9,24, 3 ,4304,968,856,6128
9/24/2013,2013,9,24, 4 ,4311,959,850,6120
9/24/2013,2013,9,24, 5 ,4496,994,898,6388
9/24/2013,2013,9,24, 6 ,4698,1007,911,6616
9/24/2013,2013,9,24, 7 ,4828,966,841,6635
9/24/2013,2013,9,24, 8 ,5521,1127,1006,7654
9/24/2013,2013,9,24, 9 ,6223,1319,1131,8673
9/24/2013,2013,9,24, 10 ,6687,1398,1182,9267
9/24/2013,2013,9,24, 11 ,6876,1439,1203,9518
9/24/2013,2013,9,24, 12 ,6789,1379,1184,9352
9/24/2013,2013,9,24, 13 ,6673,1369,1183,9225
9/24/2013,2013,9,24, 14 ,6785,1415,1227,9427
9/24/2013,2013,9,24, 15 ,6646,1395,1130,9171
9/24/2013,2013,9,24, 16 ,6582,1349,1185,9116
9/24/2013,2013,9,24, 17 ,6395,1325,1173,8893
9/24/2013,2013,9,24, 18 ,6602,1461,1244,9307
9/24/2013,2013,9,24, 19 ,6702,1456,1212,9370
9/24/2013,2013,9,24, 20 ,6501,1382,1243,9126
9/24/2013,2013,9,24, 21 ,6273,1308,1224,8805
9/24/2013,2013,9,24, 22 ,5793,1198,1128,8119
9/24/2013,2013,9,24, 23 ,5394,1098,1041,7533
9/24/2013,2013,9,24, 24 ,5026,1027,980,7033
9/25/2013,2013,9,25, 1 ,4803,984,918,6705
9/25/2013,2013,9,25, 2 ,4709,959,913,6581
9/25/2013,2013,9,25, 3 ,4601,945,875,6421
9/25/2013,2013,9,25, 4 ,4609,939,875,6423
9/25/2013,2013,9,25, 5 ,4753,985,907,6645
9/25/2013,2013,9,25, 6 ,4924,1001,935,6860
9/25/2013,2013,9,25, 7 ,5022,972,886,6880
9/25/2013,2013,9,25, 8 ,5720,1113,994,7827
9/25/2013,2013,9,25, 9 ,6356,1318,1167,8841
9/25/2013,2013,9,25, 10 ,6750,1393,1233,9376
9/25/2013,2013,9,25, 11 ,6960,1424,1249,9633
9/25/2013,2013,9,25, 12 ,6843,1352,1248,9443
9/25/2013,2013,9,25, 13 ,6741,1353,1270,9364
9/25/2013,2013,9,25, 14 ,6973,1418,1288,9679
9/25/2013,2013,9,25, 15 ,6860,1394,1280,9534
9/25/2013,2013,9,25, 16 ,6769,1357,1260,9386
9/25/2013,2013,9,25, 17 ,6612,1334,1248,9194
9/25/2013,2013,9,25, 18 ,6781,1438,1296,9515
9/25/2013,2013,9,25, 19 ,6814,1433,1235,9482
9/25/2013,2013,9,25, 20 ,6623,1385,1239,9247
9/25/2013,2013,9,25, 21 ,6382,1314,1240,8936
9/25/2013,2013,9,25, 22 ,5980,1188,1162,8330
9/25/2013,2013,9,25, 23 ,5562,1075,1055,7692
9/25/2013,2013,9,25, 24 ,5113,1016,973,7102
9/26/2013,2013,9,26, 1 ,4875,978,926,6779
9/26/2013,2013,9,26, 2 ,4733,946,894,6573
9/26/2013,2013,9,26, 3 ,4604,927,869,6400
9/26/2013,2013,9,26, 4 ,4566,926,861,6353
9/26/2013,2013,9,26, 5 ,4786,965,916,6667
9/26/2013,2013,9,26, 6 ,4919,999,931,6849
9/26/2013,2013,9,26, 7 ,5016,955,874,6845
9/26/2013,2013,9,26, 8 ,5650,1070,1009,7729
9/26/2013,2013,9,26, 9 ,6347,1249,1165,8761
9/26/2013,2013,9,26, 10 ,6751,1325,1229,9305
9/26/2013,2013,9,26, 11 ,6900,1374,1276,9550
9/26/2013,2013,9,26, 12 ,6728,1365,1268,9361
9/26/2013,2013,9,26, 13 ,6568,1366,1264,9198
9/26/2013,2013,9,26, 14 ,6839,1437,1280,9556
9/26/2013,2013,9,26, 15 ,6776,1407,1277,9460
9/26/2013,2013,9,26, 16 ,6659,1383,1262,9304
9/26/2013,2013,9,26, 17 ,6556,1328,1237,9121
9/26/2013,2013,9,26, 18 ,6751,1491,1314,9556
9/26/2013,2013,9,26, 19 ,6721,1477,1310,9508
9/26/2013,2013,9,26, 20 ,6423,1407,1098,8928
9/26/2013,2013,9,26, 21 ,6182,1313,1060,8555
9/26/2013,2013,9,26, 22 ,5819,1198,1095,8112
9/26/2013,2013,9,26, 23 ,5364,1099,1006,7469
9/26/2013,2013,9,26, 24 ,5046,1028,937,7011
9/27/2013,2013,9,27, 1 ,4836,988,890,6714
9/27/2013,2013,9,27, 2 ,4748,957,860,6565
9/27/2013,2013,9,27, 3 ,4590,931,842,6363
9/27/2013,2013,9,27, 4 ,4525,924,834,6283
9/27/2013,2013,9,27, 5 ,4758,960,877,6595
9/27/2013,2013,9,27, 6 ,4924,976,890,6790
9/27/2013,2013,9,27, 7 ,5143,953,880,6976
9/27/2013,2013,9,27, 8 ,5722,1092,1029,7843
9/27/2013,2013,9,27, 9 ,6396,1287,1142,8825
9/27/2013,2013,9,27, 10 ,6776,1366,1199,9341
9/27/2013,2013,9,27, 11 ,6973,1364,1205,9542
9/27/2013,2013,9,27, 12 ,6806,1385,1111,9302
9/27/2013,2013,9,27, 13 ,6685,1389,1123,9197
9/27/2013,2013,9,27, 14 ,6928,1445,1140,9513
9/27/2013,2013,9,27, 15 ,6839,1403,1150,9392
9/27/2013,2013,9,27, 16 ,6780,1350,1196,9326
9/27/2013,2013,9,27, 17 ,6599,1306,1154,9059
9/27/2013,2013,9,27, 18 ,6744,1484,1233,9461
9/27/2013,2013,9,27, 19 ,6698,1468,1218,9384
9/27/2013,2013,9,27, 20 ,6445,1415,1155,9015
9/27/2013,2013,9,27, 21 ,6311,1367,1148,8826
9/27/2013,2013,9,27, 22 ,5839,1244,1103,8186
9/27/2013,2013,9,27, 23 ,5542,1142,1045,7729
9/27/2013,2013,9,27, 24 ,5174,1065,974,7213
9/28/2013,2013,9,28, 1 ,4913,1012,932,6857
9/28/2013,2013,9,28, 2 ,4761,986,900,6647
9/28/2013,2013,9,28, 3 ,4628,958,881,6467
9/28/2013,2013,9,28, 4 ,4602,952,864,6418
9/28/2013,2013,9,28, 5 ,4642,968,886,6496
9/28/2013,2013,9,28, 6 ,4630,958,889,6477
9/28/2013,2013,9,28, 7 ,4764,961,875,6600
9/28/2013,2013,9,28, 8 ,5310,1055,967,7332
9/28/2013,2013,9,28, 9 ,5867,1187,1050,8104
9/28/2013,2013,9,28, 10 ,6320,1271,1105,8696
9/28/2013,2013,9,28, 11 ,6561,1329,1143,9033
9/28/2013,2013,9,28, 12 ,6476,1295,1069,8840
9/28/2013,2013,9,28, 13 ,6421,1301,1102,8824
9/28/2013,2013,9,28, 14 ,6641,1328,1112,9081
9/28/2013,2013,9,28, 15 ,6439,1295,1127,8861
9/28/2013,2013,9,28, 16 ,6190,1210,1117,8517
9/28/2013,2013,9,28, 17 ,6113,1216,1136,8465
9/28/2013,2013,9,28, 18 ,6372,1402,1210,8984
9/28/2013,2013,9,28, 19 ,6428,1411,1208,9047
9/28/2013,2013,9,28, 20 ,6239,1365,1179,8783
9/28/2013,2013,9,28, 21 ,6084,1298,1147,8529
9/28/2013,2013,9,28, 22 ,5839,1199,1079,8117
9/28/2013,2013,9,28, 23 ,5489,1105,1019,7613
9/28/2013,2013,9,28, 24 ,5158,1024,958,7140
9/29/2013,2013,9,29, 1 ,4931,976,848,6755
9/29/2013,2013,9,29, 2 ,4686,945,861,6492
9/29/2013,2013,9,29, 3 ,4556,912,839,6307
9/29/2013,2013,9,29, 4 ,4408,896,837,6141
9/29/2013,2013,9,29, 5 ,4407,909,843,6159
9/29/2013,2013,9,29, 6 ,4268,883,866,6017
9/29/2013,2013,9,29, 7 ,4396,880,833,6109
9/29/2013,2013,9,29, 8 ,4655,925,870,6450
9/29/2013,2013,9,29, 9 ,5090,991,946,7027
9/29/2013,2013,9,29, 10 ,5566,1060,984,7610
9/29/2013,2013,9,29, 11 ,5773,1118,1014,7905
9/29/2013,2013,9,29, 12 ,5835,1117,968,7920
9/29/2013,2013,9,29, 13 ,5801,1121,950,7872
9/29/2013,2013,9,29, 14 ,5853,1115,959,7927
9/29/2013,2013,9,29, 15 ,5698,1104,964,7766
9/29/2013,2013,9,29, 16 ,5633,1083,980,7696
9/29/2013,2013,9,29, 17 ,5558,1092,1034,7684
9/29/2013,2013,9,29, 18 ,6054,1286,1160,8500
9/29/2013,2013,9,29, 19 ,6370,1352,1158,8880
9/29/2013,2013,9,29, 20 ,6315,1313,1161,8789
9/29/2013,2013,9,29, 21 ,6072,1242,1127,8441
9/29/2013,2013,9,29, 22 ,5757,1148,1022,7927
9/29/2013,2013,9,29, 23 ,5513,1089,974,7576
9/29/2013,2013,9,29, 24 ,5031,996,866,6893
9/30/2013,2013,9,30, 1 ,4815,944,846,6605
9/30/2013,2013,9,30, 2 ,4655,912,817,6384
9/30/2013,2013,9,30, 3 ,4437,897,798,6132
9/30/2013,2013,9,30, 4 ,4440,890,797,6127
9/30/2013,2013,9,30, 5 ,4601,925,855,6381
9/30/2013,2013,9,30, 6 ,4741,945,887,6573
9/30/2013,2013,9,30, 7 ,4891,920,853,6664
9/30/2013,2013,9,30, 8 ,5692,1060,965,7717
9/30/2013,2013,9,30, 9 ,6400,1240,1078,8718
9/30/2013,2013,9,30, 10 ,6840,1335,1130,9305
9/30/2013,2013,9,30, 11 ,7133,1390,1149,9672
9/30/2013,2013,9,30, 12 ,6979,1356,1144,9479
9/30/2013,2013,9,30, 13 ,6965,1358,1151,9474
9/30/2013,2013,9,30, 14 ,7255,1406,1130,9791
9/30/2013,2013,9,30, 15 ,7118,1371,1165,9654
9/30/2013,2013,9,30, 16 ,7052,1357,1151,9560
9/30/2013,2013,9,30, 17 ,6780,1314,1118,9212
9/30/2013,2013,9,30, 18 ,6870,1472,1185,9527
9/30/2013,2013,9,30, 19 ,7029,1453,1135,9617
9/30/2013,2013,9,30, 20 ,6853,1394,1132,9379
9/30/2013,2013,9,30, 21 ,6652,1299,1113,9064
9/30/2013,2013,9,30, 22 ,6261,1174,1047,8482
9/30/2013,2013,9,30, 23 ,5875,1071,967,7913
9/30/2013,2013,9,30, 24 ,5482,1010,932,7424
10/1/2013,2013,10,1, 1 ,5182,966,898,7046
10/1/2013,2013,10,1, 2 ,4964,937,867,6768
10/1/2013,2013,10,1, 3 ,4859,919,842,6620
10/1/2013,2013,10,1, 4 ,4770,913,844,6527
10/1/2013,2013,10,1, 5 ,4915,955,904,6774
10/1/2013,2013,10,1, 6 ,5009,985,913,6907
10/1/2013,2013,10,1, 7 ,5073,946,868,6887
10/1/2013,2013,10,1, 8 ,5814,1067,956,7837
10/1/2013,2013,10,1, 9 ,6511,1253,1092,8856
10/1/2013,2013,10,1, 10 ,6992,1340,1126,9458
10/1/2013,2013,10,1, 11 ,7133,1395,1169,9697
10/1/2013,2013,10,1, 12 ,7031,1353,1153,9537
10/1/2013,2013,10,1, 13 ,7036,1353,1142,9531
10/1/2013,2013,10,1, 14 ,7244,1413,1142,9799
10/1/2013,2013,10,1, 15 ,7170,1379,1109,9658
10/1/2013,2013,10,1, 16 ,7073,1353,1117,9543
10/1/2013,2013,10,1, 17 ,6725,1322,1108,9155
10/1/2013,2013,10,1, 18 ,6961,1466,1163,9590
10/1/2013,2013,10,1, 19 ,6940,1441,1157,9538
10/1/2013,2013,10,1, 20 ,6743,1376,1133,9252
10/1/2013,2013,10,1, 21 ,6583,1291,1076,8950
10/1/2013,2013,10,1, 22 ,6115,1173,1026,8314
10/1/2013,2013,10,1, 23 ,5685,1074,953,7712
10/1/2013,2013,10,1, 24 ,5322,1002,916,7240
10/2/2013,2013,10,2, 1 ,5118,959,879,6956
10/2/2013,2013,10,2, 2 ,4965,931,855,6751
10/2/2013,2013,10,2, 3 ,4818,910,837,6565
10/2/2013,2013,10,2, 4 ,4789,904,837,6530
10/2/2013,2013,10,2, 5 ,4938,945,893,6776
10/2/2013,2013,10,2, 6 ,5066,965,908,6939
10/2/2013,2013,10,2, 7 ,5139,938,845,6922
10/2/2013,2013,10,2, 8 ,5927,1090,985,8002
10/2/2013,2013,10,2, 9 ,6678,1286,1092,9056
10/2/2013,2013,10,2, 10 ,7082,1387,1136,9605
10/2/2013,2013,10,2, 11 ,7316,1438,1162,9916
10/2/2013,2013,10,2, 12 ,7212,1401,1134,9747
10/2/2013,2013,10,2, 13 ,7215,1398,1141,9754
10/2/2013,2013,10,2, 14 ,7564,1447,1169,10180
10/2/2013,2013,10,2, 15 ,7437,1422,1164,10023
10/2/2013,2013,10,2, 16 ,7275,1396,1161,9832
10/2/2013,2013,10,2, 17 ,6975,1333,1119,9427
10/2/2013,2013,10,2, 18 ,7049,1499,1197,9745
10/2/2013,2013,10,2, 19 ,7198,1494,1184,9876
10/2/2013,2013,10,2, 20 ,7023,1444,1217,9684
10/2/2013,2013,10,2, 21 ,6849,1363,1177,9389
10/2/2013,2013,10,2, 22 ,6461,1238,1116,8815
10/2/2013,2013,10,2, 23 ,6072,1088,1046,8206
10/2/2013,2013,10,2, 24 ,5573,1015,974,7562
10/3/2013,2013,10,3, 1 ,5258,999,924,7181
10/3/2013,2013,10,3, 2 ,5076,968,896,6940
10/3/2013,2013,10,3, 3 ,4997,950,856,6803
10/3/2013,2013,10,3, 4 ,4939,944,863,6746
10/3/2013,2013,10,3, 5 ,5071,977,915,6963
10/3/2013,2013,10,3, 6 ,5155,989,925,7069
10/3/2013,2013,10,3, 7 ,5263,957,875,7095
10/3/2013,2013,10,3, 8 ,6018,1110,1060,8188
10/3/2013,2013,10,3, 9 ,6692,1304,1209,9205
10/3/2013,2013,10,3, 10 ,7220,1395,1264,9879
10/3/2013,2013,10,3, 11 ,7373,1444,1299,10116
10/3/2013,2013,10,3, 12 ,7299,1396,1278,9973
10/3/2013,2013,10,3, 13 ,7258,1397,1285,9940
10/3/2013,2013,10,3, 14 ,7459,1437,1286,10182
10/3/2013,2013,10,3, 15 ,7347,1391,1296,10034
10/3/2013,2013,10,3, 16 ,7265,1361,1243,9869
10/3/2013,2013,10,3, 17 ,6979,1305,1222,9506
10/3/2013,2013,10,3, 18 ,7151,1475,1283,9909
10/3/2013,2013,10,3, 19 ,7206,1452,1246,9904
10/3/2013,2013,10,3, 20 ,7044,1402,1221,9667
10/3/2013,2013,10,3, 21 ,6819,1336,1200,9355
10/3/2013,2013,10,3, 22 ,6453,1248,1106,8807
10/3/2013,2013,10,3, 23 ,5981,1128,1008,8117
10/3/2013,2013,10,3, 24 ,5564,1052,937,7553
10/4/2013,2013,10,4, 1 ,5326,1001,899,7226
10/4/2013,2013,10,4, 2 ,5221,976,872,7069
10/4/2013,2013,10,4, 3 ,5071,958,847,6876
10/4/2013,2013,10,4, 4 ,4968,950,846,6764
10/4/2013,2013,10,4, 5 ,5124,980,892,6996
10/4/2013,2013,10,4, 6 ,5155,991,902,7048
10/4/2013,2013,10,4, 7 ,5232,965,875,7072
10/4/2013,2013,10,4, 8 ,5952,1103,995,8050
10/4/2013,2013,10,4, 9 ,6751,1304,1161,9216
10/4/2013,2013,10,4, 10 ,7168,1365,1244,9777
10/4/2013,2013,10,4, 11 ,7292,1394,1263,9949
10/4/2013,2013,10,4, 12 ,7221,1360,1220,9801
10/4/2013,2013,10,4, 13 ,7262,1372,1200,9834
10/4/2013,2013,10,4, 14 ,7463,1440,1210,10113
10/4/2013,2013,10,4, 15 ,7365,1434,1137,9936
10/4/2013,2013,10,4, 16 ,7209,1375,1140,9724
10/4/2013,2013,10,4, 17 ,6887,1331,1154,9372
10/4/2013,2013,10,4, 18 ,7123,1484,1240,9847
10/4/2013,2013,10,4, 19 ,7179,1456,1219,9854
10/4/2013,2013,10,4, 20 ,7017,1406,1209,9632
10/4/2013,2013,10,4, 21 ,6764,1326,1180,9270
10/4/2013,2013,10,4, 22 ,6473,1226,1065,8764
10/4/2013,2013,10,4, 23 ,5964,1126,957,8047
10/4/2013,2013,10,4, 24 ,5598,1054,905,7557
10/5/2013,2013,10,5, 1 ,5302,1004,861,7167
10/5/2013,2013,10,5, 2 ,5081,973,838,6892
10/5/2013,2013,10,5, 3 ,5005,949,806,6760
10/5/2013,2013,10,5, 4 ,4875,908,816,6599
10/5/2013,2013,10,5, 5 ,4901,950,823,6674
10/5/2013,2013,10,5, 6 ,4827,937,848,6612
10/5/2013,2013,10,5, 7 ,4925,942,817,6684
10/5/2013,2013,10,5, 8 ,5759,1044,892,7695
10/5/2013,2013,10,5, 9 ,6042,1177,1005,8224
10/5/2013,2013,10,5, 10 ,6544,1247,1067,8858
10/5/2013,2013,10,5, 11 ,6747,1306,1114,9167
10/5/2013,2013,10,5, 12 ,6751,1289,1081,9121
10/5/2013,2013,10,5, 13 ,6645,1291,1089,9025
10/5/2013,2013,10,5, 14 ,6737,1294,1099,9130
10/5/2013,2013,10,5, 15 ,6664,1266,1076,9006
10/5/2013,2013,10,5, 16 ,6496,1232,1070,8798
10/5/2013,2013,10,5, 17 ,6248,1211,1110,8569
10/5/2013,2013,10,5, 18 ,6525,1403,1187,9115
10/5/2013,2013,10,5, 19 ,6791,1384,1172,9347
10/5/2013,2013,10,5, 20 ,6722,1348,1146,9216
10/5/2013,2013,10,5, 21 ,6543,1277,1087,8907
10/5/2013,2013,10,5, 22 ,6260,1176,941,8377
10/5/2013,2013,10,5, 23 ,5798,1086,918,7802
10/5/2013,2013,10,5, 24 ,5431,1021,847,7299
10/6/2013,2013,10,6, 1 ,5079,976,820,6875
10/6/2013,2013,10,6, 2 ,4930,940,797,6667
10/6/2013,2013,10,6, 3 ,4716,920,763,6399
10/6/2013,2013,10,6, 4 ,4615,888,762,6265
10/6/2013,2013,10,6, 5 ,4688,885,780,6353
10/6/2013,2013,10,6, 6 ,4480,844,802,6126
10/6/2013,2013,10,6, 7 ,4483,841,788,6112
10/6/2013,2013,10,6, 8 ,4793,878,814,6485
10/6/2013,2013,10,6, 9 ,5143,953,865,6961
10/6/2013,2013,10,6, 10 ,5548,1032,974,7554
10/6/2013,2013,10,6, 11 ,5922,1079,965,7966
10/6/2013,2013,10,6, 12 ,5858,1082,970,7910
10/6/2013,2013,10,6, 13 ,5809,1067,957,7833
10/6/2013,2013,10,6, 14 ,5790,1068,938,7796
10/6/2013,2013,10,6, 15 ,5681,1043,930,7654
10/6/2013,2013,10,6, 16 ,5623,1027,930,7580
10/6/2013,2013,10,6, 17 ,5551,1049,1000,7600
10/6/2013,2013,10,6, 18 ,6138,1254,1160,8552
10/6/2013,2013,10,6, 19 ,6261,1247,1114,8622
10/6/2013,2013,10,6, 20 ,6327,1219,1081,8627
10/6/2013,2013,10,6, 21 ,6129,1135,999,8263
10/6/2013,2013,10,6, 22 ,5725,1051,917,7693
10/6/2013,2013,10,6, 23 ,5435,979,843,7257
10/6/2013,2013,10,6, 24 ,5115,934,801,6850
10/7/2013,2013,10,7, 1 ,4823,893,772,6488
10/7/2013,2013,10,7, 2 ,4648,861,751,6260
10/7/2013,2013,10,7, 3 ,4536,844,711,6091
10/7/2013,2013,10,7, 4 ,4505,837,739,6081
10/7/2013,2013,10,7, 5 ,4619,883,792,6294
10/7/2013,2013,10,7, 6 ,4773,919,838,6530
10/7/2013,2013,10,7, 7 ,4951,894,789,6634
10/7/2013,2013,10,7, 8 ,5796,1036,915,7747
10/7/2013,2013,10,7, 9 ,6571,1139,1097,8807
10/7/2013,2013,10,7, 10 ,7094,1328,1167,9589
10/7/2013,2013,10,7, 11 ,7325,1371,1199,9895
10/7/2013,2013,10,7, 12 ,7204,1348,1175,9727
10/7/2013,2013,10,7, 13 ,7134,1340,1197,9671
10/7/2013,2013,10,7, 14 ,7452,1387,1181,10020
10/7/2013,2013,10,7, 15 ,7302,1362,1163,9827
10/7/2013,2013,10,7, 16 ,7087,1347,1159,9593
10/7/2013,2013,10,7, 17 ,6899,1291,1169,9359
10/7/2013,2013,10,7, 18 ,6990,1447,1259,9696
10/7/2013,2013,10,7, 19 ,7094,1436,1198,9728
10/7/2013,2013,10,7, 20 ,6927,1366,1181,9474
10/7/2013,2013,10,7, 21 ,6749,1272,1118,9139
10/7/2013,2013,10,7, 22 ,6288,1169,1008,8465
10/7/2013,2013,10,7, 23 ,5944,1062,898,7904
10/7/2013,2013,10,7, 24 ,5459,997,861,7317
10/8/2013,2013,10,8, 1 ,5215,963,832,7010
10/8/2013,2013,10,8, 2 ,5167,940,790,6897
10/8/2013,2013,10,8, 3 ,4974,920,792,6686
10/8/2013,2013,10,8, 4 ,4897,909,779,6585
10/8/2013,2013,10,8, 5 ,5058,951,837,6846
10/8/2013,2013,10,8, 6 ,5172,968,869,7009
10/8/2013,2013,10,8, 7 ,5258,937,837,7032
10/8/2013,2013,10,8, 8 ,6052,1080,953,8085
10/8/2013,2013,10,8, 9 ,6737,1269,1096,9102
10/8/2013,2013,10,8, 10 ,7170,1356,1190,9716
10/8/2013,2013,10,8, 11 ,7305,1407,1211,9923
10/8/2013,2013,10,8, 12 ,7111,1345,1189,9645
10/8/2013,2013,10,8, 13 ,6993,1344,1196,9533
10/8/2013,2013,10,8, 14 ,7243,1403,1209,9855
10/8/2013,2013,10,8, 15 ,7163,1347,1173,9683
10/8/2013,2013,10,8, 16 ,7014,1326,1177,9517
10/8/2013,2013,10,8, 17 ,6765,1281,1184,9230
10/8/2013,2013,10,8, 18 ,6986,1431,1255,9672
10/8/2013,2013,10,8, 19 ,7060,1393,1229,9682
10/8/2013,2013,10,8, 20 ,6485,1349,1182,9016
10/8/2013,2013,10,8, 21 ,6568,1266,1140,8974
10/8/2013,2013,10,8, 22 ,6063,1150,1028,8241
10/8/2013,2013,10,8, 23 ,5807,1054,962,7823
10/8/2013,2013,10,8, 24 ,5388,991,851,7230
10/9/2013,2013,10,9, 1 ,5174,948,849,6971
10/9/2013,2013,10,9, 2 ,5036,924,819,6779
10/9/2013,2013,10,9, 3 ,4893,905,806,6604
10/9/2013,2013,10,9, 4 ,4813,900,801,6514
10/9/2013,2013,10,9, 5 ,4945,940,858,6743
10/9/2013,2013,10,9, 6 ,5079,969,887,6935
10/9/2013,2013,10,9, 7 ,5185,931,841,6957
10/9/2013,2013,10,9, 8 ,5969,1053,961,7983
10/9/2013,2013,10,9, 9 ,6665,1255,1125,9045
10/9/2013,2013,10,9, 10 ,7141,1354,1193,9688
10/9/2013,2013,10,9, 11 ,7332,1378,1235,9945
10/9/2013,2013,10,9, 12 ,7216,1341,1191,9748
10/9/2013,2013,10,9, 13 ,7150,1346,1183,9679
10/9/2013,2013,10,9, 14 ,7344,1401,1221,9966
10/9/2013,2013,10,9, 15 ,7223,1364,1206,9793
10/9/2013,2013,10,9, 16 ,7083,1343,1204,9630
10/9/2013,2013,10,9, 17 ,6913,1320,1178,9411
10/9/2013,2013,10,9, 18 ,7072,1475,1282,9829
10/9/2013,2013,10,9, 19 ,7177,1447,1248,9872
10/9/2013,2013,10,9, 20 ,7015,1392,1213,9620
10/9/2013,2013,10,9, 21 ,6792,1315,1117,9224
10/9/2013,2013,10,9, 22 ,6358,1188,1050,8596
10/9/2013,2013,10,9, 23 ,5888,1086,944,7918
10/9/2013,2013,10,9, 24 ,5472,1016,884,7372
10/10/2013,2013,10,10, 1 ,5302,966,853,7121
10/10/2013,2013,10,10, 2 ,5108,930,836,6874
10/10/2013,2013,10,10, 3 ,4982,911,818,6711
10/10/2013,2013,10,10, 4 ,4969,906,820,6695
10/10/2013,2013,10,10, 5 ,5046,950,869,6865
10/10/2013,2013,10,10, 6 ,5110,977,893,6980
10/10/2013,2013,10,10, 7 ,5268,925,847,7040
10/10/2013,2013,10,10, 8 ,5953,1063,956,7972
10/10/2013,2013,10,10, 9 ,6675,1248,1037,8960
10/10/2013,2013,10,10, 10 ,7169,1323,1159,9651
10/10/2013,2013,10,10, 11 ,7381,1359,1187,9927
10/10/2013,2013,10,10, 12 ,7292,1341,1187,9820
10/10/2013,2013,10,10, 13 ,7203,1337,1202,9742
10/10/2013,2013,10,10, 14 ,7546,1398,1257,10201
10/10/2013,2013,10,10, 15 ,7339,1365,1235,9939
10/10/2013,2013,10,10, 16 ,7200,1325,1237,9762
10/10/2013,2013,10,10, 17 ,7072,1292,1195,9559
10/10/2013,2013,10,10, 18 ,7190,1458,1284,9932
10/10/2013,2013,10,10, 19 ,7007,1431,1258,9696
10/10/2013,2013,10,10, 20 ,6656,1376,1235,9267
10/10/2013,2013,10,10, 21 ,6447,1316,1188,8951
10/10/2013,2013,10,10, 22 ,6116,1194,1070,8380
10/10/2013,2013,10,10, 23 ,5740,1094,998,7832
10/10/2013,2013,10,10, 24 ,5357,1011,925,7293
10/11/2013,2013,10,11, 1 ,5142,975,890,7007
10/11/2013,2013,10,11, 2 ,4984,947,861,6792
10/11/2013,2013,10,11, 3 ,4871,930,834,6635
10/11/2013,2013,10,11, 4 ,4819,922,830,6571
10/11/2013,2013,10,11, 5 ,5028,956,878,6862
10/11/2013,2013,10,11, 6 ,5119,967,903,6989
10/11/2013,2013,10,11, 7 ,5210,925,868,7003
10/11/2013,2013,10,11, 8 ,5900,1077,996,7973
10/11/2013,2013,10,11, 9 ,6622,1271,1157,9050
10/11/2013,2013,10,11, 10 ,6986,1361,1243,9590
10/11/2013,2013,10,11, 11 ,7107,1416,1262,9785
10/11/2013,2013,10,11, 12 ,6879,1382,1124,9385
10/11/2013,2013,10,11, 13 ,6795,1368,1239,9402
10/11/2013,2013,10,11, 14 ,6985,1439,1233,9657
10/11/2013,2013,10,11, 15 ,6858,1400,1198,9456
10/11/2013,2013,10,11, 16 ,6819,1371,1196,9386
10/11/2013,2013,10,11, 17 ,6745,1309,1226,9280
10/11/2013,2013,10,11, 18 ,6940,1481,1288,9709
10/11/2013,2013,10,11, 19 ,6787,1457,1234,9478
10/11/2013,2013,10,11, 20 ,6558,1401,1245,9204
10/11/2013,2013,10,11, 21 ,6285,1338,1199,8822
10/11/2013,2013,10,11, 22 ,5790,1230,1096,8116
10/11/2013,2013,10,11, 23 ,5277,1140,990,7407
10/11/2013,2013,10,11, 24 ,4654,1054,931,6639
10/12/2013,2013,10,12, 1 ,4301,1015,884,6200
10/12/2013,2013,10,12, 2 ,4217,990,848,6055
10/12/2013,2013,10,12, 3 ,4084,964,845,5893
10/12/2013,2013,10,12, 4 ,4056,949,830,5835
10/12/2013,2013,10,12, 5 ,4086,963,856,5905
10/12/2013,2013,10,12, 6 ,4087,956,858,5901
10/12/2013,2013,10,12, 7 ,4281,964,849,6094
10/12/2013,2013,10,12, 8 ,4644,1065,933,6642
10/12/2013,2013,10,12, 9 ,5166,1203,1075,7444
10/12/2013,2013,10,12, 10 ,5594,1280,1129,8003
10/12/2013,2013,10,12, 11 ,5833,1333,1164,8330
10/12/2013,2013,10,12, 12 ,5695,1281,1078,8054
10/12/2013,2013,10,12, 13 ,5602,1291,1103,7996
10/12/2013,2013,10,12, 14 ,5774,1277,1119,8170
10/12/2013,2013,10,12, 15 ,5695,1250,1118,8063
10/12/2013,2013,10,12, 16 ,5610,1225,1071,7906
10/12/2013,2013,10,12, 17 ,5594,1175,1093,7862
10/12/2013,2013,10,12, 18 ,5978,1384,1173,8535
10/12/2013,2013,10,12, 19 ,5980,1377,1156,8513
10/12/2013,2013,10,12, 20 ,5835,1334,1154,8323
10/12/2013,2013,10,12, 21 ,5692,1294,1146,8132
10/12/2013,2013,10,12, 22 ,5351,1181,1048,7580
10/12/2013,2013,10,12, 23 ,5028,1076,974,7078
10/12/2013,2013,10,12, 24 ,4676,1013,889,6578
10/13/2013,2013,10,13, 1 ,4498,976,844,6318
10/13/2013,2013,10,13, 2 ,4377,943,819,6139
10/13/2013,2013,10,13, 3 ,4230,924,809,5963
10/13/2013,2013,10,13, 4 ,4241,914,791,5946
10/13/2013,2013,10,13, 5 ,4229,917,815,5961
10/13/2013,2013,10,13, 6 ,4129,893,797,5819
10/13/2013,2013,10,13, 7 ,4172,896,798,5866
10/13/2013,2013,10,13, 8 ,4488,931,826,6245
10/13/2013,2013,10,13, 9 ,4882,1019,913,6814
10/13/2013,2013,10,13, 10 ,5309,1092,1000,7401
10/13/2013,2013,10,13, 11 ,5589,1152,1063,7804
10/13/2013,2013,10,13, 12 ,5572,1165,1081,7818
10/13/2013,2013,10,13, 13 ,5633,1168,1078,7879
10/13/2013,2013,10,13, 14 ,5652,1167,1100,7919
10/13/2013,2013,10,13, 15 ,5479,1124,1067,7670
10/13/2013,2013,10,13, 16 ,5393,1092,1040,7525
10/13/2013,2013,10,13, 17 ,5267,1101,1049,7417
10/13/2013,2013,10,13, 18 ,6016,1331,1226,8573
10/13/2013,2013,10,13, 19 ,6100,1364,1207,8671
10/13/2013,2013,10,13, 20 ,6043,1327,1204,8574
10/13/2013,2013,10,13, 21 ,5838,1263,1172,8273
10/13/2013,2013,10,13, 22 ,5433,1167,1081,7681
10/13/2013,2013,10,13, 23 ,5123,1076,1007,7206
10/13/2013,2013,10,13, 24 ,4799,1008,915,6722
10/14/2013,2013,10,14, 1 ,4572,957,875,6404
10/14/2013,2013,10,14, 2 ,4369,926,836,6131
10/14/2013,2013,10,14, 3 ,4276,901,819,5996
10/14/2013,2013,10,14, 4 ,4292,891,810,5993
10/14/2013,2013,10,14, 5 ,4371,927,850,6148
10/14/2013,2013,10,14, 6 ,4511,948,870,6329
10/14/2013,2013,10,14, 7 ,4593,920,840,6353
10/14/2013,2013,10,14, 8 ,5334,1083,977,7394
10/14/2013,2013,10,14, 9 ,6142,1274,1141,8557
10/14/2013,2013,10,14, 10 ,6735,1381,1240,9356
10/14/2013,2013,10,14, 11 ,6912,1437,1255,9604
10/14/2013,2013,10,14, 12 ,6824,1396,1230,9450
10/14/2013,2013,10,14, 13 ,6833,1359,1256,9448
10/14/2013,2013,10,14, 14 ,7012,1396,1265,9673
10/14/2013,2013,10,14, 15 ,6982,1361,1152,9495
10/14/2013,2013,10,14, 16 ,6808,1324,1163,9295
10/14/2013,2013,10,14, 17 ,6556,1292,1156,9004
10/14/2013,2013,10,14, 18 ,6783,1458,1254,9495
10/14/2013,2013,10,14, 19 ,6727,1434,1219,9380
10/14/2013,2013,10,14, 20 ,6548,1368,1188,9104
10/14/2013,2013,10,14, 21 ,6326,1312,1163,8801
10/14/2013,2013,10,14, 22 ,5975,1192,1045,8212
10/14/2013,2013,10,14, 23 ,5575,1082,933,7590
10/14/2013,2013,10,14, 24 ,5213,1011,897,7121
10/15/2013,2013,10,15, 1 ,4944,971,859,6774
10/15/2013,2013,10,15, 2 ,4864,941,836,6641
10/15/2013,2013,10,15, 3 ,4729,914,811,6454
10/15/2013,2013,10,15, 4 ,4634,909,812,6355
10/15/2013,2013,10,15, 5 ,4620,927,831,6378
10/15/2013,2013,10,15, 6 ,4540,891,824,6255
10/15/2013,2013,10,15, 7 ,4599,912,818,6329
10/15/2013,2013,10,15, 8 ,4981,1001,880,6862
10/15/2013,2013,10,15, 9 ,5513,662,949,7124
10/15/2013,2013,10,15, 10 ,6007,778,1074,7859
10/15/2013,2013,10,15, 11 ,6219,914,1134,8267
10/15/2013,2013,10,15, 12 ,6082,949,1133,8164
10/15/2013,2013,10,15, 13 ,6096,956,1145,8197
10/15/2013,2013,10,15, 14 ,6227,978,1184,8389
10/15/2013,2013,10,15, 15 ,6094,978,1156,8228
10/15/2013,2013,10,15, 16 ,5966,983,1130,8079
10/15/2013,2013,10,15, 17 ,5817,947,1140,7904
10/15/2013,2013,10,15, 18 ,6399,1148,1243,8790
10/15/2013,2013,10,15, 19 ,6458,1143,1182,8783
10/15/2013,2013,10,15, 20 ,6400,1134,1179,8713
10/15/2013,2013,10,15, 21 ,6180,1072,1141,8393
10/15/2013,2013,10,15, 22 ,5783,986,1028,7797
10/15/2013,2013,10,15, 23 ,5389,907,927,7223
10/15/2013,2013,10,15, 24 ,5051,852,881,6784
10/16/2013,2013,10,16, 1 ,5128,819,854,6801
10/16/2013,2013,10,16, 2 ,4800,796,819,6415
10/16/2013,2013,10,16, 3 ,4714,780,799,6293
10/16/2013,2013,10,16, 4 ,4574,776,804,6154
10/16/2013,2013,10,16, 5 ,4751,811,855,6417
10/16/2013,2013,10,16, 6 ,4839,844,877,6560
10/16/2013,2013,10,16, 7 ,4996,847,824,6667
10/16/2013,2013,10,16, 8 ,5725,946,962,7633
10/16/2013,2013,10,16, 9 ,6459,1113,1118,8690
10/16/2013,2013,10,16, 10 ,6904,1182,1210,9296
10/16/2013,2013,10,16, 11 ,7118,1228,1238,9584
10/16/2013,2013,10,16, 12 ,6922,1205,1212,9339
10/16/2013,2013,10,16, 13 ,6712,1227,1217,9156
10/16/2013,2013,10,16, 14 ,6878,1272,1247,9397
10/16/2013,2013,10,16, 15 ,6730,1248,1240,9218
10/16/2013,2013,10,16, 16 ,6608,1230,1231,9069
10/16/2013,2013,10,16, 17 ,6526,1206,1203,8935
10/16/2013,2013,10,16, 18 ,6804,1371,1281,9456
10/16/2013,2013,10,16, 19 ,6626,1332,1243,9201
10/16/2013,2013,10,16, 20 ,6376,1295,1211,8882
10/16/2013,2013,10,16, 21 ,6113,1235,1209,8557
10/16/2013,2013,10,16, 22 ,5795,1119,1090,8004
10/16/2013,2013,10,16, 23 ,5354,1026,1010,7390
10/16/2013,2013,10,16, 24 ,4998,957,950,6905
10/17/2013,2013,10,17, 1 ,4725,935,904,6564
10/17/2013,2013,10,17, 2 ,4638,907,874,6419
10/17/2013,2013,10,17, 3 ,4518,891,853,6262
10/17/2013,2013,10,17, 4 ,4502,890,841,6233
10/17/2013,2013,10,17, 5 ,4687,911,900,6498
10/17/2013,2013,10,17, 6 ,4803,933,911,6647
10/17/2013,2013,10,17, 7 ,4904,921,873,6698
10/17/2013,2013,10,17, 8 ,5604,1042,968,7614
10/17/2013,2013,10,17, 9 ,6257,1229,1127,8613
10/17/2013,2013,10,17, 10 ,6636,1320,1211,9167
10/17/2013,2013,10,17, 11 ,6839,1372,1224,9435
10/17/2013,2013,10,17, 12 ,6678,1327,1197,9202
10/17/2013,2013,10,17, 13 ,6650,1315,1188,9153
10/17/2013,2013,10,17, 14 ,6900,1365,1211,9476
10/17/2013,2013,10,17, 15 ,6783,1339,1198,9320
10/17/2013,2013,10,17, 16 ,6648,1321,1197,9166
10/17/2013,2013,10,17, 17 ,6457,1289,1181,8927
10/17/2013,2013,10,17, 18 ,6725,1453,1256,9434
10/17/2013,2013,10,17, 19 ,6595,1424,1205,9224
10/17/2013,2013,10,17, 20 ,6423,1346,1229,8998
10/17/2013,2013,10,17, 21 ,6147,1266,1170,8583
10/17/2013,2013,10,17, 22 ,5808,1138,1062,8008
10/17/2013,2013,10,17, 23 ,5370,1042,1012,7424
10/17/2013,2013,10,17, 24 ,4964,969,932,6865
10/18/2013,2013,10,18, 1 ,4794,936,894,6624
10/18/2013,2013,10,18, 2 ,4669,912,865,6446
10/18/2013,2013,10,18, 3 ,4524,890,848,6262
10/18/2013,2013,10,18, 4 ,4497,887,843,6227
10/18/2013,2013,10,18, 5 ,4606,908,886,6400
10/18/2013,2013,10,18, 6 ,4758,911,893,6562
10/18/2013,2013,10,18, 7 ,4816,925,853,6594
10/18/2013,2013,10,18, 8 ,5515,1035,981,7531
10/18/2013,2013,10,18, 9 ,6252,1255,1141,8648
10/18/2013,2013,10,18, 10 ,6725,1333,1213,9271
10/18/2013,2013,10,18, 11 ,6884,1393,1092,9369
10/18/2013,2013,10,18, 12 ,6675,1365,1211,9251
10/18/2013,2013,10,18, 13 ,6595,1367,1229,9191
10/18/2013,2013,10,18, 14 ,6872,1418,1243,9533
10/18/2013,2013,10,18, 15 ,6752,1399,1233,9384
10/18/2013,2013,10,18, 16 ,6668,1359,1223,9250
10/18/2013,2013,10,18, 17 ,6435,1282,1183,8900
10/18/2013,2013,10,18, 18 ,6716,1457,1291,9464
10/18/2013,2013,10,18, 19 ,6672,1440,1243,9355
10/18/2013,2013,10,18, 20 ,6519,1402,1236,9157
10/18/2013,2013,10,18, 21 ,6321,1325,1232,8878
10/18/2013,2013,10,18, 22 ,5985,1211,1147,8343
10/18/2013,2013,10,18, 23 ,5644,1115,1054,7813
10/18/2013,2013,10,18, 24 ,5212,1022,981,7215
10/19/2013,2013,10,19, 1 ,4971,990,933,6894
10/19/2013,2013,10,19, 2 ,4788,958,900,6646
10/19/2013,2013,10,19, 3 ,4664,937,881,6482
10/19/2013,2013,10,19, 4 ,4570,923,862,6355
10/19/2013,2013,10,19, 5 ,4546,934,880,6360
10/19/2013,2013,10,19, 6 ,4570,923,881,6374
10/19/2013,2013,10,19, 7 ,4639,939,864,6442
10/19/2013,2013,10,19, 8 ,5134,1048,952,7134
10/19/2013,2013,10,19, 9 ,5707,1197,1070,7974
10/19/2013,2013,10,19, 10 ,6188,1288,1147,8623
10/19/2013,2013,10,19, 11 ,6426,1334,1194,8954
10/19/2013,2013,10,19, 12 ,6273,1312,1157,8742
10/19/2013,2013,10,19, 13 ,6197,1296,1160,8653
10/19/2013,2013,10,19, 14 ,6349,1325,1201,8875
10/19/2013,2013,10,19, 15 ,6236,1299,1188,8723
10/19/2013,2013,10,19, 16 ,6031,1254,1138,8423
10/19/2013,2013,10,19, 17 ,5858,1224,1094,8176
10/19/2013,2013,10,19, 18 ,6353,1439,1240,9032
10/19/2013,2013,10,19, 19 ,6390,1414,1195,8999
10/19/2013,2013,10,19, 20 ,6282,1350,1187,8819
10/19/2013,2013,10,19, 21 ,6097,1304,1185,8586
10/19/2013,2013,10,19, 22 ,5761,1160,1050,7971
10/19/2013,2013,10,19, 23 ,5384,1076,1001,7461
10/19/2013,2013,10,19, 24 ,5114,1020,934,7068
10/20/2013,2013,10,20, 1 ,4852,985,902,6739
10/20/2013,2013,10,20, 2 ,4708,953,878,6539
10/20/2013,2013,10,20, 3 ,4565,923,840,6328
10/20/2013,2013,10,20, 4 ,4473,915,832,6220
10/20/2013,2013,10,20, 5 ,4464,924,844,6232
10/20/2013,2013,10,20, 6 ,4332,899,813,6044
10/20/2013,2013,10,20, 7 ,4340,898,749,5987
10/20/2013,2013,10,20, 8 ,4673,947,810,6430
10/20/2013,2013,10,20, 9 ,5070,1009,892,6971
10/20/2013,2013,10,20, 10 ,5545,1090,967,7602
10/20/2013,2013,10,20, 11 ,5736,1133,1031,7900
10/20/2013,2013,10,20, 12 ,5656,1147,1025,7828
10/20/2013,2013,10,20, 13 ,5691,1141,1047,7879
10/20/2013,2013,10,20, 14 ,5768,1134,1053,7955
10/20/2013,2013,10,20, 15 ,5614,1124,1031,7769
10/20/2013,2013,10,20, 16 ,5492,1101,1005,7598
10/20/2013,2013,10,20, 17 ,5431,1073,982,7486
10/20/2013,2013,10,20, 18 ,6078,1339,1179,8596
10/20/2013,2013,10,20, 19 ,6171,1343,1179,8693
10/20/2013,2013,10,20, 20 ,6148,1285,1172,8605
10/20/2013,2013,10,20, 21 ,5937,1216,1133,8286
10/20/2013,2013,10,20, 22 ,5640,1127,1035,7802
10/20/2013,2013,10,20, 23 ,5287,1040,963,7290
10/20/2013,2013,10,20, 24 ,5035,980,910,6925
10/21/2013,2013,10,21, 1 ,4708,940,875,6523
10/21/2013,2013,10,21, 2 ,4577,910,843,6330
10/21/2013,2013,10,21, 3 ,4456,883,825,6164
10/21/2013,2013,10,21, 4 ,4425,879,820,6124
10/21/2013,2013,10,21, 5 ,4633,911,864,6408
10/21/2013,2013,10,21, 6 ,4783,930,891,6604
10/21/2013,2013,10,21, 7 ,4862,922,842,6626
10/21/2013,2013,10,21, 8 ,5677,1043,989,7709
10/21/2013,2013,10,21, 9 ,6485,1242,1128,8855
10/21/2013,2013,10,21, 10 ,7030,1328,1196,9554
10/21/2013,2013,10,21, 11 ,7203,1380,1202,9785
10/21/2013,2013,10,21, 12 ,7076,1337,1205,9618
10/21/2013,2013,10,21, 13 ,7080,1340,1221,9641
10/21/2013,2013,10,21, 14 ,7324,1400,1216,9940
10/21/2013,2013,10,21, 15 ,7233,1371,1228,9832
10/21/2013,2013,10,21, 16 ,7056,1343,1204,9603
10/21/2013,2013,10,21, 17 ,6810,1309,1208,9327
10/21/2013,2013,10,21, 18 ,7098,1474,1237,9809
10/21/2013,2013,10,21, 19 ,7029,1428,1230,9687
10/21/2013,2013,10,21, 20 ,6855,1378,1235,9468
10/21/2013,2013,10,21, 21 ,6603,1294,1193,9090
10/21/2013,2013,10,21, 22 ,6292,1187,1086,8565
10/21/2013,2013,10,21, 23 ,5806,1089,1004,7899
10/21/2013,2013,10,21, 24 ,5398,1019,936,7353
10/22/2013,2013,10,22, 1 ,5195,981,896,7072
10/22/2013,2013,10,22, 2 ,4935,947,878,6760
10/22/2013,2013,10,22, 3 ,4936,930,873,6739
10/22/2013,2013,10,22, 4 ,4830,928,851,6609
10/22/2013,2013,10,22, 5 ,4987,946,902,6835
10/22/2013,2013,10,22, 6 ,5052,961,909,6922
10/22/2013,2013,10,22, 7 ,5164,950,860,6974
10/22/2013,2013,10,22, 8 ,5847,1084,977,7908
10/22/2013,2013,10,22, 9 ,6624,1281,1156,9061
10/22/2013,2013,10,22, 10 ,7097,1361,1232,9690
10/22/2013,2013,10,22, 11 ,7274,1414,1257,9945
10/22/2013,2013,10,22, 12 ,7075,1366,1224,9665
10/22/2013,2013,10,22, 13 ,7100,1368,1245,9713
10/22/2013,2013,10,22, 14 ,7336,1429,1275,10040
10/22/2013,2013,10,22, 15 ,7248,1397,1216,9861
10/22/2013,2013,10,22, 16 ,7102,1360,1206,9668
10/22/2013,2013,10,22, 17 ,6759,1298,1207,9264
10/22/2013,2013,10,22, 18 ,7123,1492,1239,9854
10/22/2013,2013,10,22, 19 ,7039,1454,1206,9699
10/22/2013,2013,10,22, 20 ,6898,1393,1191,9482
10/22/2013,2013,10,22, 21 ,6573,1314,1159,9046
10/22/2013,2013,10,22, 22 ,6172,1213,1094,8479
10/22/2013,2013,10,22, 23 ,5779,1107,1000,7886
10/22/2013,2013,10,22, 24 ,5454,1036,925,7415
10/23/2013,2013,10,23, 1 ,5140,986,902,7028
10/23/2013,2013,10,23, 2 ,5032,960,884,6876
10/23/2013,2013,10,23, 3 ,4866,929,852,6647
10/23/2013,2013,10,23, 4 ,4813,925,850,6588
10/23/2013,2013,10,23, 5 ,4938,952,894,6784
10/23/2013,2013,10,23, 6 ,5054,959,919,6932
10/23/2013,2013,10,23, 7 ,5068,962,864,6894
10/23/2013,2013,10,23, 8 ,5716,1102,1000,7818
10/23/2013,2013,10,23, 9 ,6477,1285,1158,8920
10/23/2013,2013,10,23, 10 ,6851,1387,1240,9478
10/23/2013,2013,10,23, 11 ,7101,1434,1262,9797
10/23/2013,2013,10,23, 12 ,6966,1390,1232,9588
10/23/2013,2013,10,23, 13 ,6945,1377,1249,9571
10/23/2013,2013,10,23, 14 ,7172,1445,1271,9888
10/23/2013,2013,10,23, 15 ,7102,1398,1246,9746
10/23/2013,2013,10,23, 16 ,6890,1377,1230,9497
10/23/2013,2013,10,23, 17 ,6687,1320,1227,9234
10/23/2013,2013,10,23, 18 ,6983,1504,1299,9786
10/23/2013,2013,10,23, 19 ,6896,1476,1231,9603
10/23/2013,2013,10,23, 20 ,6718,1406,1244,9368
10/23/2013,2013,10,23, 21 ,6518,1331,1209,9058
10/23/2013,2013,10,23, 22 ,6147,1217,1149,8513
10/23/2013,2013,10,23, 23 ,5778,1119,1034,7931
10/23/2013,2013,10,23, 24 ,5366,1019,955,7340
10/24/2013,2013,10,24, 1 ,5145,992,916,7053
10/24/2013,2013,10,24, 2 ,4937,963,893,6793
10/24/2013,2013,10,24, 3 ,4880,942,855,6677
10/24/2013,2013,10,24, 4 ,4807,930,855,6592
10/24/2013,2013,10,24, 5 ,4931,957,904,6792
10/24/2013,2013,10,24, 6 ,5057,962,909,6928
10/24/2013,2013,10,24, 7 ,5067,962,853,6882
10/24/2013,2013,10,24, 8 ,5739,1106,997,7842
10/24/2013,2013,10,24, 9 ,6445,1288,1173,8906
10/24/2013,2013,10,24, 10 ,6893,1371,1235,9499
10/24/2013,2013,10,24, 11 ,7177,1424,1244,9845
10/24/2013,2013,10,24, 12 ,6992,1389,1216,9597
10/24/2013,2013,10,24, 13 ,6982,1378,1264,9624
10/24/2013,2013,10,24, 14 ,7267,1445,1267,9979
10/24/2013,2013,10,24, 15 ,7177,1422,1262,9861
10/24/2013,2013,10,24, 16 ,7177,1393,1243,9813
10/24/2013,2013,10,24, 17 ,6707,1317,1225,9249
10/24/2013,2013,10,24, 18 ,6998,1519,1273,9790
10/24/2013,2013,10,24, 19 ,6944,1471,1295,9710
10/24/2013,2013,10,24, 20 ,6700,1407,1286,9393
10/24/2013,2013,10,24, 21 ,6467,1333,1238,9038
10/24/2013,2013,10,24, 22 ,6101,1223,1125,8449
10/24/2013,2013,10,24, 23 ,5709,1110,1029,7848
10/24/2013,2013,10,24, 24 ,5350,1033,964,7347
10/25/2013,2013,10,25, 1 ,5096,982,920,6998
10/25/2013,2013,10,25, 2 ,4948,963,888,6799
10/25/2013,2013,10,25, 3 ,4813,945,871,6629
10/25/2013,2013,10,25, 4 ,4761,938,857,6556
10/25/2013,2013,10,25, 5 ,4856,954,901,6711
10/25/2013,2013,10,25, 6 ,4935,958,910,6803
10/25/2013,2013,10,25, 7 ,5056,962,870,6888
10/25/2013,2013,10,25, 8 ,5702,1098,1014,7814
10/25/2013,2013,10,25, 9 ,6357,1289,1179,8825
10/25/2013,2013,10,25, 10 ,6875,1385,1254,9514
10/25/2013,2013,10,25, 11 ,7109,1411,1267,9787
10/25/2013,2013,10,25, 12 ,7002,1368,1238,9608
10/25/2013,2013,10,25, 13 ,6982,1378,1262,9622
10/25/2013,2013,10,25, 14 ,7234,1428,1278,9940
10/25/2013,2013,10,25, 15 ,7043,1386,1252,9681
10/25/2013,2013,10,25, 16 ,6980,1372,1170,9522
10/25/2013,2013,10,25, 17 ,6690,1319,1182,9191
10/25/2013,2013,10,25, 18 ,7019,1493,1246,9758
10/25/2013,2013,10,25, 19 ,6875,1451,1274,9600
10/25/2013,2013,10,25, 20 ,6733,1407,1277,9417
10/25/2013,2013,10,25, 21 ,6571,1336,1198,9105
10/25/2013,2013,10,25, 22 ,6212,1241,1131,8584
10/25/2013,2013,10,25, 23 ,5804,1136,1030,7970
10/25/2013,2013,10,25, 24 ,5393,1035,953,7381
10/26/2013,2013,10,26, 1 ,5131,999,904,7034
10/26/2013,2013,10,26, 2 ,4928,968,867,6763
10/26/2013,2013,10,26, 3 ,4803,944,857,6604
10/26/2013,2013,10,26, 4 ,4719,924,841,6484
10/26/2013,2013,10,26, 5 ,4734,939,868,6541
10/26/2013,2013,10,26, 6 ,4711,927,861,6499
10/26/2013,2013,10,26, 7 ,4768,944,858,6570
10/26/2013,2013,10,26, 8 ,5284,1029,951,7264
10/26/2013,2013,10,26, 9 ,5811,1173,1060,8044
10/26/2013,2013,10,26, 10 ,6245,1249,1154,8648
10/26/2013,2013,10,26, 11 ,6477,1313,1209,8999
10/26/2013,2013,10,26, 12 ,6356,1271,1191,8818
10/26/2013,2013,10,26, 13 ,6312,1270,1210,8792
10/26/2013,2013,10,26, 14 ,6468,1309,1232,9009
10/26/2013,2013,10,26, 15 ,6308,1279,1197,8784
10/26/2013,2013,10,26, 16 ,6043,1239,1160,8442
10/26/2013,2013,10,26, 17 ,5828,1218,1169,8215
10/26/2013,2013,10,26, 18 ,6358,1432,1297,9087
10/26/2013,2013,10,26, 19 ,6365,1408,1265,9038
10/26/2013,2013,10,26, 20 ,6240,1340,1215,8795
10/26/2013,2013,10,26, 21 ,6137,1271,1143,8551
10/26/2013,2013,10,26, 22 ,5764,1172,1073,8009
10/26/2013,2013,10,26, 23 ,5393,1080,987,7460
10/26/2013,2013,10,26, 24 ,5116,1014,916,7046
10/27/2013,2013,10,27, 1 ,4888,976,868,6732
10/27/2013,2013,10,27, 2 ,4741,949,833,6523
10/27/2013,2013,10,27, 3 ,4607,922,803,6332
10/27/2013,2013,10,27, 4 ,4534,909,797,6240
10/27/2013,2013,10,27, 5 ,4489,915,812,6216
10/27/2013,2013,10,27, 6 ,4405,891,811,6107
10/27/2013,2013,10,27, 7 ,4419,893,799,6111
10/27/2013,2013,10,27, 8 ,4660,939,834,6433
10/27/2013,2013,10,27, 9 ,5008,1011,894,6913
10/27/2013,2013,10,27, 10 ,5455,1087,990,7532
10/27/2013,2013,10,27, 11 ,5663,1128,1053,7844
10/27/2013,2013,10,27, 12 ,5589,1129,1048,7766
10/27/2013,2013,10,27, 13 ,5561,1125,1056,7742
10/27/2013,2013,10,27, 14 ,5562,1107,1066,7735
10/27/2013,2013,10,27, 15 ,5424,1089,1039,7552
10/27/2013,2013,10,27, 16 ,5335,1075,1030,7440
10/27/2013,2013,10,27, 17 ,5282,1112,1070,7464
10/27/2013,2013,10,27, 18 ,5955,1334,1234,8523
10/27/2013,2013,10,27, 19 ,6012,1298,1217,8527
10/27/2013,2013,10,27, 20 ,5890,1251,1145,8286
10/27/2013,2013,10,27, 21 ,5720,1173,1099,7992
10/27/2013,2013,10,27, 22 ,5426,1106,1046,7578
10/27/2013,2013,10,27, 23 ,5190,1032,927,7149
10/27/2013,2013,10,27, 24 ,4877,978,886,6741
10/28/2013,2013,10,28, 1 ,4673,930,839,6442
10/28/2013,2013,10,28, 2 ,4459,884,794,6137
10/28/2013,2013,10,28, 3 ,4337,882,740,5959
10/28/2013,2013,10,28, 4 ,4280,876,734,5890
10/28/2013,2013,10,28, 5 ,4313,893,752,5958
10/28/2013,2013,10,28, 6 ,4173,879,745,5797
10/28/2013,2013,10,28, 7 ,4152,868,718,5738
10/28/2013,2013,10,28, 8 ,4326,893,753,5972
10/28/2013,2013,10,28, 9 ,4619,964,827,6410
10/28/2013,2013,10,28, 10 ,5042,1030,925,6997
10/28/2013,2013,10,28, 11 ,5241,1069,1009,7319
10/28/2013,2013,10,28, 12 ,5281,1093,1022,7396
10/28/2013,2013,10,28, 13 ,5281,1113,1017,7411
10/28/2013,2013,10,28, 14 ,5372,1102,1005,7479
10/28/2013,2013,10,28, 15 ,5337,1095,997,7429
10/28/2013,2013,10,28, 16 ,5242,1086,988,7316
10/28/2013,2013,10,28, 17 ,5170,1096,1030,7296
10/28/2013,2013,10,28, 18 ,5914,1342,1209,8465
10/28/2013,2013,10,28, 19 ,5929,1329,1160,8418
10/28/2013,2013,10,28, 20 ,5893,1274,1129,8296
10/28/2013,2013,10,28, 21 ,5761,1214,1051,8026
10/28/2013,2013,10,28, 22 ,5440,1128,963,7531
10/28/2013,2013,10,28, 23 ,5176,1044,896,7116
10/28/2013,2013,10,28, 24 ,4816,975,844,6635
10/29/2013,2013,10,29, 1 ,4532,934,794,6260
10/29/2013,2013,10,29, 2 ,4421,904,769,6094
10/29/2013,2013,10,29, 3 ,4310,882,746,5938
10/29/2013,2013,10,29, 4 ,4260,873,740,5873
10/29/2013,2013,10,29, 5 ,4343,893,763,5999
10/29/2013,2013,10,29, 6 ,4400,897,795,6092
10/29/2013,2013,10,29, 7 ,4707,914,800,6421
10/29/2013,2013,10,29, 8 ,5508,1068,925,7501
10/29/2013,2013,10,29, 9 ,6350,1261,1089,8700
10/29/2013,2013,10,29, 10 ,6867,1358,1207,9432
10/29/2013,2013,10,29, 11 ,7152,1404,1244,9800
10/29/2013,2013,10,29, 12 ,7029,1363,1243,9635
10/29/2013,2013,10,29, 13 ,6972,1356,1209,9537
10/29/2013,2013,10,29, 14 ,7177,1400,1234,9811
10/29/2013,2013,10,29, 15 ,7068,1379,1235,9682
10/29/2013,2013,10,29, 16 ,6976,1348,1232,9556
10/29/2013,2013,10,29, 17 ,6667,1296,1220,9183
10/29/2013,2013,10,29, 18 ,7000,1457,1333,9790
10/29/2013,2013,10,29, 19 ,6866,1420,1260,9546
10/29/2013,2013,10,29, 20 ,6627,1360,1196,9183
10/29/2013,2013,10,29, 21 ,6397,1264,1114,8775
10/29/2013,2013,10,29, 22 ,6020,1168,1004,8192
10/29/2013,2013,10,29, 23 ,5648,1071,907,7626
10/29/2013,2013,10,29, 24 ,5166,1001,846,7013
10/30/2013,2013,10,30, 1 ,4931,986,810,6727
10/30/2013,2013,10,30, 2 ,4812,927,785,6524
10/30/2013,2013,10,30, 3 ,4682,906,784,6372
10/30/2013,2013,10,30, 4 ,4629,893,782,6304
10/30/2013,2013,10,30, 5 ,4679,908,813,6400
10/30/2013,2013,10,30, 6 ,4739,908,833,6480
10/30/2013,2013,10,30, 7 ,4911,931,816,6658
10/30/2013,2013,10,30, 8 ,5606,1063,937,7606
10/30/2013,2013,10,30, 9 ,6356,1262,1096,8714
10/30/2013,2013,10,30, 10 ,6742,1344,1194,9280
10/30/2013,2013,10,30, 11 ,7027,1404,1215,9646
10/30/2013,2013,10,30, 12 ,6887,1372,1203,9462
10/30/2013,2013,10,30, 13 ,6812,1374,1230,9416
10/30/2013,2013,10,30, 14 ,7012,1408,1253,9673
10/30/2013,2013,10,30, 15 ,6933,1389,1239,9561
10/30/2013,2013,10,30, 16 ,6806,1361,1230,9397
10/30/2013,2013,10,30, 17 ,6524,1300,1198,9022
10/30/2013,2013,10,30, 18 ,6940,1494,1288,9722
10/30/2013,2013,10,30, 19 ,6810,1444,1243,9497
10/30/2013,2013,10,30, 20 ,6639,1378,1198,9215
10/30/2013,2013,10,30, 21 ,6371,1300,1155,8826
10/30/2013,2013,10,30, 22 ,6075,1180,1035,8290
10/30/2013,2013,10,30, 23 ,5632,1072,971,7675
10/30/2013,2013,10,30, 24 ,5285,1009,904,7198
10/31/2013,2013,10,31, 1 ,5048,956,863,6867
10/31/2013,2013,10,31, 2 ,4919,923,824,6666
10/31/2013,2013,10,31, 3 ,4693,900,800,6393
10/31/2013,2013,10,31, 4 ,4646,890,802,6338
10/31/2013,2013,10,31, 5 ,4674,906,826,6406
10/31/2013,2013,10,31, 6 ,4681,903,838,6422
10/31/2013,2013,10,31, 7 ,4868,920,839,6627
10/31/2013,2013,10,31, 8 ,5472,1047,949,7468
10/31/2013,2013,10,31, 9 ,6196,1224,1114,8534
10/31/2013,2013,10,31, 10 ,6589,1196,1217,9002
10/31/2013,2013,10,31, 11 ,6798,1365,1270,9433
10/31/2013,2013,10,31, 12 ,6715,1340,1256,9311
10/31/2013,2013,10,31, 13 ,6561,1317,1248,9126
10/31/2013,2013,10,31, 14 ,6716,1359,1278,9353
10/31/2013,2013,10,31, 15 ,6538,1311,1247,9096
10/31/2013,2013,10,31, 16 ,6341,1273,1206,8820
10/31/2013,2013,10,31, 17 ,6084,1219,1181,8484
10/31/2013,2013,10,31, 18 ,6499,1402,1332,9233
10/31/2013,2013,10,31, 19 ,6406,1364,1283,9053
10/31/2013,2013,10,31, 20 ,6205,1328,1194,8727
10/31/2013,2013,10,31, 21 ,6054,1250,1110,8414
10/31/2013,2013,10,31, 22 ,5701,1160,1017,7878
10/31/2013,2013,10,31, 23 ,5346,1074,937,7357
10/31/2013,2013,10,31, 24 ,5030,984,874,6888
11/1/2013,2013,11,1, 1 ,4747,951,829,6527
11/1/2013,2013,11,1, 2 ,4639,904,806,6349
11/1/2013,2013,11,1, 3 ,4503,875,790,6168
11/1/2013,2013,11,1, 4 ,4434,862,775,6071
11/1/2013,2013,11,1, 5 ,4387,866,779,6032
11/1/2013,2013,11,1, 6 ,4137,824,776,5737
11/1/2013,2013,11,1, 7 ,3953,806,766,5525
11/1/2013,2013,11,1, 8 ,3979,856,798,5633
11/1/2013,2013,11,1, 9 ,4256,914,872,6042
11/1/2013,2013,11,1, 10 ,4450,959,942,6351
11/1/2013,2013,11,1, 11 ,4687,1001,1000,6688
11/1/2013,2013,11,1, 12 ,4809,1016,1001,6826
11/1/2013,2013,11,1, 13 ,4878,1033,1010,6921
11/1/2013,2013,11,1, 14 ,4895,1024,1006,6925
11/1/2013,2013,11,1, 15 ,4777,998,960,6735
11/1/2013,2013,11,1, 16 ,4635,973,949,6557
11/1/2013,2013,11,1, 17 ,4625,985,972,6582
11/1/2013,2013,11,1, 18 ,5213,1196,1132,7541
11/1/2013,2013,11,1, 19 ,5340,1187,1128,7655
11/1/2013,2013,11,1, 20 ,5421,1170,1067,7658
11/1/2013,2013,11,1, 21 ,5339,1124,1041,7504
11/1/2013,2013,11,1, 22 ,5140,1044,948,7132
11/1/2013,2013,11,1, 23 ,4850,965,864,6679
11/1/2013,2013,11,1, 24 ,4538,914,813,6265
11/2/2013,2013,11,2, 1 ,4313,879,774,5966
11/2/2013,2013,11,2, 2 ,4189,852,749,5790
11/2/2013,2013,11,2, 3 ,3980,837,709,5526
11/2/2013,2013,11,2, 4 ,3958,822,717,5497
11/2/2013,2013,11,2, 5 ,3880,827,742,5449
11/2/2013,2013,11,2, 6 ,3871,802,735,5408
11/2/2013,2013,11,2, 7 ,4002,815,733,5550
11/2/2013,2013,11,2, 8 ,4233,862,777,5872
11/2/2013,2013,11,2, 9 ,4688,948,849,6485
11/2/2013,2013,11,2, 10 ,5209,1025,912,7146
11/2/2013,2013,11,2, 11 ,5447,1070,958,7475
11/2/2013,2013,11,2, 12 ,5403,1074,974,7451
11/2/2013,2013,11,2, 13 ,5338,1076,986,7400
11/2/2013,2013,11,2, 14 ,5410,1081,989,7480
11/2/2013,2013,11,2, 15 ,5271,1050,962,7283
11/2/2013,2013,11,2, 16 ,5152,1023,946,7121
11/2/2013,2013,11,2, 17 ,5195,1047,994,7236
11/2/2013,2013,11,2, 18 ,5830,1291,1189,8310
11/2/2013,2013,11,2, 19 ,5879,1285,1174,8338
11/2/2013,2013,11,2, 20 ,5822,1230,1120,8172
11/2/2013,2013,11,2, 21 ,5664,1172,1042,7878
11/2/2013,2013,11,2, 22 ,5339,1090,962,7391
11/2/2013,2013,11,2, 23 ,4984,1010,886,6880
11/2/2013,2013,11,2, 24 ,4686,950,828,6464
11/3/2013,2013,11,3, 1 ,4466,910,790,6166
11/3/2013,2013,11,3, 2 ,4319,874,764,5957
11/3/2013,2013,11,3, 3 ,4239,858,743,5840
11/3/2013,2013,11,3, 4 ,4126,847,738,5711
11/3/2013,2013,11,3, 5 ,4161,857,727,5745
11/3/2013,2013,11,3, 6 ,4137,837,746,5720
11/3/2013,2013,11,3, 7 ,4203,850,749,5802
11/3/2013,2013,11,3, 8 ,4531,909,793,6233
11/3/2013,2013,11,3, 9 ,4963,979,886,6828
11/3/2013,2013,11,3, 10 ,5408,1067,979,7454
11/3/2013,2013,11,3, 11 ,5630,1114,1025,7769
11/3/2013,2013,11,3, 12 ,5571,1117,1034,7722
11/3/2013,2013,11,3, 13 ,5551,1104,1032,7687
11/3/2013,2013,11,3, 14 ,5511,1116,1040,7667
11/3/2013,2013,11,3, 15 ,5519,1093,1022,7634
11/3/2013,2013,11,3, 16 ,5373,1078,1001,7452
11/3/2013,2013,11,3, 17 ,5415,1111,1075,7601
11/3/2013,2013,11,3, 18 ,6136,1373,1210,8719
11/3/2013,2013,11,3, 19 ,6140,1356,1172,8668
11/3/2013,2013,11,3, 20 ,6079,1318,1091,8488
11/3/2013,2013,11,3, 21 ,5923,1222,1051,8196
11/3/2013,2013,11,3, 22 ,5598,1145,971,7714
11/3/2013,2013,11,3, 23 ,5238,1062,890,7190
11/3/2013,2013,11,3, 24 ,4909,995,836,6740
11/4/2013,2013,11,4, 1 ,4661,955,800,6416
11/4/2013,2013,11,4, 2 ,4431,925,778,6134
11/4/2013,2013,11,4, 3 ,4395,898,760,6053
11/4/2013,2013,11,4, 4 ,4335,895,759,5989
11/4/2013,2013,11,4, 5 ,4573,923,797,6293
11/4/2013,2013,11,4, 6 ,4718,959,829,6506
11/4/2013,2013,11,4, 7 ,4847,977,811,6635
11/4/2013,2013,11,4, 8 ,5592,1042,905,7539
11/4/2013,2013,11,4, 9 ,6388,1170,1073,8631
11/4/2013,2013,11,4, 10 ,6837,1313,1132,9282
11/4/2013,2013,11,4, 11 ,7158,1368,1201,9727
11/4/2013,2013,11,4, 12 ,7051,1326,1193,9570
11/4/2013,2013,11,4, 13 ,6957,1314,1197,9468
11/4/2013,2013,11,4, 14 ,7175,1351,1234,9760
11/4/2013,2013,11,4, 15 ,7025,1337,1224,9586
11/4/2013,2013,11,4, 16 ,6899,1320,1212,9431
11/4/2013,2013,11,4, 17 ,6727,1340,1217,9284
11/4/2013,2013,11,4, 18 ,7098,1463,1349,9910
11/4/2013,2013,11,4, 19 ,6833,1404,1269,9506
11/4/2013,2013,11,4, 20 ,6687,1264,1240,9191
11/4/2013,2013,11,4, 21 ,6475,1139,1166,8780
11/4/2013,2013,11,4, 22 ,6103,1081,1058,8242
11/4/2013,2013,11,4, 23 ,5674,1010,927,7611
11/4/2013,2013,11,4, 24 ,5303,959,869,7131
11/5/2013,2013,11,5, 1 ,5065,936,846,6847
11/5/2013,2013,11,5, 2 ,4963,916,825,6704
11/5/2013,2013,11,5, 3 ,4835,896,808,6539
11/5/2013,2013,11,5, 4 ,4762,900,790,6452
11/5/2013,2013,11,5, 5 ,4954,941,853,6748
11/5/2013,2013,11,5, 6 ,5005,968,872,6845
11/5/2013,2013,11,5, 7 ,5074,945,831,6850
11/5/2013,2013,11,5, 8 ,5807,1083,964,7854
11/5/2013,2013,11,5, 9 ,6462,1258,1149,8869
11/5/2013,2013,11,5, 10 ,6889,1335,1243,9467
11/5/2013,2013,11,5, 11 ,7077,1393,1302,9772
11/5/2013,2013,11,5, 12 ,6849,1369,1267,9485
11/5/2013,2013,11,5, 13 ,6793,1379,1282,9454
11/5/2013,2013,11,5, 14 ,6966,1433,1306,9705
11/5/2013,2013,11,5, 15 ,6826,1397,1272,9495
11/5/2013,2013,11,5, 16 ,6790,1380,1259,9429
11/5/2013,2013,11,5, 17 ,6611,1324,1246,9181
11/5/2013,2013,11,5, 18 ,6999,1517,1377,9893
11/5/2013,2013,11,5, 19 ,6884,1481,1319,9684
11/5/2013,2013,11,5, 20 ,6658,1430,1267,9355
11/5/2013,2013,11,5, 21 ,6387,1354,1167,8908
11/5/2013,2013,11,5, 22 ,5992,1235,1065,8292
11/5/2013,2013,11,5, 23 ,5605,1132,959,7696
11/5/2013,2013,11,5, 24 ,5267,1062,899,7228
11/6/2013,2013,11,6, 1 ,5021,1020,860,6901
11/6/2013,2013,11,6, 2 ,4914,986,840,6740
11/6/2013,2013,11,6, 3 ,4800,958,818,6576
11/6/2013,2013,11,6, 4 ,4729,950,825,6504
11/6/2013,2013,11,6, 5 ,4883,989,874,6746
11/6/2013,2013,11,6, 6 ,5004,1014,896,6914
11/6/2013,2013,11,6, 7 ,5126,974,822,6922
11/6/2013,2013,11,6, 8 ,5842,1120,982,7944
11/6/2013,2013,11,6, 9 ,6596,1322,1144,9062
11/6/2013,2013,11,6, 10 ,7020,1424,1255,9699
11/6/2013,2013,11,6, 11 ,7343,1458,1274,10075
11/6/2013,2013,11,6, 12 ,7171,1426,1265,9862
11/6/2013,2013,11,6, 13 ,7096,1423,1274,9793
11/6/2013,2013,11,6, 14 ,7374,1475,1307,10156
11/6/2013,2013,11,6, 15 ,7231,1452,1291,9974
11/6/2013,2013,11,6, 16 ,7122,1423,1213,9758
11/6/2013,2013,11,6, 17 ,6813,1357,1241,9411
11/6/2013,2013,11,6, 18 ,7193,1516,1382,10091
11/6/2013,2013,11,6, 19 ,7050,1492,1286,9828
11/6/2013,2013,11,6, 20 ,6799,1429,1279,9507
11/6/2013,2013,11,6, 21 ,6580,1350,1210,9140
11/6/2013,2013,11,6, 22 ,6202,1264,1104,8570
11/6/2013,2013,11,6, 23 ,5859,1160,1009,8028
11/6/2013,2013,11,6, 24 ,5428,1079,926,7433
11/7/2013,2013,11,7, 1 ,5239,1027,883,7149
11/7/2013,2013,11,7, 2 ,5059,994,859,6912
11/7/2013,2013,11,7, 3 ,4920,962,841,6723
11/7/2013,2013,11,7, 4 ,4807,960,831,6598
11/7/2013,2013,11,7, 5 ,4989,975,885,6849
11/7/2013,2013,11,7, 6 ,5111,1009,923,7043
11/7/2013,2013,11,7, 7 ,5126,1001,874,7001
11/7/2013,2013,11,7, 8 ,5877,1105,986,7968
11/7/2013,2013,11,7, 9 ,6516,1284,1124,8924
11/7/2013,2013,11,7, 10 ,6964,1345,1205,9514
11/7/2013,2013,11,7, 11 ,7232,1350,1221,9803
11/7/2013,2013,11,7, 12 ,7048,1300,1203,9551
11/7/2013,2013,11,7, 13 ,6996,1248,1196,9440
11/7/2013,2013,11,7, 14 ,7261,1278,1213,9752
11/7/2013,2013,11,7, 15 ,7212,1212,1187,9611
11/7/2013,2013,11,7, 16 ,7056,1174,1190,9420
11/7/2013,2013,11,7, 17 ,6769,1153,1211,9133
11/7/2013,2013,11,7, 18 ,7215,1265,1333,9813
11/7/2013,2013,11,7, 19 ,6962,1213,1260,9435
11/7/2013,2013,11,7, 20 ,6788,1155,1200,9143
11/7/2013,2013,11,7, 21 ,6562,1049,1121,8732
11/7/2013,2013,11,7, 22 ,6127,961,1018,8106
11/7/2013,2013,11,7, 23 ,5781,880,927,7588
11/7/2013,2013,11,7, 24 ,5436,818,916,7170
11/8/2013,2013,11,8, 1 ,5172,785,838,6795
11/8/2013,2013,11,8, 2 ,5010,747,801,6558
11/8/2013,2013,11,8, 3 ,4912,729,792,6433
11/8/2013,2013,11,8, 4 ,4774,714,773,6261
11/8/2013,2013,11,8, 5 ,4944,701,797,6442
11/8/2013,2013,11,8, 6 ,5113,677,864,6654
11/8/2013,2013,11,8, 7 ,5206,616,842,6664
11/8/2013,2013,11,8, 8 ,5702,570,926,7198
11/8/2013,2013,11,8, 9 ,6268,520,1051,7839
11/8/2013,2013,11,8, 10 ,6662,414,1129,8205
11/8/2013,2013,11,8, 11 ,6881,265,1161,8307
11/8/2013,2013,11,8, 12 ,6386,241,1116,7743
11/8/2013,2013,11,8, 13 ,6315,205,1127,7647
11/8/2013,2013,11,8, 14 ,6419,123,1162,7704
11/8/2013,2013,11,8, 15 ,6359,61,1161,7581
11/8/2013,2013,11,8, 16 ,6259,65,1145,7469
11/8/2013,2013,11,8, 17 ,6268,76,1179,7523
11/8/2013,2013,11,8, 18 ,6368,103,1288,7759
11/8/2013,2013,11,8, 19 ,5957,89,1244,7290
11/8/2013,2013,11,8, 20 ,5749,131,1174,7054
11/8/2013,2013,11,8, 21 ,5508,165,1123,6796
11/8/2013,2013,11,8, 22 ,5215,161,1022,6398
11/8/2013,2013,11,8, 23 ,4925,192,927,6044
11/8/2013,2013,11,8, 24 ,4573,213,894,5680
11/9/2013,2013,11,9, 1 ,4422,214,815,5451
11/9/2013,2013,11,9, 2 ,4284,239,789,5312
11/9/2013,2013,11,9, 3 ,4244,257,786,5287
11/9/2013,2013,11,9, 4 ,4200,279,768,5247
11/9/2013,2013,11,9, 5 ,4260,282,799,5341
11/9/2013,2013,11,9, 6 ,4302,316,824,5442
11/9/2013,2013,11,9, 7 ,4545,373,808,5726
11/9/2013,2013,11,9, 8 ,4989,429,897,6315
11/9/2013,2013,11,9, 9 ,5472,504,1031,7007
11/9/2013,2013,11,9, 10 ,5920,576,1129,7625
11/9/2013,2013,11,9, 11 ,6197,607,1187,7991
11/9/2013,2013,11,9, 12 ,6112,578,1172,7862
11/9/2013,2013,11,9, 13 ,6092,575,1192,7859
11/9/2013,2013,11,9, 14 ,6272,593,1219,8084
11/9/2013,2013,11,9, 15 ,6192,625,1196,8013
11/9/2013,2013,11,9, 16 ,6112,634,1158,7904
11/9/2013,2013,11,9, 17 ,6030,652,1183,7865
11/9/2013,2013,11,9, 18 ,6582,718,1317,8617
11/9/2013,2013,11,9, 19 ,6507,735,1258,8500
11/9/2013,2013,11,9, 20 ,6397,718,1196,8311
11/9/2013,2013,11,9, 21 ,6225,702,1125,8052
11/9/2013,2013,11,9, 22 ,6001,702,1082,7785
11/9/2013,2013,11,9, 23 ,5641,717,978,7336
11/9/2013,2013,11,9, 24 ,5328,605,880,6813
11/10/2013,2013,11,10, 1 ,5090,600,861,6551
11/10/2013,2013,11,10, 2 ,4926,587,821,6334
11/10/2013,2013,11,10, 3 ,4809,571,798,6178
11/10/2013,2013,11,10, 4 ,4609,565,780,5954
11/10/2013,2013,11,10, 5 ,4573,566,790,5929
11/10/2013,2013,11,10, 6 ,4538,556,803,5897
11/10/2013,2013,11,10, 7 ,4609,582,761,5952
11/10/2013,2013,11,10, 8 ,4928,606,805,6339
11/10/2013,2013,11,10, 9 ,5222,664,880,6766
11/10/2013,2013,11,10, 10 ,5682,717,962,7361
11/10/2013,2013,11,10, 11 ,5881,757,1041,7679
11/10/2013,2013,11,10, 12 ,5828,761,1030,7619
11/10/2013,2013,11,10, 13 ,5831,767,1043,7641
11/10/2013,2013,11,10, 14 ,5810,769,1040,7619
11/10/2013,2013,11,10, 15 ,5686,764,1017,7467
11/10/2013,2013,11,10, 16 ,5544,758,994,7296
11/10/2013,2013,11,10, 17 ,5423,755,1021,7199
11/10/2013,2013,11,10, 18 ,6183,892,1249,8324
11/10/2013,2013,11,10, 19 ,6261,873,1221,8355
11/10/2013,2013,11,10, 20 ,6235,852,1203,8290
11/10/2013,2013,11,10, 21 ,6023,828,1123,7974
11/10/2013,2013,11,10, 22 ,5747,776,1035,7558
11/10/2013,2013,11,10, 23 ,5375,715,921,7011
11/10/2013,2013,11,10, 24 ,5151,670,845,6666
11/11/2013,2013,11,11, 1 ,4867,633,827,6327
11/11/2013,2013,11,11, 2 ,4714,611,802,6127
11/11/2013,2013,11,11, 3 ,4556,595,784,5935
11/11/2013,2013,11,11, 4 ,4530,590,783,5903
11/11/2013,2013,11,11, 5 ,4684,621,834,6139
11/11/2013,2013,11,11, 6 ,4934,647,862,6443
11/11/2013,2013,11,11, 7 ,5117,638,815,6570
11/11/2013,2013,11,11, 8 ,5646,718,912,7276
11/11/2013,2013,11,11, 9 ,6481,873,1121,8475
11/11/2013,2013,11,11, 10 ,6988,916,1215,9119
11/11/2013,2013,11,11, 11 ,7205,953,1231,9389
11/11/2013,2013,11,11, 12 ,7078,944,1207,9229
11/11/2013,2013,11,11, 13 ,7036,947,1191,9174
11/11/2013,2013,11,11, 14 ,7173,1006,1222,9401
11/11/2013,2013,11,11, 15 ,7081,975,1206,9262
11/11/2013,2013,11,11, 16 ,6957,965,1199,9121
11/11/2013,2013,11,11, 17 ,6765,953,1213,8931
11/11/2013,2013,11,11, 18 ,7153,1045,1317,9515
11/11/2013,2013,11,11, 19 ,6908,1020,1245,9173
11/11/2013,2013,11,11, 20 ,6691,972,1199,8862
11/11/2013,2013,11,11, 21 ,6449,920,1082,8451
11/11/2013,2013,11,11, 22 ,6083,866,1019,7968
11/11/2013,2013,11,11, 23 ,5715,807,926,7448
11/11/2013,2013,11,11, 24 ,5365,762,899,7026
11/12/2013,2013,11,12, 1 ,5099,725,817,6641
11/12/2013,2013,11,12, 2 ,4942,699,785,6426
11/12/2013,2013,11,12, 3 ,4802,679,780,6261
11/12/2013,2013,11,12, 4 ,4747,668,773,6188
11/12/2013,2013,11,12, 5 ,4880,689,818,6387
11/12/2013,2013,11,12, 6 ,5069,722,897,6688
11/12/2013,2013,11,12, 7 ,5096,712,874,6682
11/12/2013,2013,11,12, 8 ,5803,788,963,7554
11/12/2013,2013,11,12, 9 ,6532,912,1072,8516
11/12/2013,2013,11,12, 10 ,6944,967,1147,9058
11/12/2013,2013,11,12, 11 ,7126,979,1181,9286
11/12/2013,2013,11,12, 12 ,6980,943,1151,9074
11/12/2013,2013,11,12, 13 ,6865,954,1152,8971
11/12/2013,2013,11,12, 14 ,7182,983,1171,9336
11/12/2013,2013,11,12, 15 ,7006,979,1165,9150
11/12/2013,2013,11,12, 16 ,6891,980,1178,9049
11/12/2013,2013,11,12, 17 ,6663,981,1207,8851
11/12/2013,2013,11,12, 18 ,7108,1037,1310,9455
11/12/2013,2013,11,12, 19 ,6905,994,1218,9117
11/12/2013,2013,11,12, 20 ,6732,941,1195,8868
11/12/2013,2013,11,12, 21 ,6446,892,1090,8428
11/12/2013,2013,11,12, 22 ,6043,814,1028,7885
11/12/2013,2013,11,12, 23 ,5621,753,918,7292
11/12/2013,2013,11,12, 24 ,5400,714,806,6920
11/13/2013,2013,11,13, 1 ,5088,686,815,6589
11/13/2013,2013,11,13, 2 ,4984,668,788,6440
11/13/2013,2013,11,13, 3 ,4881,660,774,6315
11/13/2013,2013,11,13, 4 ,4848,657,777,6282
11/13/2013,2013,11,13, 5 ,4977,683,834,6494
11/13/2013,2013,11,13, 6 ,5109,711,882,6702
11/13/2013,2013,11,13, 7 ,5151,700,839,6690
11/13/2013,2013,11,13, 8 ,5746,802,955,7503
11/13/2013,2013,11,13, 9 ,6363,936,1111,8410
11/13/2013,2013,11,13, 10 ,6744,1008,1196,8948
11/13/2013,2013,11,13, 11 ,6918,1048,1260,9226
11/13/2013,2013,11,13, 12 ,6681,1008,1258,8947
11/13/2013,2013,11,13, 13 ,6586,1010,1238,8834
11/13/2013,2013,11,13, 14 ,6860,1025,1268,9153
11/13/2013,2013,11,13, 15 ,6805,1016,1208,9029
11/13/2013,2013,11,13, 16 ,6842,1015,1222,9079
11/13/2013,2013,11,13, 17 ,6731,994,1221,8946
11/13/2013,2013,11,13, 18 ,7123,1076,1319,9518
11/13/2013,2013,11,13, 19 ,6944,1038,1279,9261
11/13/2013,2013,11,13, 20 ,6747,1013,1265,9025
11/13/2013,2013,11,13, 21 ,6414,959,1158,8531
11/13/2013,2013,11,13, 22 ,6036,886,1075,7997
11/13/2013,2013,11,13, 23 ,5696,826,963,7485
11/13/2013,2013,11,13, 24 ,5276,764,853,6893
11/14/2013,2013,11,14, 1 ,5001,733,855,6589
11/14/2013,2013,11,14, 2 ,4929,712,827,6468
11/14/2013,2013,11,14, 3 ,4768,689,807,6264
11/14/2013,2013,11,14, 4 ,4781,690,804,6275
11/14/2013,2013,11,14, 5 ,4982,711,851,6544
11/14/2013,2013,11,14, 6 ,5124,741,905,6770
11/14/2013,2013,11,14, 7 ,5192,726,844,6762
11/14/2013,2013,11,14, 8 ,5769,840,964,7573
11/14/2013,2013,11,14, 9 ,6587,983,1141,8711
11/14/2013,2013,11,14, 10 ,7079,1027,1235,9341
11/14/2013,2013,11,14, 11 ,7348,1061,1285,9694
11/14/2013,2013,11,14, 12 ,7216,1035,1281,9532
11/14/2013,2013,11,14, 13 ,7195,1040,1247,9482
11/14/2013,2013,11,14, 14 ,7466,1072,1286,9824
11/14/2013,2013,11,14, 15 ,7351,1057,1251,9659
11/14/2013,2013,11,14, 16 ,7212,1009,1243,9464
11/14/2013,2013,11,14, 17 ,6975,1008,1264,9247
11/14/2013,2013,11,14, 18 ,7440,1101,1361,9902
11/14/2013,2013,11,14, 19 ,7232,1064,1324,9620
11/14/2013,2013,11,14, 20 ,7000,1034,1280,9314
11/14/2013,2013,11,14, 21 ,6766,973,1219,8958
11/14/2013,2013,11,14, 22 ,6379,905,1089,8373
11/14/2013,2013,11,14, 23 ,5967,837,986,7790
11/14/2013,2013,11,14, 24 ,5587,784,912,7283
11/15/2013,2013,11,15, 1 ,5367,752,855,6974
11/15/2013,2013,11,15, 2 ,5114,734,819,6667
11/15/2013,2013,11,15, 3 ,5029,709,805,6543
11/15/2013,2013,11,15, 4 ,5086,701,803,6590
11/15/2013,2013,11,15, 5 ,5145,719,854,6718
11/15/2013,2013,11,15, 6 ,5218,738,889,6845
11/15/2013,2013,11,15, 7 ,5274,728,841,6843
11/15/2013,2013,11,15, 8 ,5911,830,953,7694
11/15/2013,2013,11,15, 9 ,6660,989,1127,8776
11/15/2013,2013,11,15, 10 ,7202,1075,1230,9507
11/15/2013,2013,11,15, 11 ,7450,1082,1269,9801
11/15/2013,2013,11,15, 12 ,7343,1088,1270,9701
11/15/2013,2013,11,15, 13 ,7278,1043,1240,9561
11/15/2013,2013,11,15, 14 ,7488,1126,1293,9907
11/15/2013,2013,11,15, 15 ,7363,1095,1277,9735
11/15/2013,2013,11,15, 16 ,7214,1062,1246,9522
11/15/2013,2013,11,15, 17 ,6894,1026,1223,9143
11/15/2013,2013,11,15, 18 ,7303,1092,1370,9765
11/15/2013,2013,11,15, 19 ,7134,1065,1315,9514
11/15/2013,2013,11,15, 20 ,6938,1038,1264,9240
11/15/2013,2013,11,15, 21 ,6724,985,1196,8905
11/15/2013,2013,11,15, 22 ,6329,927,1109,8365
11/15/2013,2013,11,15, 23 ,6051,863,1023,7937
11/15/2013,2013,11,15, 24 ,5597,799,1003,7399
11/16/2013,2013,11,16, 1 ,5381,765,859,7005
11/16/2013,2013,11,16, 2 ,5163,736,830,6729
11/16/2013,2013,11,16, 3 ,5043,716,809,6568
11/16/2013,2013,11,16, 4 ,4999,706,811,6516
11/16/2013,2013,11,16, 5 ,4944,717,836,6497
11/16/2013,2013,11,16, 6 ,4934,719,841,6494
11/16/2013,2013,11,16, 7 ,4979,729,832,6540
11/16/2013,2013,11,16, 8 ,5588,802,909,7299
11/16/2013,2013,11,16, 9 ,6069,919,1022,8010
11/16/2013,2013,11,16, 10 ,6516,975,1115,8606
11/16/2013,2013,11,16, 11 ,6723,1013,1168,8904
11/16/2013,2013,11,16, 12 ,6621,986,1149,8756
11/16/2013,2013,11,16, 13 ,6655,979,1152,8786
11/16/2013,2013,11,16, 14 ,6761,1006,1145,8912
11/16/2013,2013,11,16, 15 ,6588,985,1138,8711
11/16/2013,2013,11,16, 16 ,6364,950,1122,8436
11/16/2013,2013,11,16, 17 ,6130,921,1122,8173
11/16/2013,2013,11,16, 18 ,6756,1035,1315,9106
11/16/2013,2013,11,16, 19 ,6646,1010,1280,8936
11/16/2013,2013,11,16, 20 ,6572,982,1262,8816
11/16/2013,2013,11,16, 21 ,6416,938,1150,8504
11/16/2013,2013,11,16, 22 ,6179,884,1092,8155
11/16/2013,2013,11,16, 23 ,5843,830,985,7658
11/16/2013,2013,11,16, 24 ,5497,770,890,7157
11/17/2013,2013,11,17, 1 ,5254,738,840,6832
11/17/2013,2013,11,17, 2 ,5076,714,811,6601
11/17/2013,2013,11,17, 3 ,4896,698,787,6381
11/17/2013,2013,11,17, 4 ,4767,687,772,6226
11/17/2013,2013,11,17, 5 ,4723,687,793,6203
11/17/2013,2013,11,17, 6 ,4608,678,800,6086
11/17/2013,2013,11,17, 7 ,4568,678,775,6021
11/17/2013,2013,11,17, 8 ,4859,711,814,6384
11/17/2013,2013,11,17, 9 ,5308,770,874,6952
11/17/2013,2013,11,17, 10 ,5597,819,962,7378
11/17/2013,2013,11,17, 11 ,5813,856,1014,7683
11/17/2013,2013,11,17, 12 ,5842,865,1024,7731
11/17/2013,2013,11,17, 13 ,5804,861,1019,7684
11/17/2013,2013,11,17, 14 ,5800,844,1032,7676
11/17/2013,2013,11,17, 15 ,5716,836,1017,7569
11/17/2013,2013,11,17, 16 ,5585,827,1002,7414
11/17/2013,2013,11,17, 17 ,5519,831,997,7347
11/17/2013,2013,11,17, 18 ,6246,980,1262,8488
11/17/2013,2013,11,17, 19 ,6321,969,1244,8534
11/17/2013,2013,11,17, 20 ,6206,934,1191,8331
11/17/2013,2013,11,17, 21 ,6022,895,1115,8032
11/17/2013,2013,11,17, 22 ,5686,843,1033,7562
11/17/2013,2013,11,17, 23 ,5371,784,941,7096
11/17/2013,2013,11,17, 24 ,5078,740,812,6630
11/18/2013,2013,11,18, 1 ,4805,709,833,6347
11/18/2013,2013,11,18, 2 ,4614,677,803,6094
11/18/2013,2013,11,18, 3 ,4427,661,781,5869
11/18/2013,2013,11,18, 4 ,4410,663,774,5847
11/18/2013,2013,11,18, 5 ,4640,692,828,6160
11/18/2013,2013,11,18, 6 ,4797,720,866,6383
11/18/2013,2013,11,18, 7 ,4896,715,824,6435
11/18/2013,2013,11,18, 8 ,5631,832,937,7400
11/18/2013,2013,11,18, 9 ,6463,984,1140,8587
11/18/2013,2013,11,18, 10 ,7008,1062,1254,9324
11/18/2013,2013,11,18, 11 ,7284,1080,1292,9656
11/18/2013,2013,11,18, 12 ,7104,1079,1273,9456
11/18/2013,2013,11,18, 13 ,7057,1077,1268,9402
11/18/2013,2013,11,18, 14 ,7270,1119,1319,9708
11/18/2013,2013,11,18, 15 ,7129,1114,1313,9556
11/18/2013,2013,11,18, 16 ,7071,1101,1286,9458
11/18/2013,2013,11,18, 17 ,6770,1051,1268,9089
11/18/2013,2013,11,18, 18 ,7213,1130,1380,9723
11/18/2013,2013,11,18, 19 ,6991,1106,1314,9411
11/18/2013,2013,11,18, 20 ,6796,1069,1315,9180
11/18/2013,2013,11,18, 21 ,6558,1016,1223,8797
11/18/2013,2013,11,18, 22 ,6107,938,1123,8168
11/18/2013,2013,11,18, 23 ,5702,866,1008,7576
11/18/2013,2013,11,18, 24 ,5418,799,947,7164
11/19/2013,2013,11,19, 1 ,5160,770,880,6810
11/19/2013,2013,11,19, 2 ,5010,748,848,6606
11/19/2013,2013,11,19, 3 ,4889,728,828,6445
11/19/2013,2013,11,19, 4 ,4907,720,822,6449
11/19/2013,2013,11,19, 5 ,5108,750,878,6736
11/19/2013,2013,11,19, 6 ,5213,763,905,6881
11/19/2013,2013,11,19, 7 ,5256,752,846,6854
11/19/2013,2013,11,19, 8 ,5847,860,958,7665
11/19/2013,2013,11,19, 9 ,6561,1031,1124,8716
11/19/2013,2013,11,19, 10 ,7024,1077,1234,9335
11/19/2013,2013,11,19, 11 ,7227,1101,1286,9614
11/19/2013,2013,11,19, 12 ,7092,1082,1243,9417
11/19/2013,2013,11,19, 13 ,6950,1084,1236,9270
11/19/2013,2013,11,19, 14 ,7155,1114,1287,9556
11/19/2013,2013,11,19, 15 ,7029,1095,1263,9387
11/19/2013,2013,11,19, 16 ,6941,1096,1237,9274
11/19/2013,2013,11,19, 17 ,6671,1071,1239,8981
11/19/2013,2013,11,19, 18 ,7128,1121,1325,9574
11/19/2013,2013,11,19, 19 ,6885,1104,1298,9287
11/19/2013,2013,11,19, 20 ,6697,1064,1229,8990
11/19/2013,2013,11,19, 21 ,6386,1013,1165,8564
11/19/2013,2013,11,19, 22 ,5996,935,1070,8001
11/19/2013,2013,11,19, 23 ,5592,869,953,7414
11/19/2013,2013,11,19, 24 ,5320,817,894,7031
11/20/2013,2013,11,20, 1 ,5025,785,864,6674
11/20/2013,2013,11,20, 2 ,4920,761,831,6512
11/20/2013,2013,11,20, 3 ,4809,740,822,6371
11/20/2013,2013,11,20, 4 ,4795,736,818,6349
11/20/2013,2013,11,20, 5 ,4952,761,882,6595
11/20/2013,2013,11,20, 6 ,5102,773,907,6782
11/20/2013,2013,11,20, 7 ,5163,758,837,6758
11/20/2013,2013,11,20, 8 ,5870,857,979,7706
11/20/2013,2013,11,20, 9 ,6442,1012,1134,8588
11/20/2013,2013,11,20, 10 ,6891,1072,1239,9202
11/20/2013,2013,11,20, 11 ,7151,1116,1277,9544
11/20/2013,2013,11,20, 12 ,6976,1085,1254,9315
11/20/2013,2013,11,20, 13 ,6893,1080,1253,9226
11/20/2013,2013,11,20, 14 ,7215,1122,1286,9623
11/20/2013,2013,11,20, 15 ,7026,1101,1240,9367
11/20/2013,2013,11,20, 16 ,6934,1083,1233,9250
11/20/2013,2013,11,20, 17 ,6746,1046,1225,9017
11/20/2013,2013,11,20, 18 ,7207,1131,1322,9660
11/20/2013,2013,11,20, 19 ,7014,1101,1299,9414
11/20/2013,2013,11,20, 20 ,6752,1059,1263,9074
11/20/2013,2013,11,20, 21 ,6527,994,1199,8720
11/20/2013,2013,11,20, 22 ,6105,937,1081,8123
11/20/2013,2013,11,20, 23 ,5720,858,974,7552
11/20/2013,2013,11,20, 24 ,5399,807,951,7157
11/21/2013,2013,11,21, 1 ,5210,761,871,6842
11/21/2013,2013,11,21, 2 ,5038,724,849,6611
11/21/2013,2013,11,21, 3 ,4874,717,829,6420
11/21/2013,2013,11,21, 4 ,4842,724,833,6399
11/21/2013,2013,11,21, 5 ,5013,759,886,6658
11/21/2013,2013,11,21, 6 ,5168,761,911,6840
11/21/2013,2013,11,21, 7 ,5214,774,844,6832
11/21/2013,2013,11,21, 8 ,5789,918,963,7670
11/21/2013,2013,11,21, 9 ,6490,1037,1152,8679
11/21/2013,2013,11,21, 10 ,6934,1075,1230,9239
11/21/2013,2013,11,21, 11 ,6835,1103,1278,9216
11/21/2013,2013,11,21, 12 ,6744,1077,1283,9104
11/21/2013,2013,11,21, 13 ,6720,1081,1288,9089
11/21/2013,2013,11,21, 14 ,6960,1129,1262,9351
11/21/2013,2013,11,21, 15 ,6904,1118,1246,9268
11/21/2013,2013,11,21, 16 ,6857,1087,1224,9168
11/21/2013,2013,11,21, 17 ,6652,1027,1227,8906
11/21/2013,2013,11,21, 18 ,7115,1130,1297,9542
11/21/2013,2013,11,21, 19 ,6962,1090,1247,9299
11/21/2013,2013,11,21, 20 ,6746,1055,1228,9029
11/21/2013,2013,11,21, 21 ,6484,1014,1160,8658
11/21/2013,2013,11,21, 22 ,6225,930,1064,8219
11/21/2013,2013,11,21, 23 ,5782,873,956,7611
11/21/2013,2013,11,21, 24 ,5381,814,937,7132
11/22/2013,2013,11,22, 1 ,5164,783,848,6795
11/22/2013,2013,11,22, 2 ,4978,762,823,6563
11/22/2013,2013,11,22, 3 ,4833,744,806,6383
11/22/2013,2013,11,22, 4 ,4754,741,805,6300
11/22/2013,2013,11,22, 5 ,4962,768,859,6589
11/22/2013,2013,11,22, 6 ,5063,782,910,6755
11/22/2013,2013,11,22, 7 ,5200,752,870,6822
11/22/2013,2013,11,22, 8 ,5792,841,953,7586
11/22/2013,2013,11,22, 9 ,6499,1004,1103,8606
11/22/2013,2013,11,22, 10 ,6931,1064,1193,9188
11/22/2013,2013,11,22, 11 ,7118,1096,1215,9429
11/22/2013,2013,11,22, 12 ,7034,1072,1186,9292
11/22/2013,2013,11,22, 13 ,6894,1081,1165,9140
11/22/2013,2013,11,22, 14 ,7081,1118,1207,9406
11/22/2013,2013,11,22, 15 ,6981,1094,1190,9265
11/22/2013,2013,11,22, 16 ,6842,1086,1194,9122
11/22/2013,2013,11,22, 17 ,6691,1057,1225,8973
11/22/2013,2013,11,22, 18 ,7135,1136,1308,9579
11/22/2013,2013,11,22, 19 ,6901,1094,1246,9241
11/22/2013,2013,11,22, 20 ,6735,1056,1196,8987
11/22/2013,2013,11,22, 21 ,6441,1003,1111,8555
11/22/2013,2013,11,22, 22 ,6139,921,1008,8068
11/22/2013,2013,11,22, 23 ,5807,840,916,7563
11/22/2013,2013,11,22, 24 ,5403,792,851,7046
11/23/2013,2013,11,23, 1 ,5115,756,804,6675
11/23/2013,2013,11,23, 2 ,4961,737,789,6487
11/23/2013,2013,11,23, 3 ,4826,722,771,6319
11/23/2013,2013,11,23, 4 ,4736,716,764,6216
11/23/2013,2013,11,23, 5 ,4805,729,752,6286
11/23/2013,2013,11,23, 6 ,4821,735,823,6379
11/23/2013,2013,11,23, 7 ,4904,751,818,6473
11/23/2013,2013,11,23, 8 ,5409,805,877,7091
11/23/2013,2013,11,23, 9 ,5911,926,967,7804
11/23/2013,2013,11,23, 10 ,6350,977,1070,8397
11/23/2013,2013,11,23, 11 ,6568,1017,1136,8721
11/23/2013,2013,11,23, 12 ,6418,984,1129,8531
11/23/2013,2013,11,23, 13 ,6299,963,1133,8395
11/23/2013,2013,11,23, 14 ,6476,1010,1169,8655
11/23/2013,2013,11,23, 15 ,6387,985,1148,8520
11/23/2013,2013,11,23, 16 ,6238,970,1105,8313
11/23/2013,2013,11,23, 17 ,6212,952,1122,8286
11/23/2013,2013,11,23, 18 ,6713,1067,1314,9094
11/23/2013,2013,11,23, 19 ,6609,1046,1271,8926
11/23/2013,2013,11,23, 20 ,6488,1012,1235,8735
11/23/2013,2013,11,23, 21 ,6284,959,1163,8406
11/23/2013,2013,11,23, 22 ,5960,891,1072,7923
11/23/2013,2013,11,23, 23 ,5638,837,966,7441
11/23/2013,2013,11,23, 24 ,5218,788,907,6913
11/24/2013,2013,11,24, 1 ,4968,763,858,6589
11/24/2013,2013,11,24, 2 ,4834,732,828,6394
11/24/2013,2013,11,24, 3 ,4703,718,804,6225
11/24/2013,2013,11,24, 4 ,4599,718,794,6111
11/24/2013,2013,11,24, 5 ,4632,714,788,6134
11/24/2013,2013,11,24, 6 ,4539,706,811,6056
11/24/2013,2013,11,24, 7 ,4549,707,803,6059
11/24/2013,2013,11,24, 8 ,4849,752,844,6445
11/24/2013,2013,11,24, 9 ,5257,813,926,6996
11/24/2013,2013,11,24, 10 ,5695,880,1029,7604
11/24/2013,2013,11,24, 11 ,5986,915,1097,7998
11/24/2013,2013,11,24, 12 ,5934,926,1106,7966
11/24/2013,2013,11,24, 13 ,5915,925,1110,7950
11/24/2013,2013,11,24, 14 ,5903,931,1116,7950
11/24/2013,2013,11,24, 15 ,5845,923,1100,7868
11/24/2013,2013,11,24, 16 ,5504,873,1047,7424
11/24/2013,2013,11,24, 17 ,5545,873,1053,7471
11/24/2013,2013,11,24, 18 ,6271,1027,1274,8572
11/24/2013,2013,11,24, 19 ,6310,1031,1256,8597
11/24/2013,2013,11,24, 20 ,6292,1012,1208,8512
11/24/2013,2013,11,24, 21 ,6061,980,1141,8182
11/24/2013,2013,11,24, 22 ,5712,922,1018,7652
11/24/2013,2013,11,24, 23 ,5385,858,940,7183
11/24/2013,2013,11,24, 24 ,5051,727,804,6582
11/25/2013,2013,11,25, 1 ,4756,661,829,6246
11/25/2013,2013,11,25, 2 ,4589,664,800,6053
11/25/2013,2013,11,25, 3 ,4477,649,777,5903
11/25/2013,2013,11,25, 4 ,4450,702,765,5917
11/25/2013,2013,11,25, 5 ,4640,739,817,6196
11/25/2013,2013,11,25, 6 ,4863,770,858,6491
11/25/2013,2013,11,25, 7 ,4996,764,814,6574
11/25/2013,2013,11,25, 8 ,5755,838,935,7528
11/25/2013,2013,11,25, 9 ,6466,991,1109,8566
11/25/2013,2013,11,25, 10 ,6972,1123,1223,9318
11/25/2013,2013,11,25, 11 ,7219,1165,1286,9670
11/25/2013,2013,11,25, 12 ,7116,1103,1294,9513
11/25/2013,2013,11,25, 13 ,7043,1104,1285,9432
11/25/2013,2013,11,25, 14 ,7295,1118,1312,9725
11/25/2013,2013,11,25, 15 ,7199,1143,1287,9629
11/25/2013,2013,11,25, 16 ,7129,1095,1269,9493
11/25/2013,2013,11,25, 17 ,6852,1041,1249,9142
11/25/2013,2013,11,25, 18 ,7371,1164,1396,9931
11/25/2013,2013,11,25, 19 ,7174,1141,1351,9666
11/25/2013,2013,11,25, 20 ,6929,1136,1312,9377
11/25/2013,2013,11,25, 21 ,6757,1079,1224,9060
11/25/2013,2013,11,25, 22 ,6411,997,1133,8541
11/25/2013,2013,11,25, 23 ,5980,915,998,7893
11/25/2013,2013,11,25, 24 ,5606,856,935,7397
11/26/2013,2013,11,26, 1 ,5321,815,891,7027
11/26/2013,2013,11,26, 2 ,5164,793,866,6823
11/26/2013,2013,11,26, 3 ,4982,773,827,6582
11/26/2013,2013,11,26, 4 ,4952,768,837,6557
11/26/2013,2013,11,26, 5 ,5122,793,894,6809
11/26/2013,2013,11,26, 6 ,5247,812,915,6974
11/26/2013,2013,11,26, 7 ,5273,791,860,6924
11/26/2013,2013,11,26, 8 ,6010,907,974,7891
11/26/2013,2013,11,26, 9 ,6723,1073,1133,8929
11/26/2013,2013,11,26, 10 ,7210,1127,1229,9566
11/26/2013,2013,11,26, 11 ,7391,1178,1264,9833
11/26/2013,2013,11,26, 12 ,7188,1145,1237,9570
11/26/2013,2013,11,26, 13 ,7203,1121,1223,9547
11/26/2013,2013,11,26, 14 ,7387,1168,1277,9832
11/26/2013,2013,11,26, 15 ,7257,1153,1240,9650
11/26/2013,2013,11,26, 16 ,7128,1130,1228,9486
11/26/2013,2013,11,26, 17 ,6897,1101,1224,9222
11/26/2013,2013,11,26, 18 ,7296,1209,1375,9880
11/26/2013,2013,11,26, 19 ,7101,1150,1322,9573
11/26/2013,2013,11,26, 20 ,6919,1096,1245,9260
11/26/2013,2013,11,26, 21 ,6648,1040,1143,8831
11/26/2013,2013,11,26, 22 ,6347,965,1059,8371
11/26/2013,2013,11,26, 23 ,5889,882,955,7726
11/26/2013,2013,11,26, 24 ,5493,837,884,7214
11/27/2013,2013,11,27, 1 ,5200,793,852,6845
11/27/2013,2013,11,27, 2 ,5063,757,885,6705
11/27/2013,2013,11,27, 3 ,4913,742,797,6452
11/27/2013,2013,11,27, 4 ,4833,743,806,6382
11/27/2013,2013,11,27, 5 ,5045,767,861,6673
11/27/2013,2013,11,27, 6 ,5224,799,904,6927
11/27/2013,2013,11,27, 7 ,5225,770,838,6833
11/27/2013,2013,11,27, 8 ,5949,897,983,7829
11/27/2013,2013,11,27, 9 ,6710,1037,1132,8879
11/27/2013,2013,11,27, 10 ,7199,1109,1228,9536
11/27/2013,2013,11,27, 11 ,7472,1162,1282,9916
11/27/2013,2013,11,27, 12 ,7345,1113,1239,9697
11/27/2013,2013,11,27, 13 ,7270,1120,1254,9644
11/27/2013,2013,11,27, 14 ,7513,1176,1293,9982
11/27/2013,2013,11,27, 15 ,7366,1169,1272,9807
11/27/2013,2013,11,27, 16 ,7239,1165,1253,9657
11/27/2013,2013,11,27, 17 ,6907,1126,1212,9245
11/27/2013,2013,11,27, 18 ,7380,1238,1374,9992
11/27/2013,2013,11,27, 19 ,7237,1183,1323,9743
11/27/2013,2013,11,27, 20 ,7011,1188,1272,9471
11/27/2013,2013,11,27, 21 ,6776,1110,1191,9077
11/27/2013,2013,11,27, 22 ,6432,1030,1055,8517
11/27/2013,2013,11,27, 23 ,5943,935,936,7814
11/27/2013,2013,11,27, 24 ,5587,860,852,7299
11/28/2013,2013,11,28, 1 ,5311,811,858,6980
11/28/2013,2013,11,28, 2 ,5163,783,834,6780
11/28/2013,2013,11,28, 3 ,5020,768,809,6597
11/28/2013,2013,11,28, 4 ,4934,757,814,6505
11/28/2013,2013,11,28, 5 ,5163,785,864,6812
11/28/2013,2013,11,28, 6 ,5275,812,889,6976
11/28/2013,2013,11,28, 7 ,5300,793,821,6914
11/28/2013,2013,11,28, 8 ,6057,915,960,7932
11/28/2013,2013,11,28, 9 ,6747,1089,1149,8985
11/28/2013,2013,11,28, 10 ,7190,1157,1213,9560
11/28/2013,2013,11,28, 11 ,7427,1169,1245,9841
11/28/2013,2013,11,28, 12 ,7308,1158,1216,9682
11/28/2013,2013,11,28, 13 ,7286,1155,1196,9637
11/28/2013,2013,11,28, 14 ,7538,1159,1230,9927
11/28/2013,2013,11,28, 15 ,7353,1151,1205,9709
11/28/2013,2013,11,28, 16 ,7248,1150,1187,9585
11/28/2013,2013,11,28, 17 ,6985,1137,1207,9329
11/28/2013,2013,11,28, 18 ,7418,1240,1357,10015
11/28/2013,2013,11,28, 19 ,7237,1231,1300,9768
11/28/2013,2013,11,28, 20 ,6961,1148,1157,9266
11/28/2013,2013,11,28, 21 ,6776,1089,1111,8976
11/28/2013,2013,11,28, 22 ,6422,1008,1005,8435
11/28/2013,2013,11,28, 23 ,5923,923,909,7755
11/28/2013,2013,11,28, 24 ,5547,856,858,7261
11/29/2013,2013,11,29, 1 ,5286,824,818,6928
11/29/2013,2013,11,29, 2 ,5150,807,806,6763
11/29/2013,2013,11,29, 3 ,5041,791,791,6623
11/29/2013,2013,11,29, 4 ,4961,782,796,6539
11/29/2013,2013,11,29, 5 ,5083,805,841,6729
11/29/2013,2013,11,29, 6 ,5194,832,868,6894
11/29/2013,2013,11,29, 7 ,5273,809,802,6884
11/29/2013,2013,11,29, 8 ,5897,906,920,7723
11/29/2013,2013,11,29, 9 ,6674,1074,1105,8853
11/29/2013,2013,11,29, 10 ,6997,1134,1201,9332
11/29/2013,2013,11,29, 11 ,7211,1173,1253,9637
11/29/2013,2013,11,29, 12 ,6994,1149,1232,9375
11/29/2013,2013,11,29, 13 ,6882,1155,1225,9262
11/29/2013,2013,11,29, 14 ,7097,1187,1268,9552
11/29/2013,2013,11,29, 15 ,6967,1180,1252,9399
11/29/2013,2013,11,29, 16 ,6871,1159,1230,9260
11/29/2013,2013,11,29, 17 ,6632,1124,1206,8962
11/29/2013,2013,11,29, 18 ,7077,1218,1370,9665
11/29/2013,2013,11,29, 19 ,6878,1185,1281,9344
11/29/2013,2013,11,29, 20 ,6736,1139,1255,9130
11/29/2013,2013,11,29, 21 ,6387,1100,1181,8668
11/29/2013,2013,11,29, 22 ,6010,1017,1111,8138
11/29/2013,2013,11,29, 23 ,5703,931,998,7632
11/29/2013,2013,11,29, 24 ,5265,881,889,7035
11/30/2013,2013,11,30, 1 ,4989,839,868,6696
11/30/2013,2013,11,30, 2 ,4810,821,843,6474
11/30/2013,2013,11,30, 3 ,4703,801,825,6329
11/30/2013,2013,11,30, 4 ,4602,784,816,6202
11/30/2013,2013,11,30, 5 ,4656,793,835,6284
11/30/2013,2013,11,30, 6 ,4538,783,849,6170
11/30/2013,2013,11,30, 7 ,4470,787,829,6086
11/30/2013,2013,11,30, 8 ,4794,848,891,6533
11/30/2013,2013,11,30, 9 ,5264,939,989,7192
11/30/2013,2013,11,30, 10 ,5607,1003,1088,7698
11/30/2013,2013,11,30, 11 ,5803,1042,1146,7991
11/30/2013,2013,11,30, 12 ,5685,1032,1136,7853
11/30/2013,2013,11,30, 13 ,5601,1041,1142,7784
11/30/2013,2013,11,30, 14 ,5695,1063,1145,7903
11/30/2013,2013,11,30, 15 ,5645,1043,1140,7828
11/30/2013,2013,11,30, 16 ,5509,1003,1105,7617
11/30/2013,2013,11,30, 17 ,5524,987,1115,7626
11/30/2013,2013,11,30, 18 ,6132,1150,1281,8563
11/30/2013,2013,11,30, 19 ,6130,1141,1271,8542
11/30/2013,2013,11,30, 20 ,5965,1101,1231,8297
11/30/2013,2013,11,30, 21 ,5945,1059,1158,8162
11/30/2013,2013,11,30, 22 ,5573,995,1032,7600
11/30/2013,2013,11,30, 23 ,5175,920,948,7043
11/30/2013,2013,11,30, 24 ,4854,847,882,6583
12/1/2013,2013,12,1, 1 ,4611,812,839,6262
12/1/2013,2013,12,1, 2 ,4487,782,795,6064
12/1/2013,2013,12,1, 3 ,4374,762,783,5919
12/1/2013,2013,12,1, 4 ,4274,748,770,5792
12/1/2013,2013,12,1, 5 ,4317,753,793,5863
12/1/2013,2013,12,1, 6 ,4351,736,800,5887
12/1/2013,2013,12,1, 7 ,4418,737,791,5946
12/1/2013,2013,12,1, 8 ,4613,792,830,6235
12/1/2013,2013,12,1, 9 ,4913,865,886,6664
12/1/2013,2013,12,1, 10 ,5281,932,967,7180
12/1/2013,2013,12,1, 11 ,5413,951,1032,7396
12/1/2013,2013,12,1, 12 ,5338,983,1059,7380
12/1/2013,2013,12,1, 13 ,5311,981,1061,7353
12/1/2013,2013,12,1, 14 ,5350,986,1073,7409
12/1/2013,2013,12,1, 15 ,5283,956,1047,7286
12/1/2013,2013,12,1, 16 ,5261,940,1021,7222
12/1/2013,2013,12,1, 17 ,5296,946,1014,7256
12/1/2013,2013,12,1, 18 ,6096,1139,1260,8495
12/1/2013,2013,12,1, 19 ,6126,1140,1239,8505
12/1/2013,2013,12,1, 20 ,6090,1116,1208,8414
12/1/2013,2013,12,1, 21 ,5900,1061,1105,8066
12/1/2013,2013,12,1, 22 ,5510,978,1023,7511
12/1/2013,2013,12,1, 23 ,5132,897,938,6967
12/1/2013,2013,12,1, 24 ,4809,843,799,6451
12/2/2013,2013,12,2, 1 ,4558,807,825,6190
12/2/2013,2013,12,2, 2 ,4316,777,791,5884
12/2/2013,2013,12,2, 3 ,4248,758,771,5777
12/2/2013,2013,12,2, 4 ,4207,754,769,5730
12/2/2013,2013,12,2, 5 ,4503,786,815,6104
12/2/2013,2013,12,2, 6 ,4724,813,858,6395
12/2/2013,2013,12,2, 7 ,4837,800,785,6422
12/2/2013,2013,12,2, 8 ,5472,914,929,7315
12/2/2013,2013,12,2, 9 ,6285,1084,1129,8498
12/2/2013,2013,12,2, 10 ,6843,1174,1244,9261
12/2/2013,2013,12,2, 11 ,7079,1201,1284,9564
12/2/2013,2013,12,2, 12 ,6921,1168,1280,9369
12/2/2013,2013,12,2, 13 ,6834,1173,1272,9279
12/2/2013,2013,12,2, 14 ,7055,1206,1275,9536
12/2/2013,2013,12,2, 15 ,6923,1172,1256,9351
12/2/2013,2013,12,2, 16 ,6742,1154,1252,9148
12/2/2013,2013,12,2, 17 ,6581,1131,1238,8950
12/2/2013,2013,12,2, 18 ,7016,1248,1366,9630
12/2/2013,2013,12,2, 19 ,6876,1207,1293,9376
12/2/2013,2013,12,2, 20 ,6644,1173,1249,9066
12/2/2013,2013,12,2, 21 ,6359,1132,1207,8698
12/2/2013,2013,12,2, 22 ,6006,1032,1101,8139
12/2/2013,2013,12,2, 23 ,5429,942,965,7336
12/2/2013,2013,12,2, 24 ,5184,891,901,6976
12/3/2013,2013,12,3, 1 ,4892,856,859,6607
12/3/2013,2013,12,3, 2 ,4769,833,834,6436
12/3/2013,2013,12,3, 3 ,4620,807,816,6243
12/3/2013,2013,12,3, 4 ,4632,802,820,6254
12/3/2013,2013,12,3, 5 ,4817,832,857,6506
12/3/2013,2013,12,3, 6 ,5010,857,912,6779
12/3/2013,2013,12,3, 7 ,5030,830,843,6703
12/3/2013,2013,12,3, 8 ,5644,947,922,7513
12/3/2013,2013,12,3, 9 ,6414,1123,1130,8667
12/3/2013,2013,12,3, 10 ,6822,1191,1265,9278
12/3/2013,2013,12,3, 11 ,7020,1182,1303,9505
12/3/2013,2013,12,3, 12 ,6857,1140,1279,9276
12/3/2013,2013,12,3, 13 ,6818,1164,1291,9273
12/3/2013,2013,12,3, 14 ,7058,1201,1337,9596
12/3/2013,2013,12,3, 15 ,6887,1182,1310,9379
12/3/2013,2013,12,3, 16 ,6797,1168,1295,9260
12/3/2013,2013,12,3, 17 ,6622,1113,1253,8988
12/3/2013,2013,12,3, 18 ,7054,1176,1396,9626
12/3/2013,2013,12,3, 19 ,6953,1177,1375,9505
12/3/2013,2013,12,3, 20 ,6713,1138,1337,9188
12/3/2013,2013,12,3, 21 ,6505,1107,1270,8882
12/3/2013,2013,12,3, 22 ,6073,1054,1159,8286
12/3/2013,2013,12,3, 23 ,5603,943,1029,7575
12/3/2013,2013,12,3, 24 ,5251,888,941,7080
12/4/2013,2013,12,4, 1 ,5034,859,905,6798
12/4/2013,2013,12,4, 2 ,4919,825,877,6621
12/4/2013,2013,12,4, 3 ,4762,803,844,6409
12/4/2013,2013,12,4, 4 ,4709,806,842,6357
12/4/2013,2013,12,4, 5 ,4912,838,885,6635
12/4/2013,2013,12,4, 6 ,5143,858,914,6915
12/4/2013,2013,12,4, 7 ,5171,832,845,6848
12/4/2013,2013,12,4, 8 ,5739,966,974,7679
12/4/2013,2013,12,4, 9 ,6415,1129,1160,8704
12/4/2013,2013,12,4, 10 ,6904,1220,1269,9393
12/4/2013,2013,12,4, 11 ,7091,1282,1314,9687
12/4/2013,2013,12,4, 12 ,6919,1198,1311,9428
12/4/2013,2013,12,4, 13 ,6837,1215,1308,9360
12/4/2013,2013,12,4, 14 ,7056,1246,1339,9641
12/4/2013,2013,12,4, 15 ,6920,1206,1319,9445
12/4/2013,2013,12,4, 16 ,6819,1212,1298,9329
12/4/2013,2013,12,4, 17 ,6665,1174,1272,9111
12/4/2013,2013,12,4, 18 ,7079,1284,1402,9765
12/4/2013,2013,12,4, 19 ,6950,1258,1367,9575
12/4/2013,2013,12,4, 20 ,6749,1227,1333,9309
12/4/2013,2013,12,4, 21 ,6444,1157,1277,8878
12/4/2013,2013,12,4, 22 ,6059,1069,1166,8294
12/4/2013,2013,12,4, 23 ,5118,974,1025,7117
12/4/2013,2013,12,4, 24 ,5124,903,953,6980
12/5/2013,2013,12,5, 1 ,4951,865,922,6738
12/5/2013,2013,12,5, 2 ,4782,837,888,6507
12/5/2013,2013,12,5, 3 ,4690,821,864,6375
12/5/2013,2013,12,5, 4 ,4669,818,839,6326
12/5/2013,2013,12,5, 5 ,4862,841,875,6578
12/5/2013,2013,12,5, 6 ,5045,871,924,6840
12/5/2013,2013,12,5, 7 ,5072,841,857,6770
12/5/2013,2013,12,5, 8 ,5616,960,982,7558
12/5/2013,2013,12,5, 9 ,6332,1140,1170,8642
12/5/2013,2013,12,5, 10 ,6729,1213,1271,9213
12/5/2013,2013,12,5, 11 ,6906,1245,1349,9500
12/5/2013,2013,12,5, 12 ,6783,1212,1312,9307
12/5/2013,2013,12,5, 13 ,6666,1185,1316,9167
12/5/2013,2013,12,5, 14 ,6856,1239,1352,9447
12/5/2013,2013,12,5, 15 ,6808,1226,1331,9365
12/5/2013,2013,12,5, 16 ,6664,1205,1308,9177
12/5/2013,2013,12,5, 17 ,6521,1165,1261,8947
12/5/2013,2013,12,5, 18 ,6975,1276,1378,9629
12/5/2013,2013,12,5, 19 ,6837,1261,1351,9449
12/5/2013,2013,12,5, 20 ,6641,1227,1334,9202
12/5/2013,2013,12,5, 21 ,6350,1159,1257,8766
12/5/2013,2013,12,5, 22 ,5999,1059,1145,8203
12/5/2013,2013,12,5, 23 ,5562,960,1019,7541
12/5/2013,2013,12,5, 24 ,5182,899,956,7037
12/6/2013,2013,12,6, 1 ,4958,856,918,6732
12/6/2013,2013,12,6, 2 ,4775,831,887,6493
12/6/2013,2013,12,6, 3 ,4693,810,862,6365
12/6/2013,2013,12,6, 4 ,4686,804,855,6345
12/6/2013,2013,12,6, 5 ,4938,830,894,6662
12/6/2013,2013,12,6, 6 ,5068,853,917,6838
12/6/2013,2013,12,6, 7 ,5110,832,868,6810
12/6/2013,2013,12,6, 8 ,5612,932,976,7520
12/6/2013,2013,12,6, 9 ,6367,1108,1154,8629
12/6/2013,2013,12,6, 10 ,6823,1197,1247,9267
12/6/2013,2013,12,6, 11 ,7011,1233,1304,9548
12/6/2013,2013,12,6, 12 ,6788,1201,1292,9281
12/6/2013,2013,12,6, 13 ,6745,1207,1308,9260
12/6/2013,2013,12,6, 14 ,6952,1250,1351,9553
12/6/2013,2013,12,6, 15 ,6823,1234,1313,9370
12/6/2013,2013,12,6, 16 ,6744,1200,1289,9233
12/6/2013,2013,12,6, 17 ,6548,1156,1235,8939
12/6/2013,2013,12,6, 18 ,7011,1297,1406,9714
12/6/2013,2013,12,6, 19 ,6874,1265,1365,9504
12/6/2013,2013,12,6, 20 ,6626,1223,1353,9202
12/6/2013,2013,12,6, 21 ,6326,1158,1280,8764
12/6/2013,2013,12,6, 22 ,6068,1080,1179,8327
12/6/2013,2013,12,6, 23 ,5640,979,1061,7680
12/6/2013,2013,12,6, 24 ,5256,915,1003,7174
12/7/2013,2013,12,7, 1 ,5047,876,936,6859
12/7/2013,2013,12,7, 2 ,4847,848,889,6584
12/7/2013,2013,12,7, 3 ,4746,820,869,6435
12/7/2013,2013,12,7, 4 ,4743,812,860,6415
12/7/2013,2013,12,7, 5 ,4772,822,878,6472
12/7/2013,2013,12,7, 6 ,4798,832,878,6508
12/7/2013,2013,12,7, 7 ,4801,831,851,6483
12/7/2013,2013,12,7, 8 ,5228,912,932,7072
12/7/2013,2013,12,7, 9 ,5752,1052,1072,7876
12/7/2013,2013,12,7, 10 ,6184,1128,1172,8484
12/7/2013,2013,12,7, 11 ,6513,1159,1246,8918
12/7/2013,2013,12,7, 12 ,6336,1145,1233,8714
12/7/2013,2013,12,7, 13 ,6264,1138,1239,8641
12/7/2013,2013,12,7, 14 ,6358,1183,1273,8814
12/7/2013,2013,12,7, 15 ,6212,1147,1248,8607
12/7/2013,2013,12,7, 16 ,6091,1124,1202,8417
12/7/2013,2013,12,7, 17 ,5947,1108,1186,8241
12/7/2013,2013,12,7, 18 ,6574,1198,1371,9143
12/7/2013,2013,12,7, 19 ,6524,1200,1359,9083
12/7/2013,2013,12,7, 20 ,6416,1165,1317,8898
12/7/2013,2013,12,7, 21 ,6197,1123,1276,8596
12/7/2013,2013,12,7, 22 ,5943,1047,1177,8167
12/7/2013,2013,12,7, 23 ,5454,988,1055,7497
12/7/2013,2013,12,7, 24 ,5196,905,955,7056
12/8/2013,2013,12,8, 1 ,4928,866,929,6723
12/8/2013,2013,12,8, 2 ,4802,836,894,6532
12/8/2013,2013,12,8, 3 ,4610,817,859,6286
12/8/2013,2013,12,8, 4 ,4514,805,841,6160
12/8/2013,2013,12,8, 5 ,4490,813,849,6152
12/8/2013,2013,12,8, 6 ,4496,790,847,6133
12/8/2013,2013,12,8, 7 ,4470,786,799,6055
12/8/2013,2013,12,8, 8 ,4738,817,852,6407
12/8/2013,2013,12,8, 9 ,5085,882,928,6895
12/8/2013,2013,12,8, 10 ,5544,956,1005,7505
12/8/2013,2013,12,8, 11 ,5731,985,1072,7788
12/8/2013,2013,12,8, 12 ,5619,989,1080,7688
12/8/2013,2013,12,8, 13 ,5618,985,1098,7701
12/8/2013,2013,12,8, 14 ,5614,994,1107,7715
12/8/2013,2013,12,8, 15 ,5525,981,1096,7602
12/8/2013,2013,12,8, 16 ,5484,956,1083,7523
12/8/2013,2013,12,8, 17 ,5454,949,1074,7477
12/8/2013,2013,12,8, 18 ,6205,1120,1273,8598
12/8/2013,2013,12,8, 19 ,6326,1135,1296,8757
12/8/2013,2013,12,8, 20 ,6128,1127,1237,8492
12/8/2013,2013,12,8, 21 ,6011,1086,1173,8270
12/8/2013,2013,12,8, 22 ,5638,1009,1089,7736
12/8/2013,2013,12,8, 23 ,5246,922,999,7167
12/8/2013,2013,12,8, 24 ,4954,870,996,6820
12/9/2013,2013,12,9, 1 ,4705,818,880,6403
12/9/2013,2013,12,9, 2 ,4580,786,851,6217
12/9/2013,2013,12,9, 3 ,4484,760,824,6068
12/9/2013,2013,12,9, 4 ,4452,762,816,6030
12/9/2013,2013,12,9, 5 ,4628,791,855,6274
12/9/2013,2013,12,9, 6 ,4930,817,891,6638
12/9/2013,2013,12,9, 7 ,5010,802,830,6642
12/9/2013,2013,12,9, 8 ,5644,922,926,7492
12/9/2013,2013,12,9, 9 ,6459,1105,1136,8700
12/9/2013,2013,12,9, 10 ,7070,1187,1259,9516
12/9/2013,2013,12,9, 11 ,7372,1219,1325,9916
12/9/2013,2013,12,9, 12 ,7225,1221,1325,9771
12/9/2013,2013,12,9, 13 ,7117,1207,1321,9645
12/9/2013,2013,12,9, 14 ,7436,1268,1372,10076
12/9/2013,2013,12,9, 15 ,7250,1230,1357,9837
12/9/2013,2013,12,9, 16 ,7182,1209,1326,9717
12/9/2013,2013,12,9, 17 ,6971,1146,1289,9406
12/9/2013,2013,12,9, 18 ,7401,1293,1404,10098
12/9/2013,2013,12,9, 19 ,7325,1271,1370,9966
12/9/2013,2013,12,9, 20 ,7131,1185,1328,9644
12/9/2013,2013,12,9, 21 ,6806,1140,1271,9217
12/9/2013,2013,12,9, 22 ,6433,1058,1164,8655
12/9/2013,2013,12,9, 23 ,5970,964,1047,7981
12/9/2013,2013,12,9, 24 ,5507,916,955,7378
12/10/2013,2013,12,10, 1 ,5232,871,922,7025
12/10/2013,2013,12,10, 2 ,5163,830,884,6877
12/10/2013,2013,12,10, 3 ,4994,811,871,6676
12/10/2013,2013,12,10, 4 ,4983,803,862,6648
12/10/2013,2013,12,10, 5 ,5098,818,904,6820
12/10/2013,2013,12,10, 6 ,5287,834,927,7048
12/10/2013,2013,12,10, 7 ,5263,806,866,6935
12/10/2013,2013,12,10, 8 ,5905,945,982,7832
12/10/2013,2013,12,10, 9 ,6690,1102,1154,8946
12/10/2013,2013,12,10, 10 ,7217,1176,1253,9646
12/10/2013,2013,12,10, 11 ,7400,1208,1314,9922
12/10/2013,2013,12,10, 12 ,7217,1189,1290,9696
12/10/2013,2013,12,10, 13 ,7188,1182,1277,9647
12/10/2013,2013,12,10, 14 ,7434,1234,1308,9976
12/10/2013,2013,12,10, 15 ,7256,1222,1273,9751
12/10/2013,2013,12,10, 16 ,7174,1191,1242,9607
12/10/2013,2013,12,10, 17 ,6894,1147,1234,9275
12/10/2013,2013,12,10, 18 ,7337,1264,1383,9984
12/10/2013,2013,12,10, 19 ,7190,1233,1342,9765
12/10/2013,2013,12,10, 20 ,6972,1224,1301,9497
12/10/2013,2013,12,10, 21 ,6783,1156,1225,9164
12/10/2013,2013,12,10, 22 ,6413,1061,1110,8584
12/10/2013,2013,12,10, 23 ,5910,958,996,7864
12/10/2013,2013,12,10, 24 ,5554,882,950,7386
12/11/2013,2013,12,11, 1 ,5251,848,881,6980
12/11/2013,2013,12,11, 2 ,5084,822,844,6750
12/11/2013,2013,12,11, 3 ,4994,799,830,6623
12/11/2013,2013,12,11, 4 ,4984,795,829,6608
12/11/2013,2013,12,11, 5 ,5085,812,878,6775
12/11/2013,2013,12,11, 6 ,5214,841,917,6972
12/11/2013,2013,12,11, 7 ,5252,813,856,6921
12/11/2013,2013,12,11, 8 ,5874,950,969,7793
12/11/2013,2013,12,11, 9 ,6637,1114,1138,8889
12/11/2013,2013,12,11, 10 ,7089,1175,1238,9502
12/11/2013,2013,12,11, 11 ,7338,1217,1308,9863
12/11/2013,2013,12,11, 12 ,7211,1197,1267,9675
12/11/2013,2013,12,11, 13 ,7150,1215,1289,9654
12/11/2013,2013,12,11, 14 ,7377,1248,1320,9945
12/11/2013,2013,12,11, 15 ,7260,1209,1300,9769
12/11/2013,2013,12,11, 16 ,7097,1194,1260,9551
12/11/2013,2013,12,11, 17 ,6860,1149,1238,9247
12/11/2013,2013,12,11, 18 ,7323,1274,1400,9997
12/11/2013,2013,12,11, 19 ,7259,1253,1359,9871
12/11/2013,2013,12,11, 20 ,7018,1203,1289,9510
12/11/2013,2013,12,11, 21 ,6802,1142,1233,9177
12/11/2013,2013,12,11, 22 ,6200,1062,1094,8356
12/11/2013,2013,12,11, 23 ,5955,965,1007,7927
12/11/2013,2013,12,11, 24 ,5523,906,912,7341
12/12/2013,2013,12,12, 1 ,5301,862,894,7057
12/12/2013,2013,12,12, 2 ,5119,841,862,6822
12/12/2013,2013,12,12, 3 ,4936,820,844,6600
12/12/2013,2013,12,12, 4 ,4916,794,841,6551
12/12/2013,2013,12,12, 5 ,5096,813,885,6794
12/12/2013,2013,12,12, 6 ,5176,840,923,6939
12/12/2013,2013,12,12, 7 ,5336,811,867,7014
12/12/2013,2013,12,12, 8 ,5854,942,978,7774
12/12/2013,2013,12,12, 9 ,6613,1114,1163,8890
12/12/2013,2013,12,12, 10 ,7079,1187,1260,9526
12/12/2013,2013,12,12, 11 ,7214,1216,1308,9738
12/12/2013,2013,12,12, 12 ,7036,1203,1292,9531
12/12/2013,2013,12,12, 13 ,7079,1169,1272,9520
12/12/2013,2013,12,12, 14 ,7202,1173,1327,9702
12/12/2013,2013,12,12, 15 ,7010,1175,1302,9487
12/12/2013,2013,12,12, 16 ,6934,1172,1294,9400
12/12/2013,2013,12,12, 17 ,6677,1132,1239,9048
12/12/2013,2013,12,12, 18 ,7131,1269,1420,9820
12/12/2013,2013,12,12, 19 ,7065,1246,1372,9683
12/12/2013,2013,12,12, 20 ,6899,1202,1333,9434
12/12/2013,2013,12,12, 21 ,6620,1122,1243,8985
12/12/2013,2013,12,12, 22 ,6233,1046,1126,8405
12/12/2013,2013,12,12, 23 ,5848,952,1027,7827
12/12/2013,2013,12,12, 24 ,5404,883,928,7215
12/13/2013,2013,12,13, 1 ,5134,853,915,6902
12/13/2013,2013,12,13, 2 ,5000,823,887,6710
12/13/2013,2013,12,13, 3 ,4889,805,861,6555
12/13/2013,2013,12,13, 4 ,4764,801,849,6414
12/13/2013,2013,12,13, 5 ,4976,820,888,6684
12/13/2013,2013,12,13, 6 ,5139,837,924,6900
12/13/2013,2013,12,13, 7 ,5208,811,855,6874
12/13/2013,2013,12,13, 8 ,5856,934,983,7773
12/13/2013,2013,12,13, 9 ,6615,1104,1135,8854
12/13/2013,2013,12,13, 10 ,7070,1188,1236,9494
12/13/2013,2013,12,13, 11 ,7335,1223,1290,9848
12/13/2013,2013,12,13, 12 ,7158,1176,1241,9575
12/13/2013,2013,12,13, 13 ,7084,1172,1259,9515
12/13/2013,2013,12,13, 14 ,7360,1181,1304,9845
12/13/2013,2013,12,13, 15 ,7241,1194,1282,9717
12/13/2013,2013,12,13, 16 ,7082,1182,1257,9521
12/13/2013,2013,12,13, 17 ,6798,1115,1228,9141
12/13/2013,2013,12,13, 18 ,7257,1239,1399,9895
12/13/2013,2013,12,13, 19 ,7135,1221,1355,9711
12/13/2013,2013,12,13, 20 ,6904,1189,1324,9417
12/13/2013,2013,12,13, 21 ,6718,1172,1258,9148
12/13/2013,2013,12,13, 22 ,6384,1089,1151,8624
12/13/2013,2013,12,13, 23 ,6019,999,1038,8056
12/13/2013,2013,12,13, 24 ,5599,930,938,7467
12/14/2013,2013,12,14, 1 ,5229,879,869,6977
12/14/2013,2013,12,14, 2 ,5081,846,859,6786
12/14/2013,2013,12,14, 3 ,4927,823,830,6580
12/14/2013,2013,12,14, 4 ,4830,819,822,6471
12/14/2013,2013,12,14, 5 ,4895,823,845,6563
12/14/2013,2013,12,14, 6 ,4910,827,834,6571
12/14/2013,2013,12,14, 7 ,4942,827,819,6588
12/14/2013,2013,12,14, 8 ,5433,902,890,7225
12/14/2013,2013,12,14, 9 ,6063,1041,1034,8138
12/14/2013,2013,12,14, 10 ,6432,1106,1120,8658
12/14/2013,2013,12,14, 11 ,6708,1153,1180,9041
12/14/2013,2013,12,14, 12 ,6566,1135,1158,8859
12/14/2013,2013,12,14, 13 ,6455,1133,1191,8779
12/14/2013,2013,12,14, 14 ,6630,1151,1227,9008
12/14/2013,2013,12,14, 15 ,6470,1130,1207,8807
12/14/2013,2013,12,14, 16 ,6325,1079,1174,8578
12/14/2013,2013,12,14, 17 ,6097,1056,1141,8294
12/14/2013,2013,12,14, 18 ,6756,1236,1336,9328
12/14/2013,2013,12,14, 19 ,6759,1227,1327,9313
12/14/2013,2013,12,14, 20 ,6674,1188,1302,9164
12/14/2013,2013,12,14, 21 ,6559,1148,1240,8947
12/14/2013,2013,12,14, 22 ,6305,1069,1125,8499
12/14/2013,2013,12,14, 23 ,6033,983,1019,8035
12/14/2013,2013,12,14, 24 ,5552,907,929,7388
12/15/2013,2013,12,15, 1 ,5235,851,848,6934
12/15/2013,2013,12,15, 2 ,5027,820,829,6676
12/15/2013,2013,12,15, 3 ,4897,797,794,6488
12/15/2013,2013,12,15, 4 ,4772,787,784,6343
12/15/2013,2013,12,15, 5 ,4767,784,796,6347
12/15/2013,2013,12,15, 6 ,4713,772,797,6282
12/15/2013,2013,12,15, 7 ,4633,793,772,6198
12/15/2013,2013,12,15, 8 ,4866,822,812,6500
12/15/2013,2013,12,15, 9 ,5252,886,855,6993
12/15/2013,2013,12,15, 10 ,5681,961,918,7560
12/15/2013,2013,12,15, 11 ,5860,992,983,7835
12/15/2013,2013,12,15, 12 ,5879,1001,1002,7882
12/15/2013,2013,12,15, 13 ,5826,1013,1006,7845
12/15/2013,2013,12,15, 14 ,5841,1021,985,7847
12/15/2013,2013,12,15, 15 ,5696,1015,974,7685
12/15/2013,2013,12,15, 16 ,5575,991,926,7492
12/15/2013,2013,12,15, 17 ,5563,983,1032,7578
12/15/2013,2013,12,15, 18 ,6289,1178,1255,8722
12/15/2013,2013,12,15, 19 ,6356,1197,1272,8825
12/15/2013,2013,12,15, 20 ,6370,1182,1241,8793
12/15/2013,2013,12,15, 21 ,6253,1123,1179,8555
12/15/2013,2013,12,15, 22 ,5966,1038,1061,8065
12/15/2013,2013,12,15, 23 ,5689,965,966,7620
12/15/2013,2013,12,15, 24 ,5252,897,848,6997
12/16/2013,2013,12,16, 1 ,4899,842,845,6586
12/16/2013,2013,12,16, 2 ,4764,813,818,6395
12/16/2013,2013,12,16, 3 ,4589,795,755,6139
12/16/2013,2013,12,16, 4 ,4593,795,789,6177
12/16/2013,2013,12,16, 5 ,4715,811,811,6337
12/16/2013,2013,12,16, 6 ,4997,850,868,6715
12/16/2013,2013,12,16, 7 ,5031,846,845,6722
12/16/2013,2013,12,16, 8 ,5680,954,908,7542
12/16/2013,2013,12,16, 9 ,6557,1153,1074,8784
12/16/2013,2013,12,16, 10 ,7099,1239,1176,9514
12/16/2013,2013,12,16, 11 ,7297,1291,1229,9817
12/16/2013,2013,12,16, 12 ,7225,1251,1204,9680
12/16/2013,2013,12,16, 13 ,7176,1245,1188,9609
12/16/2013,2013,12,16, 14 ,7358,1291,1228,9877
12/16/2013,2013,12,16, 15 ,7298,1271,1205,9774
12/16/2013,2013,12,16, 16 ,7158,1250,1207,9615
12/16/2013,2013,12,16, 17 ,6898,1230,1202,9330
12/16/2013,2013,12,16, 18 ,7302,1349,1343,9994
12/16/2013,2013,12,16, 19 ,7173,1327,1310,9810
12/16/2013,2013,12,16, 20 ,7023,1280,1265,9568
12/16/2013,2013,12,16, 21 ,6764,1204,1174,9142
12/16/2013,2013,12,16, 22 ,6376,1094,1026,8496
12/16/2013,2013,12,16, 23 ,5907,988,926,7821
12/16/2013,2013,12,16, 24 ,5480,915,849,7244
12/17/2013,2013,12,17, 1 ,5166,877,795,6838
12/17/2013,2013,12,17, 2 ,5002,849,804,6655
12/17/2013,2013,12,17, 3 ,4876,836,793,6505
12/17/2013,2013,12,17, 4 ,4861,827,796,6484
12/17/2013,2013,12,17, 5 ,4938,844,827,6609
12/17/2013,2013,12,17, 6 ,5159,873,876,6908
12/17/2013,2013,12,17, 7 ,5141,859,831,6831
12/17/2013,2013,12,17, 8 ,5818,973,932,7723
12/17/2013,2013,12,17, 9 ,6634,1131,1095,8860
12/17/2013,2013,12,17, 10 ,7192,1226,1201,9619
12/17/2013,2013,12,17, 11 ,7428,1277,1204,9909
12/17/2013,2013,12,17, 12 ,7320,1252,1214,9786
12/17/2013,2013,12,17, 13 ,7326,1245,1235,9806
12/17/2013,2013,12,17, 14 ,7599,1281,1291,10171
12/17/2013,2013,12,17, 15 ,7525,1262,1264,10051
12/17/2013,2013,12,17, 16 ,7402,1246,1234,9882
12/17/2013,2013,12,17, 17 ,7105,1196,1220,9521
12/17/2013,2013,12,17, 18 ,7436,1333,1375,10144
12/17/2013,2013,12,17, 19 ,7374,1316,1337,10027
12/17/2013,2013,12,17, 20 ,7188,1289,1297,9774
12/17/2013,2013,12,17, 21 ,6914,1219,1203,9336
12/17/2013,2013,12,17, 22 ,6616,1110,1116,8842
12/17/2013,2013,12,17, 23 ,6040,990,993,8023
12/17/2013,2013,12,17, 24 ,5612,920,917,7449
12/18/2013,2013,12,18, 1 ,5316,882,868,7066
12/18/2013,2013,12,18, 2 ,5165,851,842,6858
12/18/2013,2013,12,18, 3 ,4964,832,828,6624
12/18/2013,2013,12,18, 4 ,4908,834,831,6573
12/18/2013,2013,12,18, 5 ,5070,850,869,6789
12/18/2013,2013,12,18, 6 ,5226,866,890,6982
12/18/2013,2013,12,18, 7 ,5243,847,833,6923
12/18/2013,2013,12,18, 8 ,5892,961,931,7784
12/18/2013,2013,12,18, 9 ,6724,1140,1105,8969
12/18/2013,2013,12,18, 10 ,7032,1228,1218,9478
12/18/2013,2013,12,18, 11 ,7285,1280,1274,9839
12/18/2013,2013,12,18, 12 ,7157,1247,1258,9662
12/18/2013,2013,12,18, 13 ,7077,1243,1270,9590
12/18/2013,2013,12,18, 14 ,7375,1292,1285,9952
12/18/2013,2013,12,18, 15 ,7287,1235,1284,9806
12/18/2013,2013,12,18, 16 ,7196,1244,1272,9712
12/18/2013,2013,12,18, 17 ,6968,1179,1213,9360
12/18/2013,2013,12,18, 18 ,7343,1329,1350,10022
12/18/2013,2013,12,18, 19 ,7195,1321,1308,9824
12/18/2013,2013,12,18, 20 ,6950,1282,1256,9488
12/18/2013,2013,12,18, 21 ,6778,1226,1200,9204
12/18/2013,2013,12,18, 22 ,6371,1113,1079,8563
12/18/2013,2013,12,18, 23 ,5916,1012,977,7905
12/18/2013,2013,12,18, 24 ,5545,939,946,7430
12/19/2013,2013,12,19, 1 ,5244,889,853,6986
12/19/2013,2013,12,19, 2 ,5079,860,821,6760
12/19/2013,2013,12,19, 3 ,4959,856,809,6624
12/19/2013,2013,12,19, 4 ,4915,847,804,6566
12/19/2013,2013,12,19, 5 ,4986,854,825,6665
12/19/2013,2013,12,19, 6 ,5088,875,819,6782
12/19/2013,2013,12,19, 7 ,5189,863,809,6861
12/19/2013,2013,12,19, 8 ,5756,970,914,7640
12/19/2013,2013,12,19, 9 ,6513,1122,1097,8732
12/19/2013,2013,12,19, 10 ,6983,1205,1201,9389
12/19/2013,2013,12,19, 11 ,7154,1259,1235,9648
12/19/2013,2013,12,19, 12 ,7047,1245,1226,9518
12/19/2013,2013,12,19, 13 ,6960,1252,1250,9462
12/19/2013,2013,12,19, 14 ,7202,1310,1290,9802
12/19/2013,2013,12,19, 15 ,7128,1277,1247,9652
12/19/2013,2013,12,19, 16 ,6953,1244,1237,9434
12/19/2013,2013,12,19, 17 ,6772,1195,1186,9153
12/19/2013,2013,12,19, 18 ,7228,1346,1343,9917
12/19/2013,2013,12,19, 19 ,7147,1322,1308,9777
12/19/2013,2013,12,19, 20 ,6851,1268,1264,9383
12/19/2013,2013,12,19, 21 ,6676,1199,1179,9054
12/19/2013,2013,12,19, 22 ,6327,1104,1061,8492
12/19/2013,2013,12,19, 23 ,5891,986,964,7841
12/19/2013,2013,12,19, 24 ,5484,908,898,7290
12/20/2013,2013,12,20, 1 ,5196,886,852,6934
12/20/2013,2013,12,20, 2 ,5024,862,824,6710
12/20/2013,2013,12,20, 3 ,4895,831,812,6538
12/20/2013,2013,12,20, 4 ,4883,828,813,6524
12/20/2013,2013,12,20, 5 ,4917,842,824,6583
12/20/2013,2013,12,20, 6 ,5040,857,849,6746
12/20/2013,2013,12,20, 7 ,5148,862,831,6841
12/20/2013,2013,12,20, 8 ,5704,971,920,7595
12/20/2013,2013,12,20, 9 ,6476,1138,1108,8722
12/20/2013,2013,12,20, 10 ,7028,1226,1224,9478
12/20/2013,2013,12,20, 11 ,7125,1271,1282,9678
12/20/2013,2013,12,20, 12 ,7036,1233,1264,9533
12/20/2013,2013,12,20, 13 ,6900,1246,1261,9407
12/20/2013,2013,12,20, 14 ,7090,1286,1299,9675
12/20/2013,2013,12,20, 15 ,7037,1265,1266,9568
12/20/2013,2013,12,20, 16 ,6911,1242,1232,9385
12/20/2013,2013,12,20, 17 ,6704,1182,1182,9068
12/20/2013,2013,12,20, 18 ,7118,1335,1365,9818
12/20/2013,2013,12,20, 19 ,6991,1307,1348,9646
12/20/2013,2013,12,20, 20 ,6830,1296,1298,9424
12/20/2013,2013,12,20, 21 ,6590,1224,1213,9027
12/20/2013,2013,12,20, 22 ,6329,1133,1116,8578
12/20/2013,2013,12,20, 23 ,5889,1040,1001,7930
12/20/2013,2013,12,20, 24 ,5484,961,941,7386
12/21/2013,2013,12,21, 1 ,5093,902,863,6858
12/21/2013,2013,12,21, 2 ,4950,872,827,6649
12/21/2013,2013,12,21, 3 ,4802,858,803,6463
12/21/2013,2013,12,21, 4 ,4702,842,793,6337
12/21/2013,2013,12,21, 5 ,4726,843,797,6366
12/21/2013,2013,12,21, 6 ,4769,854,806,6429
12/21/2013,2013,12,21, 7 ,4729,846,789,6364
12/21/2013,2013,12,21, 8 ,5122,915,847,6884
12/21/2013,2013,12,21, 9 ,5788,1042,947,7777
12/21/2013,2013,12,21, 10 ,6225,1116,1044,8385
12/21/2013,2013,12,21, 11 ,6503,1152,1112,8767
12/21/2013,2013,12,21, 12 ,6360,1116,1110,8586
12/21/2013,2013,12,21, 13 ,6313,1100,1118,8531
12/21/2013,2013,12,21, 14 ,6382,1128,1163,8673
12/21/2013,2013,12,21, 15 ,6184,1089,1142,8415
12/21/2013,2013,12,21, 16 ,6003,1065,1112,8180
12/21/2013,2013,12,21, 17 ,5879,1053,1102,8034
12/21/2013,2013,12,21, 18 ,6503,1219,1285,9007
12/21/2013,2013,12,21, 19 ,6553,1209,1280,9042
12/21/2013,2013,12,21, 20 ,6405,1190,1243,8838
12/21/2013,2013,12,21, 21 ,6282,1149,1202,8633
12/21/2013,2013,12,21, 22 ,5935,1046,1078,8059
12/21/2013,2013,12,21, 23 ,5565,973,991,7529
12/21/2013,2013,12,21, 24 ,5153,898,904,6955
12/22/2013,2013,12,22, 1 ,4854,844,859,6557
12/22/2013,2013,12,22, 2 ,4685,818,828,6331
12/22/2013,2013,12,22, 3 ,4486,805,815,6106
12/22/2013,2013,12,22, 4 ,4485,794,803,6082
12/22/2013,2013,12,22, 5 ,4451,792,814,6057
12/22/2013,2013,12,22, 6 ,4486,789,811,6086
12/22/2013,2013,12,22, 7 ,4380,789,803,5972
12/22/2013,2013,12,22, 8 ,4578,842,852,6272
12/22/2013,2013,12,22, 9 ,5010,914,915,6839
12/22/2013,2013,12,22, 10 ,5417,977,1013,7407
12/22/2013,2013,12,22, 11 ,5668,1007,1062,7737
12/22/2013,2013,12,22, 12 ,5602,1025,1061,7688
12/22/2013,2013,12,22, 13 ,5573,1018,1056,7647
12/22/2013,2013,12,22, 14 ,5613,1022,1067,7702
12/22/2013,2013,12,22, 15 ,5494,1004,1045,7543
12/22/2013,2013,12,22, 16 ,5372,990,1037,7399
12/22/2013,2013,12,22, 17 ,5300,991,1056,7347
12/22/2013,2013,12,22, 18 ,5996,1172,1268,8436
12/22/2013,2013,12,22, 19 ,6141,1182,1273,8596
12/22/2013,2013,12,22, 20 ,6142,1159,1216,8517
12/22/2013,2013,12,22, 21 ,5975,1091,1141,8207
12/22/2013,2013,12,22, 22 ,5691,1008,1044,7743
12/22/2013,2013,12,22, 23 ,5290,931,942,7163
12/22/2013,2013,12,22, 24 ,4958,865,957,6780
12/23/2013,2013,12,23, 1 ,4664,808,820,6292
12/23/2013,2013,12,23, 2 ,4471,781,777,6029
12/23/2013,2013,12,23, 3 ,4410,765,771,5946
12/23/2013,2013,12,23, 4 ,4299,757,771,5827
12/23/2013,2013,12,23, 5 ,4334,758,790,5882
12/23/2013,2013,12,23, 6 ,4423,774,823,6020
12/23/2013,2013,12,23, 7 ,4562,779,823,6164
12/23/2013,2013,12,23, 8 ,5130,867,883,6880
12/23/2013,2013,12,23, 9 ,5816,1038,1061,7915
12/23/2013,2013,12,23, 10 ,6282,1131,1123,8536
12/23/2013,2013,12,23, 11 ,6552,1162,1162,8876
12/23/2013,2013,12,23, 12 ,6424,1144,1155,8723
12/23/2013,2013,12,23, 13 ,6411,1140,1130,8681
12/23/2013,2013,12,23, 14 ,6454,1183,1166,8803
12/23/2013,2013,12,23, 15 ,6282,1157,1121,8560
12/23/2013,2013,12,23, 16 ,6183,1137,1117,8437
12/23/2013,2013,12,23, 17 ,5928,1096,1130,8154
12/23/2013,2013,12,23, 18 ,6391,1250,1299,8940
12/23/2013,2013,12,23, 19 ,6386,1257,1253,8896
12/23/2013,2013,12,23, 20 ,6191,1210,1222,8623
12/23/2013,2013,12,23, 21 ,6054,1169,1127,8350
12/23/2013,2013,12,23, 22 ,5796,1082,1055,7933
12/23/2013,2013,12,23, 23 ,5359,976,934,7269
12/23/2013,2013,12,23, 24 ,4918,887,852,6657
12/24/2013,2013,12,24, 1 ,4672,847,823,6342
12/24/2013,2013,12,24, 2 ,4482,817,790,6089
12/24/2013,2013,12,24, 3 ,4397,807,779,5983
12/24/2013,2013,12,24, 4 ,4262,799,779,5840
12/24/2013,2013,12,24, 5 ,4257,802,787,5846
12/24/2013,2013,12,24, 6 ,4212,802,797,5811
12/24/2013,2013,12,24, 7 ,4145,788,789,5722
12/24/2013,2013,12,24, 8 ,4316,838,830,5984
12/24/2013,2013,12,24, 9 ,4760,936,948,6644
12/24/2013,2013,12,24, 10 ,5097,988,1010,7095
12/24/2013,2013,12,24, 11 ,5287,1009,1065,7361
12/24/2013,2013,12,24, 12 ,5297,1008,1065,7370
12/24/2013,2013,12,24, 13 ,5245,994,1067,7306
12/24/2013,2013,12,24, 14 ,5240,1002,1083,7325
12/24/2013,2013,12,24, 15 ,5149,977,1038,7164
12/24/2013,2013,12,24, 16 ,4992,948,1032,6972
12/24/2013,2013,12,24, 17 ,4943,955,1045,6943
12/24/2013,2013,12,24, 18 ,5666,1142,1243,8051
12/24/2013,2013,12,24, 19 ,5700,1155,1192,8047
12/24/2013,2013,12,24, 20 ,5423,1074,1123,7620
12/24/2013,2013,12,24, 21 ,5166,1018,1067,7251
12/24/2013,2013,12,24, 22 ,4936,952,993,6881
12/24/2013,2013,12,24, 23 ,4741,910,946,6597
12/24/2013,2013,12,24, 24 ,4602,878,802,6282
12/25/2013,2013,12,25, 1 ,4403,831,859,6093
12/25/2013,2013,12,25, 2 ,4194,785,807,5786
12/25/2013,2013,12,25, 3 ,4025,749,770,5544
12/25/2013,2013,12,25, 4 ,3914,730,745,5389
12/25/2013,2013,12,25, 5 ,3853,725,739,5317
12/25/2013,2013,12,25, 6 ,3833,713,723,5269
12/25/2013,2013,12,25, 7 ,3737,694,712,5143
12/25/2013,2013,12,25, 8 ,3732,714,722,5168
12/25/2013,2013,12,25, 9 ,3886,757,766,5409
12/25/2013,2013,12,25, 10 ,4181,800,817,5798
12/25/2013,2013,12,25, 11 ,4381,822,862,6065
12/25/2013,2013,12,25, 12 ,4606,849,892,6347
12/25/2013,2013,12,25, 13 ,4634,856,901,6391
12/25/2013,2013,12,25, 14 ,4672,862,888,6422
12/25/2013,2013,12,25, 15 ,4612,850,880,6342
12/25/2013,2013,12,25, 16 ,4571,842,877,6290
12/25/2013,2013,12,25, 17 ,4541,848,900,6289
12/25/2013,2013,12,25, 18 ,5273,1084,1114,7471
12/25/2013,2013,12,25, 19 ,5475,1095,1126,7696
12/25/2013,2013,12,25, 20 ,5492,1070,1088,7650
12/25/2013,2013,12,25, 21 ,5423,1025,1033,7481
12/25/2013,2013,12,25, 22 ,5211,947,940,7098
12/25/2013,2013,12,25, 23 ,4795,853,866,6514
12/25/2013,2013,12,25, 24 ,4505,801,790,6096
12/26/2013,2013,12,26, 1 ,4322,770,771,5863
12/26/2013,2013,12,26, 2 ,4135,748,745,5628
12/26/2013,2013,12,26, 3 ,4010,729,727,5466
12/26/2013,2013,12,26, 4 ,3954,720,727,5401
12/26/2013,2013,12,26, 5 ,4010,732,740,5482
12/26/2013,2013,12,26, 6 ,4156,745,756,5657
12/26/2013,2013,12,26, 7 ,4314,769,766,5849
12/26/2013,2013,12,26, 8 ,4991,862,875,6728
12/26/2013,2013,12,26, 9 ,5794,1045,1054,7893
12/26/2013,2013,12,26, 10 ,6313,1164,1179,8656
12/26/2013,2013,12,26, 11 ,6552,1214,1232,8998
12/26/2013,2013,12,26, 12 ,6512,1198,1234,8944
12/26/2013,2013,12,26, 13 ,6476,1203,1248,8927
12/26/2013,2013,12,26, 14 ,6638,1257,1289,9184
12/26/2013,2013,12,26, 15 ,6541,1234,1270,9045
12/26/2013,2013,12,26, 16 ,6392,1216,1242,8850
12/26/2013,2013,12,26, 17 ,6198,1160,1198,8556
12/26/2013,2013,12,26, 18 ,6607,1304,1352,9263
12/26/2013,2013,12,26, 19 ,6595,1305,1346,9246
12/26/2013,2013,12,26, 20 ,6412,1262,1269,8943
12/26/2013,2013,12,26, 21 ,6125,1207,1210,8542
12/26/2013,2013,12,26, 22 ,5779,1116,1109,8004
12/26/2013,2013,12,26, 23 ,5390,1015,1017,7422
12/26/2013,2013,12,26, 24 ,5034,938,910,6882
12/27/2013,2013,12,27, 1 ,4730,886,892,6508
12/27/2013,2013,12,27, 2 ,4592,852,858,6302
12/27/2013,2013,12,27, 3 ,4450,828,834,6112
12/27/2013,2013,12,27, 4 ,4434,808,817,6059
12/27/2013,2013,12,27, 5 ,4370,819,821,6010
12/27/2013,2013,12,27, 6 ,4447,823,838,6108
12/27/2013,2013,12,27, 7 ,4558,837,832,6227
12/27/2013,2013,12,27, 8 ,5071,940,917,6928
12/27/2013,2013,12,27, 9 ,5677,1125,1086,7888
12/27/2013,2013,12,27, 10 ,6168,1219,1198,8585
12/27/2013,2013,12,27, 11 ,6457,1255,1228,8940
12/27/2013,2013,12,27, 12 ,6352,1240,1253,8845
12/27/2013,2013,12,27, 13 ,6217,1235,1238,8690
12/27/2013,2013,12,27, 14 ,6372,1288,1265,8925
12/27/2013,2013,12,27, 15 ,6264,1268,1271,8803
12/27/2013,2013,12,27, 16 ,6134,1243,1252,8629
12/27/2013,2013,12,27, 17 ,6066,1192,1199,8457
12/27/2013,2013,12,27, 18 ,6460,1312,1347,9119
12/27/2013,2013,12,27, 19 ,6423,1320,1336,9079
12/27/2013,2013,12,27, 20 ,6260,1275,1306,8841
12/27/2013,2013,12,27, 21 ,5989,1209,1235,8433
12/27/2013,2013,12,27, 22 ,5722,1129,1127,7978
12/27/2013,2013,12,27, 23 ,5290,1025,1012,7327
12/27/2013,2013,12,27, 24 ,4891,935,917,6743
12/28/2013,2013,12,28, 1 ,4655,878,897,6430
12/28/2013,2013,12,28, 2 ,4495,852,861,6208
12/28/2013,2013,12,28, 3 ,4380,834,843,6057
12/28/2013,2013,12,28, 4 ,4276,812,835,5923
12/28/2013,2013,12,28, 5 ,4317,819,836,5972
12/28/2013,2013,12,28, 6 ,4371,818,843,6032
12/28/2013,2013,12,28, 7 ,4402,827,834,6063
12/28/2013,2013,12,28, 8 ,4879,925,883,6687
12/28/2013,2013,12,28, 9 ,5238,1049,1007,7294
12/28/2013,2013,12,28, 10 ,5651,1126,1105,7882
12/28/2013,2013,12,28, 11 ,5838,1176,1158,8172
12/28/2013,2013,12,28, 12 ,5760,1143,1126,8029
12/28/2013,2013,12,28, 13 ,5685,1138,1151,7974
12/28/2013,2013,12,28, 14 ,5797,1174,1203,8174
12/28/2013,2013,12,28, 15 ,5674,1145,1179,7998
12/28/2013,2013,12,28, 16 ,5524,1108,1144,7776
12/28/2013,2013,12,28, 17 ,5452,1092,1125,7669
12/28/2013,2013,12,28, 18 ,6073,1272,1317,8662
12/28/2013,2013,12,28, 19 ,6120,1278,1340,8738
12/28/2013,2013,12,28, 20 ,5977,1227,1302,8506
12/28/2013,2013,12,28, 21 ,5757,1180,1243,8180
12/28/2013,2013,12,28, 22 ,5438,1086,1123,7647
12/28/2013,2013,12,28, 23 ,5029,996,1027,7052
12/28/2013,2013,12,28, 24 ,4683,891,934,6508
12/29/2013,2013,12,29, 1 ,4422,864,902,6188
12/29/2013,2013,12,29, 2 ,4322,830,869,6021
12/29/2013,2013,12,29, 3 ,4100,806,847,5753
12/29/2013,2013,12,29, 4 ,4045,799,824,5668
12/29/2013,2013,12,29, 5 ,4086,812,829,5727
12/29/2013,2013,12,29, 6 ,4100,811,825,5736
12/29/2013,2013,12,29, 7 ,4028,807,815,5650
12/29/2013,2013,12,29, 8 ,4297,847,846,5990
12/29/2013,2013,12,29, 9 ,4602,924,945,6471
12/29/2013,2013,12,29, 10 ,4994,988,1029,7011
12/29/2013,2013,12,29, 11 ,5252,1029,1073,7354
12/29/2013,2013,12,29, 12 ,5184,1024,1082,7290
12/29/2013,2013,12,29, 13 ,5229,1026,1088,7343
12/29/2013,2013,12,29, 14 ,5179,1010,1107,7296
12/29/2013,2013,12,29, 15 ,5127,1013,1101,7241
12/29/2013,2013,12,29, 16 ,5009,989,1079,7077
12/29/2013,2013,12,29, 17 ,4989,1017,1059,7065
12/29/2013,2013,12,29, 18 ,5684,1206,1273,8163
12/29/2013,2013,12,29, 19 ,5828,1199,1295,8322
12/29/2013,2013,12,29, 20 ,5717,1160,1263,8140
12/29/2013,2013,12,29, 21 ,5550,1100,1218,7868
12/29/2013,2013,12,29, 22 ,5156,1004,1102,7262
12/29/2013,2013,12,29, 23 ,4811,925,1005,6741
12/29/2013,2013,12,29, 24 ,4454,863,933,6250
12/30/2013,2013,12,30, 1 ,4233,809,885,5927
12/30/2013,2013,12,30, 2 ,4095,790,861,5746
12/30/2013,2013,12,30, 3 ,3900,763,819,5482
12/30/2013,2013,12,30, 4 ,3843,752,807,5402
12/30/2013,2013,12,30, 5 ,3879,757,813,5449
12/30/2013,2013,12,30, 6 ,3895,764,811,5470
12/30/2013,2013,12,30, 7 ,3863,758,803,5424
12/30/2013,2013,12,30, 8 ,4099,802,853,5754
12/30/2013,2013,12,30, 9 ,4481,903,982,6366
12/30/2013,2013,12,30, 10 ,4993,988,1078,7059
12/30/2013,2013,12,30, 11 ,5205,1029,1127,7361
12/30/2013,2013,12,30, 12 ,5159,1021,1135,7315
12/30/2013,2013,12,30, 13 ,5190,1021,1132,7343
12/30/2013,2013,12,30, 14 ,5238,1022,1144,7404
12/30/2013,2013,12,30, 15 ,5153,1003,1117,7273
12/30/2013,2013,12,30, 16 ,5046,1005,1110,7161
12/30/2013,2013,12,30, 17 ,4958,997,1065,7020
12/30/2013,2013,12,30, 18 ,5685,1192,1265,8142
12/30/2013,2013,12,30, 19 ,5805,1197,1275,8277
12/30/2013,2013,12,30, 20 ,5702,1153,1250,8105
12/30/2013,2013,12,30, 21 ,5526,1104,1181,7811
12/30/2013,2013,12,30, 22 ,5169,1024,1109,7302
12/30/2013,2013,12,30, 23 ,4776,917,987,6680
12/30/2013,2013,12,30, 24 ,4447,850,906,6203
12/31/2013,2013,12,31, 1 ,4237,813,858,5908
12/31/2013,2013,12,31, 2 ,4039,793,823,5655
12/31/2013,2013,12,31, 3 ,3990,772,790,5552
12/31/2013,2013,12,31, 4 ,3815,759,781,5355
12/31/2013,2013,12,31, 5 ,3817,766,791,5374
12/31/2013,2013,12,31, 6 ,3826,767,792,5385
12/31/2013,2013,12,31, 7 ,3718,769,780,5267
12/31/2013,2013,12,31, 8 ,3923,816,822,5561
12/31/2013,2013,12,31, 9 ,4339,918,935,6192
12/31/2013,2013,12,31, 10 ,4622,967,1010,6599
12/31/2013,2013,12,31, 11 ,4816,986,1057,6859
12/31/2013,2013,12,31, 12 ,4917,993,1056,6966
12/31/2013,2013,12,31, 13 ,4855,992,1051,6898
12/31/2013,2013,12,31, 14 ,4871,998,1064,6933
12/31/2013,2013,12,31, 15 ,4783,982,1023,6788
12/31/2013,2013,12,31, 16 ,4657,958,1010,6625
12/31/2013,2013,12,31, 17 ,4550,964,1012,6526
12/31/2013,2013,12,31, 18 ,5122,1166,1198,7486
12/31/2013,2013,12,31, 19 ,5249,1176,1206,7631
12/31/2013,2013,12,31, 20 ,5019,1113,1157,7289
12/31/2013,2013,12,31, 21 ,4859,1074,1129,7062
12/31/2013,2013,12,31, 22 ,4650,1033,1108,6791
12/31/2013,2013,12,31, 23 ,4783,1003,1071,6857
12/31/2013,2013,12,31, 24 ,4483,1039,1048,6570
1/1/2014,2014,1,1, 1 ,4323,981,1012,6316
1/1/2014,2014,1,1, 2 ,3932,871,895,5698
1/1/2014,2014,1,1, 3 ,3632,803,829,5264
1/1/2014,2014,1,1, 4 ,3515,777,792,5084
1/1/2014,2014,1,1, 5 ,3393,759,774,4926
1/1/2014,2014,1,1, 6 ,3359,735,734,4828
1/1/2014,2014,1,1, 7 ,3192,711,716,4619
1/1/2014,2014,1,1, 8 ,3238,724,730,4692
1/1/2014,2014,1,1, 9 ,3398,739,759,4896
1/1/2014,2014,1,1, 10 ,3570,755,784,5109
1/1/2014,2014,1,1, 11 ,3831,791,821,5443
1/1/2014,2014,1,1, 12 ,4095,830,864,5789
1/1/2014,2014,1,1, 13 ,4143,831,865,5839
1/1/2014,2014,1,1, 14 ,4188,833,866,5887
1/1/2014,2014,1,1, 15 ,4116,807,865,5788
1/1/2014,2014,1,1, 16 ,4070,801,863,5734
1/1/2014,2014,1,1, 17 ,4015,828,883,5726
1/1/2014,2014,1,1, 18 ,4702,1028,1080,6810
1/1/2014,2014,1,1, 19 ,4973,1048,1109,7130
1/1/2014,2014,1,1, 20 ,4902,999,1085,6986
1/1/2014,2014,1,1, 21 ,4700,929,1011,6640
1/1/2014,2014,1,1, 22 ,4420,858,926,6204
1/1/2014,2014,1,1, 23 ,4115,790,849,5754
1/1/2014,2014,1,1, 24 ,3890,750,856,5496
1/2/2014,2014,1,2, 1 ,3731,719,772,5222
1/2/2014,2014,1,2, 2 ,3575,698,743,5016
1/2/2014,2014,1,2, 3 ,3506,682,728,4916
1/2/2014,2014,1,2, 4 ,3464,679,723,4866
1/2/2014,2014,1,2, 5 ,3484,685,739,4908
1/2/2014,2014,1,2, 6 ,3633,705,755,5093
1/2/2014,2014,1,2, 7 ,3907,726,762,5395
1/2/2014,2014,1,2, 8 ,4555,800,844,6199
1/2/2014,2014,1,2, 9 ,5293,959,1037,7289
1/2/2014,2014,1,2, 10 ,5798,1043,1130,7971
1/2/2014,2014,1,2, 11 ,6150,1091,1208,8449
1/2/2014,2014,1,2, 12 ,6176,1080,1213,8469
1/2/2014,2014,1,2, 13 ,6120,1082,1219,8421
1/2/2014,2014,1,2, 14 ,6292,1122,1248,8662
1/2/2014,2014,1,2, 15 ,6203,1103,1235,8541
1/2/2014,2014,1,2, 16 ,6209,1096,1225,8530
1/2/2014,2014,1,2, 17 ,5839,1062,1144,8045
1/2/2014,2014,1,2, 18 ,6168,1214,1328,8710
1/2/2014,2014,1,2, 19 ,6212,1209,1308,8729
1/2/2014,2014,1,2, 20 ,5948,1148,1244,8340
1/2/2014,2014,1,2, 21 ,5650,1076,1197,7923
1/2/2014,2014,1,2, 22 ,5313,979,1070,7362
1/2/2014,2014,1,2, 23 ,4933,890,977,6800
1/2/2014,2014,1,2, 24 ,4619,834,881,6334
1/3/2014,2014,1,3, 1 ,4354,801,860,6015
1/3/2014,2014,1,3, 2 ,4209,774,834,5817
1/3/2014,2014,1,3, 3 ,4083,750,806,5639
1/3/2014,2014,1,3, 4 ,3979,739,797,5515
1/3/2014,2014,1,3, 5 ,4023,755,809,5587
1/3/2014,2014,1,3, 6 ,4205,771,825,5801
1/3/2014,2014,1,3, 7 ,4400,784,816,6000
1/3/2014,2014,1,3, 8 ,4983,881,909,6773
1/3/2014,2014,1,3, 9 ,5742,1056,1086,7884
1/3/2014,2014,1,3, 10 ,6201,1145,1189,8535
1/3/2014,2014,1,3, 11 ,6541,1172,1250,8963
1/3/2014,2014,1,3, 12 ,6474,1136,1237,8847
1/3/2014,2014,1,3, 13 ,6420,1119,1245,8784
1/3/2014,2014,1,3, 14 ,6696,1157,1291,9144
1/3/2014,2014,1,3, 15 ,6593,1158,1271,9022
1/3/2014,2014,1,3, 16 ,6522,1152,1267,8941
1/3/2014,2014,1,3, 17 ,6272,1094,1190,8556
1/3/2014,2014,1,3, 18 ,6514,1248,1314,9076
1/3/2014,2014,1,3, 19 ,6571,1249,1311,9131
1/3/2014,2014,1,3, 20 ,6347,1190,1279,8816
1/3/2014,2014,1,3, 21 ,6068,1111,1204,8383
1/3/2014,2014,1,3, 22 ,5675,1021,1098,7794
1/3/2014,2014,1,3, 23 ,5241,933,986,7160
1/3/2014,2014,1,3, 24 ,4904,866,919,6689
1/4/2014,2014,1,4, 1 ,4684,828,864,6376
1/4/2014,2014,1,4, 2 ,4520,797,827,6144
1/4/2014,2014,1,4, 3 ,4367,786,801,5954
1/4/2014,2014,1,4, 4 ,4285,769,788,5842
1/4/2014,2014,1,4, 5 ,4337,781,795,5913
1/4/2014,2014,1,4, 6 ,4343,793,804,5940
1/4/2014,2014,1,4, 7 ,4371,803,802,5976
1/4/2014,2014,1,4, 8 ,4754,881,860,6495
1/4/2014,2014,1,4, 9 ,5307,1037,997,7341
1/4/2014,2014,1,4, 10 ,5873,1103,1105,8081
1/4/2014,2014,1,4, 11 ,6204,1162,1153,8519
1/4/2014,2014,1,4, 12 ,6150,1141,1161,8452
1/4/2014,2014,1,4, 13 ,6075,1129,1162,8366
1/4/2014,2014,1,4, 14 ,6207,1177,1205,8589
1/4/2014,2014,1,4, 15 ,6084,1157,1176,8417
1/4/2014,2014,1,4, 16 ,5960,1129,1150,8239
1/4/2014,2014,1,4, 17 ,5760,1072,1119,7951
1/4/2014,2014,1,4, 18 ,6175,1217,1276,8668
1/4/2014,2014,1,4, 19 ,6380,1252,1294,8926
1/4/2014,2014,1,4, 20 ,6201,1197,1244,8642
1/4/2014,2014,1,4, 21 ,6013,1144,1187,8344
1/4/2014,2014,1,4, 22 ,5676,1025,1079,7780
1/4/2014,2014,1,4, 23 ,5298,949,986,7233
1/4/2014,2014,1,4, 24 ,4965,885,909,6759
1/5/2014,2014,1,5, 1 ,4704,855,863,6422
1/5/2014,2014,1,5, 2 ,4556,826,829,6211
1/5/2014,2014,1,5, 3 ,4399,805,802,6006
1/5/2014,2014,1,5, 4 ,4293,795,782,5870
1/5/2014,2014,1,5, 5 ,4219,796,788,5803
1/5/2014,2014,1,5, 6 ,4250,797,796,5843
1/5/2014,2014,1,5, 7 ,4151,794,787,5732
1/5/2014,2014,1,5, 8 ,4401,829,828,6058
1/5/2014,2014,1,5, 9 ,4739,903,909,6551
1/5/2014,2014,1,5, 10 ,5194,970,993,7157
1/5/2014,2014,1,5, 11 ,5413,1013,1045,7471
1/5/2014,2014,1,5, 12 ,5401,1013,1055,7469
1/5/2014,2014,1,5, 13 ,5360,999,1038,7397
1/5/2014,2014,1,5, 14 ,5393,1004,1051,7448
1/5/2014,2014,1,5, 15 ,5328,988,1047,7363
1/5/2014,2014,1,5, 16 ,5194,973,1013,7180
1/5/2014,2014,1,5, 17 ,5106,973,1040,7119
1/5/2014,2014,1,5, 18 ,5717,1167,1232,8116
1/5/2014,2014,1,5, 19 ,5990,1208,1258,8456
1/5/2014,2014,1,5, 20 ,5918,1161,1214,8293
1/5/2014,2014,1,5, 21 ,5670,1074,1147,7891
1/5/2014,2014,1,5, 22 ,5370,983,1037,7390
1/5/2014,2014,1,5, 23 ,4990,881,951,6822
1/5/2014,2014,1,5, 24 ,4711,843,899,6453
1/6/2014,2014,1,6, 1 ,4431,808,831,6070
1/6/2014,2014,1,6, 2 ,4260,781,785,5826
1/6/2014,2014,1,6, 3 ,4144,771,765,5680
1/6/2014,2014,1,6, 4 ,4176,770,759,5705
1/6/2014,2014,1,6, 5 ,4390,807,803,6000
1/6/2014,2014,1,6, 6 ,4648,858,858,6364
1/6/2014,2014,1,6, 7 ,4668,837,790,6295
1/6/2014,2014,1,6, 8 ,5301,939,894,7134
1/6/2014,2014,1,6, 9 ,6049,1128,1097,8274
1/6/2014,2014,1,6, 10 ,6597,1222,1203,9022
1/6/2014,2014,1,6, 11 ,6818,1258,1275,9351
1/6/2014,2014,1,6, 12 ,6663,1249,1250,9162
1/6/2014,2014,1,6, 13 ,6616,1228,1236,9080
1/6/2014,2014,1,6, 14 ,6819,1288,1276,9383
1/6/2014,2014,1,6, 15 ,6708,1260,1264,9232
1/6/2014,2014,1,6, 16 ,6635,1240,1242,9117
1/6/2014,2014,1,6, 17 ,6361,1192,1206,8759
1/6/2014,2014,1,6, 18 ,6636,1322,1336,9294
1/6/2014,2014,1,6, 19 ,6635,1330,1292,9257
1/6/2014,2014,1,6, 20 ,6638,1248,1199,9085
1/6/2014,2014,1,6, 21 ,6421,1182,1112,8715
1/6/2014,2014,1,6, 22 ,6157,1076,1034,8267
1/6/2014,2014,1,6, 23 ,5325,979,940,7244
1/6/2014,2014,1,6, 24 ,4937,912,835,6684
1/7/2014,2014,1,7, 1 ,4700,870,848,6418
1/7/2014,2014,1,7, 2 ,4579,845,827,6251
1/7/2014,2014,1,7, 3 ,4505,824,807,6136
1/7/2014,2014,1,7, 4 ,4479,813,800,6092
1/7/2014,2014,1,7, 5 ,4649,846,828,6323
1/7/2014,2014,1,7, 6 ,4867,891,888,6646
1/7/2014,2014,1,7, 7 ,4913,854,857,6624
1/7/2014,2014,1,7, 8 ,5537,946,890,7373
1/7/2014,2014,1,7, 9 ,6308,1134,1027,8469
1/7/2014,2014,1,7, 10 ,6739,1217,1040,8996
1/7/2014,2014,1,7, 11 ,6973,1252,1132,9357
1/7/2014,2014,1,7, 12 ,6786,1205,1095,9086
1/7/2014,2014,1,7, 13 ,6670,1189,1069,8928
1/7/2014,2014,1,7, 14 ,6899,1241,1120,9260
1/7/2014,2014,1,7, 15 ,6795,1215,1096,9106
1/7/2014,2014,1,7, 16 ,6745,1203,1119,9067
1/7/2014,2014,1,7, 17 ,6454,1163,1119,8736
1/7/2014,2014,1,7, 18 ,6684,1286,1271,9241
1/7/2014,2014,1,7, 19 ,6771,1276,1242,9289
1/7/2014,2014,1,7, 20 ,6491,1203,1167,8861
1/7/2014,2014,1,7, 21 ,6170,1120,1068,8358
1/7/2014,2014,1,7, 22 ,5748,1019,975,7742
1/7/2014,2014,1,7, 23 ,5303,922,878,7103
1/7/2014,2014,1,7, 24 ,4967,858,829,6654
1/8/2014,2014,1,8, 1 ,4759,832,781,6372
1/8/2014,2014,1,8, 2 ,4579,807,757,6143
1/8/2014,2014,1,8, 3 ,4508,790,742,6040
1/8/2014,2014,1,8, 4 ,4469,785,742,5996
1/8/2014,2014,1,8, 5 ,4631,818,781,6230
1/8/2014,2014,1,8, 6 ,4891,869,865,6625
1/8/2014,2014,1,8, 7 ,4908,840,794,6542
1/8/2014,2014,1,8, 8 ,5446,933,871,7250
1/8/2014,2014,1,8, 9 ,6219,1118,1039,8376
1/8/2014,2014,1,8, 10 ,6733,1208,1147,9088
1/8/2014,2014,1,8, 11 ,7000,1248,1201,9449
1/8/2014,2014,1,8, 12 ,6820,1204,1156,9180
1/8/2014,2014,1,8, 13 ,6836,1208,1156,9200
1/8/2014,2014,1,8, 14 ,7063,1259,1212,9534
1/8/2014,2014,1,8, 15 ,6913,1228,1199,9340
1/8/2014,2014,1,8, 16 ,6773,1202,1184,9159
1/8/2014,2014,1,8, 17 ,6469,1192,1172,8833
1/8/2014,2014,1,8, 18 ,6701,1310,1272,9283
1/8/2014,2014,1,8, 19 ,6721,1282,1259,9262
1/8/2014,2014,1,8, 20 ,6448,1209,1204,8861
1/8/2014,2014,1,8, 21 ,6222,1119,1099,8440
1/8/2014,2014,1,8, 22 ,5808,1015,1007,7830
1/8/2014,2014,1,8, 23 ,5358,924,911,7193
1/8/2014,2014,1,8, 24 ,5018,862,835,6715
1/9/2014,2014,1,9, 1 ,4743,828,800,6371
1/9/2014,2014,1,9, 2 ,4609,802,779,6190
1/9/2014,2014,1,9, 3 ,4491,789,762,6042
1/9/2014,2014,1,9, 4 ,4444,783,758,5985
1/9/2014,2014,1,9, 5 ,4628,820,801,6249
1/9/2014,2014,1,9, 6 ,4844,867,878,6589
1/9/2014,2014,1,9, 7 ,4906,864,822,6592
1/9/2014,2014,1,9, 8 ,5407,941,882,7230
1/9/2014,2014,1,9, 9 ,6115,1085,1043,8243
1/9/2014,2014,1,9, 10 ,6616,1174,1128,8918
1/9/2014,2014,1,9, 11 ,6824,1216,1185,9225
1/9/2014,2014,1,9, 12 ,6666,1171,1167,9004
1/9/2014,2014,1,9, 13 ,6604,1151,1161,8916
1/9/2014,2014,1,9, 14 ,6879,1218,1213,9310
1/9/2014,2014,1,9, 15 ,6813,1195,1186,9194
1/9/2014,2014,1,9, 16 ,6669,1187,1174,9030
1/9/2014,2014,1,9, 17 ,6321,1153,1163,8637
1/9/2014,2014,1,9, 18 ,6659,1288,1274,9221
1/9/2014,2014,1,9, 19 ,6690,1274,1269,9233
1/9/2014,2014,1,9, 20 ,6431,1205,1188,8824
1/9/2014,2014,1,9, 21 ,6200,1126,1113,8439
1/9/2014,2014,1,9, 22 ,5713,1018,999,7730
1/9/2014,2014,1,9, 23 ,5332,919,895,7146
1/9/2014,2014,1,9, 24 ,4937,851,843,6631
1/10/2014,2014,1,10, 1 ,4734,817,807,6358
1/10/2014,2014,1,10, 2 ,4603,796,783,6182
1/10/2014,2014,1,10, 3 ,4482,773,764,6019
1/10/2014,2014,1,10, 4 ,4390,779,756,5925
1/10/2014,2014,1,10, 5 ,4641,812,789,6242
1/10/2014,2014,1,10, 6 ,4825,867,868,6560
1/10/2014,2014,1,10, 7 ,4985,857,828,6670
1/10/2014,2014,1,10, 8 ,5441,929,871,7241
1/10/2014,2014,1,10, 9 ,6109,1087,1017,8213
1/10/2014,2014,1,10, 10 ,6482,1169,1100,8751
1/10/2014,2014,1,10, 11 ,6693,1189,1130,9012
1/10/2014,2014,1,10, 12 ,6538,1146,1102,8786
1/10/2014,2014,1,10, 13 ,6415,1140,1079,8634
1/10/2014,2014,1,10, 14 ,6611,1184,1109,8904
1/10/2014,2014,1,10, 15 ,6465,1156,1076,8697
1/10/2014,2014,1,10, 16 ,6398,1135,1074,8607
1/10/2014,2014,1,10, 17 ,6169,1108,1088,8365
1/10/2014,2014,1,10, 18 ,6467,1237,1190,8894
1/10/2014,2014,1,10, 19 ,6499,1233,1123,8855
1/10/2014,2014,1,10, 20 ,6179,1186,1049,8414
1/10/2014,2014,1,10, 21 ,5911,1104,969,7984
1/10/2014,2014,1,10, 22 ,5553,1005,908,7466
1/10/2014,2014,1,10, 23 ,5132,887,814,6833
1/10/2014,2014,1,10, 24 ,4766,831,840,6437
1/11/2014,2014,1,11, 1 ,4532,805,717,6054
1/11/2014,2014,1,11, 2 ,4442,783,698,5923
1/11/2014,2014,1,11, 3 ,4286,764,678,5728
1/11/2014,2014,1,11, 4 ,4243,758,675,5676
1/11/2014,2014,1,11, 5 ,4328,788,694,5810
1/11/2014,2014,1,11, 6 ,4448,817,743,6008
1/11/2014,2014,1,11, 7 ,4544,837,770,6151
1/11/2014,2014,1,11, 8 ,4898,898,818,6614
1/11/2014,2014,1,11, 9 ,5414,996,907,7317
1/11/2014,2014,1,11, 10 ,5806,1054,965,7825
1/11/2014,2014,1,11, 11 ,6044,1085,999,8128
1/11/2014,2014,1,11, 12 ,5971,1011,983,7965
1/11/2014,2014,1,11, 13 ,5829,989,961,7779
1/11/2014,2014,1,11, 14 ,5944,1017,979,7940
1/11/2014,2014,1,11, 15 ,5821,1009,974,7804
1/11/2014,2014,1,11, 16 ,5665,1004,978,7647
1/11/2014,2014,1,11, 17 ,5525,1030,1025,7580
1/11/2014,2014,1,11, 18 ,5894,1149,1131,8174
1/11/2014,2014,1,11, 19 ,6090,1135,1106,8331
1/11/2014,2014,1,11, 20 ,5857,1085,1050,7992
1/11/2014,2014,1,11, 21 ,5618,1007,958,7583
1/11/2014,2014,1,11, 22 ,5220,912,862,6994
1/11/2014,2014,1,11, 23 ,4804,836,781,6421
1/11/2014,2014,1,11, 24 ,4492,783,765,6040
1/12/2014,2014,1,12, 1 ,4299,749,698,5746
1/12/2014,2014,1,12, 2 ,4210,732,664,5606
1/12/2014,2014,1,12, 3 ,4106,716,649,5471
1/12/2014,2014,1,12, 4 ,4061,707,647,5415
1/12/2014,2014,1,12, 5 ,4084,715,656,5455
1/12/2014,2014,1,12, 6 ,4103,738,714,5555
1/12/2014,2014,1,12, 7 ,4125,768,733,5626
1/12/2014,2014,1,12, 8 ,4317,801,756,5874
1/12/2014,2014,1,12, 9 ,4715,853,792,6360
1/12/2014,2014,1,12, 10 ,5092,904,849,6845
1/12/2014,2014,1,12, 11 ,5286,921,847,7054
1/12/2014,2014,1,12, 12 ,5247,911,880,7038
1/12/2014,2014,1,12, 13 ,5181,893,872,6946
1/12/2014,2014,1,12, 14 ,5227,883,877,6987
1/12/2014,2014,1,12, 15 ,5130,874,880,6884
1/12/2014,2014,1,12, 16 ,5104,881,889,6874
1/12/2014,2014,1,12, 17 ,5073,932,936,6941
1/12/2014,2014,1,12, 18 ,5748,1086,1085,7919
1/12/2014,2014,1,12, 19 ,5880,1086,1100,8066
1/12/2014,2014,1,12, 20 ,5723,1014,1047,7784
1/12/2014,2014,1,12, 21 ,5424,920,981,7325
1/12/2014,2014,1,12, 22 ,5050,841,916,6807
1/12/2014,2014,1,12, 23 ,4648,768,812,6228
1/12/2014,2014,1,12, 24 ,4417,714,733,5864
1/13/2014,2014,1,13, 1 ,4113,689,705,5507
1/13/2014,2014,1,13, 2 ,4048,672,691,5411
1/13/2014,2014,1,13, 3 ,3935,665,677,5277
1/13/2014,2014,1,13, 4 ,3935,664,672,5271
1/13/2014,2014,1,13, 5 ,4208,705,719,5632
1/13/2014,2014,1,13, 6 ,4590,788,747,6125
1/13/2014,2014,1,13, 7 ,4692,813,785,6290
1/13/2014,2014,1,13, 8 ,5190,876,823,6889
1/13/2014,2014,1,13, 9 ,6006,1017,963,7986
1/13/2014,2014,1,13, 10 ,6403,1094,1035,8532
1/13/2014,2014,1,13, 11 ,6623,1123,1110,8856
1/13/2014,2014,1,13, 12 ,6452,1080,1088,8620
1/13/2014,2014,1,13, 13 ,6349,1046,1090,8485
1/13/2014,2014,1,13, 14 ,6600,1085,1131,8816
1/13/2014,2014,1,13, 15 ,6501,1074,1099,8674
1/13/2014,2014,1,13, 16 ,6375,1074,1120,8569
1/13/2014,2014,1,13, 17 ,6221,1073,1129,8423
1/13/2014,2014,1,13, 18 ,6484,1205,1244,8933
1/13/2014,2014,1,13, 19 ,6513,1200,1175,8888
1/13/2014,2014,1,13, 20 ,6175,1115,1125,8415
1/13/2014,2014,1,13, 21 ,5863,1031,1031,7925
1/13/2014,2014,1,13, 22 ,5371,920,932,7223
1/13/2014,2014,1,13, 23 ,5054,826,849,6729
1/13/2014,2014,1,13, 24 ,4648,767,791,6206
1/14/2014,2014,1,14, 1 ,4438,760,754,5952
1/14/2014,2014,1,14, 2 ,4331,744,737,5812
1/14/2014,2014,1,14, 3 ,4257,733,718,5708
1/14/2014,2014,1,14, 4 ,4216,728,719,5663
1/14/2014,2014,1,14, 5 ,4417,772,756,5945
1/14/2014,2014,1,14, 6 ,4733,832,838,6403
1/14/2014,2014,1,14, 7 ,4834,847,816,6497
1/14/2014,2014,1,14, 8 ,5306,916,856,7078
1/14/2014,2014,1,14, 9 ,5941,1066,993,8000
1/14/2014,2014,1,14, 10 ,6384,1138,1077,8599
1/14/2014,2014,1,14, 11 ,6665,1162,1113,8940
1/14/2014,2014,1,14, 12 ,6499,1127,1082,8708
1/14/2014,2014,1,14, 13 ,6392,1112,1063,8567
1/14/2014,2014,1,14, 14 ,6708,1165,1109,8982
1/14/2014,2014,1,14, 15 ,6591,1146,1100,8837
1/14/2014,2014,1,14, 16 ,6532,1144,1103,8779
1/14/2014,2014,1,14, 17 ,6328,1135,1108,8571
1/14/2014,2014,1,14, 18 ,6650,1220,1216,9086
1/14/2014,2014,1,14, 19 ,6673,1229,1199,9101
1/14/2014,2014,1,14, 20 ,6381,1153,1140,8674
1/14/2014,2014,1,14, 21 ,6081,1081,1062,8224
1/14/2014,2014,1,14, 22 ,5565,974,950,7489
1/14/2014,2014,1,14, 23 ,5165,887,856,6908
1/14/2014,2014,1,14, 24 ,4761,807,791,6359
1/15/2014,2014,1,15, 1 ,4563,786,757,6106
1/15/2014,2014,1,15, 2 ,4420,762,728,5910
1/15/2014,2014,1,15, 3 ,4330,751,708,5789
1/15/2014,2014,1,15, 4 ,4323,739,710,5772
1/15/2014,2014,1,15, 5 ,4512,779,766,6057
1/15/2014,2014,1,15, 6 ,4824,837,847,6508
1/15/2014,2014,1,15, 7 ,4855,836,799,6490
1/15/2014,2014,1,15, 8 ,5387,902,856,7145
1/15/2014,2014,1,15, 9 ,6042,1047,1019,8108
1/15/2014,2014,1,15, 10 ,6428,1124,1091,8643
1/15/2014,2014,1,15, 11 ,6630,1163,1127,8920
1/15/2014,2014,1,15, 12 ,6458,1125,1083,8666
1/15/2014,2014,1,15, 13 ,6384,1117,1078,8579
1/15/2014,2014,1,15, 14 ,6615,1166,1139,8920
1/15/2014,2014,1,15, 15 ,6472,1152,1098,8722
1/15/2014,2014,1,15, 16 ,6356,1134,1097,8587
1/15/2014,2014,1,15, 17 ,6108,1106,1102,8316
1/15/2014,2014,1,15, 18 ,6345,1212,1208,8765
1/15/2014,2014,1,15, 19 ,6368,1208,1185,8761
1/15/2014,2014,1,15, 20 ,6086,1134,1122,8342
1/15/2014,2014,1,15, 21 ,5700,1060,1049,7809
1/15/2014,2014,1,15, 22 ,5381,956,977,7314
1/15/2014,2014,1,15, 23 ,4941,860,870,6671
1/15/2014,2014,1,15, 24 ,4594,797,777,6168
1/16/2014,2014,1,16, 1 ,4403,759,753,5915
1/16/2014,2014,1,16, 2 ,4220,742,730,5692
1/16/2014,2014,1,16, 3 ,4175,713,713,5601
1/16/2014,2014,1,16, 4 ,4133,717,717,5567
1/16/2014,2014,1,16, 5 ,4368,764,760,5892
1/16/2014,2014,1,16, 6 ,4686,827,837,6350
1/16/2014,2014,1,16, 7 ,4904,829,784,6517
1/16/2014,2014,1,16, 8 ,5162,892,858,6912
1/16/2014,2014,1,16, 9 ,5787,1047,988,7822
1/16/2014,2014,1,16, 10 ,6169,1117,1087,8373
1/16/2014,2014,1,16, 11 ,6351,1151,1135,8637
1/16/2014,2014,1,16, 12 ,6219,1107,1126,8452
1/16/2014,2014,1,16, 13 ,6134,1081,1110,8325
1/16/2014,2014,1,16, 14 ,6387,1145,1180,8712
1/16/2014,2014,1,16, 15 ,6253,1128,1174,8555
1/16/2014,2014,1,16, 16 ,6164,1115,1159,8438
1/16/2014,2014,1,16, 17 ,5917,1088,1141,8146
1/16/2014,2014,1,16, 18 ,6157,1204,1238,8599
1/16/2014,2014,1,16, 19 ,6269,1205,1223,8697
1/16/2014,2014,1,16, 20 ,5992,1137,1167,8296
1/16/2014,2014,1,16, 21 ,5665,1045,1085,7795
1/16/2014,2014,1,16, 22 ,5306,951,987,7244
1/16/2014,2014,1,16, 23 ,4917,852,879,6648
1/16/2014,2014,1,16, 24 ,4549,785,794,6128
1/17/2014,2014,1,17, 1 ,4359,755,777,5891
1/17/2014,2014,1,17, 2 ,4223,730,751,5704
1/17/2014,2014,1,17, 3 ,4200,725,737,5662
1/17/2014,2014,1,17, 4 ,4141,724,737,5602
1/17/2014,2014,1,17, 5 ,4410,767,782,5959
1/17/2014,2014,1,17, 6 ,4693,829,833,6355
1/17/2014,2014,1,17, 7 ,4804,845,796,6445
1/17/2014,2014,1,17, 8 ,5227,893,866,6986
1/17/2014,2014,1,17, 9 ,5861,1028,990,7879
1/17/2014,2014,1,17, 10 ,6198,1072,1115,8385
1/17/2014,2014,1,17, 11 ,6360,1106,1139,8605
1/17/2014,2014,1,17, 12 ,6247,1064,1114,8425
1/17/2014,2014,1,17, 13 ,6169,1057,1106,8332
1/17/2014,2014,1,17, 14 ,6422,1100,1130,8652
1/17/2014,2014,1,17, 15 ,6308,1088,1135,8531
1/17/2014,2014,1,17, 16 ,6240,1092,1101,8433
1/17/2014,2014,1,17, 17 ,5981,1089,1082,8152
1/17/2014,2014,1,17, 18 ,6298,1175,1217,8690
1/17/2014,2014,1,17, 19 ,6314,1177,1212,8703
1/17/2014,2014,1,17, 20 ,6038,1102,1147,8287
1/17/2014,2014,1,17, 21 ,5766,1031,1079,7876
1/17/2014,2014,1,17, 22 ,5359,952,984,7295
1/17/2014,2014,1,17, 23 ,4991,856,887,6734
1/17/2014,2014,1,17, 24 ,4621,802,812,6235
1/18/2014,2014,1,18, 1 ,4416,768,779,5963
1/18/2014,2014,1,18, 2 ,4302,747,779,5828
1/18/2014,2014,1,18, 3 ,4226,734,732,5692
1/18/2014,2014,1,18, 4 ,4148,732,727,5607
1/18/2014,2014,1,18, 5 ,4224,753,738,5715
1/18/2014,2014,1,18, 6 ,4387,784,774,5945
1/18/2014,2014,1,18, 7 ,4464,807,783,6054
1/18/2014,2014,1,18, 8 ,4868,864,827,6559
1/18/2014,2014,1,18, 9 ,5349,956,931,7236
1/18/2014,2014,1,18, 10 ,5689,1006,1012,7707
1/18/2014,2014,1,18, 11 ,5944,1033,1069,8046
1/18/2014,2014,1,18, 12 ,5776,993,1038,7807
1/18/2014,2014,1,18, 13 ,5649,987,1031,7667
1/18/2014,2014,1,18, 14 ,5728,985,1064,7777
1/18/2014,2014,1,18, 15 ,5527,964,1043,7534
1/18/2014,2014,1,18, 16 ,5438,956,1032,7426
1/18/2014,2014,1,18, 17 ,5352,951,1050,7353
1/18/2014,2014,1,18, 18 ,5717,1076,1148,7941
1/18/2014,2014,1,18, 19 ,5804,1103,1164,8071
1/18/2014,2014,1,18, 20 ,5804,1055,1107,7966
1/18/2014,2014,1,18, 21 ,5446,987,1029,7462
1/18/2014,2014,1,18, 22 ,5081,889,946,6916
1/18/2014,2014,1,18, 23 ,4696,811,850,6357
1/18/2014,2014,1,18, 24 ,4366,740,783,5889
1/19/2014,2014,1,19, 1 ,4171,708,746,5625
1/19/2014,2014,1,19, 2 ,4048,689,717,5454
1/19/2014,2014,1,19, 3 ,3918,678,695,5291
1/19/2014,2014,1,19, 4 ,3875,670,692,5237
1/19/2014,2014,1,19, 5 ,3892,691,706,5289
1/19/2014,2014,1,19, 6 ,3994,698,740,5432
1/19/2014,2014,1,19, 7 ,4039,727,760,5526
1/19/2014,2014,1,19, 8 ,4184,750,788,5722
1/19/2014,2014,1,19, 9 ,4461,792,831,6084
1/19/2014,2014,1,19, 10 ,4774,828,877,6479
1/19/2014,2014,1,19, 11 ,4888,817,884,6589
1/19/2014,2014,1,19, 12 ,4793,822,874,6489
1/19/2014,2014,1,19, 13 ,4686,806,883,6375
1/19/2014,2014,1,19, 14 ,4700,743,864,6307
1/19/2014,2014,1,19, 15 ,4651,794,833,6278
1/19/2014,2014,1,19, 16 ,4594,779,853,6226
1/19/2014,2014,1,19, 17 ,4540,845,864,6249
1/19/2014,2014,1,19, 18 ,5168,1008,1020,7196
1/19/2014,2014,1,19, 19 ,5396,1044,996,7436
1/19/2014,2014,1,19, 20 ,5263,986,972,7221
1/19/2014,2014,1,19, 21 ,4919,909,897,6725
1/19/2014,2014,1,19, 22 ,4513,820,797,6130
1/19/2014,2014,1,19, 23 ,4124,743,727,5594
1/19/2014,2014,1,19, 24 ,3910,696,683,5289
1/20/2014,2014,1,20, 1 ,3708,667,648,5023
1/20/2014,2014,1,20, 2 ,3577,653,623,4853
1/20/2014,2014,1,20, 3 ,3478,641,610,4729
1/20/2014,2014,1,20, 4 ,3502,638,615,4755
1/20/2014,2014,1,20, 5 ,3812,684,665,5161
1/20/2014,2014,1,20, 6 ,4267,769,680,5716
1/20/2014,2014,1,20, 7 ,4387,798,776,5961
1/20/2014,2014,1,20, 8 ,4847,848,808,6503
1/20/2014,2014,1,20, 9 ,5512,985,945,7442
1/20/2014,2014,1,20, 10 ,5964,1052,1011,8027
1/20/2014,2014,1,20, 11 ,6193,1087,1043,8323
1/20/2014,2014,1,20, 12 ,6015,1058,1038,8111
1/20/2014,2014,1,20, 13 ,5861,1032,992,7885
1/20/2014,2014,1,20, 14 ,6121,1072,991,8184
1/20/2014,2014,1,20, 15 ,6014,1054,972,8040
1/20/2014,2014,1,20, 16 ,5996,1053,976,8025
1/20/2014,2014,1,20, 17 ,5865,1063,995,7923
1/20/2014,2014,1,20, 18 ,6100,1183,1102,8385
1/20/2014,2014,1,20, 19 ,6200,1182,1108,8490
1/20/2014,2014,1,20, 20 ,5901,1115,1039,8055
1/20/2014,2014,1,20, 21 ,5517,1023,953,7493
1/20/2014,2014,1,20, 22 ,5101,922,865,6888
1/20/2014,2014,1,20, 23 ,4683,821,766,6270
1/20/2014,2014,1,20, 24 ,4325,751,668,5744
1/21/2014,2014,1,21, 1 ,4143,726,686,5555
1/21/2014,2014,1,21, 2 ,4035,711,651,5397
1/21/2014,2014,1,21, 3 ,3951,703,651,5305
1/21/2014,2014,1,21, 4 ,3981,707,657,5345
1/21/2014,2014,1,21, 5 ,4311,754,711,5776
1/21/2014,2014,1,21, 6 ,4607,823,796,6226
1/21/2014,2014,1,21, 7 ,4720,825,761,6306
1/21/2014,2014,1,21, 8 ,5140,868,807,6815
1/21/2014,2014,1,21, 9 ,5679,1014,945,7638
1/21/2014,2014,1,21, 10 ,6068,1082,1029,8179
1/21/2014,2014,1,21, 11 ,6315,1119,1072,8506
1/21/2014,2014,1,21, 12 ,6087,1086,1060,8233
1/21/2014,2014,1,21, 13 ,5947,1068,1055,8070
1/21/2014,2014,1,21, 14 ,6197,1114,1096,8407
1/21/2014,2014,1,21, 15 ,6092,1100,1091,8283
1/21/2014,2014,1,21, 16 ,6045,1096,1074,8215
1/21/2014,2014,1,21, 17 ,5958,1078,1082,8118
1/21/2014,2014,1,21, 18 ,6236,1201,1187,8624
1/21/2014,2014,1,21, 19 ,6265,1218,1203,8686
1/21/2014,2014,1,21, 20 ,5978,1150,1129,8257
1/21/2014,2014,1,21, 21 ,5654,1062,1060,7776
1/21/2014,2014,1,21, 22 ,5221,959,954,7134
1/21/2014,2014,1,21, 23 ,4788,854,850,6492
1/21/2014,2014,1,21, 24 ,4406,790,736,5932
1/22/2014,2014,1,22, 1 ,4241,758,743,5742
1/22/2014,2014,1,22, 2 ,4104,738,718,5560
1/22/2014,2014,1,22, 3 ,4007,727,705,5439
1/22/2014,2014,1,22, 4 ,4103,724,707,5534
1/22/2014,2014,1,22, 5 ,4333,768,753,5854
1/22/2014,2014,1,22, 6 ,4706,839,834,6379
1/22/2014,2014,1,22, 7 ,4772,825,790,6387
1/22/2014,2014,1,22, 8 ,5261,895,856,7012
1/22/2014,2014,1,22, 9 ,5842,1050,1006,7898
1/22/2014,2014,1,22, 10 ,6195,1125,1091,8411
1/22/2014,2014,1,22, 11 ,6410,1171,1131,8712
1/22/2014,2014,1,22, 12 ,6252,1136,1112,8500
1/22/2014,2014,1,22, 13 ,6126,1127,1102,8355
1/22/2014,2014,1,22, 14 ,6360,1179,1148,8687
1/22/2014,2014,1,22, 15 ,6338,1159,1121,8618
1/22/2014,2014,1,22, 16 ,6282,1158,1107,8547
1/22/2014,2014,1,22, 17 ,6083,1111,1110,8304
1/22/2014,2014,1,22, 18 ,6323,1208,1154,8685
1/22/2014,2014,1,22, 19 ,6468,1228,1194,8890
1/22/2014,2014,1,22, 20 ,6140,1161,1129,8430
1/22/2014,2014,1,22, 21 ,5773,1080,1055,7908
1/22/2014,2014,1,22, 22 ,5314,979,955,7248
1/22/2014,2014,1,22, 23 ,4912,874,850,6636
1/22/2014,2014,1,22, 24 ,4562,805,811,6178
1/23/2014,2014,1,23, 1 ,4301,778,748,5827
1/23/2014,2014,1,23, 2 ,4179,754,728,5661
1/23/2014,2014,1,23, 3 ,4078,739,713,5530
1/23/2014,2014,1,23, 4 ,4101,736,709,5546
1/23/2014,2014,1,23, 5 ,4339,782,760,5881
1/23/2014,2014,1,23, 6 ,4655,844,853,6352
1/23/2014,2014,1,23, 7 ,4699,833,805,6337
1/23/2014,2014,1,23, 8 ,5154,899,852,6905
1/23/2014,2014,1,23, 9 ,5737,1046,984,7767
1/23/2014,2014,1,23, 10 ,6119,1119,1075,8313
1/23/2014,2014,1,23, 11 ,6322,1162,1133,8617
1/23/2014,2014,1,23, 12 ,6116,1119,1131,8366
1/23/2014,2014,1,23, 13 ,6015,1099,1114,8228
1/23/2014,2014,1,23, 14 ,6278,1156,1173,8607
1/23/2014,2014,1,23, 15 ,6229,1132,1161,8522
1/23/2014,2014,1,23, 16 ,6113,1124,1145,8382
1/23/2014,2014,1,23, 17 ,5886,1090,1127,8103
1/23/2014,2014,1,23, 18 ,6175,1188,1217,8580
1/23/2014,2014,1,23, 19 ,6246,1215,1250,8711
1/23/2014,2014,1,23, 20 ,5989,1143,1187,8319
1/23/2014,2014,1,23, 21 ,5634,1048,1097,7779
1/23/2014,2014,1,23, 22 ,5093,945,994,7032
1/23/2014,2014,1,23, 23 ,4727,848,887,6462
1/23/2014,2014,1,23, 24 ,4393,787,777,5957
1/24/2014,2014,1,24, 1 ,4201,751,782,5734
1/24/2014,2014,1,24, 2 ,4095,727,755,5577
1/24/2014,2014,1,24, 3 ,3989,713,737,5439
1/24/2014,2014,1,24, 4 ,4036,701,739,5476
1/24/2014,2014,1,24, 5 ,4271,761,788,5820
1/24/2014,2014,1,24, 6 ,4564,826,861,6251
1/24/2014,2014,1,24, 7 ,4682,812,791,6285
1/24/2014,2014,1,24, 8 ,4982,886,861,6729
1/24/2014,2014,1,24, 9 ,5750,1041,998,7789
1/24/2014,2014,1,24, 10 ,6108,1116,1065,8289
1/24/2014,2014,1,24, 11 ,6301,1153,1116,8570
1/24/2014,2014,1,24, 12 ,6055,1111,1077,8243
1/24/2014,2014,1,24, 13 ,5986,1092,1075,8153
1/24/2014,2014,1,24, 14 ,6199,1150,1120,8469
1/24/2014,2014,1,24, 15 ,6149,1136,1105,8390
1/24/2014,2014,1,24, 16 ,6072,1114,1099,8285
1/24/2014,2014,1,24, 17 ,5866,1062,1101,8029
1/24/2014,2014,1,24, 18 ,6007,1177,1191,8375
1/24/2014,2014,1,24, 19 ,6180,1211,1189,8580
1/24/2014,2014,1,24, 20 ,5910,1134,1142,8186
1/24/2014,2014,1,24, 21 ,5540,1058,1082,7680
1/24/2014,2014,1,24, 22 ,5061,952,981,6994
1/24/2014,2014,1,24, 23 ,4649,843,862,6354
1/24/2014,2014,1,24, 24 ,4278,772,825,5875
1/25/2014,2014,1,25, 1 ,4063,738,763,5564
1/25/2014,2014,1,25, 2 ,3920,714,733,5367
1/25/2014,2014,1,25, 3 ,3843,698,723,5264
1/25/2014,2014,1,25, 4 ,3861,696,725,5282
1/25/2014,2014,1,25, 5 ,3955,702,754,5411
1/25/2014,2014,1,25, 6 ,4122,746,779,5647
1/25/2014,2014,1,25, 7 ,4253,763,787,5803
1/25/2014,2014,1,25, 8 ,4592,818,845,6255
1/25/2014,2014,1,25, 9 ,5107,932,919,6958
1/25/2014,2014,1,25, 10 ,5488,982,996,7466
1/25/2014,2014,1,25, 11 ,5718,1029,1060,7807
1/25/2014,2014,1,25, 12 ,5558,1000,1042,7600
1/25/2014,2014,1,25, 13 ,5505,1006,1036,7547
1/25/2014,2014,1,25, 14 ,5700,1044,1080,7824
1/25/2014,2014,1,25, 15 ,5624,1027,1046,7697
1/25/2014,2014,1,25, 16 ,5508,1009,1050,7567
1/25/2014,2014,1,25, 17 ,5334,970,1018,7322
1/25/2014,2014,1,25, 18 ,5575,1077,1146,7798
1/25/2014,2014,1,25, 19 ,5901,1152,1196,8249
1/25/2014,2014,1,25, 20 ,5628,1093,1136,7857
1/25/2014,2014,1,25, 21 ,5368,1030,1074,7472
1/25/2014,2014,1,25, 22 ,4880,921,952,6753
1/25/2014,2014,1,25, 23 ,4458,825,854,6137
1/25/2014,2014,1,25, 24 ,4165,767,759,5691
1/26/2014,2014,1,26, 1 ,3882,722,719,5323
1/26/2014,2014,1,26, 2 ,3748,705,692,5145
1/26/2014,2014,1,26, 3 ,3693,686,677,5056
1/26/2014,2014,1,26, 4 ,3678,680,667,5025
1/26/2014,2014,1,26, 5 ,3689,694,679,5062
1/26/2014,2014,1,26, 6 ,3724,702,721,5147
1/26/2014,2014,1,26, 7 ,3754,708,723,5185
1/26/2014,2014,1,26, 8 ,3934,743,739,5416
1/26/2014,2014,1,26, 9 ,4297,793,797,5887
1/26/2014,2014,1,26, 10 ,4688,848,863,6399
1/26/2014,2014,1,26, 11 ,5005,838,902,6745
1/26/2014,2014,1,26, 12 ,4900,871,914,6685
1/26/2014,2014,1,26, 13 ,4885,864,915,6664
1/26/2014,2014,1,26, 14 ,4907,863,920,6690
1/26/2014,2014,1,26, 15 ,4780,858,918,6556
1/26/2014,2014,1,26, 16 ,4783,852,920,6555
1/26/2014,2014,1,26, 17 ,4803,869,925,6597
1/26/2014,2014,1,26, 18 ,5236,1032,1119,7387
1/26/2014,2014,1,26, 19 ,5537,1097,1136,7770
1/26/2014,2014,1,26, 20 ,5437,1044,1080,7561
1/26/2014,2014,1,26, 21 ,5181,965,1000,7146
1/26/2014,2014,1,26, 22 ,4732,868,896,6496
1/26/2014,2014,1,26, 23 ,4292,784,796,5872
1/26/2014,2014,1,26, 24 ,4014,727,795,5536
1/27/2014,2014,1,27, 1 ,3838,694,740,5272
1/27/2014,2014,1,27, 2 ,3702,672,665,5039
1/27/2014,2014,1,27, 3 ,3673,664,650,4987
1/27/2014,2014,1,27, 4 ,3628,668,656,4952
1/27/2014,2014,1,27, 5 ,3902,716,704,5322
1/27/2014,2014,1,27, 6 ,4319,804,794,5917
1/27/2014,2014,1,27, 7 ,4484,797,739,6020
1/27/2014,2014,1,27, 8 ,5005,853,788,6646
1/27/2014,2014,1,27, 9 ,5624,1011,938,7573
1/27/2014,2014,1,27, 10 ,6076,1093,1054,8223
1/27/2014,2014,1,27, 11 ,6328,1136,1110,8574
1/27/2014,2014,1,27, 12 ,6098,1106,1092,8296
1/27/2014,2014,1,27, 13 ,6060,1096,1079,8235
1/27/2014,2014,1,27, 14 ,6327,1144,1126,8597
1/27/2014,2014,1,27, 15 ,6292,1142,1120,8554
1/27/2014,2014,1,27, 16 ,6024,1126,1109,8259
1/27/2014,2014,1,27, 17 ,6049,1082,1098,8229
1/27/2014,2014,1,27, 18 ,6167,1187,1196,8550
1/27/2014,2014,1,27, 19 ,6330,1223,1212,8765
1/27/2014,2014,1,27, 20 ,6014,1138,1153,8305
1/27/2014,2014,1,27, 21 ,5717,1062,1063,7842
1/27/2014,2014,1,27, 22 ,5235,959,953,7147
1/27/2014,2014,1,27, 23 ,4773,843,846,6462
1/27/2014,2014,1,27, 24 ,4419,773,735,5927
1/28/2014,2014,1,28, 1 ,4189,737,740,5666
1/28/2014,2014,1,28, 2 ,4132,720,720,5572
1/28/2014,2014,1,28, 3 ,4048,701,703,5452
1/28/2014,2014,1,28, 4 ,4015,697,702,5414
1/28/2014,2014,1,28, 5 ,4247,738,760,5745
1/28/2014,2014,1,28, 6 ,4582,815,841,6238
1/28/2014,2014,1,28, 7 ,4690,798,790,6278
1/28/2014,2014,1,28, 8 ,5141,878,862,6881
1/28/2014,2014,1,28, 9 ,5837,1036,999,7872
1/28/2014,2014,1,28, 10 ,6177,1117,1094,8388
1/28/2014,2014,1,28, 11 ,6369,1135,1135,8639
1/28/2014,2014,1,28, 12 ,6244,1100,1120,8464
1/28/2014,2014,1,28, 13 ,6193,1072,1122,8387
1/28/2014,2014,1,28, 14 ,6503,1130,1170,8803
1/28/2014,2014,1,28, 15 ,6397,1116,1170,8683
1/28/2014,2014,1,28, 16 ,6272,1110,1161,8543
1/28/2014,2014,1,28, 17 ,5990,1090,1109,8189
1/28/2014,2014,1,28, 18 ,6190,1196,1189,8575
1/28/2014,2014,1,28, 19 ,6410,1245,1243,8898
1/28/2014,2014,1,28, 20 ,6080,1149,1176,8405
1/28/2014,2014,1,28, 21 ,5749,1068,1069,7886
1/28/2014,2014,1,28, 22 ,5346,951,974,7271
1/28/2014,2014,1,28, 23 ,4898,833,862,6593
1/28/2014,2014,1,28, 24 ,4466,769,787,6022
1/29/2014,2014,1,29, 1 ,4311,742,764,5817
1/29/2014,2014,1,29, 2 ,4206,724,745,5675
1/29/2014,2014,1,29, 3 ,4088,708,722,5518
1/29/2014,2014,1,29, 4 ,4039,711,719,5469
1/29/2014,2014,1,29, 5 ,4334,747,782,5863
1/29/2014,2014,1,29, 6 ,4664,816,855,6335
1/29/2014,2014,1,29, 7 ,4714,812,810,6336
1/29/2014,2014,1,29, 8 ,5196,874,875,6945
1/29/2014,2014,1,29, 9 ,5850,1021,1023,7894
1/29/2014,2014,1,29, 10 ,6271,1090,1100,8461
1/29/2014,2014,1,29, 11 ,6507,1137,1161,8805
1/29/2014,2014,1,29, 12 ,6337,1099,1135,8571
1/29/2014,2014,1,29, 13 ,6299,1106,1116,8521
1/29/2014,2014,1,29, 14 ,6564,1147,1145,8856
1/29/2014,2014,1,29, 15 ,6462,1171,1121,8754
1/29/2014,2014,1,29, 16 ,6363,1160,1114,8637
1/29/2014,2014,1,29, 17 ,6073,1122,1105,8300
1/29/2014,2014,1,29, 18 ,6284,1195,1191,8670
1/29/2014,2014,1,29, 19 ,6451,1268,1241,8960
1/29/2014,2014,1,29, 20 ,6170,1193,1178,8541
1/29/2014,2014,1,29, 21 ,5849,1107,1099,8055
1/29/2014,2014,1,29, 22 ,5440,989,983,7412
1/29/2014,2014,1,29, 23 ,4952,877,871,6700
1/29/2014,2014,1,29, 24 ,4583,815,801,6199
1/30/2014,2014,1,30, 1 ,4381,765,757,5903
1/30/2014,2014,1,30, 2 ,4231,742,747,5720
1/30/2014,2014,1,30, 3 ,4158,727,728,5613
1/30/2014,2014,1,30, 4 ,4154,725,735,5614
1/30/2014,2014,1,30, 5 ,4386,770,774,5930
1/30/2014,2014,1,30, 6 ,4696,833,865,6394
1/30/2014,2014,1,30, 7 ,4767,817,805,6389
1/30/2014,2014,1,30, 8 ,5222,889,878,6989
1/30/2014,2014,1,30, 9 ,5785,1051,1026,7862
1/30/2014,2014,1,30, 10 ,6187,1137,1108,8432
1/30/2014,2014,1,30, 11 ,6415,1191,1167,8773
1/30/2014,2014,1,30, 12 ,6172,1144,1149,8465
1/30/2014,2014,1,30, 13 ,6091,1138,1150,8379
1/30/2014,2014,1,30, 14 ,6300,1177,1195,8672
1/30/2014,2014,1,30, 15 ,6230,1164,1182,8576
1/30/2014,2014,1,30, 16 ,6194,1151,1165,8510
1/30/2014,2014,1,30, 17 ,6035,1082,1135,8252
1/30/2014,2014,1,30, 18 ,6130,1178,1244,8552
1/30/2014,2014,1,30, 19 ,6365,1234,1265,8864
1/30/2014,2014,1,30, 20 ,6090,1158,1179,8427
1/30/2014,2014,1,30, 21 ,5686,1079,1090,7855
1/30/2014,2014,1,30, 22 ,5279,940,983,7202
1/30/2014,2014,1,30, 23 ,4777,837,870,6484
1/30/2014,2014,1,30, 24 ,4427,793,879,6099
1/31/2014,2014,1,31, 1 ,4240,754,787,5781
1/31/2014,2014,1,31, 2 ,4132,721,763,5616
1/31/2014,2014,1,31, 3 ,3943,711,741,5395
1/31/2014,2014,1,31, 4 ,3949,705,734,5388
1/31/2014,2014,1,31, 5 ,3956,721,757,5434
1/31/2014,2014,1,31, 6 ,4094,766,806,5666
1/31/2014,2014,1,31, 7 ,4156,776,782,5714
1/31/2014,2014,1,31, 8 ,4490,834,830,6154
1/31/2014,2014,1,31, 9 ,4905,939,936,6780
1/31/2014,2014,1,31, 10 ,5321,991,1000,7312
1/31/2014,2014,1,31, 11 ,5590,1039,1039,7668
1/31/2014,2014,1,31, 12 ,5528,1017,1025,7570
1/31/2014,2014,1,31, 13 ,5461,1011,1001,7473
1/31/2014,2014,1,31, 14 ,5591,1029,1023,7643
1/31/2014,2014,1,31, 15 ,5447,1006,1016,7469
1/31/2014,2014,1,31, 16 ,5380,991,1022,7393
1/31/2014,2014,1,31, 17 ,5272,1017,1021,7310
1/31/2014,2014,1,31, 18 ,5514,1146,1143,7803
1/31/2014,2014,1,31, 19 ,5968,1142,1182,8292
1/31/2014,2014,1,31, 20 ,5719,998,1114,7831
1/31/2014,2014,1,31, 21 ,5513,938,1045,7496
1/31/2014,2014,1,31, 22 ,5133,804,940,6877
1/31/2014,2014,1,31, 23 ,4615,692,834,6141
1/31/2014,2014,1,31, 24 ,4304,644,846,5794
2/1/2014,2014,2,1, 1 ,4113,603,737,5453
2/1/2014,2014,2,1, 2 ,3951,575,715,5241
2/1/2014,2014,2,1, 3 ,3886,552,701,5139
2/1/2014,2014,2,1, 4 ,3881,561,696,5138
2/1/2014,2014,2,1, 5 ,3941,599,726,5266
2/1/2014,2014,2,1, 6 ,4088,637,767,5492
2/1/2014,2014,2,1, 7 ,4184,681,766,5631
2/1/2014,2014,2,1, 8 ,4506,734,837,6077
2/1/2014,2014,2,1, 9 ,5097,854,948,6899
2/1/2014,2014,2,1, 10 ,5512,922,1034,7468
2/1/2014,2014,2,1, 11 ,5787,981,1100,7868
2/1/2014,2014,2,1, 12 ,5665,974,1094,7733
2/1/2014,2014,2,1, 13 ,5649,981,1114,7744
2/1/2014,2014,2,1, 14 ,5771,1021,1154,7946
2/1/2014,2014,2,1, 15 ,5712,1023,1136,7871
2/1/2014,2014,2,1, 16 ,5557,996,1099,7652
2/1/2014,2014,2,1, 17 ,5456,969,1062,7487
2/1/2014,2014,2,1, 18 ,5808,1094,1173,8075
2/1/2014,2014,2,1, 19 ,6155,1166,1228,8549
2/1/2014,2014,2,1, 20 ,6006,1111,1191,8308
2/1/2014,2014,2,1, 21 ,5783,1042,1132,7957
2/1/2014,2014,2,1, 22 ,5458,956,1030,7444
2/1/2014,2014,2,1, 23 ,5016,853,921,6790
2/1/2014,2014,2,1, 24 ,4680,777,832,6289
2/2/2014,2014,2,2, 1 ,4471,735,789,5995
2/2/2014,2014,2,2, 2 ,4319,715,758,5792
2/2/2014,2014,2,2, 3 ,4168,689,730,5587
2/2/2014,2014,2,2, 4 ,4119,678,719,5516
2/2/2014,2014,2,2, 5 ,4170,688,725,5583
2/2/2014,2014,2,2, 6 ,4229,698,758,5685
2/2/2014,2014,2,2, 7 ,4231,710,744,5685
2/2/2014,2014,2,2, 8 ,4407,743,766,5916
2/2/2014,2014,2,2, 9 ,4734,806,827,6367
2/2/2014,2014,2,2, 10 ,5209,864,909,6982
2/2/2014,2014,2,2, 11 ,5436,894,955,7285
2/2/2014,2014,2,2, 12 ,5432,902,978,7312
2/2/2014,2014,2,2, 13 ,5459,912,985,7356
2/2/2014,2014,2,2, 14 ,5471,917,988,7376
2/2/2014,2014,2,2, 15 ,5435,918,970,7323
2/2/2014,2014,2,2, 16 ,5393,911,954,7258
2/2/2014,2014,2,2, 17 ,5324,902,969,7195
2/2/2014,2014,2,2, 18 ,5626,1035,1101,7762
2/2/2014,2014,2,2, 19 ,6127,1164,1190,8481
2/2/2014,2014,2,2, 20 ,6098,1102,1152,8352
2/2/2014,2014,2,2, 21 ,5876,1018,1084,7978
2/2/2014,2014,2,2, 22 ,5549,928,991,7468
2/2/2014,2014,2,2, 23 ,5112,821,882,6815
2/2/2014,2014,2,2, 24 ,4850,764,885,6499
2/3/2014,2014,2,3, 1 ,4553,728,767,6048
2/3/2014,2014,2,3, 2 ,4401,703,734,5838
2/3/2014,2014,2,3, 3 ,4255,688,715,5658
2/3/2014,2014,2,3, 4 ,4258,693,710,5661
2/3/2014,2014,2,3, 5 ,4501,737,750,5988
2/3/2014,2014,2,3, 6 ,4763,807,832,6402
2/3/2014,2014,2,3, 7 ,4862,790,755,6407
2/3/2014,2014,2,3, 8 ,5517,875,858,7250
2/3/2014,2014,2,3, 9 ,6189,1067,1024,8280
2/3/2014,2014,2,3, 10 ,6695,1158,1143,8996
2/3/2014,2014,2,3, 11 ,6958,1209,1212,9379
2/3/2014,2014,2,3, 12 ,6851,1176,1205,9232
2/3/2014,2014,2,3, 13 ,6846,1192,1217,9255
2/3/2014,2014,2,3, 14 ,7086,1265,1253,9604
2/3/2014,2014,2,3, 15 ,7028,1236,1249,9513
2/3/2014,2014,2,3, 16 ,6967,1234,1235,9436
2/3/2014,2014,2,3, 17 ,6607,1158,1171,8936
2/3/2014,2014,2,3, 18 ,6602,1220,1238,9060
2/3/2014,2014,2,3, 19 ,6905,1327,1301,9533
2/3/2014,2014,2,3, 20 ,6713,1254,1244,9211
2/3/2014,2014,2,3, 21 ,6446,1167,1167,8780
2/3/2014,2014,2,3, 22 ,6031,1056,1044,8131
2/3/2014,2014,2,3, 23 ,5613,950,940,7503
2/3/2014,2014,2,3, 24 ,5174,870,860,6904
2/4/2014,2014,2,4, 1 ,4943,816,830,6589
2/4/2014,2014,2,4, 2 ,4753,789,800,6342
2/4/2014,2014,2,4, 3 ,4617,771,777,6165
2/4/2014,2014,2,4, 4 ,4572,769,769,6110
2/4/2014,2014,2,4, 5 ,4769,805,819,6393
2/4/2014,2014,2,4, 6 ,5025,884,887,6796
2/4/2014,2014,2,4, 7 ,5159,851,816,6826
2/4/2014,2014,2,4, 8 ,5588,947,902,7437
2/4/2014,2014,2,4, 9 ,6361,1134,1081,8576
2/4/2014,2014,2,4, 10 ,6860,1207,1183,9250
2/4/2014,2014,2,4, 11 ,7104,1259,1255,9618
2/4/2014,2014,2,4, 12 ,7046,1240,1228,9514
2/4/2014,2014,2,4, 13 ,7038,1231,1234,9503
2/4/2014,2014,2,4, 14 ,7302,1297,1288,9887
2/4/2014,2014,2,4, 15 ,7232,1285,1244,9761
2/4/2014,2014,2,4, 16 ,7140,1271,1221,9632
2/4/2014,2014,2,4, 17 ,6754,1192,1168,9114
2/4/2014,2014,2,4, 18 ,6771,1242,1243,9256
2/4/2014,2014,2,4, 19 ,7038,1353,1283,9674
2/4/2014,2014,2,4, 20 ,6844,1271,1248,9363
2/4/2014,2014,2,4, 21 ,6552,1191,1203,8946
2/4/2014,2014,2,4, 22 ,6153,1079,1083,8315
2/4/2014,2014,2,4, 23 ,5720,971,984,7675
2/4/2014,2014,2,4, 24 ,5374,893,887,7154
2/5/2014,2014,2,5, 1 ,5045,853,862,6760
2/5/2014,2014,2,5, 2 ,4900,823,837,6560
2/5/2014,2014,2,5, 3 ,4766,806,808,6380
2/5/2014,2014,2,5, 4 ,4713,794,805,6312
2/5/2014,2014,2,5, 5 ,4912,831,853,6596
2/5/2014,2014,2,5, 6 ,5166,894,911,6971
2/5/2014,2014,2,5, 7 ,5125,870,849,6844
2/5/2014,2014,2,5, 8 ,5710,975,932,7617
2/5/2014,2014,2,5, 9 ,6480,1148,1112,8740
2/5/2014,2014,2,5, 10 ,6939,1227,1219,9385
2/5/2014,2014,2,5, 11 ,7169,1289,1269,9727
2/5/2014,2014,2,5, 12 ,7001,1266,1247,9514
2/5/2014,2014,2,5, 13 ,7006,1259,1229,9494
2/5/2014,2014,2,5, 14 ,7346,1334,1267,9947
2/5/2014,2014,2,5, 15 ,7219,1298,1231,9748
2/5/2014,2014,2,5, 16 ,7097,1271,1219,9587
2/5/2014,2014,2,5, 17 ,6824,1185,1184,9193
2/5/2014,2014,2,5, 18 ,6855,1263,1249,9367
2/5/2014,2014,2,5, 19 ,7128,1354,1290,9772
2/5/2014,2014,2,5, 20 ,6905,1282,1254,9441
2/5/2014,2014,2,5, 21 ,6575,1216,1187,8978
2/5/2014,2014,2,5, 22 ,6223,1125,1115,8463
2/5/2014,2014,2,5, 23 ,5746,1021,1001,7768
2/5/2014,2014,2,5, 24 ,5392,921,856,7169
2/6/2014,2014,2,6, 1 ,5147,873,860,6880
2/6/2014,2014,2,6, 2 ,4925,853,829,6607
2/6/2014,2014,2,6, 3 ,4793,836,801,6430
2/6/2014,2014,2,6, 4 ,4784,824,791,6399
2/6/2014,2014,2,6, 5 ,4940,851,830,6621
2/6/2014,2014,2,6, 6 ,5166,896,900,6962
2/6/2014,2014,2,6, 7 ,5139,875,831,6845
2/6/2014,2014,2,6, 8 ,5738,973,910,7621
2/6/2014,2014,2,6, 9 ,6479,1146,1091,8716
2/6/2014,2014,2,6, 10 ,6941,1232,1189,9362
2/6/2014,2014,2,6, 11 ,7251,1276,1246,9773
2/6/2014,2014,2,6, 12 ,7086,1236,1236,9558
2/6/2014,2014,2,6, 13 ,7083,1244,1255,9582
2/6/2014,2014,2,6, 14 ,7382,1326,1263,9971
2/6/2014,2014,2,6, 15 ,7262,1307,1256,9825
2/6/2014,2014,2,6, 16 ,7191,1271,1215,9677
2/6/2014,2014,2,6, 17 ,6850,1195,1169,9214
2/6/2014,2014,2,6, 18 ,6813,1248,1257,9318
2/6/2014,2014,2,6, 19 ,7187,1350,1243,9780
2/6/2014,2014,2,6, 20 ,6910,1269,1238,9417
2/6/2014,2014,2,6, 21 ,6652,1191,1212,9055
2/6/2014,2014,2,6, 22 ,6239,1092,1110,8441
2/6/2014,2014,2,6, 23 ,5760,998,995,7753
2/6/2014,2014,2,6, 24 ,5346,921,938,7205
2/7/2014,2014,2,7, 1 ,5136,876,888,6900
2/7/2014,2014,2,7, 2 ,4897,852,855,6604
2/7/2014,2014,2,7, 3 ,4826,831,834,6491
2/7/2014,2014,2,7, 4 ,4702,822,824,6348
2/7/2014,2014,2,7, 5 ,4876,845,855,6576
2/7/2014,2014,2,7, 6 ,5070,899,901,6870
2/7/2014,2014,2,7, 7 ,5043,873,841,6757
2/7/2014,2014,2,7, 8 ,5596,952,911,7459
2/7/2014,2014,2,7, 9 ,6425,1130,1048,8603
2/7/2014,2014,2,7, 10 ,6965,1209,1142,9316
2/7/2014,2014,2,7, 11 ,7240,1267,1194,9701
2/7/2014,2014,2,7, 12 ,7066,1213,1160,9439
2/7/2014,2014,2,7, 13 ,7118,1202,1171,9491
2/7/2014,2014,2,7, 14 ,7452,1262,1188,9902
2/7/2014,2014,2,7, 15 ,7346,1223,1187,9756
2/7/2014,2014,2,7, 16 ,7217,1199,1181,9597
2/7/2014,2014,2,7, 17 ,6808,1167,1147,9122
2/7/2014,2014,2,7, 18 ,6774,1246,1247,9267
2/7/2014,2014,2,7, 19 ,7095,1285,1232,9612
2/7/2014,2014,2,7, 20 ,6840,1231,1191,9262
2/7/2014,2014,2,7, 21 ,6628,1161,1124,8913
2/7/2014,2014,2,7, 22 ,6331,1056,1035,8422
2/7/2014,2014,2,7, 23 ,5949,962,938,7849
2/7/2014,2014,2,7, 24 ,5541,899,886,7326
2/8/2014,2014,2,8, 1 ,5249,853,815,6917
2/8/2014,2014,2,8, 2 ,5016,829,802,6647
2/8/2014,2014,2,8, 3 ,4918,814,784,6516
2/8/2014,2014,2,8, 4 ,4811,806,772,6389
2/8/2014,2014,2,8, 5 ,4815,822,795,6432
2/8/2014,2014,2,8, 6 ,4831,849,830,6510
2/8/2014,2014,2,8, 7 ,4962,843,820,6625
2/8/2014,2014,2,8, 8 ,5320,928,878,7126
2/8/2014,2014,2,8, 9 ,5948,1058,1003,8009
2/8/2014,2014,2,8, 10 ,6421,1137,1095,8653
2/8/2014,2014,2,8, 11 ,6801,1185,1160,9146
2/8/2014,2014,2,8, 12 ,6707,1142,1114,8963
2/8/2014,2014,2,8, 13 ,6595,1127,1130,8852
2/8/2014,2014,2,8, 14 ,6806,1149,1155,9110
2/8/2014,2014,2,8, 15 ,6680,1072,1140,8892
2/8/2014,2014,2,8, 16 ,6564,1048,1133,8745
2/8/2014,2014,2,8, 17 ,6284,1020,1105,8409
2/8/2014,2014,2,8, 18 ,6281,1141,1199,8621
2/8/2014,2014,2,8, 19 ,6839,1179,1239,9257
2/8/2014,2014,2,8, 20 ,6651,1129,1179,8959
2/8/2014,2014,2,8, 21 ,6517,1060,1134,8711
2/8/2014,2014,2,8, 22 ,6190,987,1049,8226
2/8/2014,2014,2,8, 23 ,5862,913,937,7712
2/8/2014,2014,2,8, 24 ,5464,848,852,7164
2/9/2014,2014,2,9, 1 ,5185,823,811,6819
2/9/2014,2014,2,9, 2 ,4961,780,794,6535
2/9/2014,2014,2,9, 3 ,4834,767,761,6362
2/9/2014,2014,2,9, 4 ,4726,757,740,6223
2/9/2014,2014,2,9, 5 ,4649,768,773,6190
2/9/2014,2014,2,9, 6 ,4631,779,796,6206
2/9/2014,2014,2,9, 7 ,4519,788,732,6039
2/9/2014,2014,2,9, 8 ,4702,819,749,6270
2/9/2014,2014,2,9, 9 ,5011,881,802,6694
2/9/2014,2014,2,9, 10 ,5510,951,857,7318
2/9/2014,2014,2,9, 11 ,5768,988,882,7638
2/9/2014,2014,2,9, 12 ,5753,994,885,7632
2/9/2014,2014,2,9, 13 ,5784,989,879,7652
2/9/2014,2014,2,9, 14 ,5784,987,883,7654
2/9/2014,2014,2,9, 15 ,5686,980,866,7532
2/9/2014,2014,2,9, 16 ,5549,958,871,7378
2/9/2014,2014,2,9, 17 ,5410,969,898,7277
2/9/2014,2014,2,9, 18 ,5741,1073,1026,7840
2/9/2014,2014,2,9, 19 ,6350,1211,1162,8723
2/9/2014,2014,2,9, 20 ,6352,1176,1130,8658
2/9/2014,2014,2,9, 21 ,6152,1115,1068,8335
2/9/2014,2014,2,9, 22 ,5817,1021,966,7804
2/9/2014,2014,2,9, 23 ,5436,939,872,7247
2/9/2014,2014,2,9, 24 ,5094,877,773,6744
2/10/2014,2014,2,10, 1 ,4778,833,763,6374
2/10/2014,2014,2,10, 2 ,4559,809,737,6105
2/10/2014,2014,2,10, 3 ,4496,779,714,5989
2/10/2014,2014,2,10, 4 ,4403,771,714,5888
2/10/2014,2014,2,10, 5 ,4590,813,768,6171
2/10/2014,2014,2,10, 6 ,4938,876,851,6665
2/10/2014,2014,2,10, 7 ,4961,851,803,6615
2/10/2014,2014,2,10, 8 ,5651,948,879,7478
2/10/2014,2014,2,10, 9 ,6437,1134,1053,8624
2/10/2014,2014,2,10, 10 ,6995,1242,1157,9394
2/10/2014,2014,2,10, 11 ,7303,1289,1208,9800
2/10/2014,2014,2,10, 12 ,7187,1267,1198,9652
2/10/2014,2014,2,10, 13 ,7193,1261,1192,9646
2/10/2014,2014,2,10, 14 ,7470,1316,1212,9998
2/10/2014,2014,2,10, 15 ,7396,1277,1188,9861
2/10/2014,2014,2,10, 16 ,7296,1249,1164,9709
2/10/2014,2014,2,10, 17 ,6905,1205,1171,9281
2/10/2014,2014,2,10, 18 ,6870,1278,1242,9390
2/10/2014,2014,2,10, 19 ,7187,1326,1248,9761
2/10/2014,2014,2,10, 20 ,7002,1267,1200,9469
2/10/2014,2014,2,10, 21 ,6751,1217,1146,9114
2/10/2014,2014,2,10, 22 ,6374,1102,1030,8506
2/10/2014,2014,2,10, 23 ,5974,993,919,7886
2/10/2014,2014,2,10, 24 ,5177,921,887,6985
2/11/2014,2014,2,11, 1 ,5141,877,812,6830
2/11/2014,2014,2,11, 2 ,4997,850,779,6626
2/11/2014,2014,2,11, 3 ,4913,833,761,6507
2/11/2014,2014,2,11, 4 ,4825,821,765,6411
2/11/2014,2014,2,11, 5 ,4985,852,819,6656
2/11/2014,2014,2,11, 6 ,5193,895,900,6988
2/11/2014,2014,2,11, 7 ,5244,869,822,6935
2/11/2014,2014,2,11, 8 ,5754,976,920,7650
2/11/2014,2014,2,11, 9 ,6493,1151,1073,8717
2/11/2014,2014,2,11, 10 ,6821,1233,1166,9220
2/11/2014,2014,2,11, 11 ,7050,1267,1214,9531
2/11/2014,2014,2,11, 12 ,6944,1233,1206,9383
2/11/2014,2014,2,11, 13 ,6819,1224,1220,9263
2/11/2014,2014,2,11, 14 ,7064,1266,1258,9588
2/11/2014,2014,2,11, 15 ,6960,1246,1236,9442
2/11/2014,2014,2,11, 16 ,6819,1221,1222,9262
2/11/2014,2014,2,11, 17 ,6596,1175,1182,8953
2/11/2014,2014,2,11, 18 ,6617,1225,1263,9105
2/11/2014,2014,2,11, 19 ,6882,1331,1292,9505
2/11/2014,2014,2,11, 20 ,6608,1266,1231,9105
2/11/2014,2014,2,11, 21 ,6323,1175,1160,8658
2/11/2014,2014,2,11, 22 ,5872,1071,1045,7988
2/11/2014,2014,2,11, 23 ,5476,972,948,7396
2/11/2014,2014,2,11, 24 ,5155,902,811,6868
2/12/2014,2014,2,12, 1 ,4936,858,833,6627
2/12/2014,2014,2,12, 2 ,4757,828,803,6388
2/12/2014,2014,2,12, 3 ,4655,809,782,6246
2/12/2014,2014,2,12, 4 ,4601,798,782,6181
2/12/2014,2014,2,12, 5 ,4779,836,835,6450
2/12/2014,2014,2,12, 6 ,5011,890,908,6809
2/12/2014,2014,2,12, 7 ,5034,855,825,6714
2/12/2014,2014,2,12, 8 ,5564,949,864,7377
2/12/2014,2014,2,12, 9 ,6260,1118,1006,8384
2/12/2014,2014,2,12, 10 ,6655,1192,1109,8956
2/12/2014,2014,2,12, 11 ,6897,1233,1160,9290
2/12/2014,2014,2,12, 12 ,6744,1196,1152,9092
2/12/2014,2014,2,12, 13 ,6748,1194,1185,9127
2/12/2014,2014,2,12, 14 ,6942,1254,1234,9430
2/12/2014,2014,2,12, 15 ,6827,1236,1195,9258
2/12/2014,2014,2,12, 16 ,6719,1215,1176,9110
2/12/2014,2014,2,12, 17 ,6367,1170,1155,8692
2/12/2014,2014,2,12, 18 ,6438,1260,1254,8952
2/12/2014,2014,2,12, 19 ,6775,1309,1274,9358
2/12/2014,2014,2,12, 20 ,6447,1231,1203,8881
2/12/2014,2014,2,12, 21 ,6202,1166,1151,8519
2/12/2014,2014,2,12, 22 ,5770,1055,1046,7871
2/12/2014,2014,2,12, 23 ,5391,934,922,7247
2/12/2014,2014,2,12, 24 ,4910,871,867,6648
2/13/2014,2014,2,13, 1 ,4750,835,816,6401
2/13/2014,2014,2,13, 2 ,4564,812,795,6171
2/13/2014,2014,2,13, 3 ,4425,789,774,5988
2/13/2014,2014,2,13, 4 ,4426,785,769,5980
2/13/2014,2014,2,13, 5 ,4642,822,814,6278
2/13/2014,2014,2,13, 6 ,4886,896,889,6671
2/13/2014,2014,2,13, 7 ,4875,866,849,6590
2/13/2014,2014,2,13, 8 ,5424,939,899,7262
2/13/2014,2014,2,13, 9 ,6089,1091,1046,8226
2/13/2014,2014,2,13, 10 ,6541,1165,1127,8833
2/13/2014,2014,2,13, 11 ,6847,1198,1169,9214
2/13/2014,2014,2,13, 12 ,6691,1156,1143,8990
2/13/2014,2014,2,13, 13 ,6633,1143,1152,8928
2/13/2014,2014,2,13, 14 ,6922,1195,1185,9302
2/13/2014,2014,2,13, 15 ,6817,1166,1172,9155
2/13/2014,2014,2,13, 16 ,6729,1155,1167,9051
2/13/2014,2014,2,13, 17 ,6453,1116,1146,8715
2/13/2014,2014,2,13, 18 ,6555,1203,1240,8998
2/13/2014,2014,2,13, 19 ,6783,1265,1254,9302
2/13/2014,2014,2,13, 20 ,6496,1184,1178,8858
2/13/2014,2014,2,13, 21 ,6281,1116,1118,8515
2/13/2014,2014,2,13, 22 ,5811,1013,992,7816
2/13/2014,2014,2,13, 23 ,5372,919,901,7192
2/13/2014,2014,2,13, 24 ,4968,857,804,6629
2/14/2014,2014,2,14, 1 ,4736,815,789,6340
2/14/2014,2014,2,14, 2 ,4598,788,768,6154
2/14/2014,2014,2,14, 3 ,4425,774,748,5947
2/14/2014,2014,2,14, 4 ,4426,771,750,5947
2/14/2014,2014,2,14, 5 ,4533,805,801,6139
2/14/2014,2014,2,14, 6 ,4830,874,889,6593
2/14/2014,2014,2,14, 7 ,4902,853,835,6590
2/14/2014,2014,2,14, 8 ,5303,920,885,7108
2/14/2014,2014,2,14, 9 ,6078,1073,1040,8191
2/14/2014,2014,2,14, 10 ,6478,1169,1131,8778
2/14/2014,2014,2,14, 11 ,6775,1216,1190,9181
2/14/2014,2014,2,14, 12 ,6655,1188,1103,8946
2/14/2014,2014,2,14, 13 ,6670,1177,1173,9020
2/14/2014,2014,2,14, 14 ,6973,1224,1217,9414
2/14/2014,2014,2,14, 15 ,6819,1209,1182,9210
2/14/2014,2014,2,14, 16 ,6756,1191,1174,9121
2/14/2014,2014,2,14, 17 ,6363,1123,1142,8628
2/14/2014,2014,2,14, 18 ,6339,1189,1200,8728
2/14/2014,2014,2,14, 19 ,6727,1258,1256,9241
2/14/2014,2014,2,14, 20 ,6403,1195,1192,8790
2/14/2014,2014,2,14, 21 ,6166,1141,1129,8436
2/14/2014,2014,2,14, 22 ,5798,1050,1043,7891
2/14/2014,2014,2,14, 23 ,5402,954,936,7292
2/14/2014,2014,2,14, 24 ,5081,890,852,6823
2/15/2014,2014,2,15, 1 ,4782,843,819,6444
2/15/2014,2014,2,15, 2 ,4600,816,793,6209
2/15/2014,2014,2,15, 3 ,4536,792,770,6098
2/15/2014,2014,2,15, 4 ,4410,772,761,5943
2/15/2014,2014,2,15, 5 ,4481,786,777,6044
2/15/2014,2014,2,15, 6 ,4490,797,805,6092
2/15/2014,2014,2,15, 7 ,4594,802,806,6202
2/15/2014,2014,2,15, 8 ,4966,876,866,6708
2/15/2014,2014,2,15, 9 ,5523,1006,967,7496
2/15/2014,2014,2,15, 10 ,5968,1087,1058,8113
2/15/2014,2014,2,15, 11 ,6295,1133,1098,8526
2/15/2014,2014,2,15, 12 ,6067,1103,1091,8261
2/15/2014,2014,2,15, 13 ,6015,1105,1110,8230
2/15/2014,2014,2,15, 14 ,6119,1142,1133,8394
2/15/2014,2014,2,15, 15 ,6071,1122,1126,8319
2/15/2014,2014,2,15, 16 ,5872,1088,1116,8076
2/15/2014,2014,2,15, 17 ,5643,1034,1064,7741
2/15/2014,2014,2,15, 18 ,5768,1096,1183,8047
2/15/2014,2014,2,15, 19 ,6221,1212,1250,8683
2/15/2014,2014,2,15, 20 ,6093,1159,1200,8452
2/15/2014,2014,2,15, 21 ,5894,1114,1128,8136
2/15/2014,2014,2,15, 22 ,5549,1014,1042,7605
2/15/2014,2014,2,15, 23 ,5119,918,918,6955
2/15/2014,2014,2,15, 24 ,4760,855,849,6464
2/16/2014,2014,2,16, 1 ,4534,814,791,6139
2/16/2014,2014,2,16, 2 ,4368,784,767,5919
2/16/2014,2014,2,16, 3 ,4210,763,750,5723
2/16/2014,2014,2,16, 4 ,4214,754,743,5711
2/16/2014,2014,2,16, 5 ,4159,760,761,5680
2/16/2014,2014,2,16, 6 ,4227,753,793,5773
2/16/2014,2014,2,16, 7 ,4223,749,754,5726
2/16/2014,2014,2,16, 8 ,4402,800,761,5963
2/16/2014,2014,2,16, 9 ,4766,845,813,6424
2/16/2014,2014,2,16, 10 ,5188,916,876,6980
2/16/2014,2014,2,16, 11 ,5413,959,923,7295
2/16/2014,2014,2,16, 12 ,5344,971,968,7283
2/16/2014,2014,2,16, 13 ,5329,958,949,7236
2/16/2014,2014,2,16, 14 ,5376,965,955,7296
2/16/2014,2014,2,16, 15 ,5253,959,949,7161
2/16/2014,2014,2,16, 16 ,5213,944,938,7095
2/16/2014,2014,2,16, 17 ,5201,936,952,7089
2/16/2014,2014,2,16, 18 ,5511,1053,1107,7671
2/16/2014,2014,2,16, 19 ,6002,1191,1182,8375
2/16/2014,2014,2,16, 20 ,5941,1124,1131,8196
2/16/2014,2014,2,16, 21 ,5718,1083,1079,7880
2/16/2014,2014,2,16, 22 ,5324,991,969,7284
2/16/2014,2014,2,16, 23 ,4846,901,876,6623
2/16/2014,2014,2,16, 24 ,4517,834,819,6170
2/17/2014,2014,2,17, 1 ,4297,797,765,5859
2/17/2014,2014,2,17, 2 ,4234,772,747,5753
2/17/2014,2014,2,17, 3 ,4171,752,726,5649
2/17/2014,2014,2,17, 4 ,4160,750,723,5633
2/17/2014,2014,2,17, 5 ,4377,795,787,5959
2/17/2014,2014,2,17, 6 ,4686,864,866,6416
2/17/2014,2014,2,17, 7 ,4805,828,808,6441
2/17/2014,2014,2,17, 8 ,5418,927,878,7223
2/17/2014,2014,2,17, 9 ,6218,1087,1042,8347
2/17/2014,2014,2,17, 10 ,6722,1196,1147,9065
2/17/2014,2014,2,17, 11 ,6982,1249,1200,9431
2/17/2014,2014,2,17, 12 ,6900,1222,1177,9299
2/17/2014,2014,2,17, 13 ,6764,1208,1161,9133
2/17/2014,2014,2,17, 14 ,7086,1275,1220,9581
2/17/2014,2014,2,17, 15 ,6957,1250,1194,9401
2/17/2014,2014,2,17, 16 ,6831,1229,1184,9244
2/17/2014,2014,2,17, 17 ,6549,1170,1128,8847
2/17/2014,2014,2,17, 18 ,6530,1234,1238,9002
2/17/2014,2014,2,17, 19 ,6813,1304,1280,9397
2/17/2014,2014,2,17, 20 ,6565,1242,1211,9018
2/17/2014,2014,2,17, 21 ,6271,1181,1145,8597
2/17/2014,2014,2,17, 22 ,5832,1056,1025,7913
2/17/2014,2014,2,17, 23 ,5304,958,929,7191
2/17/2014,2014,2,17, 24 ,4987,888,855,6730
2/18/2014,2014,2,18, 1 ,4717,836,821,6374
2/18/2014,2014,2,18, 2 ,4618,805,799,6222
2/18/2014,2014,2,18, 3 ,4490,792,773,6055
2/18/2014,2014,2,18, 4 ,4535,786,772,6093
2/18/2014,2014,2,18, 5 ,4724,824,821,6369
2/18/2014,2014,2,18, 6 ,5010,879,889,6778
2/18/2014,2014,2,18, 7 ,4982,836,809,6627
2/18/2014,2014,2,18, 8 ,5525,946,913,7384
2/18/2014,2014,2,18, 9 ,6331,1116,1062,8509
2/18/2014,2014,2,18, 10 ,6720,1188,1159,9067
2/18/2014,2014,2,18, 11 ,7025,1246,1224,9495
2/18/2014,2014,2,18, 12 ,6864,1209,1205,9278
2/18/2014,2014,2,18, 13 ,6918,1217,1204,9339
2/18/2014,2014,2,18, 14 ,7114,1267,1274,9655
2/18/2014,2014,2,18, 15 ,7026,1237,1265,9528
2/18/2014,2014,2,18, 16 ,6942,1221,1246,9409
2/18/2014,2014,2,18, 17 ,6575,1153,1183,8911
2/18/2014,2014,2,18, 18 ,6583,1208,1236,9027
2/18/2014,2014,2,18, 19 ,6907,1305,1299,9511
2/18/2014,2014,2,18, 20 ,6673,1234,1224,9131
2/18/2014,2014,2,18, 21 ,6427,1135,1168,8730
2/18/2014,2014,2,18, 22 ,5907,1008,1064,7979
2/18/2014,2014,2,18, 23 ,5541,923,954,7418
2/18/2014,2014,2,18, 24 ,5095,855,876,6826
2/19/2014,2014,2,19, 1 ,4911,815,840,6566
2/19/2014,2014,2,19, 2 ,4757,790,807,6354
2/19/2014,2014,2,19, 3 ,4610,772,787,6169
2/19/2014,2014,2,19, 4 ,4546,772,786,6104
2/19/2014,2014,2,19, 5 ,4786,816,828,6430
2/19/2014,2014,2,19, 6 ,5012,879,905,6796
2/19/2014,2014,2,19, 7 ,4977,843,816,6636
2/19/2014,2014,2,19, 8 ,5596,939,902,7437
2/19/2014,2014,2,19, 9 ,6300,1096,1058,8454
2/19/2014,2014,2,19, 10 ,6697,1185,1162,9044
2/19/2014,2014,2,19, 11 ,6962,1238,1214,9414
2/19/2014,2014,2,19, 12 ,6767,1178,1192,9137
2/19/2014,2014,2,19, 13 ,6730,1176,1199,9105
2/19/2014,2014,2,19, 14 ,7032,1241,1261,9534
2/19/2014,2014,2,19, 15 ,6922,1212,1232,9366
2/19/2014,2014,2,19, 16 ,6799,1212,1197,9208
2/19/2014,2014,2,19, 17 ,6520,1143,1162,8825
2/19/2014,2014,2,19, 18 ,6537,1230,1226,8993
2/19/2014,2014,2,19, 19 ,6826,1302,1292,9420
2/19/2014,2014,2,19, 20 ,6643,1226,1235,9104
2/19/2014,2014,2,19, 21 ,6343,1148,1176,8667
2/19/2014,2014,2,19, 22 ,5964,1038,1064,8066
2/19/2014,2014,2,19, 23 ,5467,922,937,7326
2/19/2014,2014,2,19, 24 ,5111,860,910,6881
2/20/2014,2014,2,20, 1 ,4778,828,819,6425
2/20/2014,2014,2,20, 2 ,4602,804,790,6196
2/20/2014,2014,2,20, 3 ,4546,785,775,6106
2/20/2014,2014,2,20, 4 ,4525,783,773,6081
2/20/2014,2014,2,20, 5 ,4740,831,820,6391
2/20/2014,2014,2,20, 6 ,4960,888,893,6741
2/20/2014,2014,2,20, 7 ,4973,852,814,6639
2/20/2014,2014,2,20, 8 ,5595,941,886,7422
2/20/2014,2014,2,20, 9 ,6204,1107,1039,8350
2/20/2014,2014,2,20, 10 ,6722,1187,1142,9051
2/20/2014,2014,2,20, 11 ,7016,1248,1216,9480
2/20/2014,2014,2,20, 12 ,6827,1206,1204,9237
2/20/2014,2014,2,20, 13 ,6832,1201,1199,9232
2/20/2014,2014,2,20, 14 ,7134,1254,1256,9644
2/20/2014,2014,2,20, 15 ,7034,1228,1225,9487
2/20/2014,2014,2,20, 16 ,6883,1227,1220,9330
2/20/2014,2014,2,20, 17 ,6577,1156,1168,8901
2/20/2014,2014,2,20, 18 ,6529,1208,1217,8954
2/20/2014,2014,2,20, 19 ,6876,1295,1274,9445
2/20/2014,2014,2,20, 20 ,6613,1231,1219,9063
2/20/2014,2014,2,20, 21 ,6275,1151,1174,8600
2/20/2014,2014,2,20, 22 ,5761,1023,1047,7831
2/20/2014,2014,2,20, 23 ,5399,929,948,7276
2/20/2014,2014,2,20, 24 ,5017,865,915,6797
2/21/2014,2014,2,21, 1 ,4783,824,824,6431
2/21/2014,2014,2,21, 2 ,4675,800,798,6273
2/21/2014,2014,2,21, 3 ,4560,786,771,6117
2/21/2014,2014,2,21, 4 ,4541,776,776,6093
2/21/2014,2014,2,21, 5 ,4684,814,821,6319
2/21/2014,2014,2,21, 6 ,4937,875,889,6701
2/21/2014,2014,2,21, 7 ,4945,835,824,6604
2/21/2014,2014,2,21, 8 ,5468,922,894,7284
2/21/2014,2014,2,21, 9 ,6125,1088,1051,8264
2/21/2014,2014,2,21, 10 ,6647,1174,1132,8953
2/21/2014,2014,2,21, 11 ,6891,1224,1192,9307
2/21/2014,2014,2,21, 12 ,6555,1188,1204,8947
2/21/2014,2014,2,21, 13 ,6540,1218,1215,8973
2/21/2014,2014,2,21, 14 ,6766,1276,1244,9286
2/21/2014,2014,2,21, 15 ,6625,1247,1231,9103
2/21/2014,2014,2,21, 16 ,6490,1222,1215,8927
2/21/2014,2014,2,21, 17 ,6236,1136,1176,8548
2/21/2014,2014,2,21, 18 ,6284,1225,1244,8753
2/21/2014,2014,2,21, 19 ,6551,1294,1298,9143
2/21/2014,2014,2,21, 20 ,6291,1226,1244,8761
2/21/2014,2014,2,21, 21 ,6011,1158,1173,8342
2/21/2014,2014,2,21, 22 ,5666,1046,1069,7781
2/21/2014,2014,2,21, 23 ,5252,938,954,7144
2/21/2014,2014,2,21, 24 ,4886,861,892,6639
2/22/2014,2014,2,22, 1 ,4651,824,829,6304
2/22/2014,2014,2,22, 2 ,4514,797,800,6111
2/22/2014,2014,2,22, 3 ,4413,781,782,5976
2/22/2014,2014,2,22, 4 ,4318,776,778,5872
2/22/2014,2014,2,22, 5 ,4404,797,804,6005
2/22/2014,2014,2,22, 6 ,4459,827,834,6120
2/22/2014,2014,2,22, 7 ,4546,830,832,6208
2/22/2014,2014,2,22, 8 ,4946,898,892,6736
2/22/2014,2014,2,22, 9 ,5468,1028,1003,7499
2/22/2014,2014,2,22, 10 ,5874,1098,1089,8061
2/22/2014,2014,2,22, 11 ,6112,1136,1155,8403
2/22/2014,2014,2,22, 12 ,5978,1097,1141,8216
2/22/2014,2014,2,22, 13 ,5996,1088,1129,8213
2/22/2014,2014,2,22, 14 ,6160,1118,1168,8446
2/22/2014,2014,2,22, 15 ,6019,1080,1169,8268
2/22/2014,2014,2,22, 16 ,5812,1054,1131,7997
2/22/2014,2014,2,22, 17 ,5622,1041,1098,7761
2/22/2014,2014,2,22, 18 ,5882,1135,1180,8197
2/22/2014,2014,2,22, 19 ,6213,1200,1276,8689
2/22/2014,2014,2,22, 20 ,6072,1142,1232,8446
2/22/2014,2014,2,22, 21 ,5852,1070,1155,8077
2/22/2014,2014,2,22, 22 ,5510,955,1043,7508
2/22/2014,2014,2,22, 23 ,5127,872,954,6953
2/22/2014,2014,2,22, 24 ,4821,819,860,6500
2/23/2014,2014,2,23, 1 ,4612,777,827,6216
2/23/2014,2014,2,23, 2 ,4406,759,799,5964
2/23/2014,2014,2,23, 3 ,4276,746,777,5799
2/23/2014,2014,2,23, 4 ,4195,735,768,5698
2/23/2014,2014,2,23, 5 ,4207,746,787,5740
2/23/2014,2014,2,23, 6 ,4236,764,763,5763
2/23/2014,2014,2,23, 7 ,4282,766,772,5820
2/23/2014,2014,2,23, 8 ,4415,801,795,6011
2/23/2014,2014,2,23, 9 ,4789,864,869,6522
2/23/2014,2014,2,23, 10 ,5130,918,949,6997
2/23/2014,2014,2,23, 11 ,5287,957,988,7232
2/23/2014,2014,2,23, 12 ,5222,963,991,7176
2/23/2014,2014,2,23, 13 ,5153,953,981,7087
2/23/2014,2014,2,23, 14 ,5129,948,990,7067
2/23/2014,2014,2,23, 15 ,5050,933,963,6946
2/23/2014,2014,2,23, 16 ,4956,933,955,6844
2/23/2014,2014,2,23, 17 ,4990,932,968,6890
2/23/2014,2014,2,23, 18 ,5270,1065,1100,7435
2/23/2014,2014,2,23, 19 ,5780,1180,1200,8160
2/23/2014,2014,2,23, 20 ,5651,1134,1161,7946
2/23/2014,2014,2,23, 21 ,5416,1041,1094,7551
2/23/2014,2014,2,23, 22 ,4977,947,982,6906
2/23/2014,2014,2,23, 23 ,4620,855,883,6358
2/23/2014,2014,2,23, 24 ,4326,788,823,5937
2/24/2014,2014,2,24, 1 ,4108,752,774,5634
2/24/2014,2014,2,24, 2 ,3917,732,743,5392
2/24/2014,2014,2,24, 3 ,3870,713,727,5310
2/24/2014,2014,2,24, 4 ,3871,714,723,5308
2/24/2014,2014,2,24, 5 ,4125,761,766,5652
2/24/2014,2014,2,24, 6 ,4467,833,858,6158
2/24/2014,2014,2,24, 7 ,4703,811,771,6285
2/24/2014,2014,2,24, 8 ,5240,909,888,7037
2/24/2014,2014,2,24, 9 ,5999,1076,1043,8118
2/24/2014,2014,2,24, 10 ,6442,1160,1169,8771
2/24/2014,2014,2,24, 11 ,6771,1213,1242,9226
2/24/2014,2014,2,24, 12 ,6581,1181,1223,8985
2/24/2014,2014,2,24, 13 ,6556,1170,1210,8936
2/24/2014,2014,2,24, 14 ,6851,1220,1253,9324
2/24/2014,2014,2,24, 15 ,6851,1212,1243,9306
2/24/2014,2014,2,24, 16 ,6630,1187,1230,9047
2/24/2014,2014,2,24, 17 ,6307,1129,1173,8609
2/24/2014,2014,2,24, 18 ,6235,1202,1221,8658
2/24/2014,2014,2,24, 19 ,6636,1299,1288,9223
2/24/2014,2014,2,24, 20 ,6364,1228,1256,8848
2/24/2014,2014,2,24, 21 ,6098,1157,1166,8421
2/24/2014,2014,2,24, 22 ,5577,1033,1041,7651
2/24/2014,2014,2,24, 23 ,5148,937,940,7025
2/24/2014,2014,2,24, 24 ,4754,870,879,6503
2/25/2014,2014,2,25, 1 ,4547,825,825,6197
2/25/2014,2014,2,25, 2 ,4408,799,804,6011
2/25/2014,2014,2,25, 3 ,4266,780,776,5822
2/25/2014,2014,2,25, 4 ,4264,771,772,5807
2/25/2014,2014,2,25, 5 ,4317,794,799,5910
2/25/2014,2014,2,25, 6 ,4518,825,839,6182
2/25/2014,2014,2,25, 7 ,4716,843,829,6388
2/25/2014,2014,2,25, 8 ,5340,954,937,7231
2/25/2014,2014,2,25, 9 ,5984,1119,1045,8148
2/25/2014,2014,2,25, 10 ,6498,1202,1184,8884
2/25/2014,2014,2,25, 11 ,6740,1254,1227,9221
2/25/2014,2014,2,25, 12 ,6572,1223,1228,9023
2/25/2014,2014,2,25, 13 ,6519,1218,1239,8976
2/25/2014,2014,2,25, 14 ,6800,1290,1293,9383
2/25/2014,2014,2,25, 15 ,6699,1270,1262,9231
2/25/2014,2014,2,25, 16 ,6639,1233,1255,9127
2/25/2014,2014,2,25, 17 ,6411,1158,1196,8765
2/25/2014,2014,2,25, 18 ,6329,1200,1226,8755
2/25/2014,2014,2,25, 19 ,6719,1324,1324,9367
2/25/2014,2014,2,25, 20 ,6469,1257,1263,8989
2/25/2014,2014,2,25, 21 ,6200,1153,1203,8556
2/25/2014,2014,2,25, 22 ,5770,1033,1067,7870
2/25/2014,2014,2,25, 23 ,5381,936,954,7271
2/25/2014,2014,2,25, 24 ,4943,883,884,6710
2/26/2014,2014,2,26, 1 ,4703,857,847,6407
2/26/2014,2014,2,26, 2 ,4601,833,810,6244
2/26/2014,2014,2,26, 3 ,4497,813,784,6094
2/26/2014,2014,2,26, 4 ,4427,807,785,6019
2/26/2014,2014,2,26, 5 ,4614,846,835,6295
2/26/2014,2014,2,26, 6 ,4822,904,893,6619
2/26/2014,2014,2,26, 7 ,4853,860,828,6541
2/26/2014,2014,2,26, 8 ,5565,974,916,7455
2/26/2014,2014,2,26, 9 ,6059,1146,1077,8282
2/26/2014,2014,2,26, 10 ,6474,1236,1148,8858
2/26/2014,2014,2,26, 11 ,6739,1284,1250,9273
2/26/2014,2014,2,26, 12 ,6575,1253,1229,9057
2/26/2014,2014,2,26, 13 ,6493,1247,1226,8966
2/26/2014,2014,2,26, 14 ,6746,1299,1270,9315
2/26/2014,2014,2,26, 15 ,6594,1282,1255,9131
2/26/2014,2014,2,26, 16 ,6465,1267,1233,8965
2/26/2014,2014,2,26, 17 ,6293,1191,1185,8669
2/26/2014,2014,2,26, 18 ,6306,1235,1256,8797
2/26/2014,2014,2,26, 19 ,6657,1340,1326,9323
2/26/2014,2014,2,26, 20 ,6370,1270,1274,8914
2/26/2014,2014,2,26, 21 ,6112,1202,1209,8523
2/26/2014,2014,2,26, 22 ,5724,1098,1113,7935
2/26/2014,2014,2,26, 23 ,5259,985,985,7229
2/26/2014,2014,2,26, 24 ,4860,896,905,6661
2/27/2014,2014,2,27, 1 ,4673,869,830,6372
2/27/2014,2014,2,27, 2 ,4529,841,810,6180
2/27/2014,2014,2,27, 3 ,4388,827,785,6000
2/27/2014,2014,2,27, 4 ,4339,819,59,5217
2/27/2014,2014,2,27, 5 ,4532,862,23,5417
2/27/2014,2014,2,27, 6 ,4793,913,42,5748
2/27/2014,2014,2,27, 7 ,4823,872,151,5846
2/27/2014,2014,2,27, 8 ,5401,975,356,6732
2/27/2014,2014,2,27, 9 ,6256,1159,110,7525
2/27/2014,2014,2,27, 10 ,6668,1241,323,8232
2/27/2014,2014,2,27, 11 ,6949,1295,518,8762
2/27/2014,2014,2,27, 12 ,6742,1263,832,8837
2/27/2014,2014,2,27, 13 ,6725,1258,1044,9027
2/27/2014,2014,2,27, 14 ,6993,1338,1108,9439
2/27/2014,2014,2,27, 15 ,6908,1313,1112,9333
2/27/2014,2014,2,27, 16 ,6816,1287,1114,9217
2/27/2014,2014,2,27, 17 ,6443,1222,1097,8762
2/27/2014,2014,2,27, 18 ,6389,1255,1132,8776
2/27/2014,2014,2,27, 19 ,6758,1365,1098,9221
2/27/2014,2014,2,27, 20 ,6530,1306,1098,8934
2/27/2014,2014,2,27, 21 ,6247,1231,1091,8569
2/27/2014,2014,2,27, 22 ,5750,1105,1015,7870
2/27/2014,2014,2,27, 23 ,5383,996,965,7344
2/27/2014,2014,2,27, 24 ,4970,931,922,6823
2/28/2014,2014,2,28, 1 ,4673,886,870,6429
2/28/2014,2014,2,28, 2 ,4611,857,850,6318
2/28/2014,2014,2,28, 3 ,4488,827,815,6130
2/28/2014,2014,2,28, 4 ,4463,822,806,6091
2/28/2014,2014,2,28, 5 ,4591,859,853,6303
2/28/2014,2014,2,28, 6 ,4846,905,912,6663
2/28/2014,2014,2,28, 7 ,4857,861,826,6544
2/28/2014,2014,2,28, 8 ,5488,944,953,7385
2/28/2014,2014,2,28, 9 ,6168,1145,984,8297
2/28/2014,2014,2,28, 10 ,6637,1233,1121,8991
2/28/2014,2014,2,28, 11 ,6952,1292,1123,9367
2/28/2014,2014,2,28, 12 ,6784,1254,1117,9155
2/28/2014,2014,2,28, 13 ,6726,1243,1125,9094
2/28/2014,2014,2,28, 14 ,7038,1292,1118,9448
2/28/2014,2014,2,28, 15 ,6833,1257,1095,9185
2/28/2014,2014,2,28, 16 ,6758,1237,1073,9068
2/28/2014,2014,2,28, 17 ,6426,1163,1045,8634
2/28/2014,2014,2,28, 18 ,6272,1206,1082,8560
2/28/2014,2014,2,28, 19 ,6797,1303,1066,9166
2/28/2014,2014,2,28, 20 ,6492,1244,1057,8793
2/28/2014,2014,2,28, 21 ,6268,1198,1051,8517
2/28/2014,2014,2,28, 22 ,5892,1094,1011,7997
2/28/2014,2014,2,28, 23 ,5479,988,958,7425
2/28/2014,2014,2,28, 24 ,5097,911,941,6949
3/1/2014,2014,3,1, 1 ,4819,870,896,6585
3/1/2014,2014,3,1, 2 ,4594,839,862,6295
3/1/2014,2014,3,1, 3 ,4480,814,838,6132
3/1/2014,2014,3,1, 4 ,4452,802,834,6088
3/1/2014,2014,3,1, 5 ,4447,818,849,6114
3/1/2014,2014,3,1, 6 ,4475,837,875,6187
3/1/2014,2014,3,1, 7 ,4550,843,854,6247
3/1/2014,2014,3,1, 8 ,5038,914,921,6873
3/1/2014,2014,3,1, 9 ,5613,1086,979,7678
3/1/2014,2014,3,1, 10 ,6043,1155,985,8183
3/1/2014,2014,3,1, 11 ,6363,1200,961,8524
3/1/2014,2014,3,1, 12 ,6220,1181,937,8338
3/1/2014,2014,3,1, 13 ,6219,1192,926,8337
3/1/2014,2014,3,1, 14 ,6446,1191,931,8568
3/1/2014,2014,3,1, 15 ,6367,1170,975,8512
3/1/2014,2014,3,1, 16 ,6204,1128,979,8311
3/1/2014,2014,3,1, 17 ,5907,1087,956,7950
3/1/2014,2014,3,1, 18 ,5944,1131,1009,8084
3/1/2014,2014,3,1, 19 ,6485,1293,1031,8809
3/1/2014,2014,3,1, 20 ,6331,1244,1037,8612
3/1/2014,2014,3,1, 21 ,6180,1164,1033,8377
3/1/2014,2014,3,1, 22 ,5786,1057,936,7779
3/1/2014,2014,3,1, 23 ,5415,971,919,7305
3/1/2014,2014,3,1, 24 ,4972,900,830,6702
3/2/2014,2014,3,2, 1 ,4733,855,881,6469
3/2/2014,2014,3,2, 2 ,4594,821,848,6263
3/2/2014,2014,3,2, 3 ,4410,799,828,6037
3/2/2014,2014,3,2, 4 ,4297,789,816,5902
3/2/2014,2014,3,2, 5 ,4266,792,812,5870
3/2/2014,2014,3,2, 6 ,4235,781,830,5846
3/2/2014,2014,3,2, 7 ,4173,782,814,5769
3/2/2014,2014,3,2, 8 ,4455,820,838,6113
3/2/2014,2014,3,2, 9 ,4775,892,859,6526
3/2/2014,2014,3,2, 10 ,5185,954,933,7072
3/2/2014,2014,3,2, 11 ,5551,994,985,7530
3/2/2014,2014,3,2, 12 ,5549,1015,987,7551
3/2/2014,2014,3,2, 13 ,5543,1010,981,7534
3/2/2014,2014,3,2, 14 ,5583,1021,964,7568
3/2/2014,2014,3,2, 15 ,5523,1014,977,7514
3/2/2014,2014,3,2, 16 ,5403,991,950,7344
3/2/2014,2014,3,2, 17 ,5265,967,946,7178
3/2/2014,2014,3,2, 18 ,5596,1064,1002,7662
3/2/2014,2014,3,2, 19 ,6226,1176,1038,8440
3/2/2014,2014,3,2, 20 ,6128,1192,1018,8338
3/2/2014,2014,3,2, 21 ,5998,1125,1052,8175
3/2/2014,2014,3,2, 22 ,5593,1027,1042,7662
3/2/2014,2014,3,2, 23 ,5209,937,956,7102
3/2/2014,2014,3,2, 24 ,4882,840,863,6585
3/3/2014,2014,3,3, 1 ,4634,823,832,6289
3/3/2014,2014,3,3, 2 ,4395,792,799,5986
3/3/2014,2014,3,3, 3 ,4353,773,777,5903
3/3/2014,2014,3,3, 4 ,4285,761,781,5827
3/3/2014,2014,3,3, 5 ,4510,814,828,6152
3/3/2014,2014,3,3, 6 ,4800,881,877,6558
3/3/2014,2014,3,3, 7 ,4787,852,813,6452
3/3/2014,2014,3,3, 8 ,5449,966,915,7330
3/3/2014,2014,3,3, 9 ,6268,1154,1102,8524
3/3/2014,2014,3,3, 10 ,6780,1238,1115,9133
3/3/2014,2014,3,3, 11 ,7090,1291,1127,9508
3/3/2014,2014,3,3, 12 ,6946,1265,1120,9331
3/3/2014,2014,3,3, 13 ,6949,1251,1144,9344
3/3/2014,2014,3,3, 14 ,7249,1291,1163,9703
3/3/2014,2014,3,3, 15 ,7149,1270,1151,9570
3/3/2014,2014,3,3, 16 ,7053,1263,1145,9461
3/3/2014,2014,3,3, 17 ,6733,1192,1117,9042
3/3/2014,2014,3,3, 18 ,6592,1251,1117,8960
3/3/2014,2014,3,3, 19 ,6995,1350,1102,9447
3/3/2014,2014,3,3, 20 ,6732,1282,1126,9140
3/3/2014,2014,3,3, 21 ,6545,1214,1126,8885
3/3/2014,2014,3,3, 22 ,6064,1088,1027,8179
3/3/2014,2014,3,3, 23 ,5672,991,977,7640
3/3/2014,2014,3,3, 24 ,5285,912,884,7081
3/4/2014,2014,3,4, 1 ,5007,873,910,6790
3/4/2014,2014,3,4, 2 ,4798,849,876,6523
3/4/2014,2014,3,4, 3 ,4693,827,851,6371
3/4/2014,2014,3,4, 4 ,4641,824,848,6313
3/4/2014,2014,3,4, 5 ,4867,862,895,6624
3/4/2014,2014,3,4, 6 ,5046,916,955,6917
3/4/2014,2014,3,4, 7 ,5014,868,875,6757
3/4/2014,2014,3,4, 8 ,5662,983,956,7601
3/4/2014,2014,3,4, 9 ,6417,1161,1079,8657
3/4/2014,2014,3,4, 10 ,6859,1250,1162,9271
3/4/2014,2014,3,4, 11 ,7146,1319,1148,9613
3/4/2014,2014,3,4, 12 ,7070,1283,1153,9506
3/4/2014,2014,3,4, 13 ,7050,1283,1137,9470
3/4/2014,2014,3,4, 14 ,7328,1355,1155,9838
3/4/2014,2014,3,4, 15 ,7218,1334,1151,9703
3/4/2014,2014,3,4, 16 ,7164,1306,1118,9588
3/4/2014,2014,3,4, 17 ,6774,1225,1085,9084
3/4/2014,2014,3,4, 18 ,6695,1218,1140,9053
3/4/2014,2014,3,4, 19 ,7058,1372,1092,9522
3/4/2014,2014,3,4, 20 ,6908,1316,1080,9304
3/4/2014,2014,3,4, 21 ,6619,1230,1079,8928
3/4/2014,2014,3,4, 22 ,6182,1102,1027,8311
3/4/2014,2014,3,4, 23 ,5859,999,1001,7859
3/4/2014,2014,3,4, 24 ,5384,918,960,7262
3/5/2014,2014,3,5, 1 ,5106,885,911,6902
3/5/2014,2014,3,5, 2 ,4947,844,879,6670
3/5/2014,2014,3,5, 3 ,4773,826,848,6447
3/5/2014,2014,3,5, 4 ,4765,832,837,6434
3/5/2014,2014,3,5, 5 ,4943,869,888,6700
3/5/2014,2014,3,5, 6 ,5125,909,937,6971
3/5/2014,2014,3,5, 7 ,5115,877,869,6861
3/5/2014,2014,3,5, 8 ,5714,1003,980,7697
3/5/2014,2014,3,5, 9 ,6454,1182,1127,8763
3/5/2014,2014,3,5, 10 ,6935,1276,1195,9406
3/5/2014,2014,3,5, 11 ,7165,1316,1167,9648
3/5/2014,2014,3,5, 12 ,7020,1293,1145,9458
3/5/2014,2014,3,5, 13 ,7006,1295,1178,9479
3/5/2014,2014,3,5, 14 ,7245,1361,1190,9796
3/5/2014,2014,3,5, 15 ,7150,1337,1149,9636
3/5/2014,2014,3,5, 16 ,7054,1312,1168,9534
3/5/2014,2014,3,5, 17 ,6746,1227,1121,9094
3/5/2014,2014,3,5, 18 ,6706,1261,1154,9121
3/5/2014,2014,3,5, 19 ,6939,1373,1207,9519
3/5/2014,2014,3,5, 20 ,6696,1311,1207,9214
3/5/2014,2014,3,5, 21 ,6507,1242,1188,8937
3/5/2014,2014,3,5, 22 ,6109,1120,1101,8330
3/5/2014,2014,3,5, 23 ,5753,1015,1034,7802
3/5/2014,2014,3,5, 24 ,5276,937,946,7159
3/6/2014,2014,3,6, 1 ,5024,892,912,6828
3/6/2014,2014,3,6, 2 ,4879,865,870,6614
3/6/2014,2014,3,6, 3 ,4772,839,851,6462
3/6/2014,2014,3,6, 4 ,4679,834,838,6351
3/6/2014,2014,3,6, 5 ,4874,868,887,6629
3/6/2014,2014,3,6, 6 ,5090,919,935,6944
3/6/2014,2014,3,6, 7 ,5039,878,855,6772
3/6/2014,2014,3,6, 8 ,5681,987,918,7586
3/6/2014,2014,3,6, 9 ,6393,1167,1094,8654
3/6/2014,2014,3,6, 10 ,6861,1272,1135,9268
3/6/2014,2014,3,6, 11 ,7182,1318,1166,9666
3/6/2014,2014,3,6, 12 ,7078,1286,1150,9514
3/6/2014,2014,3,6, 13 ,7019,1285,1184,9488
3/6/2014,2014,3,6, 14 ,7311,1343,1215,9869
3/6/2014,2014,3,6, 15 ,7208,1314,1192,9714
3/6/2014,2014,3,6, 16 ,7037,1299,1180,9516
3/6/2014,2014,3,6, 17 ,6745,1220,1116,9081
3/6/2014,2014,3,6, 18 ,6617,1269,1170,9056
3/6/2014,2014,3,6, 19 ,6917,1387,1184,9488
3/6/2014,2014,3,6, 20 ,6801,1327,1205,9333
3/6/2014,2014,3,6, 21 ,6586,1258,1197,9041
3/6/2014,2014,3,6, 22 ,6141,1127,1102,8370
3/6/2014,2014,3,6, 23 ,5734,1018,1010,7762
3/6/2014,2014,3,6, 24 ,5375,944,929,7248
3/7/2014,2014,3,7, 1 ,5151,903,896,6950
3/7/2014,2014,3,7, 2 ,4987,870,854,6711
3/7/2014,2014,3,7, 3 ,4818,847,839,6504
3/7/2014,2014,3,7, 4 ,4833,843,827,6503
3/7/2014,2014,3,7, 5 ,4996,870,868,6734
3/7/2014,2014,3,7, 6 ,5201,911,920,7032
3/7/2014,2014,3,7, 7 ,5156,881,857,6894
3/7/2014,2014,3,7, 8 ,5702,1001,953,7656
3/7/2014,2014,3,7, 9 ,6375,1184,1094,8653
3/7/2014,2014,3,7, 10 ,6834,1272,1186,9292
3/7/2014,2014,3,7, 11 ,7003,1336,1179,9518
3/7/2014,2014,3,7, 12 ,6831,1288,1146,9265
3/7/2014,2014,3,7, 13 ,6713,1296,1164,9173
3/7/2014,2014,3,7, 14 ,7016,1362,1203,9581
3/7/2014,2014,3,7, 15 ,6751,1332,1188,9271
3/7/2014,2014,3,7, 16 ,6654,1308,1179,9141
3/7/2014,2014,3,7, 17 ,6360,1224,1144,8728
3/7/2014,2014,3,7, 18 ,6452,1269,1190,8911
3/7/2014,2014,3,7, 19 ,6735,1378,1174,9287
3/7/2014,2014,3,7, 20 ,6527,1313,1152,8992
3/7/2014,2014,3,7, 21 ,6300,1269,1176,8745
3/7/2014,2014,3,7, 22 ,5924,1165,1085,8174
3/7/2014,2014,3,7, 23 ,5499,1051,1004,7554
3/7/2014,2014,3,7, 24 ,5101,964,899,6964
3/8/2014,2014,3,8, 1 ,4842,933,876,6651
3/8/2014,2014,3,8, 2 ,4709,898,852,6459
3/8/2014,2014,3,8, 3 ,4606,866,828,6300
3/8/2014,2014,3,8, 4 ,4568,850,823,6241
3/8/2014,2014,3,8, 5 ,4595,865,838,6298
3/8/2014,2014,3,8, 6 ,4621,882,874,6377
3/8/2014,2014,3,8, 7 ,4694,881,838,6413
3/8/2014,2014,3,8, 8 ,5135,965,915,7015
3/8/2014,2014,3,8, 9 ,5677,1080,1010,7767
3/8/2014,2014,3,8, 10 ,6150,1135,1072,8357
3/8/2014,2014,3,8, 11 ,6441,1188,1138,8767
3/8/2014,2014,3,8, 12 ,6325,1167,1117,8609
3/8/2014,2014,3,8, 13 ,6317,1185,1124,8626
3/8/2014,2014,3,8, 14 ,6487,1221,1146,8854
3/8/2014,2014,3,8, 15 ,6317,1204,1120,8641
3/8/2014,2014,3,8, 16 ,6109,1161,1112,8382
3/8/2014,2014,3,8, 17 ,5877,1111,1051,8039
3/8/2014,2014,3,8, 18 ,5937,1190,1108,8235
3/8/2014,2014,3,8, 19 ,6518,1326,1176,9020
3/8/2014,2014,3,8, 20 ,6347,1278,1172,8797
3/8/2014,2014,3,8, 21 ,6189,1218,1150,8557
3/8/2014,2014,3,8, 22 ,5864,1103,1073,8040
3/8/2014,2014,3,8, 23 ,5483,1011,1017,7511
3/8/2014,2014,3,8, 24 ,5122,938,929,6989
3/9/2014,2014,3,9, 1 ,4829,896,873,6598
3/9/2014,2014,3,9, 2 ,4681,864,836,6381
3/9/2014,2014,3,9, 3 ,4526,832,828,6186
3/9/2014,2014,3,9, 4 ,4444,826,807,6077
3/9/2014,2014,3,9, 5 ,4427,840,816,6083
3/9/2014,2014,3,9, 6 ,4375,828,831,6034
3/9/2014,2014,3,9, 7 ,4326,836,813,5975
3/9/2014,2014,3,9, 8 ,4578,873,841,6292
3/9/2014,2014,3,9, 9 ,4945,937,933,6815
3/9/2014,2014,3,9, 10 ,5350,997,971,7318
3/9/2014,2014,3,9, 11 ,5651,1037,1052,7740
3/9/2014,2014,3,9, 12 ,5601,1042,1044,7687
3/9/2014,2014,3,9, 13 ,5618,1045,1056,7719
3/9/2014,2014,3,9, 14 ,5624,1046,1084,7754
3/9/2014,2014,3,9, 15 ,5674,1037,1071,7782
3/9/2014,2014,3,9, 16 ,5488,1021,1043,7552
3/9/2014,2014,3,9, 17 ,5370,1010,1019,7399
3/9/2014,2014,3,9, 18 ,5559,1090,1110,7759
3/9/2014,2014,3,9, 19 ,6148,1285,1144,8577
3/9/2014,2014,3,9, 20 ,6133,1256,1142,8531
3/9/2014,2014,3,9, 21 ,5937,1187,1106,8230
3/9/2014,2014,3,9, 22 ,5503,1084,1021,7608
3/9/2014,2014,3,9, 23 ,5177,988,966,7131
3/9/2014,2014,3,9, 24 ,4827,926,903,6656
3/10/2014,2014,3,10, 1 ,4558,871,850,6279
3/10/2014,2014,3,10, 2 ,4417,854,818,6089
3/10/2014,2014,3,10, 3 ,4331,826,796,5953
3/10/2014,2014,3,10, 4 ,4294,817,797,5908
3/10/2014,2014,3,10, 5 ,4522,860,835,6217
3/10/2014,2014,3,10, 6 ,4787,914,904,6605
3/10/2014,2014,3,10, 7 ,4894,877,841,6612
3/10/2014,2014,3,10, 8 ,5535,994,954,7483
3/10/2014,2014,3,10, 9 ,6324,1188,1089,8601
3/10/2014,2014,3,10, 10 ,6869,1282,1168,9319
3/10/2014,2014,3,10, 11 ,7013,1331,1181,9525
3/10/2014,2014,3,10, 12 ,6931,1296,1147,9374
3/10/2014,2014,3,10, 13 ,6923,1297,1152,9372
3/10/2014,2014,3,10, 14 ,7138,1353,1150,9641
3/10/2014,2014,3,10, 15 ,6997,1325,1131,9453
3/10/2014,2014,3,10, 16 ,6843,1301,1138,9282
3/10/2014,2014,3,10, 17 ,6630,1230,1113,8973
3/10/2014,2014,3,10, 18 ,6540,1274,1121,8935
3/10/2014,2014,3,10, 19 ,6908,1378,1125,9411
3/10/2014,2014,3,10, 20 ,6673,1309,1151,9133
3/10/2014,2014,3,10, 21 ,6481,1243,1159,8883
3/10/2014,2014,3,10, 22 ,6047,1124,1077,8248
3/10/2014,2014,3,10, 23 ,5655,1028,988,7671
3/10/2014,2014,3,10, 24 ,5231,953,928,7112
3/11/2014,2014,3,11, 1 ,5001,905,902,6808
3/11/2014,2014,3,11, 2 ,4916,888,879,6683
3/11/2014,2014,3,11, 3 ,4776,858,856,6490
3/11/2014,2014,3,11, 4 ,4717,854,847,6418
3/11/2014,2014,3,11, 5 ,4881,890,890,6661
3/11/2014,2014,3,11, 6 ,5095,934,897,6926
3/11/2014,2014,3,11, 7 ,5139,905,849,6893
3/11/2014,2014,3,11, 8 ,5803,1034,979,7816
3/11/2014,2014,3,11, 9 ,6461,1225,1078,8764
3/11/2014,2014,3,11, 10 ,6911,1328,1118,9357
3/11/2014,2014,3,11, 11 ,7101,1332,1130,9563
3/11/2014,2014,3,11, 12 ,6934,1306,1088,9328
3/11/2014,2014,3,11, 13 ,6829,1306,1113,9248
3/11/2014,2014,3,11, 14 ,7126,1375,1122,9623
3/11/2014,2014,3,11, 15 ,7021,1344,1068,9433
3/11/2014,2014,3,11, 16 ,6862,1328,1084,9274
3/11/2014,2014,3,11, 17 ,6614,1255,1120,8989
3/11/2014,2014,3,11, 18 ,6507,1346,1178,9031
3/11/2014,2014,3,11, 19 ,6900,1411,1149,9460
3/11/2014,2014,3,11, 20 ,6649,1353,1136,9138
3/11/2014,2014,3,11, 21 ,6391,1282,1091,8764
3/11/2014,2014,3,11, 22 ,5996,1152,1027,8175
3/11/2014,2014,3,11, 23 ,5596,1048,952,7596
3/11/2014,2014,3,11, 24 ,5203,975,923,7101
3/12/2014,2014,3,12, 1 ,4974,936,851,6761
3/12/2014,2014,3,12, 2 ,4867,912,829,6608
3/12/2014,2014,3,12, 3 ,4722,897,811,6430
3/12/2014,2014,3,12, 4 ,4715,882,797,6394
3/12/2014,2014,3,12, 5 ,4870,917,840,6627
3/12/2014,2014,3,12, 6 ,5083,956,919,6958
3/12/2014,2014,3,12, 7 ,5159,940,815,6914
3/12/2014,2014,3,12, 8 ,5837,1015,925,7777
3/12/2014,2014,3,12, 9 ,6506,1169,1033,8708
3/12/2014,2014,3,12, 10 ,6991,1255,1113,9359
3/12/2014,2014,3,12, 11 ,7199,1277,1144,9620
3/12/2014,2014,3,12, 12 ,6964,1241,1117,9322
3/12/2014,2014,3,12, 13 ,7013,1270,1130,9413
3/12/2014,2014,3,12, 14 ,7290,1323,1157,9770
3/12/2014,2014,3,12, 15 ,7226,1299,1144,9669
3/12/2014,2014,3,12, 16 ,7042,1288,1132,9462
3/12/2014,2014,3,12, 17 ,6782,1247,1122,9151
3/12/2014,2014,3,12, 18 ,6679,1290,1145,9114
3/12/2014,2014,3,12, 19 ,7017,1354,1120,9491
3/12/2014,2014,3,12, 20 ,6804,1295,1135,9234
3/12/2014,2014,3,12, 21 ,6597,1216,1117,8930
3/12/2014,2014,3,12, 22 ,6213,1116,1085,8414
3/12/2014,2014,3,12, 23 ,5738,1018,1017,7773
3/12/2014,2014,3,12, 24 ,5354,944,897,7195
3/13/2014,2014,3,13, 1 ,5138,911,869,6918
3/13/2014,2014,3,13, 2 ,4918,890,845,6653
3/13/2014,2014,3,13, 3 ,4780,867,821,6468
3/13/2014,2014,3,13, 4 ,4761,864,832,6457
3/13/2014,2014,3,13, 5 ,4907,898,868,6673
3/13/2014,2014,3,13, 6 ,5053,961,920,6934
3/13/2014,2014,3,13, 7 ,5076,933,868,6877
3/13/2014,2014,3,13, 8 ,5788,1046,960,7794
3/13/2014,2014,3,13, 9 ,6502,1208,967,8677
3/13/2014,2014,3,13, 10 ,7041,1263,1044,9348
3/13/2014,2014,3,13, 11 ,7373,1295,1057,9725
3/13/2014,2014,3,13, 12 ,7230,1256,1053,9539
3/13/2014,2014,3,13, 13 ,7312,1257,1078,9647
3/13/2014,2014,3,13, 14 ,7512,1315,1097,9924
3/13/2014,2014,3,13, 15 ,7466,1296,1055,9817
3/13/2014,2014,3,13, 16 ,7325,1292,1081,9698
3/13/2014,2014,3,13, 17 ,6953,1213,1056,9222
3/13/2014,2014,3,13, 18 ,6836,1291,1088,9215
3/13/2014,2014,3,13, 19 ,7233,1386,1063,9682
3/13/2014,2014,3,13, 20 ,7002,1321,1073,9396
3/13/2014,2014,3,13, 21 ,6821,1244,1101,9166
3/13/2014,2014,3,13, 22 ,6450,1127,1043,8620
3/13/2014,2014,3,13, 23 ,6024,1032,982,8038
3/13/2014,2014,3,13, 24 ,5658,955,909,7522
3/14/2014,2014,3,14, 1 ,5328,933,834,7095
3/14/2014,2014,3,14, 2 ,5164,906,806,6876
3/14/2014,2014,3,14, 3 ,5000,884,789,6673
3/14/2014,2014,3,14, 4 ,4942,876,786,6604
3/14/2014,2014,3,14, 5 ,5091,906,805,6802
3/14/2014,2014,3,14, 6 ,5228,947,835,7010
3/14/2014,2014,3,14, 7 ,5223,913,803,6939
3/14/2014,2014,3,14, 8 ,5925,1048,916,7889
3/14/2014,2014,3,14, 9 ,6705,1244,1024,8973
3/14/2014,2014,3,14, 10 ,7134,1291,1057,9482
3/14/2014,2014,3,14, 11 ,7441,1330,1121,9892
3/14/2014,2014,3,14, 12 ,7315,1296,1107,9718
3/14/2014,2014,3,14, 13 ,7267,1273,1114,9654
3/14/2014,2014,3,14, 14 ,7631,1333,1160,10124
3/14/2014,2014,3,14, 15 ,7496,1316,1096,9908
3/14/2014,2014,3,14, 16 ,7369,1295,1099,9763
3/14/2014,2014,3,14, 17 ,6977,1229,1102,9308
3/14/2014,2014,3,14, 18 ,6771,1285,1128,9184
3/14/2014,2014,3,14, 19 ,7128,1364,1094,9586
3/14/2014,2014,3,14, 20 ,6927,1321,1128,9376
3/14/2014,2014,3,14, 21 ,6731,1258,1129,9118
3/14/2014,2014,3,14, 22 ,6464,1159,1034,8657
3/14/2014,2014,3,14, 23 ,6044,1031,981,8056
3/14/2014,2014,3,14, 24 ,5604,963,932,7499
3/15/2014,2014,3,15, 1 ,5387,917,795,7099
3/15/2014,2014,3,15, 2 ,5202,892,773,6867
3/15/2014,2014,3,15, 3 ,5077,867,784,6728
3/15/2014,2014,3,15, 4 ,4936,859,781,6576
3/15/2014,2014,3,15, 5 ,4991,871,813,6675
3/15/2014,2014,3,15, 6 ,4998,881,858,6737
3/15/2014,2014,3,15, 7 ,5074,887,831,6792
3/15/2014,2014,3,15, 8 ,5572,995,868,7435
3/15/2014,2014,3,15, 9 ,6070,1133,984,8187
3/15/2014,2014,3,15, 10 ,6440,1221,1090,8751
3/15/2014,2014,3,15, 11 ,6708,1279,1099,9086
3/15/2014,2014,3,15, 12 ,6636,1248,1083,8967
3/15/2014,2014,3,15, 13 ,6555,1250,1121,8926
3/15/2014,2014,3,15, 14 ,6724,1282,1094,9100
3/15/2014,2014,3,15, 15 ,6663,1251,1085,8999
3/15/2014,2014,3,15, 16 ,6480,1197,1081,8758
3/15/2014,2014,3,15, 17 ,6145,1160,1107,8412
3/15/2014,2014,3,15, 18 ,6140,1209,1160,8509
3/15/2014,2014,3,15, 19 ,6591,1342,1225,9158
3/15/2014,2014,3,15, 20 ,6559,1301,1222,9082
3/15/2014,2014,3,15, 21 ,6381,1251,1193,8825
3/15/2014,2014,3,15, 22 ,6163,1184,1104,8451
3/15/2014,2014,3,15, 23 ,5822,1070,1007,7899
3/15/2014,2014,3,15, 24 ,5403,986,948,7337
3/16/2014,2014,3,16, 1 ,5119,931,875,6925
3/16/2014,2014,3,16, 2 ,4955,899,847,6701
3/16/2014,2014,3,16, 3 ,4842,875,820,6537
3/16/2014,2014,3,16, 4 ,4743,858,802,6403
3/16/2014,2014,3,16, 5 ,4679,857,796,6332
3/16/2014,2014,3,16, 6 ,4640,845,801,6286
3/16/2014,2014,3,16, 7 ,4584,849,803,6236
3/16/2014,2014,3,16, 8 ,4817,889,813,6519
3/16/2014,2014,3,16, 9 ,5153,955,883,6991
3/16/2014,2014,3,16, 10 ,5631,1017,954,7602
3/16/2014,2014,3,16, 11 ,5803,1053,1013,7869
3/16/2014,2014,3,16, 12 ,5830,1047,1032,7909
3/16/2014,2014,3,16, 13 ,5810,1053,1038,7901
3/16/2014,2014,3,16, 14 ,5818,1052,1038,7908
3/16/2014,2014,3,16, 15 ,5733,1047,1015,7795
3/16/2014,2014,3,16, 16 ,5617,1023,980,7620
3/16/2014,2014,3,16, 17 ,5458,1002,971,7431
3/16/2014,2014,3,16, 18 ,5604,1108,1086,7798
3/16/2014,2014,3,16, 19 ,6286,1254,1211,8751
3/16/2014,2014,3,16, 20 ,6160,1221,1173,8554
3/16/2014,2014,3,16, 21 ,6082,1151,1134,8367
3/16/2014,2014,3,16, 22 ,5800,1060,1039,7899
3/16/2014,2014,3,16, 23 ,5451,968,956,7375
3/16/2014,2014,3,16, 24 ,5048,897,895,6840
3/17/2014,2014,3,17, 1 ,4802,850,842,6494
3/17/2014,2014,3,17, 2 ,4641,822,813,6276
3/17/2014,2014,3,17, 3 ,4537,801,787,6125
3/17/2014,2014,3,17, 4 ,4439,801,783,6023
3/17/2014,2014,3,17, 5 ,4702,842,824,6368
3/17/2014,2014,3,17, 6 ,4925,892,869,6686
3/17/2014,2014,3,17, 7 ,5064,867,822,6753
3/17/2014,2014,3,17, 8 ,5697,986,901,7584
3/17/2014,2014,3,17, 9 ,6502,1175,1029,8706
3/17/2014,2014,3,17, 10 ,6948,1269,1081,9298
3/17/2014,2014,3,17, 11 ,7213,1314,1114,9641
3/17/2014,2014,3,17, 12 ,7017,1284,1111,9412
3/17/2014,2014,3,17, 13 ,7001,1287,1113,9401
3/17/2014,2014,3,17, 14 ,7300,1355,1137,9792
3/17/2014,2014,3,17, 15 ,7220,1326,1107,9653
3/17/2014,2014,3,17, 16 ,7140,1312,1108,9560
3/17/2014,2014,3,17, 17 ,6681,1237,1136,9054
3/17/2014,2014,3,17, 18 ,6534,1276,1190,9000
3/17/2014,2014,3,17, 19 ,6966,1389,1266,9621
3/17/2014,2014,3,17, 20 ,6746,1325,1209,9280
3/17/2014,2014,3,17, 21 ,6489,1260,1171,8920
3/17/2014,2014,3,17, 22 ,6124,1140,1052,8316
3/17/2014,2014,3,17, 23 ,5766,1052,956,7774
3/17/2014,2014,3,17, 24 ,5418,984,877,7279
3/18/2014,2014,3,18, 1 ,5147,923,848,6918
3/18/2014,2014,3,18, 2 ,4967,891,818,6676
3/18/2014,2014,3,18, 3 ,4777,867,789,6433
3/18/2014,2014,3,18, 4 ,4761,854,794,6409
3/18/2014,2014,3,18, 5 ,4898,892,840,6630
3/18/2014,2014,3,18, 6 ,5059,922,885,6866
3/18/2014,2014,3,18, 7 ,5132,887,815,6834
3/18/2014,2014,3,18, 8 ,5807,1009,922,7738
3/18/2014,2014,3,18, 9 ,6501,1184,1070,8755
3/18/2014,2014,3,18, 10 ,7005,1284,1203,9492
3/18/2014,2014,3,18, 11 ,7256,1330,1212,9798
3/18/2014,2014,3,18, 12 ,7173,1287,1189,9649
3/18/2014,2014,3,18, 13 ,7114,1302,1206,9622
3/18/2014,2014,3,18, 14 ,7443,1354,1245,10042
3/18/2014,2014,3,18, 15 ,7366,1339,1254,9959
3/18/2014,2014,3,18, 16 ,7184,1301,1242,9727
3/18/2014,2014,3,18, 17 ,6843,1232,1193,9268
3/18/2014,2014,3,18, 18 ,6635,1288,1243,9166
3/18/2014,2014,3,18, 19 ,7059,1375,1284,9718
3/18/2014,2014,3,18, 20 ,6835,1308,1238,9381
3/18/2014,2014,3,18, 21 ,6572,1264,1158,8994
3/18/2014,2014,3,18, 22 ,6259,1134,1030,8423
3/18/2014,2014,3,18, 23 ,5863,1048,935,7846
3/18/2014,2014,3,18, 24 ,5466,977,856,7299
3/19/2014,2014,3,19, 1 ,5180,935,839,6954
3/19/2014,2014,3,19, 2 ,5049,903,820,6772
3/19/2014,2014,3,19, 3 ,4943,872,795,6610
3/19/2014,2014,3,19, 4 ,4831,866,785,6482
3/19/2014,2014,3,19, 5 ,4988,896,832,6716
3/19/2014,2014,3,19, 6 ,5113,934,893,6940
3/19/2014,2014,3,19, 7 ,5183,908,864,6955
3/19/2014,2014,3,19, 8 ,5820,1028,927,7775
3/19/2014,2014,3,19, 9 ,6520,1206,1067,8793
3/19/2014,2014,3,19, 10 ,6928,1295,1160,9383
3/19/2014,2014,3,19, 11 ,7218,1347,1194,9759
3/19/2014,2014,3,19, 12 ,7072,1304,1164,9540
3/19/2014,2014,3,19, 13 ,7075,1315,1157,9547
3/19/2014,2014,3,19, 14 ,7397,1339,1198,9934
3/19/2014,2014,3,19, 15 ,7285,1324,1171,9780
3/19/2014,2014,3,19, 16 ,7210,1311,1179,9700
3/19/2014,2014,3,19, 17 ,6743,1256,1170,9169
3/19/2014,2014,3,19, 18 ,6710,1287,1238,9235
3/19/2014,2014,3,19, 19 ,7067,1378,1233,9678
3/19/2014,2014,3,19, 20 ,6893,1324,1205,9422
3/19/2014,2014,3,19, 21 ,6693,1271,1130,9094
3/19/2014,2014,3,19, 22 ,6370,1158,1042,8570
3/19/2014,2014,3,19, 23 ,5918,1054,934,7906
3/19/2014,2014,3,19, 24 ,5522,980,867,7369
3/20/2014,2014,3,20, 1 ,5280,932,838,7050
3/20/2014,2014,3,20, 2 ,5080,911,811,6802
3/20/2014,2014,3,20, 3 ,4925,891,795,6611
3/20/2014,2014,3,20, 4 ,4882,871,792,6545
3/20/2014,2014,3,20, 5 ,4996,898,837,6731
3/20/2014,2014,3,20, 6 ,5104,938,889,6931
3/20/2014,2014,3,20, 7 ,5151,922,852,6925
3/20/2014,2014,3,20, 8 ,5830,1051,946,7827
3/20/2014,2014,3,20, 9 ,6518,1251,1098,8867
3/20/2014,2014,3,20, 10 ,6973,1327,1149,9449
3/20/2014,2014,3,20, 11 ,7245,1368,1208,9821
3/20/2014,2014,3,20, 12 ,7060,1328,1195,9583
3/20/2014,2014,3,20, 13 ,7159,1347,1168,9674
3/20/2014,2014,3,20, 14 ,7442,1393,1194,10029
3/20/2014,2014,3,20, 15 ,7368,1381,1180,9929
3/20/2014,2014,3,20, 16 ,7289,1367,1179,9835
3/20/2014,2014,3,20, 17 ,6912,1287,1168,9367
3/20/2014,2014,3,20, 18 ,6756,1309,1231,9296
3/20/2014,2014,3,20, 19 ,7115,1406,1228,9749
3/20/2014,2014,3,20, 20 ,6955,1352,1186,9493
3/20/2014,2014,3,20, 21 ,6786,1287,1140,9213
3/20/2014,2014,3,20, 22 ,6458,1194,1031,8683
3/20/2014,2014,3,20, 23 ,6089,1094,936,8119
3/20/2014,2014,3,20, 24 ,5669,1018,813,7500
3/21/2014,2014,3,21, 1 ,5464,942,838,7244
3/21/2014,2014,3,21, 2 ,5221,916,800,6937
3/21/2014,2014,3,21, 3 ,5065,889,780,6734
3/21/2014,2014,3,21, 4 ,5002,879,779,6660
3/21/2014,2014,3,21, 5 ,5069,902,825,6796
3/21/2014,2014,3,21, 6 ,5176,933,885,6994
3/21/2014,2014,3,21, 7 ,5282,914,864,7060
3/21/2014,2014,3,21, 8 ,5900,1042,932,7874
3/21/2014,2014,3,21, 9 ,6456,1241,1102,8799
3/21/2014,2014,3,21, 10 ,7043,1312,1190,9545
3/21/2014,2014,3,21, 11 ,7322,1332,1243,9897
3/21/2014,2014,3,21, 12 ,7092,1310,1195,9597
3/21/2014,2014,3,21, 13 ,7024,1332,1198,9554
3/21/2014,2014,3,21, 14 ,7287,1387,1223,9897
3/21/2014,2014,3,21, 15 ,7097,1342,1190,9629
3/21/2014,2014,3,21, 16 ,6966,1327,1187,9480
3/21/2014,2014,3,21, 17 ,6644,1241,1172,9057
3/21/2014,2014,3,21, 18 ,6666,1321,1214,9201
3/21/2014,2014,3,21, 19 ,6971,1386,1185,9542
3/21/2014,2014,3,21, 20 ,6776,1334,1157,9267
3/21/2014,2014,3,21, 21 ,6597,1264,1114,8975
3/21/2014,2014,3,21, 22 ,6288,1158,1028,8474
3/21/2014,2014,3,21, 23 ,5914,1060,942,7916
3/21/2014,2014,3,21, 24 ,5556,995,869,7420
3/22/2014,2014,3,22, 1 ,5286,938,837,7061
3/22/2014,2014,3,22, 2 ,5127,913,810,6850
3/22/2014,2014,3,22, 3 ,4959,893,794,6646
3/22/2014,2014,3,22, 4 ,4877,876,796,6549
3/22/2014,2014,3,22, 5 ,4859,891,823,6573
3/22/2014,2014,3,22, 6 ,4859,906,858,6623
3/22/2014,2014,3,22, 7 ,4947,919,855,6721
3/22/2014,2014,3,22, 8 ,5345,995,917,7257
3/22/2014,2014,3,22, 9 ,5919,1108,1023,8050
3/22/2014,2014,3,22, 10 ,6344,1168,1093,8605
3/22/2014,2014,3,22, 11 ,6576,1199,1149,8924
3/22/2014,2014,3,22, 12 ,6418,1174,1135,8727
3/22/2014,2014,3,22, 13 ,6302,1186,1141,8629
3/22/2014,2014,3,22, 14 ,6485,1216,1154,8855
3/22/2014,2014,3,22, 15 ,6427,1207,1112,8746
3/22/2014,2014,3,22, 16 ,6315,1175,1098,8588
3/22/2014,2014,3,22, 17 ,5950,1145,1091,8186
3/22/2014,2014,3,22, 18 ,6005,1238,1178,8421
3/22/2014,2014,3,22, 19 ,6545,1317,1209,9071
3/22/2014,2014,3,22, 20 ,6434,1278,1207,8919
3/22/2014,2014,3,22, 21 ,6275,1218,1135,8628
3/22/2014,2014,3,22, 22 ,5992,1116,1044,8152
3/22/2014,2014,3,22, 23 ,5615,1015,956,7586
3/22/2014,2014,3,22, 24 ,5259,946,882,7087
3/23/2014,2014,3,23, 1 ,5011,892,838,6741
3/23/2014,2014,3,23, 2 ,4846,860,809,6515
3/23/2014,2014,3,23, 3 ,4698,838,789,6325
3/23/2014,2014,3,23, 4 ,4618,824,781,6223
3/23/2014,2014,3,23, 5 ,4542,833,793,6168
3/23/2014,2014,3,23, 6 ,4490,842,806,6138
3/23/2014,2014,3,23, 7 ,4460,846,795,6101
3/23/2014,2014,3,23, 8 ,4737,873,814,6424
3/23/2014,2014,3,23, 9 ,5117,926,892,6935
3/23/2014,2014,3,23, 10 ,5439,968,983,7390
3/23/2014,2014,3,23, 11 ,5651,987,1030,7668
3/23/2014,2014,3,23, 12 ,5551,985,1045,7581
3/23/2014,2014,3,23, 13 ,5525,968,1056,7549
3/23/2014,2014,3,23, 14 ,5524,965,1044,7533
3/23/2014,2014,3,23, 15 ,5464,948,1003,7415
3/23/2014,2014,3,23, 16 ,5371,948,995,7314
3/23/2014,2014,3,23, 17 ,5302,992,1022,7316
3/23/2014,2014,3,23, 18 ,5460,1127,1120,7707
3/23/2014,2014,3,23, 19 ,6135,1195,1169,8499
3/23/2014,2014,3,23, 20 ,6010,1143,1148,8301
3/23/2014,2014,3,23, 21 ,5867,1073,1062,8002
3/23/2014,2014,3,23, 22 ,5594,978,967,7539
3/23/2014,2014,3,23, 23 ,5270,909,883,7062
3/23/2014,2014,3,23, 24 ,5033,846,828,6707
3/24/2014,2014,3,24, 1 ,4720,806,787,6313
3/24/2014,2014,3,24, 2 ,4640,783,753,6176
3/24/2014,2014,3,24, 3 ,4525,769,734,6028
3/24/2014,2014,3,24, 4 ,4470,766,733,5969
3/24/2014,2014,3,24, 5 ,4617,802,779,6198
3/24/2014,2014,3,24, 6 ,4836,860,829,6525
3/24/2014,2014,3,24, 7 ,5027,858,806,6691
3/24/2014,2014,3,24, 8 ,5784,952,917,7653
3/24/2014,2014,3,24, 9 ,6414,1127,1062,8603
3/24/2014,2014,3,24, 10 ,6813,1254,1191,9258
3/24/2014,2014,3,24, 11 ,7105,1297,1259,9661
3/24/2014,2014,3,24, 12 ,6891,1275,1240,9406
3/24/2014,2014,3,24, 13 ,6807,1272,1249,9328
3/24/2014,2014,3,24, 14 ,6871,1325,1280,9476
3/24/2014,2014,3,24, 15 ,6800,1305,1245,9350
3/24/2014,2014,3,24, 16 ,6679,1288,1229,9196
3/24/2014,2014,3,24, 17 ,6494,1229,1203,8926
3/24/2014,2014,3,24, 18 ,6515,1289,1264,9068
3/24/2014,2014,3,24, 19 ,6717,1365,1267,9349
3/24/2014,2014,3,24, 20 ,6556,1315,1214,9085
3/24/2014,2014,3,24, 21 ,6323,1242,1164,8729
3/24/2014,2014,3,24, 22 ,5917,1124,1069,8110
3/24/2014,2014,3,24, 23 ,5505,1015,967,7487
3/24/2014,2014,3,24, 24 ,5108,951,846,6905
3/25/2014,2014,3,25, 1 ,4897,906,862,6665
3/25/2014,2014,3,25, 2 ,4787,883,845,6515
3/25/2014,2014,3,25, 3 ,4645,858,814,6317
3/25/2014,2014,3,25, 4 ,4649,852,807,6308
3/25/2014,2014,3,25, 5 ,4713,887,846,6446
3/25/2014,2014,3,25, 6 ,4908,923,874,6705
3/25/2014,2014,3,25, 7 ,5073,918,856,6847
3/25/2014,2014,3,25, 8 ,5681,1047,982,7710
3/25/2014,2014,3,25, 9 ,6348,1222,1130,8700
3/25/2014,2014,3,25, 10 ,6807,1314,1213,9334
3/25/2014,2014,3,25, 11 ,7095,1352,1282,9729
3/25/2014,2014,3,25, 12 ,7020,1303,1263,9586
3/25/2014,2014,3,25, 13 ,6986,1316,1302,9604
3/25/2014,2014,3,25, 14 ,7175,1376,1308,9859
3/25/2014,2014,3,25, 15 ,7102,1343,1304,9749
3/25/2014,2014,3,25, 16 ,6999,1325,1301,9625
3/25/2014,2014,3,25, 17 ,6601,1250,1236,9087
3/25/2014,2014,3,25, 18 ,6581,1303,1312,9196
3/25/2014,2014,3,25, 19 ,6919,1400,1296,9615
3/25/2014,2014,3,25, 20 ,6659,1348,1309,9316
3/25/2014,2014,3,25, 21 ,6528,1269,1224,9021
3/25/2014,2014,3,25, 22 ,6201,1159,1141,8501
3/25/2014,2014,3,25, 23 ,5816,1052,1023,7891
3/25/2014,2014,3,25, 24 ,5425,978,941,7344
3/26/2014,2014,3,26, 1 ,5150,934,911,6995
3/26/2014,2014,3,26, 2 ,5014,902,879,6795
3/26/2014,2014,3,26, 3 ,4905,884,853,6642
3/26/2014,2014,3,26, 4 ,4888,876,841,6605
3/26/2014,2014,3,26, 5 ,4942,905,872,6719
3/26/2014,2014,3,26, 6 ,5062,933,928,6923
3/26/2014,2014,3,26, 7 ,5290,927,894,7111
3/26/2014,2014,3,26, 8 ,5906,1051,1011,7968
3/26/2014,2014,3,26, 9 ,6667,1243,1175,9085
3/26/2014,2014,3,26, 10 ,7134,1333,1247,9714
3/26/2014,2014,3,26, 11 ,7428,1391,1291,10110
3/26/2014,2014,3,26, 12 ,7310,1349,1269,9928
3/26/2014,2014,3,26, 13 ,7272,1355,1244,9871
3/26/2014,2014,3,26, 14 ,7509,1380,1305,10194
3/26/2014,2014,3,26, 15 ,7367,1363,1283,10013
3/26/2014,2014,3,26, 16 ,7264,1338,1263,9865
3/26/2014,2014,3,26, 17 ,6823,1261,1201,9285
3/26/2014,2014,3,26, 18 ,6715,1292,1266,9273
3/26/2014,2014,3,26, 19 ,7102,1410,1280,9792
3/26/2014,2014,3,26, 20 ,6931,1340,1273,9544
3/26/2014,2014,3,26, 21 ,6773,1276,1221,9270
3/26/2014,2014,3,26, 22 ,6471,1198,1139,8808
3/26/2014,2014,3,26, 23 ,6102,1083,1039,8224
3/26/2014,2014,3,26, 24 ,5705,1011,1008,7724
3/27/2014,2014,3,27, 1 ,5439,980,913,7332
3/27/2014,2014,3,27, 2 ,5223,942,892,7057
3/27/2014,2014,3,27, 3 ,5102,914,871,6887
3/27/2014,2014,3,27, 4 ,5038,909,863,6810
3/27/2014,2014,3,27, 5 ,5074,933,893,6900
3/27/2014,2014,3,27, 6 ,5127,952,920,6999
3/27/2014,2014,3,27, 7 ,5300,950,899,7149
3/27/2014,2014,3,27, 8 ,6015,1070,1014,8099
3/27/2014,2014,3,27, 9 ,6679,1239,1142,9060
3/27/2014,2014,3,27, 10 ,7219,1316,1237,9772
3/27/2014,2014,3,27, 11 ,7451,1375,1277,10103
3/27/2014,2014,3,27, 12 ,7290,1370,1280,9940
3/27/2014,2014,3,27, 13 ,7246,1355,1292,9893
3/27/2014,2014,3,27, 14 ,7537,1364,1290,10191
3/27/2014,2014,3,27, 15 ,7368,1336,1301,10005
3/27/2014,2014,3,27, 16 ,7314,1322,1289,9925
3/27/2014,2014,3,27, 17 ,6954,1247,1223,9424
3/27/2014,2014,3,27, 18 ,6764,1278,1297,9339
3/27/2014,2014,3,27, 19 ,7177,1386,1295,9858
3/27/2014,2014,3,27, 20 ,6956,1328,1282,9566
3/27/2014,2014,3,27, 21 ,6824,1273,1235,9332
3/27/2014,2014,3,27, 22 ,6490,1159,1146,8795
3/27/2014,2014,3,27, 23 ,6088,1080,1051,8219
3/27/2014,2014,3,27, 24 ,5798,1011,959,7768
3/28/2014,2014,3,28, 1 ,5511,967,929,7407
3/28/2014,2014,3,28, 2 ,5332,933,902,7167
3/28/2014,2014,3,28, 3 ,5151,907,874,6932
3/28/2014,2014,3,28, 4 ,5055,902,865,6822
3/28/2014,2014,3,28, 5 ,5114,926,889,6929
3/28/2014,2014,3,28, 6 ,5148,940,904,6992
3/28/2014,2014,3,28, 7 ,5278,944,910,7132
3/28/2014,2014,3,28, 8 ,6012,1084,969,8065
3/28/2014,2014,3,28, 9 ,6745,1265,1084,9094
3/28/2014,2014,3,28, 10 ,7269,1344,1201,9814
3/28/2014,2014,3,28, 11 ,7539,1391,1191,10121
3/28/2014,2014,3,28, 12 ,7373,1353,1157,9883
3/28/2014,2014,3,28, 13 ,7399,1360,1180,9939
3/28/2014,2014,3,28, 14 ,7702,1420,1187,10309
3/28/2014,2014,3,28, 15 ,7526,1385,1222,10133
3/28/2014,2014,3,28, 16 ,7405,1366,1199,9970
3/28/2014,2014,3,28, 17 ,7015,1278,1167,9460
3/28/2014,2014,3,28, 18 ,6758,1312,1206,9276
3/28/2014,2014,3,28, 19 ,7197,1413,1213,9823
3/28/2014,2014,3,28, 20 ,6978,1370,1183,9531
3/28/2014,2014,3,28, 21 ,6871,1318,1171,9360
3/28/2014,2014,3,28, 22 ,6632,1219,1107,8958
3/28/2014,2014,3,28, 23 ,6242,1127,1042,8411
3/28/2014,2014,3,28, 24 ,5782,1049,988,7819
3/29/2014,2014,3,29, 1 ,5575,1000,922,7497
3/29/2014,2014,3,29, 2 ,5383,956,900,7239
3/29/2014,2014,3,29, 3 ,5210,935,869,7014
3/29/2014,2014,3,29, 4 ,5094,922,863,6879
3/29/2014,2014,3,29, 5 ,5067,927,883,6877
3/29/2014,2014,3,29, 6 ,5006,921,888,6815
3/29/2014,2014,3,29, 7 ,5065,934,888,6887
3/29/2014,2014,3,29, 8 ,5514,1038,969,7521
3/29/2014,2014,3,29, 9 ,6170,1184,1083,8437
3/29/2014,2014,3,29, 10 ,6634,1266,1175,9075
3/29/2014,2014,3,29, 11 ,6988,1307,1205,9500
3/29/2014,2014,3,29, 12 ,6858,1288,1162,9308
3/29/2014,2014,3,29, 13 ,6883,1295,1185,9363
3/29/2014,2014,3,29, 14 ,7103,1331,1196,9630
3/29/2014,2014,3,29, 15 ,6978,1296,1157,9431
3/29/2014,2014,3,29, 16 ,6776,1250,1134,9160
3/29/2014,2014,3,29, 17 ,6419,1184,1105,8708
3/29/2014,2014,3,29, 18 ,6343,1260,1183,8786
3/29/2014,2014,3,29, 19 ,6865,1387,1170,9422
3/29/2014,2014,3,29, 20 ,6876,1358,1185,9419
3/29/2014,2014,3,29, 21 ,6678,1267,1146,9091
3/29/2014,2014,3,29, 22 ,6563,1199,1095,8857
3/29/2014,2014,3,29, 23 ,6209,1113,1005,8327
3/29/2014,2014,3,29, 24 ,5823,1041,950,7814
3/30/2014,2014,3,30, 1 ,5567,995,882,7444
3/30/2014,2014,3,30, 2 ,5380,961,835,7176
3/30/2014,2014,3,30, 3 ,5209,929,819,6957
3/30/2014,2014,3,30, 4 ,5060,919,813,6792
3/30/2014,2014,3,30, 5 ,5016,921,830,6767
3/30/2014,2014,3,30, 6 ,4785,900,841,6526
3/30/2014,2014,3,30, 7 ,4747,909,820,6476
3/30/2014,2014,3,30, 8 ,5032,953,849,6834
3/30/2014,2014,3,30, 9 ,5348,1018,928,7294
3/30/2014,2014,3,30, 10 ,5792,1076,975,7843
3/30/2014,2014,3,30, 11 ,6035,1117,1051,8203
3/30/2014,2014,3,30, 12 ,6051,1118,1048,8217
3/30/2014,2014,3,30, 13 ,6069,1125,1062,8256
3/30/2014,2014,3,30, 14 ,6108,1118,1063,8289
3/30/2014,2014,3,30, 15 ,6020,1106,1038,8164
3/30/2014,2014,3,30, 16 ,5839,1080,1020,7939
3/30/2014,2014,3,30, 17 ,5671,1069,1034,7774
3/30/2014,2014,3,30, 18 ,5709,1160,1132,8001
3/30/2014,2014,3,30, 19 ,6525,1325,1171,9021
3/30/2014,2014,3,30, 20 ,6523,1301,1169,8993
3/30/2014,2014,3,30, 21 ,6417,1246,1132,8795
3/30/2014,2014,3,30, 22 ,6197,1169,1065,8431
3/30/2014,2014,3,30, 23 ,5934,1094,993,8021
3/30/2014,2014,3,30, 24 ,5592,1018,927,7537
3/31/2014,2014,3,31, 1 ,5567,954,873,7394
3/31/2014,2014,3,31, 2 ,5034,922,842,6798
3/31/2014,2014,3,31, 3 ,4822,892,822,6536
3/31/2014,2014,3,31, 4 ,4736,875,816,6427
3/31/2014,2014,3,31, 5 ,4763,896,823,6482
3/31/2014,2014,3,31, 6 ,4863,912,862,6637
3/31/2014,2014,3,31, 7 ,5124,928,841,6893
3/31/2014,2014,3,31, 8 ,5890,1072,980,7942
3/31/2014,2014,3,31, 9 ,6743,1264,1106,9113
3/31/2014,2014,3,31, 10 ,7269,1350,1160,9779
3/31/2014,2014,3,31, 11 ,7574,1414,1172,10160
3/31/2014,2014,3,31, 12 ,7401,1366,1174,9941
3/31/2014,2014,3,31, 13 ,7445,1376,1189,10010
3/31/2014,2014,3,31, 14 ,7706,1440,1232,10378
3/31/2014,2014,3,31, 15 ,7630,1420,1206,10256
3/31/2014,2014,3,31, 16 ,7485,1396,1200,10081
3/31/2014,2014,3,31, 17 ,7139,1299,1178,9616
3/31/2014,2014,3,31, 18 ,6729,1300,1211,9240
3/31/2014,2014,3,31, 19 ,7179,1422,1193,9794
3/31/2014,2014,3,31, 20 ,7063,1379,1170,9612
3/31/2014,2014,3,31, 21 ,6928,1312,1178,9418
3/31/2014,2014,3,31, 22 ,6723,1221,1127,9071
3/31/2014,2014,3,31, 23 ,6301,1117,1020,8438
3/31/2014,2014,3,31, 24 ,5882,1046,995,7923
4/1/2014,2014,4,1, 1 ,5526,992,901,7419
4/1/2014,2014,4,1, 2 ,5386,953,844,7183
4/1/2014,2014,4,1, 3 ,5157,925,831,6913
4/1/2014,2014,4,1, 4 ,5085,910,830,6825
4/1/2014,2014,4,1, 5 ,5019,916,857,6792
4/1/2014,2014,4,1, 6 ,5062,922,875,6859
4/1/2014,2014,4,1, 7 ,5268,939,866,7073
4/1/2014,2014,4,1, 8 ,6053,1085,949,8087
4/1/2014,2014,4,1, 9 ,6888,1282,1114,9284
4/1/2014,2014,4,1, 10 ,7360,1384,1157,9901
4/1/2014,2014,4,1, 11 ,7636,1424,1176,10236
4/1/2014,2014,4,1, 12 ,7532,1392,1155,10079
4/1/2014,2014,4,1, 13 ,7653,1406,1165,10224
4/1/2014,2014,4,1, 14 ,7788,1461,1191,10440
4/1/2014,2014,4,1, 15 ,7807,1436,1189,10432
4/1/2014,2014,4,1, 16 ,7692,1419,1166,10277
4/1/2014,2014,4,1, 17 ,7231,1339,1125,9695
4/1/2014,2014,4,1, 18 ,6935,1328,1157,9420
4/1/2014,2014,4,1, 19 ,7388,1457,1139,9984
4/1/2014,2014,4,1, 20 ,7276,1409,1157,9842
4/1/2014,2014,4,1, 21 ,7164,1343,1168,9675
4/1/2014,2014,4,1, 22 ,6878,1235,1096,9209
4/1/2014,2014,4,1, 23 ,6470,1134,1048,8652
4/1/2014,2014,4,1, 24 ,6056,1057,998,8111
4/2/2014,2014,4,2, 1 ,5773,1004,914,7691
4/2/2014,2014,4,2, 2 ,5557,966,867,7390
4/2/2014,2014,4,2, 3 ,5481,940,852,7273
4/2/2014,2014,4,2, 4 ,5349,923,853,7125
4/2/2014,2014,4,2, 5 ,5307,935,873,7115
4/2/2014,2014,4,2, 6 ,5318,942,903,7163
4/2/2014,2014,4,2, 7 ,5448,955,883,7286
4/2/2014,2014,4,2, 8 ,6048,1108,990,8146
4/2/2014,2014,4,2, 9 ,6858,1301,1113,9272
4/2/2014,2014,4,2, 10 ,7455,1363,1136,9954
4/2/2014,2014,4,2, 11 ,7743,1411,1162,10316
4/2/2014,2014,4,2, 12 ,7653,1358,1160,10171
4/2/2014,2014,4,2, 13 ,7651,1374,1186,10211
4/2/2014,2014,4,2, 14 ,7959,1442,1165,10566
4/2/2014,2014,4,2, 15 ,7852,1426,1162,10440
4/2/2014,2014,4,2, 16 ,7729,1375,1138,10242
4/2/2014,2014,4,2, 17 ,7339,1278,1115,9732
4/2/2014,2014,4,2, 18 ,7044,1309,1154,9507
4/2/2014,2014,4,2, 19 ,7429,1418,1138,9985
4/2/2014,2014,4,2, 20 ,7243,1383,1164,9790
4/2/2014,2014,4,2, 21 ,7171,1324,1166,9661
4/2/2014,2014,4,2, 22 ,6914,1224,1130,9268
4/2/2014,2014,4,2, 23 ,6600,1102,1048,8750
4/2/2014,2014,4,2, 24 ,6238,1010,986,8234
4/3/2014,2014,4,3, 1 ,5924,967,951,7842
4/3/2014,2014,4,3, 2 ,5670,956,933,7559
4/3/2014,2014,4,3, 3 ,5530,935,894,7359
4/3/2014,2014,4,3, 4 ,5375,925,875,7175
4/3/2014,2014,4,3, 5 ,5380,932,885,7197
4/3/2014,2014,4,3, 6 ,5332,947,901,7180
4/3/2014,2014,4,3, 7 ,5502,961,904,7367
4/3/2014,2014,4,3, 8 ,6290,1107,992,8389
4/3/2014,2014,4,3, 9 ,6989,1299,1097,9385
4/3/2014,2014,4,3, 10 ,7487,1387,1167,10041
4/3/2014,2014,4,3, 11 ,7761,1445,1184,10390
4/3/2014,2014,4,3, 12 ,7634,1405,1152,10191
4/3/2014,2014,4,3, 13 ,7690,1412,1164,10266
4/3/2014,2014,4,3, 14 ,7942,1467,1205,10614
4/3/2014,2014,4,3, 15 ,7819,1435,1205,10459
4/3/2014,2014,4,3, 16 ,7693,1428,1171,10292
4/3/2014,2014,4,3, 17 ,7245,1319,1134,9698
4/3/2014,2014,4,3, 18 ,6968,1341,1187,9496
4/3/2014,2014,4,3, 19 ,7476,1456,1170,10102
4/3/2014,2014,4,3, 20 ,7275,1401,1181,9857
4/3/2014,2014,4,3, 21 ,7181,1351,1202,9734
4/3/2014,2014,4,3, 22 ,6947,1243,1120,9310
4/3/2014,2014,4,3, 23 ,6647,1146,1059,8852
4/3/2014,2014,4,3, 24 ,6239,1076,999,8314
4/4/2014,2014,4,4, 1 ,5940,1015,949,7904
4/4/2014,2014,4,4, 2 ,5734,991,910,7635
4/4/2014,2014,4,4, 3 ,5622,972,882,7476
4/4/2014,2014,4,4, 4 ,5400,953,869,7222
4/4/2014,2014,4,4, 5 ,5389,964,893,7246
4/4/2014,2014,4,4, 6 ,5361,963,901,7225
4/4/2014,2014,4,4, 7 ,5565,987,896,7448
4/4/2014,2014,4,4, 8 ,6302,1135,1012,8449
4/4/2014,2014,4,4, 9 ,7054,1316,1152,9522
4/4/2014,2014,4,4, 10 ,7516,1409,1180,10105
4/4/2014,2014,4,4, 11 ,7813,1437,1215,10465
4/4/2014,2014,4,4, 12 ,7630,1406,1159,10195
4/4/2014,2014,4,4, 13 ,7673,1425,1197,10295
4/4/2014,2014,4,4, 14 ,7940,1471,1208,10619
4/4/2014,2014,4,4, 15 ,7806,1449,1188,10443
4/4/2014,2014,4,4, 16 ,7697,1441,1169,10307
4/4/2014,2014,4,4, 17 ,7202,1325,1148,9675
4/4/2014,2014,4,4, 18 ,7060,1325,1195,9580
4/4/2014,2014,4,4, 19 ,7382,1450,1162,9994
4/4/2014,2014,4,4, 20 ,7226,1414,1172,9812
4/4/2014,2014,4,4, 21 ,7138,1346,1172,9656
4/4/2014,2014,4,4, 22 ,6902,1249,1115,9266
4/4/2014,2014,4,4, 23 ,6514,1156,1043,8713
4/4/2014,2014,4,4, 24 ,6141,1083,980,8204
4/5/2014,2014,4,5, 1 ,5867,1025,937,7829
4/5/2014,2014,4,5, 2 ,5649,988,897,7534
4/5/2014,2014,4,5, 3 ,5435,956,851,7242
4/5/2014,2014,4,5, 4 ,5317,942,858,7117
4/5/2014,2014,4,5, 5 ,5187,954,873,7014
4/5/2014,2014,4,5, 6 ,5064,938,880,6882
4/5/2014,2014,4,5, 7 ,5091,955,842,6888
4/5/2014,2014,4,5, 8 ,5611,1048,897,7556
4/5/2014,2014,4,5, 9 ,6225,1192,962,8379
4/5/2014,2014,4,5, 10 ,6662,1276,1047,8985
4/5/2014,2014,4,5, 11 ,6970,1323,1089,9382
4/5/2014,2014,4,5, 12 ,6850,1285,1055,9190
4/5/2014,2014,4,5, 13 ,6854,1299,1037,9190
4/5/2014,2014,4,5, 14 ,7068,1339,1082,9489
4/5/2014,2014,4,5, 15 ,6911,1312,1076,9299
4/5/2014,2014,4,5, 16 ,6725,1284,1064,9073
4/5/2014,2014,4,5, 17 ,6430,1220,1046,8696
4/5/2014,2014,4,5, 18 ,6330,1253,1132,8715
4/5/2014,2014,4,5, 19 ,6844,1414,1133,9391
4/5/2014,2014,4,5, 20 ,6813,1376,1131,9320
4/5/2014,2014,4,5, 21 ,6815,1329,1127,9271
4/5/2014,2014,4,5, 22 ,6607,1229,1071,8907
4/5/2014,2014,4,5, 23 ,6320,1146,1026,8492
4/5/2014,2014,4,5, 24 ,5917,1067,980,7964
4/6/2014,2014,4,6, 1 ,5867,1010,898,7775
4/6/2014,2014,4,6, 2 ,5515,976,857,7348
4/6/2014,2014,4,6, 3 ,5277,952,851,7080
4/6/2014,2014,4,6, 4 ,5195,931,834,6960
4/6/2014,2014,4,6, 5 ,5063,933,840,6836
4/6/2014,2014,4,6, 6 ,4855,896,838,6589
4/6/2014,2014,4,6, 7 ,4805,905,827,6537
4/6/2014,2014,4,6, 8 ,5015,964,841,6820
4/6/2014,2014,4,6, 9 ,5458,1039,919,7416
4/6/2014,2014,4,6, 10 ,5889,1106,953,7948
4/6/2014,2014,4,6, 11 ,6138,1149,1008,8295
4/6/2014,2014,4,6, 12 ,6066,1146,1006,8218
4/6/2014,2014,4,6, 13 ,6092,1143,1027,8262
4/6/2014,2014,4,6, 14 ,6129,1132,1022,8283
4/6/2014,2014,4,6, 15 ,6009,1128,1015,8152
4/6/2014,2014,4,6, 16 ,5861,1092,999,7952
4/6/2014,2014,4,6, 17 ,5710,1080,1011,7801
4/6/2014,2014,4,6, 18 ,5859,1184,1080,8123
4/6/2014,2014,4,6, 19 ,6483,1335,1121,8939
4/6/2014,2014,4,6, 20 ,6516,1295,1115,8926
4/6/2014,2014,4,6, 21 ,6333,1232,1108,8673
4/6/2014,2014,4,6, 22 ,6136,1164,1074,8374
4/6/2014,2014,4,6, 23 ,5892,1076,1009,7977
4/6/2014,2014,4,6, 24 ,5541,1001,1039,7581
4/7/2014,2014,4,7, 1 ,5220,956,889,7065
4/7/2014,2014,4,7, 2 ,5049,926,854,6829
4/7/2014,2014,4,7, 3 ,4947,909,845,6701
4/7/2014,2014,4,7, 4 ,4794,895,832,6521
4/7/2014,2014,4,7, 5 ,4824,904,839,6567
4/7/2014,2014,4,7, 6 ,4918,917,876,6711
4/7/2014,2014,4,7, 7 ,5180,942,875,6997
4/7/2014,2014,4,7, 8 ,5992,1078,997,8067
4/7/2014,2014,4,7, 9 ,6775,1260,1102,9137
4/7/2014,2014,4,7, 10 ,7256,1348,1128,9732
4/7/2014,2014,4,7, 11 ,7662,1398,1156,10216
4/7/2014,2014,4,7, 12 ,7439,1380,1130,9949
4/7/2014,2014,4,7, 13 ,7512,1376,1136,10024
4/7/2014,2014,4,7, 14 ,7786,1413,1160,10359
4/7/2014,2014,4,7, 15 ,7707,1382,1149,10238
4/7/2014,2014,4,7, 16 ,7591,1375,1125,10091
4/7/2014,2014,4,7, 17 ,7240,1304,1109,9653
4/7/2014,2014,4,7, 18 ,6916,1319,1140,9375
4/7/2014,2014,4,7, 19 ,7309,1432,1167,9908
4/7/2014,2014,4,7, 20 ,7178,1384,1139,9701
4/7/2014,2014,4,7, 21 ,6990,1322,1138,9450
4/7/2014,2014,4,7, 22 ,6796,1220,1113,9129
4/7/2014,2014,4,7, 23 ,6406,1117,1040,8563
4/7/2014,2014,4,7, 24 ,6044,1043,973,8060
4/8/2014,2014,4,8, 1 ,5750,1009,942,7701
4/8/2014,2014,4,8, 2 ,5567,977,911,7455
4/8/2014,2014,4,8, 3 ,5427,943,888,7258
4/8/2014,2014,4,8, 4 ,5265,926,873,7064
4/8/2014,2014,4,8, 5 ,5302,933,879,7114
4/8/2014,2014,4,8, 6 ,5252,936,923,7111
4/8/2014,2014,4,8, 7 ,5468,939,917,7324
4/8/2014,2014,4,8, 8 ,6236,1107,1012,8355
4/8/2014,2014,4,8, 9 ,6925,1291,1113,9329
4/8/2014,2014,4,8, 10 ,7430,1372,1147,9949
4/8/2014,2014,4,8, 11 ,7710,1431,1165,10306
4/8/2014,2014,4,8, 12 ,7566,1399,1135,10100
4/8/2014,2014,4,8, 13 ,7563,1407,1115,10085
4/8/2014,2014,4,8, 14 ,7775,1446,1142,10363
4/8/2014,2014,4,8, 15 ,7674,1413,1145,10232
4/8/2014,2014,4,8, 16 ,7492,1388,1160,10040
4/8/2014,2014,4,8, 17 ,7109,1315,1111,9535
4/8/2014,2014,4,8, 18 ,6838,1335,1132,9305
4/8/2014,2014,4,8, 19 ,7265,1443,1118,9826
4/8/2014,2014,4,8, 20 ,7039,1403,1116,9558
4/8/2014,2014,4,8, 21 ,6891,1328,1110,9329
4/8/2014,2014,4,8, 22 ,6657,1233,1075,8965
4/8/2014,2014,4,8, 23 ,6336,1130,1010,8476
4/8/2014,2014,4,8, 24 ,5957,1062,947,7966
4/9/2014,2014,4,9, 1 ,5686,1006,870,7562
4/9/2014,2014,4,9, 2 ,5524,966,874,7364
4/9/2014,2014,4,9, 3 ,5379,953,861,7193
4/9/2014,2014,4,9, 4 ,5269,928,842,7039
4/9/2014,2014,4,9, 5 ,5204,937,867,7008
4/9/2014,2014,4,9, 6 ,5052,934,869,6855
4/9/2014,2014,4,9, 7 ,5022,936,854,6812
4/9/2014,2014,4,9, 8 ,5463,1020,911,7394
4/9/2014,2014,4,9, 9 ,5926,1141,980,8047
4/9/2014,2014,4,9, 10 ,6454,1223,1090,8767
4/9/2014,2014,4,9, 11 ,6685,1262,1119,9066
4/9/2014,2014,4,9, 12 ,6583,1249,1090,8922
4/9/2014,2014,4,9, 13 ,6637,1232,1106,8975
4/9/2014,2014,4,9, 14 ,6755,1271,1131,9157
4/9/2014,2014,4,9, 15 ,6670,1244,1120,9034
4/9/2014,2014,4,9, 16 ,6516,1212,1073,8801
4/9/2014,2014,4,9, 17 ,6343,1180,1092,8615
4/9/2014,2014,4,9, 18 ,6387,1266,1136,8789
4/9/2014,2014,4,9, 19 ,6914,1375,1163,9452
4/9/2014,2014,4,9, 20 ,6879,1332,1143,9354
4/9/2014,2014,4,9, 21 ,6738,1291,1116,9145
4/9/2014,2014,4,9, 22 ,6482,1191,1059,8732
4/9/2014,2014,4,9, 23 ,6174,1095,995,8264
4/9/2014,2014,4,9, 24 ,5815,1030,941,7786
4/10/2014,2014,4,10, 1 ,5561,981,888,7430
4/10/2014,2014,4,10, 2 ,5375,951,874,7200
4/10/2014,2014,4,10, 3 ,5213,927,860,7000
4/10/2014,2014,4,10, 4 ,5102,918,852,6872
4/10/2014,2014,4,10, 5 ,5134,928,873,6935
4/10/2014,2014,4,10, 6 ,5138,943,893,6974
4/10/2014,2014,4,10, 7 ,5415,955,901,7271
4/10/2014,2014,4,10, 8 ,6201,1106,1010,8317
4/10/2014,2014,4,10, 9 ,6921,1294,1115,9330
4/10/2014,2014,4,10, 10 ,7500,1381,1143,10024
4/10/2014,2014,4,10, 11 ,7732,1416,1193,10341
4/10/2014,2014,4,10, 12 ,7626,1384,1171,10181
4/10/2014,2014,4,10, 13 ,7581,1405,1172,10158
4/10/2014,2014,4,10, 14 ,7907,1448,1169,10524
4/10/2014,2014,4,10, 15 ,7763,1434,1152,10349
4/10/2014,2014,4,10, 16 ,7667,1406,1125,10198
4/10/2014,2014,4,10, 17 ,7260,1331,1125,9716
4/10/2014,2014,4,10, 18 ,6968,1323,1158,9449
4/10/2014,2014,4,10, 19 ,7299,1442,1136,9877
4/10/2014,2014,4,10, 20 ,7092,1402,1142,9636
4/10/2014,2014,4,10, 21 ,7011,1355,1160,9526
4/10/2014,2014,4,10, 22 ,6781,1245,1118,9144
4/10/2014,2014,4,10, 23 ,6431,1138,1050,8619
4/10/2014,2014,4,10, 24 ,6013,1080,956,8049
4/11/2014,2014,4,11, 1 ,5754,1040,953,7747
4/11/2014,2014,4,11, 2 ,5600,1004,926,7530
4/11/2014,2014,4,11, 3 ,5414,984,904,7302
4/11/2014,2014,4,11, 4 ,5300,969,910,7179
4/11/2014,2014,4,11, 5 ,5288,973,908,7169
4/11/2014,2014,4,11, 6 ,5278,970,906,7154
4/11/2014,2014,4,11, 7 ,5435,990,898,7323
4/11/2014,2014,4,11, 8 ,6150,1135,995,8280
4/11/2014,2014,4,11, 9 ,6859,1312,1103,9274
4/11/2014,2014,4,11, 10 ,7368,1399,1158,9925
4/11/2014,2014,4,11, 11 ,7612,1445,1173,10230
4/11/2014,2014,4,11, 12 ,7436,1398,1147,9981
4/11/2014,2014,4,11, 13 ,7368,1408,1170,9946
4/11/2014,2014,4,11, 14 ,7569,1454,1182,10205
4/11/2014,2014,4,11, 15 ,7499,1413,1140,10052
4/11/2014,2014,4,11, 16 ,7217,1398,1135,9750
4/11/2014,2014,4,11, 17 ,6964,1299,1131,9394
4/11/2014,2014,4,11, 18 ,6712,1293,1152,9157
4/11/2014,2014,4,11, 19 ,7110,1414,1148,9672
4/11/2014,2014,4,11, 20 ,6994,1375,1147,9516
4/11/2014,2014,4,11, 21 ,6862,1322,1151,9335
4/11/2014,2014,4,11, 22 ,6607,1229,1117,8953
4/11/2014,2014,4,11, 23 ,6267,1130,1036,8433
4/11/2014,2014,4,11, 24 ,5918,1039,1002,7959
4/12/2014,2014,4,12, 1 ,5620,995,922,7537
4/12/2014,2014,4,12, 2 ,5527,961,906,7394
4/12/2014,2014,4,12, 3 ,5329,936,881,7146
4/12/2014,2014,4,12, 4 ,5217,917,862,6996
4/12/2014,2014,4,12, 5 ,5156,921,882,6959
4/12/2014,2014,4,12, 6 ,5048,913,894,6855
4/12/2014,2014,4,12, 7 ,5117,917,894,6928
4/12/2014,2014,4,12, 8 ,5659,1009,970,7638
4/12/2014,2014,4,12, 9 ,6211,1146,1058,8415
4/12/2014,2014,4,12, 10 ,6570,1243,1148,8961
4/12/2014,2014,4,12, 11 ,6794,1280,1116,9190
4/12/2014,2014,4,12, 12 ,6765,1236,1092,9093
4/12/2014,2014,4,12, 13 ,6820,1230,1107,9157
4/12/2014,2014,4,12, 14 ,6949,1285,1104,9338
4/12/2014,2014,4,12, 15 ,6842,1261,1084,9187
4/12/2014,2014,4,12, 16 ,6672,1205,1086,8963
4/12/2014,2014,4,12, 17 ,6421,1170,1048,8639
4/12/2014,2014,4,12, 18 ,6300,1261,1120,8681
4/12/2014,2014,4,12, 19 ,6879,1375,1122,9376
4/12/2014,2014,4,12, 20 ,6834,1353,1143,9330
4/12/2014,2014,4,12, 21 ,6718,1295,1127,9140
4/12/2014,2014,4,12, 22 ,6488,1198,1098,8784
4/12/2014,2014,4,12, 23 ,6162,1107,1020,8289
4/12/2014,2014,4,12, 24 ,5885,1033,947,7865
4/13/2014,2014,4,13, 1 ,5602,996,889,7487
4/13/2014,2014,4,13, 2 ,5358,972,874,7204
4/13/2014,2014,4,13, 3 ,5262,935,848,7045
4/13/2014,2014,4,13, 4 ,5128,913,840,6881
4/13/2014,2014,4,13, 5 ,5074,913,847,6834
4/13/2014,2014,4,13, 6 ,4832,899,842,6573
4/13/2014,2014,4,13, 7 ,4830,911,847,6588
4/13/2014,2014,4,13, 8 ,5188,950,894,7032
4/13/2014,2014,4,13, 9 ,5545,1029,972,7546
4/13/2014,2014,4,13, 10 ,6050,1100,1043,8193
4/13/2014,2014,4,13, 11 ,6344,1146,1101,8591
4/13/2014,2014,4,13, 12 ,6260,1142,1110,8512
4/13/2014,2014,4,13, 13 ,6287,1127,1098,8512
4/13/2014,2014,4,13, 14 ,6330,1126,1108,8564
4/13/2014,2014,4,13, 15 ,6201,1074,1055,8330
4/13/2014,2014,4,13, 16 ,6026,1050,1029,8105
4/13/2014,2014,4,13, 17 ,5816,1066,1030,7912
4/13/2014,2014,4,13, 18 ,5956,1194,1135,8285
4/13/2014,2014,4,13, 19 ,6576,1289,1148,9013
4/13/2014,2014,4,13, 20 ,6529,1244,1140,8913
4/13/2014,2014,4,13, 21 ,6502,1184,1131,8817
4/13/2014,2014,4,13, 22 ,6294,1101,1051,8446
4/13/2014,2014,4,13, 23 ,6048,1028,976,8052
4/13/2014,2014,4,13, 24 ,5818,980,931,7729
4/14/2014,2014,4,14, 1 ,5447,932,844,7223
4/14/2014,2014,4,14, 2 ,5262,900,820,6982
4/14/2014,2014,4,14, 3 ,5118,877,827,6822
4/14/2014,2014,4,14, 4 ,5035,869,824,6728
4/14/2014,2014,4,14, 5 ,4997,884,852,6733
4/14/2014,2014,4,14, 6 ,5062,898,869,6829
4/14/2014,2014,4,14, 7 ,5374,932,882,7188
4/14/2014,2014,4,14, 8 ,6136,1068,1025,8229
4/14/2014,2014,4,14, 9 ,6903,1242,1095,9240
4/14/2014,2014,4,14, 10 ,7415,1326,1131,9872
4/14/2014,2014,4,14, 11 ,7708,1354,1169,10231
4/14/2014,2014,4,14, 12 ,7584,1293,1158,10035
4/14/2014,2014,4,14, 13 ,7516,1258,1158,9932
4/14/2014,2014,4,14, 14 ,7846,1294,1162,10302
4/14/2014,2014,4,14, 15 ,7718,1293,1154,10165
4/14/2014,2014,4,14, 16 ,7610,1293,1151,10054
4/14/2014,2014,4,14, 17 ,7248,1279,1163,9690
4/14/2014,2014,4,14, 18 ,6961,1336,1165,9462
4/14/2014,2014,4,14, 19 ,7300,1378,1136,9814
4/14/2014,2014,4,14, 20 ,7113,1320,1118,9551
4/14/2014,2014,4,14, 21 ,6912,1244,1108,9264
4/14/2014,2014,4,14, 22 ,6677,1134,1051,8862
4/14/2014,2014,4,14, 23 ,6251,1035,966,8252
4/14/2014,2014,4,14, 24 ,5963,974,914,7851
4/15/2014,2014,4,15, 1 ,5710,930,864,7504
4/15/2014,2014,4,15, 2 ,5441,903,836,7180
4/15/2014,2014,4,15, 3 ,5311,878,822,7011
4/15/2014,2014,4,15, 4 ,5203,871,814,6888
4/15/2014,2014,4,15, 5 ,5246,885,842,6973
4/15/2014,2014,4,15, 6 ,5163,908,876,6947
4/15/2014,2014,4,15, 7 ,5326,936,866,7128
4/15/2014,2014,4,15, 8 ,6126,1057,968,8151
4/15/2014,2014,4,15, 9 ,6750,1215,1053,9018
4/15/2014,2014,4,15, 10 ,7289,1299,1118,9706
4/15/2014,2014,4,15, 11 ,7552,1326,1142,10020
4/15/2014,2014,4,15, 12 ,7350,1290,1173,9813
4/15/2014,2014,4,15, 13 ,7289,1266,1173,9728
4/15/2014,2014,4,15, 14 ,7498,1320,1183,10001
4/15/2014,2014,4,15, 15 ,7306,1313,1174,9793
4/15/2014,2014,4,15, 16 ,7158,1311,1173,9642
4/15/2014,2014,4,15, 17 ,6776,1295,1153,9224
4/15/2014,2014,4,15, 18 ,6548,1329,1190,9067
4/15/2014,2014,4,15, 19 ,6853,1310,1193,9356
4/15/2014,2014,4,15, 20 ,6739,1245,1185,9169
4/15/2014,2014,4,15, 21 ,6598,1165,1184,8947
4/15/2014,2014,4,15, 22 ,6330,1056,1107,8493
4/15/2014,2014,4,15, 23 ,6085,965,1011,8061
4/15/2014,2014,4,15, 24 ,5651,913,913,7477
4/16/2014,2014,4,16, 1 ,5466,873,908,7247
4/16/2014,2014,4,16, 2 ,5321,852,881,7054
4/16/2014,2014,4,16, 3 ,5170,832,861,6863
4/16/2014,2014,4,16, 4 ,5020,818,853,6691
4/16/2014,2014,4,16, 5 ,5058,841,872,6771
4/16/2014,2014,4,16, 6 ,5024,879,883,6786
4/16/2014,2014,4,16, 7 ,5136,898,891,6925
4/16/2014,2014,4,16, 8 ,5813,985,1016,7814
4/16/2014,2014,4,16, 9 ,6438,1134,1112,8684
4/16/2014,2014,4,16, 10 ,6854,1214,1134,9202
4/16/2014,2014,4,16, 11 ,7096,1255,1123,9474
4/16/2014,2014,4,16, 12 ,6967,1229,1106,9302
4/16/2014,2014,4,16, 13 ,6875,1213,1164,9252
4/16/2014,2014,4,16, 14 ,6983,1265,1180,9428
4/16/2014,2014,4,16, 15 ,6824,1241,1151,9216
4/16/2014,2014,4,16, 16 ,6639,1207,1163,9009
4/16/2014,2014,4,16, 17 ,6330,1174,1143,8647
4/16/2014,2014,4,16, 18 ,6197,1250,1205,8652
4/16/2014,2014,4,16, 19 ,6591,1322,1243,9156
4/16/2014,2014,4,16, 20 ,6442,1268,1212,8922
4/16/2014,2014,4,16, 21 ,6300,1192,1182,8674
4/16/2014,2014,4,16, 22 ,6098,1098,1101,8297
4/16/2014,2014,4,16, 23 ,5808,983,1002,7793
4/16/2014,2014,4,16, 24 ,5443,927,890,7260
4/17/2014,2014,4,17, 1 ,5177,878,847,6902
4/17/2014,2014,4,17, 2 ,4942,846,835,6623
4/17/2014,2014,4,17, 3 ,4802,826,819,6447
4/17/2014,2014,4,17, 4 ,4714,810,824,6348
4/17/2014,2014,4,17, 5 ,4598,812,834,6244
4/17/2014,2014,4,17, 6 ,4268,785,813,5866
4/17/2014,2014,4,17, 7 ,4084,778,808,5670
4/17/2014,2014,4,17, 8 ,4217,819,839,5875
4/17/2014,2014,4,17, 9 ,4534,896,934,6364
4/17/2014,2014,4,17, 10 ,4726,942,992,6660
4/17/2014,2014,4,17, 11 ,4922,980,1030,6932
4/17/2014,2014,4,17, 12 ,4885,986,1031,6902
4/17/2014,2014,4,17, 13 ,4890,984,1037,6911
4/17/2014,2014,4,17, 14 ,4977,989,1049,7015
4/17/2014,2014,4,17, 15 ,4898,969,1022,6889
4/17/2014,2014,4,17, 16 ,4800,936,988,6724
4/17/2014,2014,4,17, 17 ,4640,915,964,6519
4/17/2014,2014,4,17, 18 ,4749,1019,1082,6850
4/17/2014,2014,4,17, 19 ,5426,1194,1151,7771
4/17/2014,2014,4,17, 20 ,5420,1162,1122,7704
4/17/2014,2014,4,17, 21 ,5385,1118,1061,7564
4/17/2014,2014,4,17, 22 ,5336,1071,1011,7418
4/17/2014,2014,4,17, 23 ,5209,1010,940,7159
4/17/2014,2014,4,17, 24 ,4880,925,873,6678
4/18/2014,2014,4,18, 1 ,4683,883,826,6392
4/18/2014,2014,4,18, 2 ,4550,857,788,6195
4/18/2014,2014,4,18, 3 ,4355,834,768,5957
4/18/2014,2014,4,18, 4 ,4255,808,760,5823
4/18/2014,2014,4,18, 5 ,4186,802,757,5745
4/18/2014,2014,4,18, 6 ,3905,778,726,5409
4/18/2014,2014,4,18, 7 ,3793,779,713,5285
4/18/2014,2014,4,18, 8 ,3924,818,726,5468
4/18/2014,2014,4,18, 9 ,4047,844,758,5649
4/18/2014,2014,4,18, 10 ,4173,865,790,5828
4/18/2014,2014,4,18, 11 ,4337,892,833,6062
4/18/2014,2014,4,18, 12 ,4292,884,828,6004
4/18/2014,2014,4,18, 13 ,4358,897,846,6101
4/18/2014,2014,4,18, 14 ,4441,906,833,6180
4/18/2014,2014,4,18, 15 ,4443,890,812,6145
4/18/2014,2014,4,18, 16 ,4316,867,784,5967
4/18/2014,2014,4,18, 17 ,4189,850,783,5822
4/18/2014,2014,4,18, 18 ,4326,929,958,6213
4/18/2014,2014,4,18, 19 ,5085,1096,1030,7211
4/18/2014,2014,4,18, 20 ,5262,1116,1019,7397
4/18/2014,2014,4,18, 21 ,5367,1106,992,7465
4/18/2014,2014,4,18, 22 ,5374,1073,905,7352
4/18/2014,2014,4,18, 23 ,5229,1023,878,7130
4/18/2014,2014,4,18, 24 ,4896,944,808,6648
4/19/2014,2014,4,19, 1 ,4714,903,776,6393
4/19/2014,2014,4,19, 2 ,4550,884,763,6197
4/19/2014,2014,4,19, 3 ,4370,862,749,5981
4/19/2014,2014,4,19, 4 ,4282,845,742,5869
4/19/2014,2014,4,19, 5 ,4202,850,753,5805
4/19/2014,2014,4,19, 6 ,4061,835,733,5629
4/19/2014,2014,4,19, 7 ,4213,859,753,5825
4/19/2014,2014,4,19, 8 ,4543,919,834,6296
4/19/2014,2014,4,19, 9 ,4866,1015,912,6793
4/19/2014,2014,4,19, 10 ,5299,1083,997,7379
4/19/2014,2014,4,19, 11 ,5607,1144,1075,7826
4/19/2014,2014,4,19, 12 ,5597,1150,1083,7830
4/19/2014,2014,4,19, 13 ,5640,1157,1121,7918
4/19/2014,2014,4,19, 14 ,5802,1172,1150,8124
4/19/2014,2014,4,19, 15 ,5736,1154,1121,8011
4/19/2014,2014,4,19, 16 ,5569,1114,1096,7779
4/19/2014,2014,4,19, 17 ,5446,1099,1088,7633
4/19/2014,2014,4,19, 18 ,5559,1178,1040,7777
4/19/2014,2014,4,19, 19 ,6249,1313,1225,8787
4/19/2014,2014,4,19, 20 ,6248,1289,1181,8718
4/19/2014,2014,4,19, 21 ,6189,1235,1164,8588
4/19/2014,2014,4,19, 22 ,6027,1177,1094,8298
4/19/2014,2014,4,19, 23 ,5777,1111,1018,7906
4/19/2014,2014,4,19, 24 ,5514,1030,934,7478
4/20/2014,2014,4,20, 1 ,5291,986,886,7163
4/20/2014,2014,4,20, 2 ,5095,944,856,6895
4/20/2014,2014,4,20, 3 ,4956,913,834,6703
4/20/2014,2014,4,20, 4 ,4732,901,829,6462
4/20/2014,2014,4,20, 5 ,4718,899,813,6430
4/20/2014,2014,4,20, 6 ,4466,867,813,6146
4/20/2014,2014,4,20, 7 ,4487,876,775,6138
4/20/2014,2014,4,20, 8 ,4761,934,862,6557
4/20/2014,2014,4,20, 9 ,5207,1005,938,7150
4/20/2014,2014,4,20, 10 ,5572,1062,1011,7645
4/20/2014,2014,4,20, 11 ,5798,1097,1034,7929
4/20/2014,2014,4,20, 12 ,5819,1092,1052,7963
4/20/2014,2014,4,20, 13 ,5782,1087,1037,7906
4/20/2014,2014,4,20, 14 ,5887,1081,1049,8017
4/20/2014,2014,4,20, 15 ,5868,1070,1028,7966
4/20/2014,2014,4,20, 16 ,5738,1057,1019,7814
4/20/2014,2014,4,20, 17 ,5553,1043,1033,7629
4/20/2014,2014,4,20, 18 ,5674,1157,1113,7944
4/20/2014,2014,4,20, 19 ,6377,1298,1212,8887
4/20/2014,2014,4,20, 20 ,6418,1269,1193,8880
4/20/2014,2014,4,20, 21 ,6368,1201,1141,8710
4/20/2014,2014,4,20, 22 ,6114,1114,1053,8281
4/20/2014,2014,4,20, 23 ,5992,1036,967,7995
4/20/2014,2014,4,20, 24 ,5593,970,908,7471
4/21/2014,2014,4,21, 1 ,5379,922,861,7162
4/21/2014,2014,4,21, 2 ,5135,900,839,6874
4/21/2014,2014,4,21, 3 ,5000,881,809,6690
4/21/2014,2014,4,21, 4 ,4843,869,801,6513
4/21/2014,2014,4,21, 5 ,4846,889,814,6549
4/21/2014,2014,4,21, 6 ,4880,896,828,6604
4/21/2014,2014,4,21, 7 ,5211,938,844,6993
4/21/2014,2014,4,21, 8 ,6027,1089,959,8075
4/21/2014,2014,4,21, 9 ,6905,1290,1150,9345
4/21/2014,2014,4,21, 10 ,7393,1389,1228,10010
4/21/2014,2014,4,21, 11 ,7597,1442,1213,10252
4/21/2014,2014,4,21, 12 ,7667,1419,1184,10270
4/21/2014,2014,4,21, 13 ,7668,1425,1212,10305
4/21/2014,2014,4,21, 14 ,7973,1448,1241,10662
4/21/2014,2014,4,21, 15 ,7874,1463,1251,10588
4/21/2014,2014,4,21, 16 ,7799,1438,1238,10475
4/21/2014,2014,4,21, 17 ,7358,1385,1203,9946
4/21/2014,2014,4,21, 18 ,7015,1344,1229,9588
4/21/2014,2014,4,21, 19 ,7412,1490,1175,10077
4/21/2014,2014,4,21, 20 ,7316,1434,1185,9935
4/21/2014,2014,4,21, 21 ,7113,1368,1196,9677
4/21/2014,2014,4,21, 22 ,6919,1287,1147,9353
4/21/2014,2014,4,21, 23 ,6514,1167,1061,8742
4/21/2014,2014,4,21, 24 ,6123,1099,988,8210
4/22/2014,2014,4,22, 1 ,5827,1045,952,7824
4/22/2014,2014,4,22, 2 ,5676,1012,915,7603
4/22/2014,2014,4,22, 3 ,5408,970,894,7272
4/22/2014,2014,4,22, 4 ,5314,953,885,7152
4/22/2014,2014,4,22, 5 ,5269,962,907,7138
4/22/2014,2014,4,22, 6 ,5194,962,908,7064
4/22/2014,2014,4,22, 7 ,5501,981,857,7339
4/22/2014,2014,4,22, 8 ,6297,1131,1046,8474
4/22/2014,2014,4,22, 9 ,6979,1291,1110,9380
4/22/2014,2014,4,22, 10 ,7563,1376,1229,10168
4/22/2014,2014,4,22, 11 ,7803,1420,1230,10453
4/22/2014,2014,4,22, 12 ,7678,1413,1215,10306
4/22/2014,2014,4,22, 13 ,7737,1402,1242,10381
4/22/2014,2014,4,22, 14 ,8045,1458,1261,10764
4/22/2014,2014,4,22, 15 ,7968,1464,1261,10693
4/22/2014,2014,4,22, 16 ,7835,1433,1257,10525
4/22/2014,2014,4,22, 17 ,7471,1351,1189,10011
4/22/2014,2014,4,22, 18 ,7110,1350,1236,9696
4/22/2014,2014,4,22, 19 ,7460,1480,1220,10160
4/22/2014,2014,4,22, 20 ,7418,1425,1201,10044
4/22/2014,2014,4,22, 21 ,7278,1361,1190,9829
4/22/2014,2014,4,22, 22 ,7040,1252,1131,9423
4/22/2014,2014,4,22, 23 ,6655,1151,1067,8873
4/22/2014,2014,4,22, 24 ,6305,1080,989,8374
4/23/2014,2014,4,23, 1 ,5981,1030,954,7965
4/23/2014,2014,4,23, 2 ,5795,983,921,7699
4/23/2014,2014,4,23, 3 ,5588,955,885,7428
4/23/2014,2014,4,23, 4 ,5528,948,877,7353
4/23/2014,2014,4,23, 5 ,5521,967,900,7388
4/23/2014,2014,4,23, 6 ,5405,959,912,7276
4/23/2014,2014,4,23, 7 ,5628,963,894,7485
4/23/2014,2014,4,23, 8 ,6353,1094,1039,8486
4/23/2014,2014,4,23, 9 ,7173,1265,1218,9656
4/23/2014,2014,4,23, 10 ,7643,1365,1240,10248
4/23/2014,2014,4,23, 11 ,7916,1386,1219,10521
4/23/2014,2014,4,23, 12 ,7774,1357,1195,10326
4/23/2014,2014,4,23, 13 ,7781,1352,1185,10318
4/23/2014,2014,4,23, 14 ,8084,1406,1202,10692
4/23/2014,2014,4,23, 15 ,7992,1397,1236,10625
4/23/2014,2014,4,23, 16 ,7870,1383,1215,10468
4/23/2014,2014,4,23, 17 ,7533,1317,1201,10051
4/23/2014,2014,4,23, 18 ,7269,1355,1211,9835
4/23/2014,2014,4,23, 19 ,7570,1454,1200,10224
4/23/2014,2014,4,23, 20 ,7455,1398,1202,10055
4/23/2014,2014,4,23, 21 ,7263,1337,1207,9807
4/23/2014,2014,4,23, 22 ,7014,1257,1149,9420
4/23/2014,2014,4,23, 23 ,6734,1151,1045,8930
4/23/2014,2014,4,23, 24 ,6363,1073,978,8414
4/24/2014,2014,4,24, 1 ,6036,1028,943,8007
4/24/2014,2014,4,24, 2 ,5847,988,920,7755
4/24/2014,2014,4,24, 3 ,5660,969,895,7524
4/24/2014,2014,4,24, 4 ,5594,948,879,7421
4/24/2014,2014,4,24, 5 ,5526,960,897,7383
4/24/2014,2014,4,24, 6 ,5414,962,900,7276
4/24/2014,2014,4,24, 7 ,5715,983,904,7602
4/24/2014,2014,4,24, 8 ,6559,1145,1032,8736
4/24/2014,2014,4,24, 9 ,7268,1302,1134,9704
4/24/2014,2014,4,24, 10 ,7728,1381,1208,10317
4/24/2014,2014,4,24, 11 ,8027,1447,1219,10693
4/24/2014,2014,4,24, 12 ,7918,1420,1164,10502
4/24/2014,2014,4,24, 13 ,7869,1429,1200,10498
4/24/2014,2014,4,24, 14 ,8162,1477,1247,10886
4/24/2014,2014,4,24, 15 ,8057,1472,1231,10760
4/24/2014,2014,4,24, 16 ,7956,1449,1225,10630
4/24/2014,2014,4,24, 17 ,7552,1363,1214,10129
4/24/2014,2014,4,24, 18 ,7309,1376,1235,9920
4/24/2014,2014,4,24, 19 ,7587,1479,1221,10287
4/24/2014,2014,4,24, 20 ,7503,1439,1248,10190
4/24/2014,2014,4,24, 21 ,7424,1381,1261,10066
4/24/2014,2014,4,24, 22 ,7204,1305,1193,9702
4/24/2014,2014,4,24, 23 ,6920,1205,1091,9216
4/24/2014,2014,4,24, 24 ,6548,1123,1004,8675
4/25/2014,2014,4,25, 1 ,6248,1058,965,8271
4/25/2014,2014,4,25, 2 ,6044,1032,943,8019
4/25/2014,2014,4,25, 3 ,5870,1000,912,7782
4/25/2014,2014,4,25, 4 ,5744,981,901,7626
4/25/2014,2014,4,25, 5 ,5666,991,925,7582
4/25/2014,2014,4,25, 6 ,5575,982,917,7474
4/25/2014,2014,4,25, 7 ,5806,1006,923,7735
4/25/2014,2014,4,25, 8 ,6622,1160,1072,8854
4/25/2014,2014,4,25, 9 ,7371,1352,1152,9875
4/25/2014,2014,4,25, 10 ,7831,1427,1227,10485
4/25/2014,2014,4,25, 11 ,8082,1444,1225,10751
4/25/2014,2014,4,25, 12 ,8027,1442,1230,10699
4/25/2014,2014,4,25, 13 ,8003,1448,1254,10705
4/25/2014,2014,4,25, 14 ,8195,1492,1253,10940
4/25/2014,2014,4,25, 15 ,7879,1468,1264,10611
4/25/2014,2014,4,25, 16 ,7718,1449,1245,10412
4/25/2014,2014,4,25, 17 ,7396,1370,1206,9972
4/25/2014,2014,4,25, 18 ,7325,1393,1223,9941
4/25/2014,2014,4,25, 19 ,7526,1497,1228,10251
4/25/2014,2014,4,25, 20 ,7420,1453,1230,10103
4/25/2014,2014,4,25, 21 ,7264,1402,1228,9894
4/25/2014,2014,4,25, 22 ,7096,1336,1220,9652
4/25/2014,2014,4,25, 23 ,6692,1217,1116,9025
4/25/2014,2014,4,25, 24 ,6302,1143,1034,8479
4/26/2014,2014,4,26, 1 ,6028,1075,962,8065
4/26/2014,2014,4,26, 2 ,5863,1035,949,7847
4/26/2014,2014,4,26, 3 ,5668,1013,888,7569
4/26/2014,2014,4,26, 4 ,5489,1000,916,7405
4/26/2014,2014,4,26, 5 ,5427,1000,915,7342
4/26/2014,2014,4,26, 6 ,5262,973,915,7150
4/26/2014,2014,4,26, 7 ,5391,993,900,7284
4/26/2014,2014,4,26, 8 ,5930,1095,985,8010
4/26/2014,2014,4,26, 9 ,6559,1201,1094,8854
4/26/2014,2014,4,26, 10 ,7007,1288,1152,9447
4/26/2014,2014,4,26, 11 ,7316,1344,1170,9830
4/26/2014,2014,4,26, 12 ,7223,1323,1148,9694
4/26/2014,2014,4,26, 13 ,7225,1323,1169,9717
4/26/2014,2014,4,26, 14 ,7490,1377,1204,10071
4/26/2014,2014,4,26, 15 ,7315,1334,1150,9799
4/26/2014,2014,4,26, 16 ,7059,1298,1138,9495
4/26/2014,2014,4,26, 17 ,6737,1230,1114,9081
4/26/2014,2014,4,26, 18 ,6639,1273,1181,9093
4/26/2014,2014,4,26, 19 ,7254,1426,1216,9896
4/26/2014,2014,4,26, 20 ,7218,1379,1204,9801
4/26/2014,2014,4,26, 21 ,7219,1327,1212,9758
4/26/2014,2014,4,26, 22 ,6916,1249,1158,9323
4/26/2014,2014,4,26, 23 ,6677,1153,1081,8911
4/26/2014,2014,4,26, 24 ,6260,1078,1012,8350
4/27/2014,2014,4,27, 1 ,6009,1033,970,8012
4/27/2014,2014,4,27, 2 ,5810,996,931,7737
4/27/2014,2014,4,27, 3 ,5624,973,875,7472
4/27/2014,2014,4,27, 4 ,5485,949,851,7285
4/27/2014,2014,4,27, 5 ,5410,938,880,7228
4/27/2014,2014,4,27, 6 ,5122,910,859,6891
4/27/2014,2014,4,27, 7 ,5063,939,845,6847
4/27/2014,2014,4,27, 8 ,5327,994,869,7190
4/27/2014,2014,4,27, 9 ,5753,1056,970,7779
4/27/2014,2014,4,27, 10 ,6217,1141,1024,8382
4/27/2014,2014,4,27, 11 ,6465,1189,1097,8751
4/27/2014,2014,4,27, 12 ,6451,1180,1087,8718
4/27/2014,2014,4,27, 13 ,6481,1190,1091,8762
4/27/2014,2014,4,27, 14 ,6580,1191,1105,8876
4/27/2014,2014,4,27, 15 ,6463,1175,1049,8687
4/27/2014,2014,4,27, 16 ,6318,1154,1072,8544
4/27/2014,2014,4,27, 17 ,6074,1108,1061,8243
4/27/2014,2014,4,27, 18 ,6183,1203,1128,8514
4/27/2014,2014,4,27, 19 ,6885,1375,1182,9442
4/27/2014,2014,4,27, 20 ,6976,1363,1181,9520
4/27/2014,2014,4,27, 21 ,6907,1321,1158,9386
4/27/2014,2014,4,27, 22 ,6702,1242,1138,9082
4/27/2014,2014,4,27, 23 ,6565,1181,1074,8820
4/27/2014,2014,4,27, 24 ,6254,1098,1001,8353
4/28/2014,2014,4,28, 1 ,5963,1039,986,7988
4/28/2014,2014,4,28, 2 ,5722,999,900,7621
4/28/2014,2014,4,28, 3 ,5584,979,877,7440
4/28/2014,2014,4,28, 4 ,5455,957,861,7273
4/28/2014,2014,4,28, 5 ,5446,955,885,7286
4/28/2014,2014,4,28, 6 ,5439,955,880,7274
4/28/2014,2014,4,28, 7 ,5741,997,881,7619
4/28/2014,2014,4,28, 8 ,6570,1164,1018,8752
4/28/2014,2014,4,28, 9 ,7313,1351,1113,9777
4/28/2014,2014,4,28, 10 ,7799,1478,1174,10451
4/28/2014,2014,4,28, 11 ,8069,1521,1152,10742
4/28/2014,2014,4,28, 12 ,8029,1489,1157,10675
4/28/2014,2014,4,28, 13 ,8068,1484,1158,10710
4/28/2014,2014,4,28, 14 ,8333,1529,1148,11010
4/28/2014,2014,4,28, 15 ,8250,1496,1136,10882
4/28/2014,2014,4,28, 16 ,7976,1443,1158,10577
4/28/2014,2014,4,28, 17 ,7415,1375,1152,9942
4/28/2014,2014,4,28, 18 ,7071,1389,1173,9633
4/28/2014,2014,4,28, 19 ,7521,1507,1168,10196
4/28/2014,2014,4,28, 20 ,7334,1464,1180,9978
4/28/2014,2014,4,28, 21 ,7248,1400,1193,9841
4/28/2014,2014,4,28, 22 ,7064,1305,1119,9488
4/28/2014,2014,4,28, 23 ,6773,1202,1086,9061
4/28/2014,2014,4,28, 24 ,6351,1110,1030,8491
4/29/2014,2014,4,29, 1 ,6150,1053,964,8167
4/29/2014,2014,4,29, 2 ,5897,1017,910,7824
4/29/2014,2014,4,29, 3 ,5726,983,890,7599
4/29/2014,2014,4,29, 4 ,5569,963,897,7429
4/29/2014,2014,4,29, 5 ,5567,977,890,7434
4/29/2014,2014,4,29, 6 ,5535,960,902,7397
4/29/2014,2014,4,29, 7 ,5742,998,909,7649
4/29/2014,2014,4,29, 8 ,6586,1162,1016,8764
4/29/2014,2014,4,29, 9 ,7389,1364,1070,9823
4/29/2014,2014,4,29, 10 ,7855,1474,1112,10441
4/29/2014,2014,4,29, 11 ,8176,1525,1128,10829
4/29/2014,2014,4,29, 12 ,8015,1487,1096,10598
4/29/2014,2014,4,29, 13 ,8023,1496,1095,10614
4/29/2014,2014,4,29, 14 ,8287,1554,1117,10958
4/29/2014,2014,4,29, 15 ,8049,1523,1121,10693
4/29/2014,2014,4,29, 16 ,7695,1470,1105,10270
4/29/2014,2014,4,29, 17 ,7540,1392,1067,9999
4/29/2014,2014,4,29, 18 ,7250,1416,1104,9770
4/29/2014,2014,4,29, 19 ,7566,1527,1116,10209
4/29/2014,2014,4,29, 20 ,7369,1480,1134,9983
4/29/2014,2014,4,29, 21 ,7188,1435,1111,9734
4/29/2014,2014,4,29, 22 ,7079,1353,1093,9525
4/29/2014,2014,4,29, 23 ,6765,1247,1028,9040
4/29/2014,2014,4,29, 24 ,6327,1163,988,8478
4/30/2014,2014,4,30, 1 ,6077,1105,896,8078
4/30/2014,2014,4,30, 2 ,5859,1070,904,7833
4/30/2014,2014,4,30, 3 ,5693,1050,895,7638
4/30/2014,2014,4,30, 4 ,5538,1013,875,7426
4/30/2014,2014,4,30, 5 ,5571,1021,884,7476
4/30/2014,2014,4,30, 6 ,5414,1001,892,7307
4/30/2014,2014,4,30, 7 ,5694,1030,873,7597
4/30/2014,2014,4,30, 8 ,6410,1184,942,8536
4/30/2014,2014,4,30, 9 ,7129,1390,1037,9556
4/30/2014,2014,4,30, 10 ,7638,1482,1040,10160
4/30/2014,2014,4,30, 11 ,7987,1521,1061,10569
4/30/2014,2014,4,30, 12 ,7832,1492,1075,10399
4/30/2014,2014,4,30, 13 ,7930,1500,1091,10521
4/30/2014,2014,4,30, 14 ,8130,1570,1101,10801
4/30/2014,2014,4,30, 15 ,7998,1531,1077,10606
4/30/2014,2014,4,30, 16 ,7826,1481,1039,10346
4/30/2014,2014,4,30, 17 ,7494,1391,1036,9921
4/30/2014,2014,4,30, 18 ,7166,1411,1082,9659
4/30/2014,2014,4,30, 19 ,7547,1500,1052,10099
4/30/2014,2014,4,30, 20 ,7414,1452,1117,9983
4/30/2014,2014,4,30, 21 ,7274,1404,1113,9791
4/30/2014,2014,4,30, 22 ,7116,1329,1107,9552
4/30/2014,2014,4,30, 23 ,6722,1234,1025,8981
4/30/2014,2014,4,30, 24 ,6318,1141,983,8442
5/1/2014,2014,5,1, 1 ,6023,1093,962,8078
5/1/2014,2014,5,1, 2 ,5844,1060,935,7839
5/1/2014,2014,5,1, 3 ,5613,1033,909,7555
5/1/2014,2014,5,1, 4 ,5487,1010,888,7385
5/1/2014,2014,5,1, 5 ,5357,1013,902,7272
5/1/2014,2014,5,1, 6 ,5001,971,867,6839
5/1/2014,2014,5,1, 7 ,5019,987,845,6851
5/1/2014,2014,5,1, 8 ,5395,1069,919,7383
5/1/2014,2014,5,1, 9 ,5828,1186,999,8013
5/1/2014,2014,5,1, 10 ,6364,1295,1030,8689
5/1/2014,2014,5,1, 11 ,6599,1327,1048,8974
5/1/2014,2014,5,1, 12 ,6597,1322,1052,8971
5/1/2014,2014,5,1, 13 ,6678,1328,1060,9066
5/1/2014,2014,5,1, 14 ,6810,1330,1066,9206
5/1/2014,2014,5,1, 15 ,6624,1334,1061,9019
5/1/2014,2014,5,1, 16 ,6472,1306,1049,8827
5/1/2014,2014,5,1, 17 ,6229,1269,1039,8537
5/1/2014,2014,5,1, 18 ,6249,1317,1089,8655
5/1/2014,2014,5,1, 19 ,6843,1467,1088,9398
5/1/2014,2014,5,1, 20 ,6837,1434,1094,9365
5/1/2014,2014,5,1, 21 ,6806,1388,1105,9299
5/1/2014,2014,5,1, 22 ,6615,1339,1044,8998
5/1/2014,2014,5,1, 23 ,6305,1226,1026,8557
5/1/2014,2014,5,1, 24 ,5872,1138,963,7973
5/2/2014,2014,5,2, 1 ,5716,1082,896,7694
5/2/2014,2014,5,2, 2 ,5471,1044,885,7400
5/2/2014,2014,5,2, 3 ,5298,1006,872,7176
5/2/2014,2014,5,2, 4 ,5157,992,843,6992
5/2/2014,2014,5,2, 5 ,5203,997,857,7057
5/2/2014,2014,5,2, 6 ,5151,990,860,7001
5/2/2014,2014,5,2, 7 ,5538,1035,859,7432
5/2/2014,2014,5,2, 8 ,6403,1209,953,8565
5/2/2014,2014,5,2, 9 ,7264,1401,1089,9754
5/2/2014,2014,5,2, 10 ,7715,1492,1045,10252
5/2/2014,2014,5,2, 11 ,7935,1530,1045,10510
5/2/2014,2014,5,2, 12 ,7864,1500,1042,10406
5/2/2014,2014,5,2, 13 ,7851,1526,1059,10436
5/2/2014,2014,5,2, 14 ,8058,1588,1117,10763
5/2/2014,2014,5,2, 15 ,7954,1562,1095,10611
5/2/2014,2014,5,2, 16 ,7789,1520,1084,10393
5/2/2014,2014,5,2, 17 ,7464,1435,1065,9964
5/2/2014,2014,5,2, 18 ,7146,1422,1079,9647
5/2/2014,2014,5,2, 19 ,7400,1557,1117,10074
5/2/2014,2014,5,2, 20 ,7329,1518,1120,9967
5/2/2014,2014,5,2, 21 ,7299,1457,1104,9860
5/2/2014,2014,5,2, 22 ,7059,1382,1095,9536
5/2/2014,2014,5,2, 23 ,6743,1277,1056,9076
5/2/2014,2014,5,2, 24 ,6324,1192,1036,8552
5/3/2014,2014,5,3, 1 ,6018,1143,956,8117
5/3/2014,2014,5,3, 2 ,5798,1097,933,7828
5/3/2014,2014,5,3, 3 ,5624,1069,908,7601
5/3/2014,2014,5,3, 4 ,5453,1044,891,7388
5/3/2014,2014,5,3, 5 ,5392,1044,908,7344
5/3/2014,2014,5,3, 6 ,5189,1002,886,7077
5/3/2014,2014,5,3, 7 ,5275,1025,866,7166
5/3/2014,2014,5,3, 8 ,5855,1130,934,7919
5/3/2014,2014,5,3, 9 ,6403,1270,1037,8710
5/3/2014,2014,5,3, 10 ,6899,1355,1062,9316
5/3/2014,2014,5,3, 11 ,7159,1396,1077,9632
5/3/2014,2014,5,3, 12 ,7099,1371,1042,9512
5/3/2014,2014,5,3, 13 ,7083,1384,1075,9542
5/3/2014,2014,5,3, 14 ,7247,1399,1102,9748
5/3/2014,2014,5,3, 15 ,7045,1374,1080,9499
5/3/2014,2014,5,3, 16 ,6845,1336,1060,9241
5/3/2014,2014,5,3, 17 ,6607,1265,1035,8907
5/3/2014,2014,5,3, 18 ,6426,1315,1070,8811
5/3/2014,2014,5,3, 19 ,7145,1485,1094,9724
5/3/2014,2014,5,3, 20 ,7119,1449,1112,9680
5/3/2014,2014,5,3, 21 ,7046,1419,1108,9573
5/3/2014,2014,5,3, 22 ,6895,1331,1086,9312
5/3/2014,2014,5,3, 23 ,6532,1243,1077,8852
5/3/2014,2014,5,3, 24 ,6204,1172,983,8359
5/4/2014,2014,5,4, 1 ,5829,1110,922,7861
5/4/2014,2014,5,4, 2 ,5690,1079,907,7676
5/4/2014,2014,5,4, 3 ,5514,1054,877,7445
5/4/2014,2014,5,4, 4 ,5346,1035,878,7259
5/4/2014,2014,5,4, 5 ,5266,1024,894,7184
5/4/2014,2014,5,4, 6 ,4988,971,840,6799
5/4/2014,2014,5,4, 7 ,4980,989,863,6832
5/4/2014,2014,5,4, 8 ,5278,1028,830,7136
5/4/2014,2014,5,4, 9 ,5685,1115,939,7739
5/4/2014,2014,5,4, 10 ,6090,1181,980,8251
5/4/2014,2014,5,4, 11 ,6195,1211,1001,8407
5/4/2014,2014,5,4, 12 ,6282,1229,1020,8531
5/4/2014,2014,5,4, 13 ,6312,1234,1053,8599
5/4/2014,2014,5,4, 14 ,6296,1234,1065,8595
5/4/2014,2014,5,4, 15 ,6273,1220,1062,8555
5/4/2014,2014,5,4, 16 ,6110,1190,1036,8336
5/4/2014,2014,5,4, 17 ,5917,1156,1021,8094
5/4/2014,2014,5,4, 18 ,5897,1230,1092,8219
5/4/2014,2014,5,4, 19 ,6618,1404,1168,9190
5/4/2014,2014,5,4, 20 ,6710,1387,1164,9261
5/4/2014,2014,5,4, 21 ,6626,1344,1163,9133
5/4/2014,2014,5,4, 22 ,6429,1274,1116,8819
5/4/2014,2014,5,4, 23 ,6127,1190,1055,8372
5/4/2014,2014,5,4, 24 ,5875,1129,1033,8037
5/5/2014,2014,5,5, 1 ,5539,1072,945,7556
5/5/2014,2014,5,5, 2 ,5352,1033,925,7310
5/5/2014,2014,5,5, 3 ,5217,1004,903,7124
5/5/2014,2014,5,5, 4 ,5047,982,886,6915
5/5/2014,2014,5,5, 5 ,5106,985,904,6995
5/5/2014,2014,5,5, 6 ,5038,974,884,6896
5/5/2014,2014,5,5, 7 ,5436,1013,876,7325
5/5/2014,2014,5,5, 8 ,6326,1177,1018,8521
5/5/2014,2014,5,5, 9 ,7205,1369,1066,9640
5/5/2014,2014,5,5, 10 ,7738,1459,1109,10306
5/5/2014,2014,5,5, 11 ,7969,1506,1086,10561
5/5/2014,2014,5,5, 12 ,7891,1478,1087,10456
5/5/2014,2014,5,5, 13 ,7926,1483,1101,10510
5/5/2014,2014,5,5, 14 ,8230,1533,1110,10873
5/5/2014,2014,5,5, 15 ,8135,1529,1099,10763
5/5/2014,2014,5,5, 16 ,8008,1494,1084,10586
5/5/2014,2014,5,5, 17 ,7602,1422,1067,10091
5/5/2014,2014,5,5, 18 ,7254,1415,1064,9733
5/5/2014,2014,5,5, 19 ,7608,1551,1070,10229
5/5/2014,2014,5,5, 20 ,7510,1515,1100,10125
5/5/2014,2014,5,5, 21 ,7469,1482,1120,10071
5/5/2014,2014,5,5, 22 ,7235,1404,1096,9735
5/5/2014,2014,5,5, 23 ,6859,1286,1049,9194
5/5/2014,2014,5,5, 24 ,6425,1192,1013,8630
5/6/2014,2014,5,6, 1 ,6170,1151,939,8260
5/6/2014,2014,5,6, 2 ,5911,1107,964,7982
5/6/2014,2014,5,6, 3 ,5763,1079,938,7780
5/6/2014,2014,5,6, 4 ,5593,1049,926,7568
5/6/2014,2014,5,6, 5 ,5586,1047,938,7571
5/6/2014,2014,5,6, 6 ,5457,1019,922,7398
5/6/2014,2014,5,6, 7 ,5743,1048,929,7720
5/6/2014,2014,5,6, 8 ,6603,1214,1027,8844
5/6/2014,2014,5,6, 9 ,7352,1390,1011,9753
5/6/2014,2014,5,6, 10 ,7880,1497,1001,10378
5/6/2014,2014,5,6, 11 ,8150,1536,998,10684
5/6/2014,2014,5,6, 12 ,8002,1510,966,10478
5/6/2014,2014,5,6, 13 ,8018,1526,961,10505
5/6/2014,2014,5,6, 14 ,8277,1584,1014,10875
5/6/2014,2014,5,6, 15 ,8127,1557,952,10636
5/6/2014,2014,5,6, 16 ,8022,1524,885,10431
5/6/2014,2014,5,6, 17 ,7621,1435,932,9988
5/6/2014,2014,5,6, 18 ,7177,1436,1002,9615
5/6/2014,2014,5,6, 19 ,7613,1546,984,10143
5/6/2014,2014,5,6, 20 ,7393,1517,995,9905
5/6/2014,2014,5,6, 21 ,7300,1478,1010,9788
5/6/2014,2014,5,6, 22 ,7135,1384,1040,9559
5/6/2014,2014,5,6, 23 ,6761,1282,1010,9053
5/6/2014,2014,5,6, 24 ,6372,1197,1000,8569
5/7/2014,2014,5,7, 1 ,6068,1147,915,8130
5/7/2014,2014,5,7, 2 ,5860,1103,903,7866
5/7/2014,2014,5,7, 3 ,5736,1069,910,7715
5/7/2014,2014,5,7, 4 ,5543,1053,911,7507
5/7/2014,2014,5,7, 5 ,5504,1052,921,7477
5/7/2014,2014,5,7, 6 ,5342,1024,898,7264
5/7/2014,2014,5,7, 7 ,5655,1061,903,7619
5/7/2014,2014,5,7, 8 ,6514,1227,961,8702
5/7/2014,2014,5,7, 9 ,7284,1416,970,9670
5/7/2014,2014,5,7, 10 ,7783,1526,987,10296
5/7/2014,2014,5,7, 11 ,8078,1575,982,10635
5/7/2014,2014,5,7, 12 ,7999,1532,970,10501
5/7/2014,2014,5,7, 13 ,8027,1552,961,10540
5/7/2014,2014,5,7, 14 ,8344,1603,992,10939
5/7/2014,2014,5,7, 15 ,8256,1578,992,10826
5/7/2014,2014,5,7, 16 ,8082,1546,994,10622
5/7/2014,2014,5,7, 17 ,7756,1462,971,10189
5/7/2014,2014,5,7, 18 ,7366,1440,1030,9836
5/7/2014,2014,5,7, 19 ,7734,1577,1065,10376
5/7/2014,2014,5,7, 20 ,7706,1516,1090,10312
5/7/2014,2014,5,7, 21 ,7580,1500,1055,10135
5/7/2014,2014,5,7, 22 ,7395,1417,1043,9855
5/7/2014,2014,5,7, 23 ,7055,1290,1038,9383
5/7/2014,2014,5,7, 24 ,6578,1212,1045,8835
5/8/2014,2014,5,8, 1 ,6272,1166,1011,8449
5/8/2014,2014,5,8, 2 ,6052,1122,980,8154
5/8/2014,2014,5,8, 3 ,5883,1094,951,7928
5/8/2014,2014,5,8, 4 ,5733,1073,933,7739
5/8/2014,2014,5,8, 5 ,5703,1068,949,7720
5/8/2014,2014,5,8, 6 ,5501,1033,935,7469
5/8/2014,2014,5,8, 7 ,5848,1060,941,7849
5/8/2014,2014,5,8, 8 ,6627,1232,1026,8885
5/8/2014,2014,5,8, 9 ,7461,1432,1091,9984
5/8/2014,2014,5,8, 10 ,8011,1520,1098,10629
5/8/2014,2014,5,8, 11 ,8295,1560,1081,10936
5/8/2014,2014,5,8, 12 ,8162,1531,1067,10760
5/8/2014,2014,5,8, 13 ,8180,1545,1064,10789
5/8/2014,2014,5,8, 14 ,8501,1589,1079,11169
5/8/2014,2014,5,8, 15 ,8148,1560,1044,10752
5/8/2014,2014,5,8, 16 ,8104,1520,1026,10650
5/8/2014,2014,5,8, 17 ,7805,1431,990,10226
5/8/2014,2014,5,8, 18 ,7399,1439,1042,9880
5/8/2014,2014,5,8, 19 ,7663,1547,1073,10283
5/8/2014,2014,5,8, 20 ,7635,1504,1067,10206
5/8/2014,2014,5,8, 21 ,7542,1469,1059,10070
5/8/2014,2014,5,8, 22 ,7447,1404,1071,9922
5/8/2014,2014,5,8, 23 ,7078,1297,1057,9432
5/8/2014,2014,5,8, 24 ,6576,1224,1026,8826
5/9/2014,2014,5,9, 1 ,6332,1165,992,8489
5/9/2014,2014,5,9, 2 ,6164,1123,959,8246
5/9/2014,2014,5,9, 3 ,6005,1091,939,8035
5/9/2014,2014,5,9, 4 ,5640,1072,922,7634
5/9/2014,2014,5,9, 5 ,5677,1068,938,7683
5/9/2014,2014,5,9, 6 ,5499,1038,920,7457
5/9/2014,2014,5,9, 7 ,5802,1064,932,7798
5/9/2014,2014,5,9, 8 ,6690,1226,1027,8943
5/9/2014,2014,5,9, 9 ,7445,1436,1077,9958
5/9/2014,2014,5,9, 10 ,7901,1532,1096,10529
5/9/2014,2014,5,9, 11 ,8195,1565,1119,10879
5/9/2014,2014,5,9, 12 ,8014,1521,1098,10633
5/9/2014,2014,5,9, 13 ,8032,1532,1088,10652
5/9/2014,2014,5,9, 14 ,8295,1586,1143,11024
5/9/2014,2014,5,9, 15 ,8082,1545,1113,10740
5/9/2014,2014,5,9, 16 ,7868,1480,1080,10428
5/9/2014,2014,5,9, 17 ,7465,1407,1061,9933
5/9/2014,2014,5,9, 18 ,7215,1422,1130,9767
5/9/2014,2014,5,9, 19 ,7496,1524,1157,10177
5/9/2014,2014,5,9, 20 ,7349,1488,1133,9970
5/9/2014,2014,5,9, 21 ,7299,1445,1106,9850
5/9/2014,2014,5,9, 22 ,7165,1390,1073,9628
5/9/2014,2014,5,9, 23 ,6755,1267,1021,9043
5/9/2014,2014,5,9, 24 ,6465,1177,970,8612
5/10/2014,2014,5,10, 1 ,6241,1138,943,8322
5/10/2014,2014,5,10, 2 ,6054,1096,916,8066
5/10/2014,2014,5,10, 3 ,5815,1073,886,7774
5/10/2014,2014,5,10, 4 ,5700,1057,875,7632
5/10/2014,2014,5,10, 5 ,5652,1057,889,7598
5/10/2014,2014,5,10, 6 ,5399,1025,901,7325
5/10/2014,2014,5,10, 7 ,5526,1035,879,7440
5/10/2014,2014,5,10, 8 ,6019,1147,951,8117
5/10/2014,2014,5,10, 9 ,6602,1286,951,8839
5/10/2014,2014,5,10, 10 ,7161,1365,1006,9532
5/10/2014,2014,5,10, 11 ,7476,1423,1046,9945
5/10/2014,2014,5,10, 12 ,7354,1395,1035,9784
5/10/2014,2014,5,10, 13 ,7340,1407,1103,9850
5/10/2014,2014,5,10, 14 ,7565,1437,1131,10133
5/10/2014,2014,5,10, 15 ,7347,1388,1128,9863
5/10/2014,2014,5,10, 16 ,6924,1301,1101,9326
5/10/2014,2014,5,10, 17 ,6590,1274,1093,8957
5/10/2014,2014,5,10, 18 ,6469,1357,1166,8992
5/10/2014,2014,5,10, 19 ,7106,1479,1150,9735
5/10/2014,2014,5,10, 20 ,7070,1454,1161,9685
5/10/2014,2014,5,10, 21 ,7100,1408,1144,9652
5/10/2014,2014,5,10, 22 ,6940,1330,1113,9383
5/10/2014,2014,5,10, 23 ,6642,1232,1043,8917
5/10/2014,2014,5,10, 24 ,6296,1169,982,8447
5/11/2014,2014,5,11, 1 ,6018,1106,935,8059
5/11/2014,2014,5,11, 2 ,5837,1070,901,7808
5/11/2014,2014,5,11, 3 ,5628,1045,872,7545
5/11/2014,2014,5,11, 4 ,5440,1002,857,7299
5/11/2014,2014,5,11, 5 ,5306,994,867,7167
5/11/2014,2014,5,11, 6 ,4929,941,830,6700
5/11/2014,2014,5,11, 7 ,5007,969,829,6805
5/11/2014,2014,5,11, 8 ,5335,1003,832,7170
5/11/2014,2014,5,11, 9 ,5745,1103,884,7732
5/11/2014,2014,5,11, 10 ,6170,1175,1006,8351
5/11/2014,2014,5,11, 11 ,6410,1215,1055,8680
5/11/2014,2014,5,11, 12 ,6467,1219,1061,8747
5/11/2014,2014,5,11, 13 ,6422,1220,1057,8699
5/11/2014,2014,5,11, 14 ,6481,1219,1061,8761
5/11/2014,2014,5,11, 15 ,6500,1217,1040,8757
5/11/2014,2014,5,11, 16 ,6320,1191,1016,8527
5/11/2014,2014,5,11, 17 ,6070,1158,1040,8268
5/11/2014,2014,5,11, 18 ,6085,1220,1124,8429
5/11/2014,2014,5,11, 19 ,6858,1413,1138,9409
5/11/2014,2014,5,11, 20 ,6873,1394,1141,9408
5/11/2014,2014,5,11, 21 ,6871,1347,1114,9332
5/11/2014,2014,5,11, 22 ,6685,1286,1062,9033
5/11/2014,2014,5,11, 23 ,6463,1206,992,8661
5/11/2014,2014,5,11, 24 ,6201,1140,933,8274
5/12/2014,2014,5,12, 1 ,5912,1086,884,7882
5/12/2014,2014,5,12, 2 ,5717,1050,839,7606
5/12/2014,2014,5,12, 3 ,5475,1017,824,7316
5/12/2014,2014,5,12, 4 ,5352,997,811,7160
5/12/2014,2014,5,12, 5 ,5311,1004,829,7144
5/12/2014,2014,5,12, 6 ,5256,988,827,7071
5/12/2014,2014,5,12, 7 ,5655,1035,811,7501
5/12/2014,2014,5,12, 8 ,6546,1209,996,8751
5/12/2014,2014,5,12, 9 ,7381,1408,1127,9916
5/12/2014,2014,5,12, 10 ,7861,1502,1153,10516
5/12/2014,2014,5,12, 11 ,8089,1513,1182,10784
5/12/2014,2014,5,12, 12 ,8061,1499,1183,10743
5/12/2014,2014,5,12, 13 ,8077,1516,1192,10785
5/12/2014,2014,5,12, 14 ,8389,1578,1228,11195
5/12/2014,2014,5,12, 15 ,8310,1553,1196,11059
5/12/2014,2014,5,12, 16 ,8174,1518,1179,10871
5/12/2014,2014,5,12, 17 ,7689,1443,1141,10273
5/12/2014,2014,5,12, 18 ,7330,1441,1178,9949
5/12/2014,2014,5,12, 19 ,7746,1572,1211,10529
5/12/2014,2014,5,12, 20 ,7603,1521,1193,10317
5/12/2014,2014,5,12, 21 ,7533,1476,1198,10207
5/12/2014,2014,5,12, 22 ,7411,1398,1152,9961
5/12/2014,2014,5,12, 23 ,6986,1281,1056,9323
5/12/2014,2014,5,12, 24 ,6589,1198,1001,8788
5/13/2014,2014,5,13, 1 ,5912,1142,964,8018
5/13/2014,2014,5,13, 2 ,6054,1098,933,8085
5/13/2014,2014,5,13, 3 ,5834,1073,910,7817
5/13/2014,2014,5,13, 4 ,5691,1052,895,7638
5/13/2014,2014,5,13, 5 ,5632,1049,908,7589
5/13/2014,2014,5,13, 6 ,5467,1022,902,7391
5/13/2014,2014,5,13, 7 ,5710,1058,900,7668
5/13/2014,2014,5,13, 8 ,6624,1221,1018,8863
5/13/2014,2014,5,13, 9 ,7422,1404,1139,9965
5/13/2014,2014,5,13, 10 ,7907,1499,1159,10565
5/13/2014,2014,5,13, 11 ,8170,1547,1157,10874
5/13/2014,2014,5,13, 12 ,8089,1509,1098,10696
5/13/2014,2014,5,13, 13 ,8079,1540,1127,10746
5/13/2014,2014,5,13, 14 ,8361,1592,1144,11097
5/13/2014,2014,5,13, 15 ,8304,1558,1135,10997
5/13/2014,2014,5,13, 16 ,8137,1531,1162,10830
5/13/2014,2014,5,13, 17 ,7724,1446,1133,10303
5/13/2014,2014,5,13, 18 ,7331,1465,1175,9971
5/13/2014,2014,5,13, 19 ,7780,1558,1127,10465
5/13/2014,2014,5,13, 20 ,7648,1508,1147,10303
5/13/2014,2014,5,13, 21 ,7557,1478,1110,10145
5/13/2014,2014,5,13, 22 ,7498,1387,1090,9975
5/13/2014,2014,5,13, 23 ,7062,1275,1000,9337
5/13/2014,2014,5,13, 24 ,6637,1194,948,8779
5/14/2014,2014,5,14, 1 ,6353,1144,883,8380
5/14/2014,2014,5,14, 2 ,6151,1106,860,8117
5/14/2014,2014,5,14, 3 ,5962,1071,850,7883
5/14/2014,2014,5,14, 4 ,5726,1045,846,7617
5/14/2014,2014,5,14, 5 ,5697,1048,869,7614
5/14/2014,2014,5,14, 6 ,5566,1022,884,7472
5/14/2014,2014,5,14, 7 ,5808,1059,836,7703
5/14/2014,2014,5,14, 8 ,6679,1188,1012,8879
5/14/2014,2014,5,14, 9 ,7436,1380,1128,9944
5/14/2014,2014,5,14, 10 ,8063,1467,1199,10729
5/14/2014,2014,5,14, 11 ,8243,1512,1212,10967
5/14/2014,2014,5,14, 12 ,8086,1461,1197,10744
5/14/2014,2014,5,14, 13 ,8103,1503,1223,10829
5/14/2014,2014,5,14, 14 ,8436,1572,1202,11210
5/14/2014,2014,5,14, 15 ,8274,1542,1218,11034
5/14/2014,2014,5,14, 16 ,8122,1515,1207,10844
5/14/2014,2014,5,14, 17 ,7699,1431,1186,10316
5/14/2014,2014,5,14, 18 ,7293,1434,1222,9949
5/14/2014,2014,5,14, 19 ,7757,1523,1285,10565
5/14/2014,2014,5,14, 20 ,7620,1477,1264,10361
5/14/2014,2014,5,14, 21 ,7545,1436,1202,10183
5/14/2014,2014,5,14, 22 ,7390,1349,1116,9855
5/14/2014,2014,5,14, 23 ,7125,1254,1032,9411
5/14/2014,2014,5,14, 24 ,6753,1177,974,8904
5/15/2014,2014,5,15, 1 ,6468,1139,919,8526
5/15/2014,2014,5,15, 2 ,6326,1111,893,8330
5/15/2014,2014,5,15, 3 ,6023,1085,864,7972
5/15/2014,2014,5,15, 4 ,5936,1055,859,7850
5/15/2014,2014,5,15, 5 ,5786,1061,881,7728
5/15/2014,2014,5,15, 6 ,5677,1037,884,7598
5/15/2014,2014,5,15, 7 ,5924,1073,883,7880
5/15/2014,2014,5,15, 8 ,6740,1245,980,8965
5/15/2014,2014,5,15, 9 ,7428,1431,1183,10042
5/15/2014,2014,5,15, 10 ,7932,1512,1190,10634
5/15/2014,2014,5,15, 11 ,8203,1553,1213,10969
5/15/2014,2014,5,15, 12 ,8089,1511,1183,10783
5/15/2014,2014,5,15, 13 ,8079,1522,1204,10805
5/15/2014,2014,5,15, 14 ,8386,1583,1196,11165
5/15/2014,2014,5,15, 15 ,8276,1551,1188,11015
5/15/2014,2014,5,15, 16 ,8157,1519,1204,10880
5/15/2014,2014,5,15, 17 ,7687,1431,1187,10305
5/15/2014,2014,5,15, 18 ,7378,1440,1265,10083
5/15/2014,2014,5,15, 19 ,7669,1523,1269,10461
5/15/2014,2014,5,15, 20 ,7672,1498,1251,10421
5/15/2014,2014,5,15, 21 ,7603,1450,1202,10255
5/15/2014,2014,5,15, 22 ,7473,1390,1123,9986
5/15/2014,2014,5,15, 23 ,7091,1281,1033,9405
5/15/2014,2014,5,15, 24 ,6769,1188,959,8916
5/16/2014,2014,5,16, 1 ,6535,1144,912,8591
5/16/2014,2014,5,16, 2 ,6300,1109,886,8295
5/16/2014,2014,5,16, 3 ,6100,1078,857,8035
5/16/2014,2014,5,16, 4 ,5943,1062,848,7853
5/16/2014,2014,5,16, 5 ,5876,1063,875,7814
5/16/2014,2014,5,16, 6 ,5713,1034,872,7619
5/16/2014,2014,5,16, 7 ,5937,1066,871,7874
5/16/2014,2014,5,16, 8 ,6838,1229,1010,9077
5/16/2014,2014,5,16, 9 ,7512,1410,1156,10078
5/16/2014,2014,5,16, 10 ,7998,1488,1228,10714
5/16/2014,2014,5,16, 11 ,8213,1540,1237,10990
5/16/2014,2014,5,16, 12 ,8137,1504,1230,10871
5/16/2014,2014,5,16, 13 ,8155,1509,1248,10912
5/16/2014,2014,5,16, 14 ,8211,1545,1264,11020
5/16/2014,2014,5,16, 15 ,7808,1497,1230,10535
5/16/2014,2014,5,16, 16 ,7775,1447,1229,10451
5/16/2014,2014,5,16, 17 ,7493,1369,1209,10071
5/16/2014,2014,5,16, 18 ,7348,1391,1235,9974
5/16/2014,2014,5,16, 19 ,7643,1473,1266,10382
5/16/2014,2014,5,16, 20 ,7566,1458,1243,10267
5/16/2014,2014,5,16, 21 ,7557,1410,1208,10175
5/16/2014,2014,5,16, 22 ,7314,1318,1119,9751
5/16/2014,2014,5,16, 23 ,6959,1224,1015,9198
5/16/2014,2014,5,16, 24 ,6682,1136,971,8789
5/17/2014,2014,5,17, 1 ,6419,1108,924,8451
5/17/2014,2014,5,17, 2 ,6201,1078,891,8170
5/17/2014,2014,5,17, 3 ,6052,1052,865,7969
5/17/2014,2014,5,17, 4 ,5871,1034,856,7761
5/17/2014,2014,5,17, 5 ,5767,1037,876,7680
5/17/2014,2014,5,17, 6 ,5443,998,864,7305
5/17/2014,2014,5,17, 7 ,5615,1032,874,7521
5/17/2014,2014,5,17, 8 ,6160,1145,954,8259
5/17/2014,2014,5,17, 9 ,6692,1294,1062,9048
5/17/2014,2014,5,17, 10 ,7148,1370,1153,9671
5/17/2014,2014,5,17, 11 ,7519,1413,1218,10150
5/17/2014,2014,5,17, 12 ,7342,1381,1206,9929
5/17/2014,2014,5,17, 13 ,7430,1397,1203,10030
5/17/2014,2014,5,17, 14 ,7603,1437,1218,10258
5/17/2014,2014,5,17, 15 ,7455,1399,1180,10034
5/17/2014,2014,5,17, 16 ,7252,1351,1145,9748
5/17/2014,2014,5,17, 17 ,6869,1298,1127,9294
5/17/2014,2014,5,17, 18 ,6624,1324,1224,9172
5/17/2014,2014,5,17, 19 ,7271,1490,1233,9994
5/17/2014,2014,5,17, 20 ,7323,1457,1221,10001
5/17/2014,2014,5,17, 21 ,7341,1427,1197,9965
5/17/2014,2014,5,17, 22 ,7249,1354,1108,9711
5/17/2014,2014,5,17, 23 ,6983,1231,1040,9254
5/17/2014,2014,5,17, 24 ,6583,1155,946,8684
5/18/2014,2014,5,18, 1 ,6337,1123,888,8348
5/18/2014,2014,5,18, 2 ,6156,1083,878,8117
5/18/2014,2014,5,18, 3 ,5969,1049,848,7866
5/18/2014,2014,5,18, 4 ,5763,1026,836,7625
5/18/2014,2014,5,18, 5 ,5567,1013,844,7424
5/18/2014,2014,5,18, 6 ,5203,970,824,6997
5/18/2014,2014,5,18, 7 ,5246,984,828,7058
5/18/2014,2014,5,18, 8 ,5493,1038,858,7389
5/18/2014,2014,5,18, 9 ,5937,1122,919,7978
5/18/2014,2014,5,18, 10 ,6366,1197,1018,8581
5/18/2014,2014,5,18, 11 ,6655,1238,1072,8965
5/18/2014,2014,5,18, 12 ,6595,1244,1067,8906
5/18/2014,2014,5,18, 13 ,6674,1242,1080,8996
5/18/2014,2014,5,18, 14 ,6751,1251,1088,9090
5/18/2014,2014,5,18, 15 ,6703,1228,1067,8998
5/18/2014,2014,5,18, 16 ,6485,1191,1030,8706
5/18/2014,2014,5,18, 17 ,6276,1175,1042,8493
5/18/2014,2014,5,18, 18 ,6325,1238,1156,8719
5/18/2014,2014,5,18, 19 ,6892,1439,1217,9548
5/18/2014,2014,5,18, 20 ,7063,1409,1187,9659
5/18/2014,2014,5,18, 21 ,7073,1369,1123,9565
5/18/2014,2014,5,18, 22 ,6913,1281,1063,9257
5/18/2014,2014,5,18, 23 ,6717,1198,986,8901
5/18/2014,2014,5,18, 24 ,6397,1143,933,8473
5/19/2014,2014,5,19, 1 ,6073,1095,879,8047
5/19/2014,2014,5,19, 2 ,5940,1005,857,7802
5/19/2014,2014,5,19, 3 ,5725,1016,835,7576
5/19/2014,2014,5,19, 4 ,5599,1002,829,7430
5/19/2014,2014,5,19, 5 ,5567,1008,850,7425
5/19/2014,2014,5,19, 6 ,5482,995,850,7327
5/19/2014,2014,5,19, 7 ,5862,1036,863,7761
5/19/2014,2014,5,19, 8 ,6773,1207,978,8958
5/19/2014,2014,5,19, 9 ,7525,1404,1190,10119
5/19/2014,2014,5,19, 10 ,8133,1508,1245,10886
5/19/2014,2014,5,19, 11 ,8369,1541,1239,11149
5/19/2014,2014,5,19, 12 ,8318,1495,1212,11025
5/19/2014,2014,5,19, 13 ,8276,1502,1226,11004
5/19/2014,2014,5,19, 14 ,8570,1554,1268,11392
5/19/2014,2014,5,19, 15 ,8451,1535,1241,11227
5/19/2014,2014,5,19, 16 ,8290,1502,1244,11036
5/19/2014,2014,5,19, 17 ,7799,1413,1233,10445
5/19/2014,2014,5,19, 18 ,7367,1423,1284,10074
5/19/2014,2014,5,19, 19 ,7679,1544,1258,10481
5/19/2014,2014,5,19, 20 ,7675,1506,1246,10427
5/19/2014,2014,5,19, 21 ,7572,1450,1206,10228
5/19/2014,2014,5,19, 22 ,7426,1350,1127,9903
5/19/2014,2014,5,19, 23 ,7122,1255,1033,9410
5/19/2014,2014,5,19, 24 ,6750,1180,965,8895
5/20/2014,2014,5,20, 1 ,6461,1134,930,8525
5/20/2014,2014,5,20, 2 ,6266,1103,898,8267
5/20/2014,2014,5,20, 3 ,6114,1066,872,8052
5/20/2014,2014,5,20, 4 ,5926,1043,862,7831
5/20/2014,2014,5,20, 5 ,5879,1045,889,7813
5/20/2014,2014,5,20, 6 ,5648,1022,886,7556
5/20/2014,2014,5,20, 7 ,5933,1059,891,7883
5/20/2014,2014,5,20, 8 ,6846,1224,1028,9098
5/20/2014,2014,5,20, 9 ,7638,1420,1181,10239
5/20/2014,2014,5,20, 10 ,8123,1498,1260,10881
5/20/2014,2014,5,20, 11 ,8399,1548,1246,11193
5/20/2014,2014,5,20, 12 ,8282,1507,1230,11019
5/20/2014,2014,5,20, 13 ,8331,1522,1201,11054
5/20/2014,2014,5,20, 14 ,8638,1582,1238,11458
5/20/2014,2014,5,20, 15 ,8555,1556,1232,11343
5/20/2014,2014,5,20, 16 ,8349,1501,1216,11066
5/20/2014,2014,5,20, 17 ,7878,1416,1208,10502
5/20/2014,2014,5,20, 18 ,7528,1412,1262,10202
5/20/2014,2014,5,20, 19 ,7888,1556,1248,10692
5/20/2014,2014,5,20, 20 ,7727,1510,1219,10456
5/20/2014,2014,5,20, 21 ,7700,1477,1194,10371
5/20/2014,2014,5,20, 22 ,7591,1382,1138,10111
5/20/2014,2014,5,20, 23 ,7264,1278,1048,9590
5/20/2014,2014,5,20, 24 ,6865,1193,963,9021
5/21/2014,2014,5,21, 1 ,6526,1145,923,8594
5/21/2014,2014,5,21, 2 ,6316,1104,891,8311
5/21/2014,2014,5,21, 3 ,6144,1077,875,8096
5/21/2014,2014,5,21, 4 ,5943,1050,865,7858
5/21/2014,2014,5,21, 5 ,5911,1050,892,7853
5/21/2014,2014,5,21, 6 ,5781,1033,894,7708
5/21/2014,2014,5,21, 7 ,6035,1061,897,7993
5/21/2014,2014,5,21, 8 ,6931,1224,1051,9206
5/21/2014,2014,5,21, 9 ,7663,1409,1196,10268
5/21/2014,2014,5,21, 10 ,8151,1517,1251,10919
5/21/2014,2014,5,21, 11 ,8354,1573,1239,11166
5/21/2014,2014,5,21, 12 ,8316,1512,1218,11046
5/21/2014,2014,5,21, 13 ,8390,1511,1248,11149
5/21/2014,2014,5,21, 14 ,8660,1572,1257,11489
5/21/2014,2014,5,21, 15 ,8175,1547,1236,10958
5/21/2014,2014,5,21, 16 ,8015,1503,1231,10749
5/21/2014,2014,5,21, 17 ,7737,1441,1209,10387
5/21/2014,2014,5,21, 18 ,7414,1460,1254,10128
5/21/2014,2014,5,21, 19 ,7705,1537,1206,10448
5/21/2014,2014,5,21, 20 ,7660,1503,1188,10351
5/21/2014,2014,5,21, 21 ,7479,1421,1189,10089
5/21/2014,2014,5,21, 22 ,7315,1310,1133,9758
5/21/2014,2014,5,21, 23 ,6866,1207,1031,9104
5/21/2014,2014,5,21, 24 ,6451,1141,962,8554
5/22/2014,2014,5,22, 1 ,6221,1094,907,8222
5/22/2014,2014,5,22, 2 ,6025,1055,874,7954
5/22/2014,2014,5,22, 3 ,5825,1027,866,7718
5/22/2014,2014,5,22, 4 ,5729,1013,846,7588
5/22/2014,2014,5,22, 5 ,5634,1016,865,7515
5/22/2014,2014,5,22, 6 ,5476,1002,871,7349
5/22/2014,2014,5,22, 7 ,5795,1020,862,7677
5/22/2014,2014,5,22, 8 ,6694,1165,959,8818
5/22/2014,2014,5,22, 9 ,7363,1368,1110,9841
5/22/2014,2014,5,22, 10 ,7983,1472,1207,10662
5/22/2014,2014,5,22, 11 ,8236,1543,1256,11035
5/22/2014,2014,5,22, 12 ,8187,1491,1230,10908
5/22/2014,2014,5,22, 13 ,8211,1516,1257,10984
5/22/2014,2014,5,22, 14 ,8516,1578,1296,11390
5/22/2014,2014,5,22, 15 ,8263,1532,1292,11087
5/22/2014,2014,5,22, 16 ,8040,1512,1296,10848
5/22/2014,2014,5,22, 17 ,7688,1421,1248,10357
5/22/2014,2014,5,22, 18 ,7404,1425,1280,10109
5/22/2014,2014,5,22, 19 ,7622,1538,1285,10445
5/22/2014,2014,5,22, 20 ,7662,1502,1277,10441
5/22/2014,2014,5,22, 21 ,7539,1442,1254,10235
5/22/2014,2014,5,22, 22 ,7287,1355,1170,9812
5/22/2014,2014,5,22, 23 ,6951,1257,1062,9270
5/22/2014,2014,5,22, 24 ,6627,1179,1007,8813
5/23/2014,2014,5,23, 1 ,6332,1118,951,8401
5/23/2014,2014,5,23, 2 ,6089,1068,926,8083
5/23/2014,2014,5,23, 3 ,5872,1042,895,7809
5/23/2014,2014,5,23, 4 ,5765,1018,887,7670
5/23/2014,2014,5,23, 5 ,5712,1023,909,7644
5/23/2014,2014,5,23, 6 ,5538,1001,897,7436
5/23/2014,2014,5,23, 7 ,5805,1033,907,7745
5/23/2014,2014,5,23, 8 ,6709,1197,1032,8938
5/23/2014,2014,5,23, 9 ,7516,1401,1200,10117
5/23/2014,2014,5,23, 10 ,8020,1502,1287,10809
5/23/2014,2014,5,23, 11 ,8298,1558,1314,11170
5/23/2014,2014,5,23, 12 ,8171,1519,1301,10991
5/23/2014,2014,5,23, 13 ,8179,1527,1306,11012
5/23/2014,2014,5,23, 14 ,8515,1596,1336,11447
5/23/2014,2014,5,23, 15 ,8320,1545,1312,11177
5/23/2014,2014,5,23, 16 ,8159,1525,1288,10972
5/23/2014,2014,5,23, 17 ,7666,1426,1255,10347
5/23/2014,2014,5,23, 18 ,7495,1420,1272,10187
5/23/2014,2014,5,23, 19 ,7686,1559,1279,10524
5/23/2014,2014,5,23, 20 ,7650,1524,1254,10428
5/23/2014,2014,5,23, 21 ,7531,1486,1245,10262
5/23/2014,2014,5,23, 22 ,7373,1402,1148,9923
5/23/2014,2014,5,23, 23 ,7018,1286,1050,9354
5/23/2014,2014,5,23, 24 ,6602,1201,985,8788
5/24/2014,2014,5,24, 1 ,6351,1165,930,8446
5/24/2014,2014,5,24, 2 ,6023,1109,904,8036
5/24/2014,2014,5,24, 3 ,5937,1087,874,7898
5/24/2014,2014,5,24, 4 ,5724,1065,866,7655
5/24/2014,2014,5,24, 5 ,5694,1051,880,7625
5/24/2014,2014,5,24, 6 ,5379,1016,861,7256
5/24/2014,2014,5,24, 7 ,5526,1055,870,7451
5/24/2014,2014,5,24, 8 ,6151,1169,964,8284
5/24/2014,2014,5,24, 9 ,6664,1314,1088,9066
5/24/2014,2014,5,24, 10 ,7215,1394,1182,9791
5/24/2014,2014,5,24, 11 ,7534,1447,1243,10224
5/24/2014,2014,5,24, 12 ,7412,1409,1212,10033
5/24/2014,2014,5,24, 13 ,7454,1418,1223,10095
5/24/2014,2014,5,24, 14 ,7695,1461,1234,10390
5/24/2014,2014,5,24, 15 ,7457,1435,1200,10092
5/24/2014,2014,5,24, 16 ,7204,1383,1170,9757
5/24/2014,2014,5,24, 17 ,6803,1321,1155,9279
5/24/2014,2014,5,24, 18 ,6651,1373,1239,9263
5/24/2014,2014,5,24, 19 ,7256,1520,1292,10068
5/24/2014,2014,5,24, 20 ,7307,1503,1268,10078
5/24/2014,2014,5,24, 21 ,7326,1462,1213,10001
5/24/2014,2014,5,24, 22 ,7069,1366,1100,9535
5/24/2014,2014,5,24, 23 ,6801,1277,1017,9095
5/24/2014,2014,5,24, 24 ,6444,1199,936,8579
5/25/2014,2014,5,25, 1 ,6204,1158,898,8260
5/25/2014,2014,5,25, 2 ,5958,1124,873,7955
5/25/2014,2014,5,25, 3 ,5712,1088,848,7648
5/25/2014,2014,5,25, 4 ,5570,1066,857,7493
5/25/2014,2014,5,25, 5 ,5492,1054,845,7391
5/25/2014,2014,5,25, 6 ,5102,993,832,6927
5/25/2014,2014,5,25, 7 ,5141,1002,830,6973
5/25/2014,2014,5,25, 8 ,5413,1063,870,7346
5/25/2014,2014,5,25, 9 ,5848,1151,957,7956
5/25/2014,2014,5,25, 10 ,6324,1231,1034,8589
5/25/2014,2014,5,25, 11 ,6570,1255,1079,8904
5/25/2014,2014,5,25, 12 ,6522,1220,1094,8836
5/25/2014,2014,5,25, 13 ,6514,1200,1079,8793
5/25/2014,2014,5,25, 14 ,6607,1196,1074,8877
5/25/2014,2014,5,25, 15 ,6510,1180,1070,8760
5/25/2014,2014,5,25, 16 ,6400,1164,1028,8592
5/25/2014,2014,5,25, 17 ,6025,1166,1063,8254
5/25/2014,2014,5,25, 18 ,6202,1273,1155,8630
5/25/2014,2014,5,25, 19 ,6871,1407,1188,9466
5/25/2014,2014,5,25, 20 ,6890,1407,1190,9487
5/25/2014,2014,5,25, 21 ,6807,1335,1136,9278
5/25/2014,2014,5,25, 22 ,6507,1259,1059,8825
5/25/2014,2014,5,25, 23 ,6348,1181,999,8528
5/25/2014,2014,5,25, 24 ,6039,1116,927,8082
5/26/2014,2014,5,26, 1 ,5751,1067,885,7703
5/26/2014,2014,5,26, 2 ,5528,1036,854,7418
5/26/2014,2014,5,26, 3 ,5386,1012,827,7225
5/26/2014,2014,5,26, 4 ,5198,988,829,7015
5/26/2014,2014,5,26, 5 ,5239,997,840,7076
5/26/2014,2014,5,26, 6 ,5161,985,850,6996
5/26/2014,2014,5,26, 7 ,5641,1031,871,7543
5/26/2014,2014,5,26, 8 ,6570,1212,988,8770
5/26/2014,2014,5,26, 9 ,7388,1412,1151,9951
5/26/2014,2014,5,26, 10 ,7979,1533,1250,10762
5/26/2014,2014,5,26, 11 ,8272,1571,1282,11125
5/26/2014,2014,5,26, 12 ,8172,1542,1223,10937
5/26/2014,2014,5,26, 13 ,8215,1563,1245,11023
5/26/2014,2014,5,26, 14 ,8515,1541,1279,11335
5/26/2014,2014,5,26, 15 ,8403,1599,1244,11246
5/26/2014,2014,5,26, 16 ,8046,1550,1265,10861
5/26/2014,2014,5,26, 17 ,7407,1479,1223,10109
5/26/2014,2014,5,26, 18 ,7229,1477,1263,9969
5/26/2014,2014,5,26, 19 ,7454,1595,1314,10363
5/26/2014,2014,5,26, 20 ,7516,1555,1296,10367
5/26/2014,2014,5,26, 21 ,7365,1523,1270,10158
5/26/2014,2014,5,26, 22 ,7069,1426,1195,9690
5/26/2014,2014,5,26, 23 ,6713,1314,1087,9114
5/26/2014,2014,5,26, 24 ,6294,1228,1027,8549
5/27/2014,2014,5,27, 1 ,6041,1172,955,8168
5/27/2014,2014,5,27, 2 ,5851,1134,929,7914
5/27/2014,2014,5,27, 3 ,5680,1102,905,7687
5/27/2014,2014,5,27, 4 ,5516,1081,900,7497
5/27/2014,2014,5,27, 5 ,5520,1080,911,7511
5/27/2014,2014,5,27, 6 ,5369,1055,905,7329
5/27/2014,2014,5,27, 7 ,5701,1092,898,7691
5/27/2014,2014,5,27, 8 ,6614,1258,1090,8962
5/27/2014,2014,5,27, 9 ,7415,1466,1216,10097
5/27/2014,2014,5,27, 10 ,7924,1565,1293,10782
5/27/2014,2014,5,27, 11 ,8173,1618,1315,11106
5/27/2014,2014,5,27, 12 ,8116,1561,1268,10945
5/27/2014,2014,5,27, 13 ,8166,1586,1310,11062
5/27/2014,2014,5,27, 14 ,8351,1636,1339,11326
5/27/2014,2014,5,27, 15 ,8086,1595,1286,10967
5/27/2014,2014,5,27, 16 ,7879,1537,1259,10675
5/27/2014,2014,5,27, 17 ,7581,1468,1229,10278
5/27/2014,2014,5,27, 18 ,7345,1483,1273,10101
5/27/2014,2014,5,27, 19 ,7670,1567,1310,10547
5/27/2014,2014,5,27, 20 ,7569,1546,1280,10395
5/27/2014,2014,5,27, 21 ,7474,1481,1268,10223
5/27/2014,2014,5,27, 22 ,7312,1415,1212,9939
5/27/2014,2014,5,27, 23 ,6859,1287,1113,9259
5/27/2014,2014,5,27, 24 ,6530,1200,1028,8758
5/28/2014,2014,5,28, 1 ,6212,1155,984,8351
5/28/2014,2014,5,28, 2 ,6032,1114,953,8099
5/28/2014,2014,5,28, 3 ,5842,1086,922,7850
5/28/2014,2014,5,28, 4 ,5668,1063,907,7638
5/28/2014,2014,5,28, 5 ,5611,1064,932,7607
5/28/2014,2014,5,28, 6 ,5472,1041,912,7425
5/28/2014,2014,5,28, 7 ,5832,1057,919,7808
5/28/2014,2014,5,28, 8 ,6699,1232,1064,8995
5/28/2014,2014,5,28, 9 ,7499,1435,1223,10157
5/28/2014,2014,5,28, 10 ,8017,1541,1304,10862
5/28/2014,2014,5,28, 11 ,8214,1567,1303,11084
5/28/2014,2014,5,28, 12 ,8129,1519,1300,10948
5/28/2014,2014,5,28, 13 ,8091,1511,1321,10923
5/28/2014,2014,5,28, 14 ,8273,1540,1351,11164
5/28/2014,2014,5,28, 15 ,8151,1483,1299,10933
5/28/2014,2014,5,28, 16 ,7913,1477,1270,10660
5/28/2014,2014,5,28, 17 ,7622,1417,1243,10282
5/28/2014,2014,5,28, 18 ,7322,1435,1294,10051
5/28/2014,2014,5,28, 19 ,7666,1542,1267,10475
5/28/2014,2014,5,28, 20 ,7675,1517,1261,10453
5/28/2014,2014,5,28, 21 ,7540,1459,1211,10210
5/28/2014,2014,5,28, 22 ,7377,1378,1141,9896
5/28/2014,2014,5,28, 23 ,7063,1261,1065,9389
5/28/2014,2014,5,28, 24 ,6653,1181,985,8819
5/29/2014,2014,5,29, 1 ,6326,1119,949,8394
5/29/2014,2014,5,29, 2 ,6133,1089,923,8145
5/29/2014,2014,5,29, 3 ,5908,1060,892,7860
5/29/2014,2014,5,29, 4 ,5778,1037,885,7700
5/29/2014,2014,5,29, 5 ,5741,1036,901,7678
5/29/2014,2014,5,29, 6 ,5627,1019,905,7551
5/29/2014,2014,5,29, 7 ,5896,1057,872,7825
5/29/2014,2014,5,29, 8 ,6768,1236,1027,9031
5/29/2014,2014,5,29, 9 ,7468,1425,1192,10085
5/29/2014,2014,5,29, 10 ,7931,1537,1319,10787
5/29/2014,2014,5,29, 11 ,8268,1577,1329,11174
5/29/2014,2014,5,29, 12 ,8185,1538,1292,11015
5/29/2014,2014,5,29, 13 ,8150,1533,1306,10989
5/29/2014,2014,5,29, 14 ,8251,1564,1341,11156
5/29/2014,2014,5,29, 15 ,7984,1537,1291,10812
5/29/2014,2014,5,29, 16 ,7773,1490,1295,10558
5/29/2014,2014,5,29, 17 ,7381,1422,1254,10057
5/29/2014,2014,5,29, 18 ,7272,1434,1280,9986
5/29/2014,2014,5,29, 19 ,7591,1555,1275,10421
5/29/2014,2014,5,29, 20 ,7548,1520,1251,10319
5/29/2014,2014,5,29, 21 ,7426,1465,1226,10117
5/29/2014,2014,5,29, 22 ,7165,1379,1149,9693
5/29/2014,2014,5,29, 23 ,6873,1268,1045,9186
5/29/2014,2014,5,29, 24 ,6514,1186,985,8685
5/30/2014,2014,5,30, 1 ,6191,1133,948,8272
5/30/2014,2014,5,30, 2 ,6024,1099,913,8036
5/30/2014,2014,5,30, 3 ,5733,1057,883,7673
5/30/2014,2014,5,30, 4 ,5675,1040,877,7592
5/30/2014,2014,5,30, 5 ,5679,1036,894,7609
5/30/2014,2014,5,30, 6 ,5465,1016,904,7385
5/30/2014,2014,5,30, 7 ,5716,1043,898,7657
5/30/2014,2014,5,30, 8 ,6577,1202,1027,8806
5/30/2014,2014,5,30, 9 ,7388,1402,1171,9961
5/30/2014,2014,5,30, 10 ,7918,1481,1252,10651
5/30/2014,2014,5,30, 11 ,8220,1547,1277,11044
5/30/2014,2014,5,30, 12 ,8130,1502,1250,10882
5/30/2014,2014,5,30, 13 ,8104,1489,1273,10866
5/30/2014,2014,5,30, 14 ,8344,1536,1284,11164
5/30/2014,2014,5,30, 15 ,8149,1506,1255,10910
5/30/2014,2014,5,30, 16 ,7974,1498,1239,10711
5/30/2014,2014,5,30, 17 ,7694,1396,1225,10315
5/30/2014,2014,5,30, 18 ,7274,1409,1273,9956
5/30/2014,2014,5,30, 19 ,7503,1534,1269,10306
5/30/2014,2014,5,30, 20 ,7454,1501,1211,10166
5/30/2014,2014,5,30, 21 ,7374,1447,1186,10007
5/30/2014,2014,5,30, 22 ,7288,1351,1134,9773
5/30/2014,2014,5,30, 23 ,6876,1251,1027,9154
5/30/2014,2014,5,30, 24 ,6553,1172,942,8667
5/31/2014,2014,5,31, 1 ,6286,1120,920,8326
5/31/2014,2014,5,31, 2 ,6039,1075,888,8002
5/31/2014,2014,5,31, 3 ,5930,1046,861,7837
5/31/2014,2014,5,31, 4 ,5728,1027,850,7605
5/31/2014,2014,5,31, 5 ,5593,1023,860,7476
5/31/2014,2014,5,31, 6 ,5327,987,847,7161
5/31/2014,2014,5,31, 7 ,5466,1009,837,7312
5/31/2014,2014,5,31, 8 ,6070,1118,913,8101
5/31/2014,2014,5,31, 9 ,6713,1265,1050,9028
5/31/2014,2014,5,31, 10 ,7238,1357,1089,9684
5/31/2014,2014,5,31, 11 ,7590,1413,1162,10165
5/31/2014,2014,5,31, 12 ,7490,1368,1160,10018
5/31/2014,2014,5,31, 13 ,7483,1380,1184,10047
5/31/2014,2014,5,31, 14 ,7672,1417,1218,10307
5/31/2014,2014,5,31, 15 ,7545,1372,1190,10107
5/31/2014,2014,5,31, 16 ,7117,1323,1147,9587
5/31/2014,2014,5,31, 17 ,6798,1271,1140,9209
5/31/2014,2014,5,31, 18 ,6626,1319,1255,9200
5/31/2014,2014,5,31, 19 ,7258,1470,1310,10038
5/31/2014,2014,5,31, 20 ,7296,1454,1292,10042
5/31/2014,2014,5,31, 21 ,7319,1383,1259,9961
5/31/2014,2014,5,31, 22 ,7116,1321,1166,9603
5/31/2014,2014,5,31, 23 ,6824,1223,1060,9107
5/31/2014,2014,5,31, 24 ,6469,1145,1039,8653
6/1/2014,2014,6,1, 1 ,6168,1089,919,8176
6/1/2014,2014,6,1, 2 ,6009,1033,879,7921
6/1/2014,2014,6,1, 3 ,5792,1009,857,7658
6/1/2014,2014,6,1, 4 ,5578,1002,843,7423
6/1/2014,2014,6,1, 5 ,5457,989,845,7291
6/1/2014,2014,6,1, 6 ,5072,945,827,6844
6/1/2014,2014,6,1, 7 ,5049,957,801,6807
6/1/2014,2014,6,1, 8 ,5355,1011,863,7229
6/1/2014,2014,6,1, 9 ,5794,1102,958,7854
6/1/2014,2014,6,1, 10 ,6288,1189,1033,8510
6/1/2014,2014,6,1, 11 ,6537,1237,1102,8876
6/1/2014,2014,6,1, 12 ,6604,1253,1123,8980
6/1/2014,2014,6,1, 13 ,6601,1250,1102,8953
6/1/2014,2014,6,1, 14 ,6673,1252,1106,9031
6/1/2014,2014,6,1, 15 ,6566,1229,1086,8881
6/1/2014,2014,6,1, 16 ,6405,1200,1054,8659
6/1/2014,2014,6,1, 17 ,6216,1166,1071,8453
6/1/2014,2014,6,1, 18 ,6279,1268,1169,8716
6/1/2014,2014,6,1, 19 ,6904,1466,1268,9638
6/1/2014,2014,6,1, 20 ,7005,1441,1254,9700
6/1/2014,2014,6,1, 21 ,6999,1387,1169,9555
6/1/2014,2014,6,1, 22 ,6841,1291,1101,9233
6/1/2014,2014,6,1, 23 ,6630,1228,1016,8874
6/1/2014,2014,6,1, 24 ,6254,1138,953,8345
6/2/2014,2014,6,2, 1 ,5977,1068,891,7936
6/2/2014,2014,6,2, 2 ,5745,1044,861,7650
6/2/2014,2014,6,2, 3 ,5572,1015,837,7424
6/2/2014,2014,6,2, 4 ,5425,1008,837,7270
6/2/2014,2014,6,2, 5 ,5522,1039,895,7456
6/2/2014,2014,6,2, 6 ,5366,1011,871,7248
6/2/2014,2014,6,2, 7 ,5659,1017,844,7520
6/2/2014,2014,6,2, 8 ,6677,1194,1018,8889
6/2/2014,2014,6,2, 9 ,7562,1389,1192,10143
6/2/2014,2014,6,2, 10 ,8029,1489,1292,10810
6/2/2014,2014,6,2, 11 ,8280,1545,1342,11167
6/2/2014,2014,6,2, 12 ,8203,1518,1334,11055
6/2/2014,2014,6,2, 13 ,8241,1517,1353,11111
6/2/2014,2014,6,2, 14 ,8589,1578,1357,11524
6/2/2014,2014,6,2, 15 ,8460,1550,1327,11337
6/2/2014,2014,6,2, 16 ,8185,1521,1313,11019
6/2/2014,2014,6,2, 17 ,7756,1433,1278,10467
6/2/2014,2014,6,2, 18 ,7662,1433,1319,10414
6/2/2014,2014,6,2, 19 ,7849,1554,1361,10764
6/2/2014,2014,6,2, 20 ,7842,1537,1329,10708
6/2/2014,2014,6,2, 21 ,7741,1475,1273,10489
6/2/2014,2014,6,2, 22 ,7568,1378,1192,10138
6/2/2014,2014,6,2, 23 ,7224,1256,1066,9546
6/2/2014,2014,6,2, 24 ,6753,1183,996,8932
6/3/2014,2014,6,3, 1 ,6488,1141,944,8573
6/3/2014,2014,6,3, 2 ,6283,1113,921,8317
6/3/2014,2014,6,3, 3 ,6088,1082,900,8070
6/3/2014,2014,6,3, 4 ,6011,1062,892,7965
6/3/2014,2014,6,3, 5 ,6065,1084,941,8090
6/3/2014,2014,6,3, 6 ,5773,1052,925,7750
6/3/2014,2014,6,3, 7 ,5935,1050,882,7867
6/3/2014,2014,6,3, 8 ,6862,1223,1027,9112
6/3/2014,2014,6,3, 9 ,7671,1422,1218,10311
6/3/2014,2014,6,3, 10 ,8044,1495,1258,10797
6/3/2014,2014,6,3, 11 ,8251,1539,1299,11089
6/3/2014,2014,6,3, 12 ,8164,1504,1285,10953
6/3/2014,2014,6,3, 13 ,8174,1524,1299,10997
6/3/2014,2014,6,3, 14 ,8492,1559,1323,11374
6/3/2014,2014,6,3, 15 ,8263,1509,1300,11072
6/3/2014,2014,6,3, 16 ,8101,1473,1282,10856
6/3/2014,2014,6,3, 17 ,7702,1435,1231,10368
6/3/2014,2014,6,3, 18 ,7450,1447,1286,10183
6/3/2014,2014,6,3, 19 ,7813,1578,1291,10682
6/3/2014,2014,6,3, 20 ,7672,1548,1284,10504
6/3/2014,2014,6,3, 21 ,7519,1469,1223,10211
6/3/2014,2014,6,3, 22 ,7308,1374,1148,9830
6/3/2014,2014,6,3, 23 ,6848,1256,1041,9145
6/3/2014,2014,6,3, 24 ,6523,1179,976,8678
6/4/2014,2014,6,4, 1 ,6181,1133,932,8246
6/4/2014,2014,6,4, 2 ,6015,1095,905,8015
6/4/2014,2014,6,4, 3 ,5832,1064,856,7752
6/4/2014,2014,6,4, 4 ,5650,1043,859,7552
6/4/2014,2014,6,4, 5 ,5699,1068,915,7682
6/4/2014,2014,6,4, 6 ,5559,1040,898,7497
6/4/2014,2014,6,4, 7 ,5728,1045,855,7628
6/4/2014,2014,6,4, 8 ,6636,1215,1007,8858
6/4/2014,2014,6,4, 9 ,7542,1406,1185,10133
6/4/2014,2014,6,4, 10 ,7966,1501,1227,10694
6/4/2014,2014,6,4, 11 ,8306,1547,1254,11107
6/4/2014,2014,6,4, 12 ,8197,1533,1247,10977
6/4/2014,2014,6,4, 13 ,8099,1489,1270,10858
6/4/2014,2014,6,4, 14 ,8330,1564,1307,11201
6/4/2014,2014,6,4, 15 ,8207,1532,1300,11039
6/4/2014,2014,6,4, 16 ,8022,1487,1290,10799
6/4/2014,2014,6,4, 17 ,7621,1416,1250,10287
6/4/2014,2014,6,4, 18 ,7414,1421,1296,10131
6/4/2014,2014,6,4, 19 ,7707,1569,1324,10600
6/4/2014,2014,6,4, 20 ,7578,1541,1306,10425
6/4/2014,2014,6,4, 21 ,7447,1484,1264,10195
6/4/2014,2014,6,4, 22 ,7279,1397,1187,9863
6/4/2014,2014,6,4, 23 ,6802,1276,1096,9174
6/4/2014,2014,6,4, 24 ,6427,1189,1021,8637
6/5/2014,2014,6,5, 1 ,6098,1132,931,8161
6/5/2014,2014,6,5, 2 ,5992,1081,938,8011
6/5/2014,2014,6,5, 3 ,5772,1028,911,7711
6/5/2014,2014,6,5, 4 ,5705,1020,899,7624
6/5/2014,2014,6,5, 5 ,5756,1050,958,7764
6/5/2014,2014,6,5, 6 ,5561,1032,932,7525
6/5/2014,2014,6,5, 7 ,5725,1021,883,7629
6/5/2014,2014,6,5, 8 ,6682,1170,1037,8889
6/5/2014,2014,6,5, 9 ,7545,1381,1219,10145
6/5/2014,2014,6,5, 10 ,8034,1456,1310,10800
6/5/2014,2014,6,5, 11 ,8250,1514,1363,11127
6/5/2014,2014,6,5, 12 ,7983,1531,1338,10852
6/5/2014,2014,6,5, 13 ,7768,1509,1350,10627
6/5/2014,2014,6,5, 14 ,7952,1561,1396,10909
6/5/2014,2014,6,5, 15 ,7859,1514,1381,10754
6/5/2014,2014,6,5, 16 ,7757,1493,1355,10605
6/5/2014,2014,6,5, 17 ,7480,1437,1302,10219
6/5/2014,2014,6,5, 18 ,7282,1454,1344,10080
6/5/2014,2014,6,5, 19 ,7602,1567,1392,10561
6/5/2014,2014,6,5, 20 ,7574,1532,1362,10468
6/5/2014,2014,6,5, 21 ,7411,1479,1315,10205
6/5/2014,2014,6,5, 22 ,7221,1375,1228,9824
6/5/2014,2014,6,5, 23 ,6819,1268,1118,9205
6/5/2014,2014,6,5, 24 ,6459,1169,1035,8663
6/6/2014,2014,6,6, 1 ,6158,1121,980,8259
6/6/2014,2014,6,6, 2 ,5896,1075,947,7918
6/6/2014,2014,6,6, 3 ,5797,1040,937,7774
6/6/2014,2014,6,6, 4 ,5644,1037,930,7611
6/6/2014,2014,6,6, 5 ,5661,1055,973,7689
6/6/2014,2014,6,6, 6 ,5530,1028,937,7495
6/6/2014,2014,6,6, 7 ,5804,1030,905,7739
6/6/2014,2014,6,6, 8 ,6703,1207,1045,8955
6/6/2014,2014,6,6, 9 ,7405,1402,1266,10073
6/6/2014,2014,6,6, 10 ,7934,1495,1326,10755
6/6/2014,2014,6,6, 11 ,8220,1539,1387,11146
6/6/2014,2014,6,6, 12 ,8082,1491,1350,10923
6/6/2014,2014,6,6, 13 ,8088,1478,1343,10909
6/6/2014,2014,6,6, 14 ,8257,1549,1400,11206
6/6/2014,2014,6,6, 15 ,8038,1471,1353,10862
6/6/2014,2014,6,6, 16 ,7846,1440,1328,10614
6/6/2014,2014,6,6, 17 ,7520,1378,1255,10153
6/6/2014,2014,6,6, 18 ,7311,1377,1317,10005
6/6/2014,2014,6,6, 19 ,7427,1502,1333,10262
6/6/2014,2014,6,6, 20 ,7334,1471,1288,10093
6/6/2014,2014,6,6, 21 ,7335,1421,1261,10017
6/6/2014,2014,6,6, 22 ,7073,1347,1174,9594
6/6/2014,2014,6,6, 23 ,6706,1220,1073,8999
6/6/2014,2014,6,6, 24 ,6327,1150,940,8417
6/7/2014,2014,6,7, 1 ,6090,1096,947,8133
6/7/2014,2014,6,7, 2 ,5875,1063,909,7847
6/7/2014,2014,6,7, 3 ,5748,1029,900,7677
6/7/2014,2014,6,7, 4 ,5582,1012,919,7513
6/7/2014,2014,6,7, 5 ,5445,1008,912,7365
6/7/2014,2014,6,7, 6 ,5232,976,887,7095
6/7/2014,2014,6,7, 7 ,5449,1008,889,7346
6/7/2014,2014,6,7, 8 ,6017,1135,981,8133
6/7/2014,2014,6,7, 9 ,6664,1301,1070,9035
6/7/2014,2014,6,7, 10 ,7241,1375,1175,9791
6/7/2014,2014,6,7, 11 ,7565,1444,1270,10279
6/7/2014,2014,6,7, 12 ,7357,1423,1249,10029
6/7/2014,2014,6,7, 13 ,7271,1397,1280,9948
6/7/2014,2014,6,7, 14 ,7523,1435,1316,10274
6/7/2014,2014,6,7, 15 ,7296,1388,1276,9960
6/7/2014,2014,6,7, 16 ,7038,1343,1236,9617
6/7/2014,2014,6,7, 17 ,6700,1305,1206,9211
6/7/2014,2014,6,7, 18 ,6592,1346,1257,9195
6/7/2014,2014,6,7, 19 ,7210,1434,1321,9965
6/7/2014,2014,6,7, 20 ,7249,1434,1296,9979
6/7/2014,2014,6,7, 21 ,7249,1395,1248,9892
6/7/2014,2014,6,7, 22 ,7032,1305,1172,9509
6/7/2014,2014,6,7, 23 ,6687,1204,1089,8980
6/7/2014,2014,6,7, 24 ,6317,1116,1005,8438
6/8/2014,2014,6,8, 1 ,6085,1088,959,8132
6/8/2014,2014,6,8, 2 ,5858,1044,925,7827
6/8/2014,2014,6,8, 3 ,5672,1008,896,7576
6/8/2014,2014,6,8, 4 ,5463,990,882,7335
6/8/2014,2014,6,8, 5 ,5391,987,893,7271
6/8/2014,2014,6,8, 6 ,5017,948,862,6827
6/8/2014,2014,6,8, 7 ,5089,966,854,6909
6/8/2014,2014,6,8, 8 ,5464,1034,902,7400
6/8/2014,2014,6,8, 9 ,5814,1109,976,7899
6/8/2014,2014,6,8, 10 ,6262,1184,1054,8500
6/8/2014,2014,6,8, 11 ,6514,1246,1097,8857
6/8/2014,2014,6,8, 12 ,6536,1243,1133,8912
6/8/2014,2014,6,8, 13 ,6536,1258,1150,8944
6/8/2014,2014,6,8, 14 ,6523,1271,1150,8944
6/8/2014,2014,6,8, 15 ,6360,1244,1124,8728
6/8/2014,2014,6,8, 16 ,6213,1199,1098,8510
6/8/2014,2014,6,8, 17 ,6116,1191,1092,8399
6/8/2014,2014,6,8, 18 ,6248,1328,1204,8780
6/8/2014,2014,6,8, 19 ,6784,1448,1310,9542
6/8/2014,2014,6,8, 20 ,6941,1436,1293,9670
6/8/2014,2014,6,8, 21 ,6826,1383,1256,9465
6/8/2014,2014,6,8, 22 ,6609,1296,1140,9045
6/8/2014,2014,6,8, 23 ,6314,1211,1063,8588
6/8/2014,2014,6,8, 24 ,5944,1141,996,8081
6/9/2014,2014,6,9, 1 ,5651,1094,950,7695
6/9/2014,2014,6,9, 2 ,5435,1055,922,7412
6/9/2014,2014,6,9, 3 ,5260,1028,892,7180
6/9/2014,2014,6,9, 4 ,5138,1016,892,7046
6/9/2014,2014,6,9, 5 ,5296,1049,954,7299
6/9/2014,2014,6,9, 6 ,5229,1028,913,7170
6/9/2014,2014,6,9, 7 ,5447,1001,878,7326
6/9/2014,2014,6,9, 8 ,6460,1183,1057,8700
6/9/2014,2014,6,9, 9 ,7303,1404,1218,9925
6/9/2014,2014,6,9, 10 ,7898,1501,1336,10735
6/9/2014,2014,6,9, 11 ,8091,1572,1379,11042
6/9/2014,2014,6,9, 12 ,7876,1519,1348,10743
6/9/2014,2014,6,9, 13 ,7877,1519,1349,10745
6/9/2014,2014,6,9, 14 ,8016,1577,1401,10994
6/9/2014,2014,6,9, 15 ,7771,1557,1354,10682
6/9/2014,2014,6,9, 16 ,7624,1509,1331,10464
6/9/2014,2014,6,9, 17 ,7336,1446,1284,10066
6/9/2014,2014,6,9, 18 ,7132,1474,1331,9937
6/9/2014,2014,6,9, 19 ,7517,1575,1363,10455
6/9/2014,2014,6,9, 20 ,7432,1548,1357,10337
6/9/2014,2014,6,9, 21 ,7419,1513,1301,10233
6/9/2014,2014,6,9, 22 ,7069,1400,1182,9651
6/9/2014,2014,6,9, 23 ,6623,1266,1072,8961
6/9/2014,2014,6,9, 24 ,6175,1191,990,8356
6/10/2014,2014,6,10, 1 ,5897,1140,936,7973
6/10/2014,2014,6,10, 2 ,5739,1100,899,7738
6/10/2014,2014,6,10, 3 ,5437,1071,882,7390
6/10/2014,2014,6,10, 4 ,5398,1058,869,7325
6/10/2014,2014,6,10, 5 ,5498,1088,918,7504
6/10/2014,2014,6,10, 6 ,5242,1063,909,7214
6/10/2014,2014,6,10, 7 ,5525,1040,831,7396
6/10/2014,2014,6,10, 8 ,6344,1216,990,8550
6/10/2014,2014,6,10, 9 ,7130,1405,1140,9675
6/10/2014,2014,6,10, 10 ,7657,1494,1262,10413
6/10/2014,2014,6,10, 11 ,7802,1544,1304,10650
6/10/2014,2014,6,10, 12 ,7612,1503,1275,10390
6/10/2014,2014,6,10, 13 ,7524,1503,1285,10312
6/10/2014,2014,6,10, 14 ,7691,1505,1351,10547
6/10/2014,2014,6,10, 15 ,7387,1511,1275,10173
6/10/2014,2014,6,10, 16 ,7474,1485,1254,10213
6/10/2014,2014,6,10, 17 ,7204,1428,1258,9890
6/10/2014,2014,6,10, 18 ,7059,1431,1329,9819
6/10/2014,2014,6,10, 19 ,7455,1571,1363,10389
6/10/2014,2014,6,10, 20 ,7324,1540,1333,10197
6/10/2014,2014,6,10, 21 ,7059,1466,1288,9813
6/10/2014,2014,6,10, 22 ,6746,1345,1195,9286
6/10/2014,2014,6,10, 23 ,6348,1251,1088,8687
6/10/2014,2014,6,10, 24 ,5948,1172,992,8112
6/11/2014,2014,6,11, 1 ,5692,1127,965,7784
6/11/2014,2014,6,11, 2 ,5488,1092,928,7508
6/11/2014,2014,6,11, 3 ,5324,1057,905,7286
6/11/2014,2014,6,11, 4 ,5299,1038,902,7239
6/11/2014,2014,6,11, 5 ,5381,1073,958,7412
6/11/2014,2014,6,11, 6 ,5366,1053,945,7364
6/11/2014,2014,6,11, 7 ,5549,1037,883,7469
6/11/2014,2014,6,11, 8 ,6482,1221,1051,8754
6/11/2014,2014,6,11, 9 ,7243,1413,1228,9884
6/11/2014,2014,6,11, 10 ,7753,1521,1317,10591
6/11/2014,2014,6,11, 11 ,7714,1545,1389,10648
6/11/2014,2014,6,11, 12 ,7481,1492,1350,10323
6/11/2014,2014,6,11, 13 ,7403,1484,1349,10236
6/11/2014,2014,6,11, 14 ,7505,1552,1394,10451
6/11/2014,2014,6,11, 15 ,7269,1485,1375,10129
6/11/2014,2014,6,11, 16 ,7156,1486,1337,9979
6/11/2014,2014,6,11, 17 ,6915,1413,1293,9621
6/11/2014,2014,6,11, 18 ,6835,1442,1336,9613
6/11/2014,2014,6,11, 19 ,7053,1562,1312,9927
6/11/2014,2014,6,11, 20 ,6977,1505,1260,9742
6/11/2014,2014,6,11, 21 ,6772,1439,1217,9428
6/11/2014,2014,6,11, 22 ,6520,1354,1113,8987
6/11/2014,2014,6,11, 23 ,6108,1238,1005,8351
6/11/2014,2014,6,11, 24 ,5821,1149,935,7905
6/12/2014,2014,6,12, 1 ,5563,1092,895,7550
6/12/2014,2014,6,12, 2 ,5410,1082,910,7402
6/12/2014,2014,6,12, 3 ,5326,1049,889,7264
6/12/2014,2014,6,12, 4 ,5179,1031,877,7087
6/12/2014,2014,6,12, 5 ,5146,1034,885,7065
6/12/2014,2014,6,12, 6 ,4940,992,866,6798
6/12/2014,2014,6,12, 7 ,5018,1015,856,6889
6/12/2014,2014,6,12, 8 ,5465,1116,956,7537
6/12/2014,2014,6,12, 9 ,5916,1240,1073,8229
6/12/2014,2014,6,12, 10 ,6331,1324,1169,8824
6/12/2014,2014,6,12, 11 ,6681,1365,1213,9259
6/12/2014,2014,6,12, 12 ,6493,1348,1221,9062
6/12/2014,2014,6,12, 13 ,6349,1364,1205,8918
6/12/2014,2014,6,12, 14 ,6356,1394,1245,8995
6/12/2014,2014,6,12, 15 ,6258,1360,1235,8853
6/12/2014,2014,6,12, 16 ,6120,1321,1189,8630
6/12/2014,2014,6,12, 17 ,6060,1277,1162,8499
6/12/2014,2014,6,12, 18 ,6302,1356,1273,8931
6/12/2014,2014,6,12, 19 ,6712,1513,1324,9549
6/12/2014,2014,6,12, 20 ,6751,1436,1287,9474
6/12/2014,2014,6,12, 21 ,6607,1387,1236,9230
6/12/2014,2014,6,12, 22 ,6345,1316,1158,8819
6/12/2014,2014,6,12, 23 ,5884,1207,1040,8131
6/12/2014,2014,6,12, 24 ,5570,1138,970,7678
6/13/2014,2014,6,13, 1 ,5254,1090,935,7279
6/13/2014,2014,6,13, 2 ,4998,1056,906,6960
6/13/2014,2014,6,13, 3 ,4922,1030,875,6827
6/13/2014,2014,6,13, 4 ,4831,1014,883,6728
6/13/2014,2014,6,13, 5 ,4967,1045,932,6944
6/13/2014,2014,6,13, 6 ,5014,1020,912,6946
6/13/2014,2014,6,13, 7 ,5221,1010,868,7099
6/13/2014,2014,6,13, 8 ,6086,1191,1026,8303
6/13/2014,2014,6,13, 9 ,6863,1389,1206,9458
6/13/2014,2014,6,13, 10 ,7315,1490,1307,10112
6/13/2014,2014,6,13, 11 ,7479,1549,1379,10407
6/13/2014,2014,6,13, 12 ,7286,1492,1340,10118
6/13/2014,2014,6,13, 13 ,7276,1463,1319,10058
6/13/2014,2014,6,13, 14 ,7559,1539,1374,10472
6/13/2014,2014,6,13, 15 ,7393,1508,1329,10230
6/13/2014,2014,6,13, 16 ,7325,1471,1300,10096
6/13/2014,2014,6,13, 17 ,7042,1394,1260,9696
6/13/2014,2014,6,13, 18 ,6858,1419,1296,9573
6/13/2014,2014,6,13, 19 ,7171,1519,1333,10023
6/13/2014,2014,6,13, 20 ,7074,1482,1274,9830
6/13/2014,2014,6,13, 21 ,6886,1424,1227,9537
6/13/2014,2014,6,13, 22 ,6634,1348,1171,9153
6/13/2014,2014,6,13, 23 ,6206,1210,1039,8455
6/13/2014,2014,6,13, 24 ,5836,1131,967,7934
6/14/2014,2014,6,14, 1 ,5522,1081,931,7534
6/14/2014,2014,6,14, 2 ,5467,1050,899,7416
6/14/2014,2014,6,14, 3 ,5262,1022,870,7154
6/14/2014,2014,6,14, 4 ,5175,1000,863,7038
6/14/2014,2014,6,14, 5 ,5091,1000,868,6959
6/14/2014,2014,6,14, 6 ,5023,969,869,6861
6/14/2014,2014,6,14, 7 ,5116,995,867,6978
6/14/2014,2014,6,14, 8 ,5639,1103,953,7695
6/14/2014,2014,6,14, 9 ,6285,1268,1072,8625
6/14/2014,2014,6,14, 10 ,6780,1339,1113,9232
6/14/2014,2014,6,14, 11 ,7019,1409,1203,9631
6/14/2014,2014,6,14, 12 ,6968,1393,1195,9556
6/14/2014,2014,6,14, 13 ,6956,1396,1223,9575
6/14/2014,2014,6,14, 14 ,7086,1460,1273,9819
6/14/2014,2014,6,14, 15 ,6780,1394,1224,9398
6/14/2014,2014,6,14, 16 ,6534,1334,1191,9059
6/14/2014,2014,6,14, 17 ,6388,1284,1157,8829
6/14/2014,2014,6,14, 18 ,6418,1329,1233,8980
6/14/2014,2014,6,14, 19 ,6864,1481,1332,9677
6/14/2014,2014,6,14, 20 ,6867,1461,1306,9634
6/14/2014,2014,6,14, 21 ,6783,1397,1250,9430
6/14/2014,2014,6,14, 22 ,6563,1303,1151,9017
6/14/2014,2014,6,14, 23 ,6223,1201,1034,8458
6/14/2014,2014,6,14, 24 ,5922,1132,963,8017
6/15/2014,2014,6,15, 1 ,5635,1071,920,7626
6/15/2014,2014,6,15, 2 ,5420,1043,895,7358
6/15/2014,2014,6,15, 3 ,5255,1023,869,7147
6/15/2014,2014,6,15, 4 ,5107,1000,852,6959
6/15/2014,2014,6,15, 5 ,5004,982,863,6849
6/15/2014,2014,6,15, 6 ,4837,942,834,6613
6/15/2014,2014,6,15, 7 ,4889,954,821,6664
6/15/2014,2014,6,15, 8 ,5195,995,851,7041
6/15/2014,2014,6,15, 9 ,5638,1081,944,7663
6/15/2014,2014,6,15, 10 ,6108,1150,1023,8281
6/15/2014,2014,6,15, 11 ,6366,1192,1064,8622
6/15/2014,2014,6,15, 12 ,6421,1203,1089,8713
6/15/2014,2014,6,15, 13 ,6387,1208,1092,8687
6/15/2014,2014,6,15, 14 ,6413,1215,1118,8746
6/15/2014,2014,6,15, 15 ,6326,1193,1092,8611
6/15/2014,2014,6,15, 16 ,6030,1153,1050,8233
6/15/2014,2014,6,15, 17 ,5988,1135,1074,8197
6/15/2014,2014,6,15, 18 ,6066,1247,1168,8481
6/15/2014,2014,6,15, 19 ,6675,1434,1273,9382
6/15/2014,2014,6,15, 20 ,6801,1411,1248,9460
6/15/2014,2014,6,15, 21 ,6825,1353,1182,9360
6/15/2014,2014,6,15, 22 ,6579,1257,1092,8928
6/15/2014,2014,6,15, 23 ,6314,1167,1001,8482
6/15/2014,2014,6,15, 24 ,5958,1098,916,7972
6/16/2014,2014,6,16, 1 ,5716,1054,878,7648
6/16/2014,2014,6,16, 2 ,5447,1012,857,7316
6/16/2014,2014,6,16, 3 ,5272,977,838,7087
6/16/2014,2014,6,16, 4 ,5204,969,829,7002
6/16/2014,2014,6,16, 5 ,5303,1007,891,7201
6/16/2014,2014,6,16, 6 ,5188,996,890,7074
6/16/2014,2014,6,16, 7 ,5555,979,840,7374
6/16/2014,2014,6,16, 8 ,6526,1163,991,8680
6/16/2014,2014,6,16, 9 ,7310,1379,1172,9861
6/16/2014,2014,6,16, 10 ,7900,1475,1279,10654
6/16/2014,2014,6,16, 11 ,8062,1529,1345,10936
6/16/2014,2014,6,16, 12 ,7998,1479,1303,10780
6/16/2014,2014,6,16, 13 ,7971,1478,1290,10739
6/16/2014,2014,6,16, 14 ,8285,1542,1323,11150
6/16/2014,2014,6,16, 15 ,8128,1511,1276,10915
6/16/2014,2014,6,16, 16 ,7943,1504,1263,10710
6/16/2014,2014,6,16, 17 ,7461,1408,1256,10125
6/16/2014,2014,6,16, 18 ,7302,1411,1305,10018
6/16/2014,2014,6,16, 19 ,7699,1576,1344,10619
6/16/2014,2014,6,16, 20 ,7688,1512,1285,10485
6/16/2014,2014,6,16, 21 ,7537,1459,1217,10213
6/16/2014,2014,6,16, 22 ,7311,1350,1105,9766
6/16/2014,2014,6,16, 23 ,6930,1236,1007,9173
6/16/2014,2014,6,16, 24 ,6444,1156,948,8548
6/17/2014,2014,6,17, 1 ,6209,1107,906,8222
6/17/2014,2014,6,17, 2 ,5982,1078,871,7931
6/17/2014,2014,6,17, 3 ,5765,1051,857,7673
6/17/2014,2014,6,17, 4 ,5738,1037,853,7628
6/17/2014,2014,6,17, 5 ,5745,1070,918,7733
6/17/2014,2014,6,17, 6 ,5596,1045,921,7562
6/17/2014,2014,6,17, 7 ,5765,1021,856,7642
6/17/2014,2014,6,17, 8 ,6762,1173,991,8926
6/17/2014,2014,6,17, 9 ,7405,1364,1157,9926
6/17/2014,2014,6,17, 10 ,7771,1443,1239,10453
6/17/2014,2014,6,17, 11 ,7982,1480,1282,10744
6/17/2014,2014,6,17, 12 ,8017,1451,1228,10696
6/17/2014,2014,6,17, 13 ,8112,1446,1196,10754
6/17/2014,2014,6,17, 14 ,8449,1495,1228,11172
6/17/2014,2014,6,17, 15 ,8161,1453,1205,10819
6/17/2014,2014,6,17, 16 ,7926,1416,1195,10537
6/17/2014,2014,6,17, 17 ,7633,1380,1226,10239
6/17/2014,2014,6,17, 18 ,7368,1435,1269,10072
6/17/2014,2014,6,17, 19 ,7543,1496,1300,10339
6/17/2014,2014,6,17, 20 ,7533,1446,1247,10226
6/17/2014,2014,6,17, 21 ,7445,1370,1169,9984
6/17/2014,2014,6,17, 22 ,7124,1251,1074,9449
6/17/2014,2014,6,17, 23 ,6747,1155,973,8875
6/17/2014,2014,6,17, 24 ,6317,1084,907,8308
6/18/2014,2014,6,18, 1 ,6087,1045,880,8012
6/18/2014,2014,6,18, 2 ,5867,1013,846,7726
6/18/2014,2014,6,18, 3 ,5677,980,832,7489
6/18/2014,2014,6,18, 4 ,5604,973,830,7407
6/18/2014,2014,6,18, 5 ,5652,1010,902,7564
6/18/2014,2014,6,18, 6 ,5561,1009,918,7488
6/18/2014,2014,6,18, 7 ,5889,990,854,7733
6/18/2014,2014,6,18, 8 ,6624,1105,966,8695
6/18/2014,2014,6,18, 9 ,7381,1338,1119,9838
6/18/2014,2014,6,18, 10 ,7897,1418,1233,10548
6/18/2014,2014,6,18, 11 ,7972,1437,1276,10685
6/18/2014,2014,6,18, 12 ,7728,1395,1261,10384
6/18/2014,2014,6,18, 13 ,7650,1376,1269,10295
6/18/2014,2014,6,18, 14 ,7708,1408,1310,10426
6/18/2014,2014,6,18, 15 ,7547,1376,1282,10205
6/18/2014,2014,6,18, 16 ,7477,1370,1259,10106
6/18/2014,2014,6,18, 17 ,7226,1324,1218,9768
6/18/2014,2014,6,18, 18 ,7075,1380,1264,9719
6/18/2014,2014,6,18, 19 ,7357,1468,1342,10167
6/18/2014,2014,6,18, 20 ,7327,1434,1297,10058
6/18/2014,2014,6,18, 21 ,7150,1388,1247,9785
6/18/2014,2014,6,18, 22 ,6830,1256,1128,9214
6/18/2014,2014,6,18, 23 ,6428,1153,1028,8609
6/18/2014,2014,6,18, 24 ,6021,1085,938,8044
6/19/2014,2014,6,19, 1 ,5769,1037,896,7702
6/19/2014,2014,6,19, 2 ,5580,1010,880,7470
6/19/2014,2014,6,19, 3 ,5435,986,853,7274
6/19/2014,2014,6,19, 4 ,5336,977,850,7163
6/19/2014,2014,6,19, 5 ,5466,1016,925,7407
6/19/2014,2014,6,19, 6 ,5397,1007,929,7333
6/19/2014,2014,6,19, 7 ,5559,986,856,7401
6/19/2014,2014,6,19, 8 ,6430,1149,1001,8580
6/19/2014,2014,6,19, 9 ,7101,1344,1153,9598
6/19/2014,2014,6,19, 10 ,7514,1425,1257,10196
6/19/2014,2014,6,19, 11 ,7858,1458,1325,10641
6/19/2014,2014,6,19, 12 ,7647,1430,1303,10380
6/19/2014,2014,6,19, 13 ,7540,1436,1297,10273
6/19/2014,2014,6,19, 14 ,7670,1502,1364,10536
6/19/2014,2014,6,19, 15 ,7581,1452,1339,10372
6/19/2014,2014,6,19, 16 ,7490,1424,1290,10204
6/19/2014,2014,6,19, 17 ,7253,1369,1262,9884
6/19/2014,2014,6,19, 18 ,7095,1395,1293,9783
6/19/2014,2014,6,19, 19 ,7419,1494,1388,10301
6/19/2014,2014,6,19, 20 ,7378,1464,1350,10192
6/19/2014,2014,6,19, 21 ,7221,1388,1288,9897
6/19/2014,2014,6,19, 22 ,6852,1292,1175,9319
6/19/2014,2014,6,19, 23 ,6435,1179,1065,8679
6/19/2014,2014,6,19, 24 ,5965,1098,990,8053
6/20/2014,2014,6,20, 1 ,5761,1055,940,7756
6/20/2014,2014,6,20, 2 ,5601,1026,910,7537
6/20/2014,2014,6,20, 3 ,5437,993,878,7308
6/20/2014,2014,6,20, 4 ,5370,984,898,7252
6/20/2014,2014,6,20, 5 ,5523,1023,940,7486
6/20/2014,2014,6,20, 6 ,5382,1019,942,7343
6/20/2014,2014,6,20, 7 ,5517,1001,877,7395
6/20/2014,2014,6,20, 8 ,6351,1159,998,8508
6/20/2014,2014,6,20, 9 ,7025,1334,1178,9537
6/20/2014,2014,6,20, 10 ,7498,1424,1240,10162
6/20/2014,2014,6,20, 11 ,7629,1463,1315,10407
6/20/2014,2014,6,20, 12 ,7462,1428,1243,10133
6/20/2014,2014,6,20, 13 ,7441,1426,1272,10139
6/20/2014,2014,6,20, 14 ,7704,1482,1352,10538
6/20/2014,2014,6,20, 15 ,7560,1445,1319,10324
6/20/2014,2014,6,20, 16 ,7518,1415,1299,10232
6/20/2014,2014,6,20, 17 ,7115,1342,1256,9713
6/20/2014,2014,6,20, 18 ,6906,1348,1282,9536
6/20/2014,2014,6,20, 19 ,7240,1510,1353,10103
6/20/2014,2014,6,20, 20 ,7214,1471,1307,9992
6/20/2014,2014,6,20, 21 ,7070,1387,1252,9709
6/20/2014,2014,6,20, 22 ,6821,1288,1133,9242
6/20/2014,2014,6,20, 23 ,6417,1216,972,8605
6/20/2014,2014,6,20, 24 ,6075,1131,979,8185
6/21/2014,2014,6,21, 1 ,5865,1075,916,7856
6/21/2014,2014,6,21, 2 ,5611,1044,891,7546
6/21/2014,2014,6,21, 3 ,5465,1012,872,7349
6/21/2014,2014,6,21, 4 ,5314,984,857,7155
6/21/2014,2014,6,21, 5 ,5263,999,876,7138
6/21/2014,2014,6,21, 6 ,5086,966,886,6938
6/21/2014,2014,6,21, 7 ,5335,987,843,7165
6/21/2014,2014,6,21, 8 ,5957,1085,905,7947
6/21/2014,2014,6,21, 9 ,6509,1208,1000,8717
6/21/2014,2014,6,21, 10 ,6938,1277,1085,9300
6/21/2014,2014,6,21, 11 ,7198,1310,1114,9622
6/21/2014,2014,6,21, 12 ,7075,1279,1086,9440
6/21/2014,2014,6,21, 13 ,7103,1274,1084,9461
6/21/2014,2014,6,21, 14 ,7231,1298,1110,9639
6/21/2014,2014,6,21, 15 ,7031,1265,1088,9384
6/21/2014,2014,6,21, 16 ,6909,1239,1095,9243
6/21/2014,2014,6,21, 17 ,6582,1210,1077,8869
6/21/2014,2014,6,21, 18 ,6417,1275,1199,8891
6/21/2014,2014,6,21, 19 ,6957,1395,1274,9626
6/21/2014,2014,6,21, 20 ,6986,1354,1232,9572
6/21/2014,2014,6,21, 21 ,6918,1301,1180,9399
6/21/2014,2014,6,21, 22 ,6723,1204,1073,9000
6/21/2014,2014,6,21, 23 ,6385,1137,970,8492
6/21/2014,2014,6,21, 24 ,5901,1068,897,7866
6/22/2014,2014,6,22, 1 ,5739,1027,858,7624
6/22/2014,2014,6,22, 2 ,5580,988,831,7399
6/22/2014,2014,6,22, 3 ,5394,966,809,7169
6/22/2014,2014,6,22, 4 ,5310,943,790,7043
6/22/2014,2014,6,22, 5 ,5204,949,812,6965
6/22/2014,2014,6,22, 6 ,4905,920,815,6640
6/22/2014,2014,6,22, 7 ,4995,930,798,6723
6/22/2014,2014,6,22, 8 ,4995,983,818,6796
6/22/2014,2014,6,22, 9 ,5608,1064,888,7560
6/22/2014,2014,6,22, 10 ,6068,1129,968,8165
6/22/2014,2014,6,22, 11 ,6308,1179,1020,8507
6/22/2014,2014,6,22, 12 ,6220,1194,1016,8430
6/22/2014,2014,6,22, 13 ,6191,1199,999,8389
6/22/2014,2014,6,22, 14 ,6230,1190,992,8412
6/22/2014,2014,6,22, 15 ,6114,1152,1005,8271
6/22/2014,2014,6,22, 16 ,5965,1128,976,8069
6/22/2014,2014,6,22, 17 ,5784,1121,982,7887
6/22/2014,2014,6,22, 18 ,5861,1216,1114,8191
6/22/2014,2014,6,22, 19 ,6520,1384,1218,9122
6/22/2014,2014,6,22, 20 ,6656,1370,1192,9218
6/22/2014,2014,6,22, 21 ,6639,1327,1134,9100
6/22/2014,2014,6,22, 22 ,6367,1223,1012,8602
6/22/2014,2014,6,22, 23 ,6074,1143,924,8141
6/22/2014,2014,6,22, 24 ,5714,1069,890,7673
6/23/2014,2014,6,23, 1 ,5401,1027,866,7294
6/23/2014,2014,6,23, 2 ,5213,995,806,7014
6/23/2014,2014,6,23, 3 ,5062,968,783,6813
6/23/2014,2014,6,23, 4 ,4981,957,788,6726
6/23/2014,2014,6,23, 5 ,5176,1000,854,7030
6/23/2014,2014,6,23, 6 ,5120,991,868,6979
6/23/2014,2014,6,23, 7 ,5428,978,814,7220
6/23/2014,2014,6,23, 8 ,6347,1155,970,8472
6/23/2014,2014,6,23, 9 ,7041,1350,1143,9534
6/23/2014,2014,6,23, 10 ,7369,1438,1258,10065
6/23/2014,2014,6,23, 11 ,7639,1470,1322,10431
6/23/2014,2014,6,23, 12 ,7544,1455,1303,10302
6/23/2014,2014,6,23, 13 ,7506,1451,1314,10271
6/23/2014,2014,6,23, 14 ,7845,1495,1352,10692
6/23/2014,2014,6,23, 15 ,7741,1466,1342,10549
6/23/2014,2014,6,23, 16 ,7610,1412,1311,10333
6/23/2014,2014,6,23, 17 ,7264,1333,1257,9854
6/23/2014,2014,6,23, 18 ,6956,1329,1270,9555
6/23/2014,2014,6,23, 19 ,7361,1506,1390,10257
6/23/2014,2014,6,23, 20 ,7331,1464,1339,10134
6/23/2014,2014,6,23, 21 ,7229,1416,1254,9899
6/23/2014,2014,6,23, 22 ,6898,1325,1139,9362
6/23/2014,2014,6,23, 23 ,6502,1192,1050,8744
6/23/2014,2014,6,23, 24 ,6088,1093,961,8142
6/24/2014,2014,6,24, 1 ,5819,1051,909,7779
6/24/2014,2014,6,24, 2 ,5689,1021,884,7594
6/24/2014,2014,6,24, 3 ,5556,991,874,7421
6/24/2014,2014,6,24, 4 ,5400,986,821,7207
6/24/2014,2014,6,24, 5 ,5525,1026,933,7484
6/24/2014,2014,6,24, 6 ,5401,1007,930,7338
6/24/2014,2014,6,24, 7 ,5642,985,864,7491
6/24/2014,2014,6,24, 8 ,6337,1159,1010,8506
6/24/2014,2014,6,24, 9 ,7067,1368,1168,9603
6/24/2014,2014,6,24, 10 ,7608,1449,1278,10335
6/24/2014,2014,6,24, 11 ,7843,1493,1333,10669
6/24/2014,2014,6,24, 12 ,7764,1453,1316,10533
6/24/2014,2014,6,24, 13 ,7779,1469,1313,10561
6/24/2014,2014,6,24, 14 ,8053,1535,1387,10975
6/24/2014,2014,6,24, 15 ,7877,1494,1369,10740
6/24/2014,2014,6,24, 16 ,7772,1453,1344,10569
6/24/2014,2014,6,24, 17 ,7368,1384,1276,10028
6/24/2014,2014,6,24, 18 ,7058,1398,1309,9765
6/24/2014,2014,6,24, 19 ,7485,1540,1402,10427
6/24/2014,2014,6,24, 20 ,7471,1509,1353,10333
6/24/2014,2014,6,24, 21 ,7403,1450,1299,10152
6/24/2014,2014,6,24, 22 ,7189,1304,1174,9667
6/24/2014,2014,6,24, 23 ,6740,1219,1069,9028
6/24/2014,2014,6,24, 24 ,6256,1147,991,8394
6/25/2014,2014,6,25, 1 ,6035,1087,950,8072
6/25/2014,2014,6,25, 2 ,5861,1055,910,7826
6/25/2014,2014,6,25, 3 ,5634,1029,890,7553
6/25/2014,2014,6,25, 4 ,5563,1013,888,7464
6/25/2014,2014,6,25, 5 ,5636,1044,932,7612
6/25/2014,2014,6,25, 6 ,5526,1038,937,7501
6/25/2014,2014,6,25, 7 ,5728,997,870,7595
6/25/2014,2014,6,25, 8 ,6619,1144,1004,8767
6/25/2014,2014,6,25, 9 ,7245,1324,1155,9724
6/25/2014,2014,6,25, 10 ,7754,1408,1269,10431
6/25/2014,2014,6,25, 11 ,8047,1441,1314,10802
6/25/2014,2014,6,25, 12 ,7881,1389,1275,10545
6/25/2014,2014,6,25, 13 ,7867,1411,1257,10535
6/25/2014,2014,6,25, 14 ,8130,1483,1253,10866
6/25/2014,2014,6,25, 15 ,7991,1435,1228,10654
6/25/2014,2014,6,25, 16 ,7772,1404,1183,10359
6/25/2014,2014,6,25, 17 ,7413,1368,1203,9984
6/25/2014,2014,6,25, 18 ,7187,1342,1246,9775
6/25/2014,2014,6,25, 19 ,7566,1424,1298,10288
6/25/2014,2014,6,25, 20 ,7517,1327,1250,10094
6/25/2014,2014,6,25, 21 ,7454,1256,1179,9889
6/25/2014,2014,6,25, 22 ,7229,1163,1080,9472
6/25/2014,2014,6,25, 23 ,6792,1084,976,8852
6/25/2014,2014,6,25, 24 ,6327,1012,913,8252
6/26/2014,2014,6,26, 1 ,6053,959,868,7880
6/26/2014,2014,6,26, 2 ,5857,943,835,7635
6/26/2014,2014,6,26, 3 ,5642,923,813,7378
6/26/2014,2014,6,26, 4 ,5585,917,813,7315
6/26/2014,2014,6,26, 5 ,5637,961,883,7481
6/26/2014,2014,6,26, 6 ,5593,967,902,7462
6/26/2014,2014,6,26, 7 ,5708,939,840,7487
6/26/2014,2014,6,26, 8 ,6540,1061,918,8519
6/26/2014,2014,6,26, 9 ,7165,1230,1115,9510
6/26/2014,2014,6,26, 10 ,7515,1296,1230,10041
6/26/2014,2014,6,26, 11 ,7723,1344,1292,10359
6/26/2014,2014,6,26, 12 ,7547,1317,1266,10130
6/26/2014,2014,6,26, 13 ,7531,1315,1256,10102
6/26/2014,2014,6,26, 14 ,7748,1373,1328,10449
6/26/2014,2014,6,26, 15 ,7457,1345,1291,10093
6/26/2014,2014,6,26, 16 ,7215,1335,1266,9816
6/26/2014,2014,6,26, 17 ,7004,1294,1218,9516
6/26/2014,2014,6,26, 18 ,6903,1328,1252,9483
6/26/2014,2014,6,26, 19 ,7106,1426,1328,9860
6/26/2014,2014,6,26, 20 ,6952,1381,1284,9617
6/26/2014,2014,6,26, 21 ,6775,1308,1242,9325
6/26/2014,2014,6,26, 22 ,6511,1204,1138,8853
6/26/2014,2014,6,26, 23 ,6115,1088,1033,8236
6/26/2014,2014,6,26, 24 ,5735,1017,949,7701
6/27/2014,2014,6,27, 1 ,5533,991,910,7434
6/27/2014,2014,6,27, 2 ,5337,960,893,7190
6/27/2014,2014,6,27, 3 ,5174,938,864,6976
6/27/2014,2014,6,27, 4 ,5111,938,865,6914
6/27/2014,2014,6,27, 5 ,5290,981,944,7215
6/27/2014,2014,6,27, 6 ,5228,977,918,7123
6/27/2014,2014,6,27, 7 ,5404,969,865,7238
6/27/2014,2014,6,27, 8 ,6092,1122,966,8180
6/27/2014,2014,6,27, 9 ,6757,1308,1157,9222
6/27/2014,2014,6,27, 10 ,7242,1388,1248,9878
6/27/2014,2014,6,27, 11 ,7518,1437,1299,10254
6/27/2014,2014,6,27, 12 ,7423,1405,1268,10096
6/27/2014,2014,6,27, 13 ,7364,1420,1277,10061
6/27/2014,2014,6,27, 14 ,7709,1482,1337,10528
6/27/2014,2014,6,27, 15 ,7535,1449,1318,10302
6/27/2014,2014,6,27, 16 ,7378,1416,1280,10074
6/27/2014,2014,6,27, 17 ,7097,1349,1203,9649
6/27/2014,2014,6,27, 18 ,6858,1364,1238,9460
6/27/2014,2014,6,27, 19 ,7224,1488,1331,10043
6/27/2014,2014,6,27, 20 ,7161,1444,1304,9909
6/27/2014,2014,6,27, 21 ,6998,1368,1249,9615
6/27/2014,2014,6,27, 22 ,6761,1276,1167,9204
6/27/2014,2014,6,27, 23 ,6348,1177,1061,8586
6/27/2014,2014,6,27, 24 ,6006,1090,1030,8126
6/28/2014,2014,6,28, 1 ,5765,1043,935,7743
6/28/2014,2014,6,28, 2 ,5533,1012,907,7452
6/28/2014,2014,6,28, 3 ,5380,995,882,7257
6/28/2014,2014,6,28, 4 ,5319,978,859,7156
6/28/2014,2014,6,28, 5 ,5301,972,881,7154
6/28/2014,2014,6,28, 6 ,5131,935,866,6932
6/28/2014,2014,6,28, 7 ,5355,983,860,7198
6/28/2014,2014,6,28, 8 ,5875,1092,941,7908
6/28/2014,2014,6,28, 9 ,6444,1240,1070,8754
6/28/2014,2014,6,28, 10 ,6944,1306,1150,9400
6/28/2014,2014,6,28, 11 ,7193,1373,1217,9783
6/28/2014,2014,6,28, 12 ,7079,1329,1215,9623
6/28/2014,2014,6,28, 13 ,7042,1331,1212,9585
6/28/2014,2014,6,28, 14 ,7194,1381,1256,9831
6/28/2014,2014,6,28, 15 ,7040,1342,1228,9610
6/28/2014,2014,6,28, 16 ,6834,1305,1193,9332
6/28/2014,2014,6,28, 17 ,6461,1249,1159,8869
6/28/2014,2014,6,28, 18 ,6385,1268,1220,8873
6/28/2014,2014,6,28, 19 ,6962,1460,1268,9690
6/28/2014,2014,6,28, 20 ,6951,1403,1226,9580
6/28/2014,2014,6,28, 21 ,6990,1358,1185,9533
6/28/2014,2014,6,28, 22 ,6838,1277,1088,9203
6/28/2014,2014,6,28, 23 ,6437,1174,998,8609
6/28/2014,2014,6,28, 24 ,6081,1092,913,8086
6/29/2014,2014,6,29, 1 ,5816,1042,867,7725
6/29/2014,2014,6,29, 2 ,5647,1018,863,7528
6/29/2014,2014,6,29, 3 ,5459,982,847,7288
6/29/2014,2014,6,29, 4 ,5292,973,815,7080
6/29/2014,2014,6,29, 5 ,5201,966,803,6970
6/29/2014,2014,6,29, 6 ,4953,930,812,6695
6/29/2014,2014,6,29, 7 ,4985,936,765,6686
6/29/2014,2014,6,29, 8 ,5335,988,795,7118
6/29/2014,2014,6,29, 9 ,5623,1073,849,7545
6/29/2014,2014,6,29, 10 ,6089,1139,910,8138
6/29/2014,2014,6,29, 11 ,6256,1182,973,8411
6/29/2014,2014,6,29, 12 ,6200,1184,987,8371
6/29/2014,2014,6,29, 13 ,6168,1173,1004,8345
6/29/2014,2014,6,29, 14 ,6252,1142,994,8388
6/29/2014,2014,6,29, 15 ,6093,1127,977,8197
6/29/2014,2014,6,29, 16 ,5956,1104,978,8038
6/29/2014,2014,6,29, 17 ,5845,1109,962,7916
6/29/2014,2014,6,29, 18 ,5917,1185,1062,8164
6/29/2014,2014,6,29, 19 ,6537,1341,1176,9054
6/29/2014,2014,6,29, 20 ,6640,1321,1149,9110
6/29/2014,2014,6,29, 21 ,6621,1242,1112,8975
6/29/2014,2014,6,29, 22 ,6352,1145,980,8477
6/29/2014,2014,6,29, 23 ,6068,1069,901,8038
6/29/2014,2014,6,29, 24 ,5708,1006,845,7559
6/30/2014,2014,6,30, 1 ,5464,969,812,7245
6/30/2014,2014,6,30, 2 ,5204,918,798,6920
6/30/2014,2014,6,30, 3 ,5040,896,785,6721
6/30/2014,2014,6,30, 4 ,4989,890,782,6661
6/30/2014,2014,6,30, 5 ,5173,936,825,6934
6/30/2014,2014,6,30, 6 ,5188,957,864,7009
6/30/2014,2014,6,30, 7 ,5374,928,806,7108
6/30/2014,2014,6,30, 8 ,6177,1074,925,8176
6/30/2014,2014,6,30, 9 ,7065,1277,1081,9423
6/30/2014,2014,6,30, 10 ,7499,1366,1166,10031
6/30/2014,2014,6,30, 11 ,7782,1417,1231,10430
6/30/2014,2014,6,30, 12 ,7718,1394,1198,10310
6/30/2014,2014,6,30, 13 ,7716,1381,1194,10291
6/30/2014,2014,6,30, 14 ,7994,1430,1188,10612
6/30/2014,2014,6,30, 15 ,7830,1385,1224,10439
6/30/2014,2014,6,30, 16 ,7709,1369,1219,10297
6/30/2014,2014,6,30, 17 ,7365,1334,1218,9917
6/30/2014,2014,6,30, 18 ,7067,1372,1260,9699
6/30/2014,2014,6,30, 19 ,7484,1453,1304,10241
6/30/2014,2014,6,30, 20 ,7403,1391,1242,10036
6/30/2014,2014,6,30, 21 ,7336,1334,1175,9845
6/30/2014,2014,6,30, 22 ,7105,1208,1049,9362
6/30/2014,2014,6,30, 23 ,6665,1104,956,8725
6/30/2014,2014,6,30, 24 ,6231,1036,892,8159
7/1/2014,2014,7,1, 1 ,5922,997,868,7787
7/1/2014,2014,7,1, 2 ,5793,966,834,7593
7/1/2014,2014,7,1, 3 ,5587,950,833,7370
7/1/2014,2014,7,1, 4 ,5457,943,824,7224
7/1/2014,2014,7,1, 5 ,5587,975,858,7420
7/1/2014,2014,7,1, 6 ,5443,1009,886,7338
7/1/2014,2014,7,1, 7 ,5531,975,840,7346
7/1/2014,2014,7,1, 8 ,6426,1088,948,8462
7/1/2014,2014,7,1, 9 ,7233,1260,1095,9588
7/1/2014,2014,7,1, 10 ,7698,1344,1181,10223
7/1/2014,2014,7,1, 11 ,7887,1384,1240,10511
7/1/2014,2014,7,1, 12 ,7793,1346,1208,10347
7/1/2014,2014,7,1, 13 ,7720,1335,1230,10285
7/1/2014,2014,7,1, 14 ,7989,1386,1237,10612
7/1/2014,2014,7,1, 15 ,7766,1375,1241,10382
7/1/2014,2014,7,1, 16 ,7612,1346,1225,10183
7/1/2014,2014,7,1, 17 ,7335,1302,1203,9840
7/1/2014,2014,7,1, 18 ,7123,1346,1238,9707
7/1/2014,2014,7,1, 19 ,7317,1460,1294,10071
7/1/2014,2014,7,1, 20 ,7385,1425,1260,10070
7/1/2014,2014,7,1, 21 ,7262,1348,1194,9804
7/1/2014,2014,7,1, 22 ,6985,1241,1089,9315
7/1/2014,2014,7,1, 23 ,6596,1120,992,8708
7/1/2014,2014,7,1, 24 ,6176,1049,914,8139
7/2/2014,2014,7,2, 1 ,5866,1002,874,7742
7/2/2014,2014,7,2, 2 ,5672,979,863,7514
7/2/2014,2014,7,2, 3 ,5494,949,849,7292
7/2/2014,2014,7,2, 4 ,5400,940,843,7183
7/2/2014,2014,7,2, 5 ,5536,980,887,7403
7/2/2014,2014,7,2, 6 ,5441,988,895,7324
7/2/2014,2014,7,2, 7 ,5574,955,828,7357
7/2/2014,2014,7,2, 8 ,6421,1107,951,8479
7/2/2014,2014,7,2, 9 ,7118,1286,1091,9495
7/2/2014,2014,7,2, 10 ,7629,1378,1173,10180
7/2/2014,2014,7,2, 11 ,7751,1408,1226,10385
7/2/2014,2014,7,2, 12 ,7707,1371,1205,10283
7/2/2014,2014,7,2, 13 ,7743,1367,1198,10308
7/2/2014,2014,7,2, 14 ,8066,1411,1252,10729
7/2/2014,2014,7,2, 15 ,7856,1389,1220,10465
7/2/2014,2014,7,2, 16 ,7655,1377,1239,10271
7/2/2014,2014,7,2, 17 ,7358,1344,1212,9914
7/2/2014,2014,7,2, 18 ,7074,1385,1253,9712
7/2/2014,2014,7,2, 19 ,7494,1455,1311,10260
7/2/2014,2014,7,2, 20 ,7469,1415,1287,10171
7/2/2014,2014,7,2, 21 ,7393,1338,1210,9941
7/2/2014,2014,7,2, 22 ,7044,1233,1095,9372
7/2/2014,2014,7,2, 23 ,6555,1135,1003,8693
7/2/2014,2014,7,2, 24 ,6114,1055,952,8121
7/3/2014,2014,7,3, 1 ,5877,1017,901,7795
7/3/2014,2014,7,3, 2 ,5746,989,873,7608
7/3/2014,2014,7,3, 3 ,5516,964,864,7344
7/3/2014,2014,7,3, 4 ,5473,954,846,7273
7/3/2014,2014,7,3, 5 ,5566,994,891,7451
7/3/2014,2014,7,3, 6 ,5456,1006,917,7379
7/3/2014,2014,7,3, 7 ,5623,983,852,7458
7/3/2014,2014,7,3, 8 ,6451,1133,968,8552
7/3/2014,2014,7,3, 9 ,7231,1319,1102,9652
7/3/2014,2014,7,3, 10 ,7690,1395,1207,10292
7/3/2014,2014,7,3, 11 ,7946,1422,1253,10621
7/3/2014,2014,7,3, 12 ,7788,1394,1214,10396
7/3/2014,2014,7,3, 13 ,7845,1383,1234,10462
7/3/2014,2014,7,3, 14 ,8108,1411,1286,10805
7/3/2014,2014,7,3, 15 ,7873,1365,1263,10501
7/3/2014,2014,7,3, 16 ,7681,1339,1246,10266
7/3/2014,2014,7,3, 17 ,7453,1302,1225,9980
7/3/2014,2014,7,3, 18 ,7386,1330,1251,9967
7/3/2014,2014,7,3, 19 ,7459,1438,1346,10243
7/3/2014,2014,7,3, 20 ,7243,1403,1297,9943
7/3/2014,2014,7,3, 21 ,7073,1337,1234,9644
7/3/2014,2014,7,3, 22 ,6798,1221,1122,9141
7/3/2014,2014,7,3, 23 ,6283,1114,1018,8415
7/3/2014,2014,7,3, 24 ,5837,1041,982,7860
7/4/2014,2014,7,4, 1 ,5528,1001,921,7450
7/4/2014,2014,7,4, 2 ,5394,980,925,7299
7/4/2014,2014,7,4, 3 ,5225,945,915,7085
7/4/2014,2014,7,4, 4 ,5165,941,902,7008
7/4/2014,2014,7,4, 5 ,5256,978,939,7173
7/4/2014,2014,7,4, 6 ,5419,987,912,7318
7/4/2014,2014,7,4, 7 ,5566,967,854,7387
7/4/2014,2014,7,4, 8 ,6215,1114,989,8318
7/4/2014,2014,7,4, 9 ,7013,1307,1139,9459
7/4/2014,2014,7,4, 10 ,7325,1398,1249,9972
7/4/2014,2014,7,4, 11 ,7609,1418,1305,10332
7/4/2014,2014,7,4, 12 ,7412,1370,1259,10041
7/4/2014,2014,7,4, 13 ,7405,1368,1270,10043
7/4/2014,2014,7,4, 14 ,7690,1430,1329,10449
7/4/2014,2014,7,4, 15 ,7551,1394,1298,10243
7/4/2014,2014,7,4, 16 ,7387,1357,1267,10011
7/4/2014,2014,7,4, 17 ,7200,1322,1225,9747
7/4/2014,2014,7,4, 18 ,7057,1354,1303,9714
7/4/2014,2014,7,4, 19 ,7311,1455,1349,10115
7/4/2014,2014,7,4, 20 ,7219,1388,1309,9916
7/4/2014,2014,7,4, 21 ,6994,1332,1247,9573
7/4/2014,2014,7,4, 22 ,6679,1218,1155,9052
7/4/2014,2014,7,4, 23 ,6249,1112,1046,8407
7/4/2014,2014,7,4, 24 ,5838,1048,969,7855
7/5/2014,2014,7,5, 1 ,5605,1008,931,7544
7/5/2014,2014,7,5, 2 ,5368,984,913,7265
7/5/2014,2014,7,5, 3 ,5260,958,901,7119
7/5/2014,2014,7,5, 4 ,5123,949,878,6950
7/5/2014,2014,7,5, 5 ,5102,954,884,6940
7/5/2014,2014,7,5, 6 ,5042,940,878,6860
7/5/2014,2014,7,5, 7 ,5233,976,870,7079
7/5/2014,2014,7,5, 8 ,5848,1087,963,7898
7/5/2014,2014,7,5, 9 ,6416,1210,1079,8705
7/5/2014,2014,7,5, 10 ,6921,1289,1168,9378
7/5/2014,2014,7,5, 11 ,7186,1330,1238,9754
7/5/2014,2014,7,5, 12 ,7002,1307,1212,9521
7/5/2014,2014,7,5, 13 ,7102,1316,1218,9636
7/5/2014,2014,7,5, 14 ,7239,1332,1243,9814
7/5/2014,2014,7,5, 15 ,7048,1287,1217,9552
7/5/2014,2014,7,5, 16 ,6887,1257,1194,9338
7/5/2014,2014,7,5, 17 ,6621,1246,1184,9051
7/5/2014,2014,7,5, 18 ,6579,1316,1256,9151
7/5/2014,2014,7,5, 19 ,7073,1424,1327,9824
7/5/2014,2014,7,5, 20 ,7077,1373,1295,9745
7/5/2014,2014,7,5, 21 ,6936,1306,1240,9482
7/5/2014,2014,7,5, 22 ,6694,1208,1142,9044
7/5/2014,2014,7,5, 23 ,6313,1114,1044,8471
7/5/2014,2014,7,5, 24 ,5930,1047,963,7940
7/6/2014,2014,7,6, 1 ,5675,1008,921,7604
7/6/2014,2014,7,6, 2 ,5508,983,891,7382
7/6/2014,2014,7,6, 3 ,5329,965,875,7169
7/6/2014,2014,7,6, 4 ,5154,946,857,6957
7/6/2014,2014,7,6, 5 ,5100,943,862,6905
7/6/2014,2014,7,6, 6 ,4921,921,832,6674
7/6/2014,2014,7,6, 7 ,4964,938,825,6727
7/6/2014,2014,7,6, 8 ,5191,973,828,6992
7/6/2014,2014,7,6, 9 ,5585,1041,873,7499
7/6/2014,2014,7,6, 10 ,5952,1107,915,7974
7/6/2014,2014,7,6, 11 ,6239,1148,989,8376
7/6/2014,2014,7,6, 12 ,6212,1134,1024,8370
7/6/2014,2014,7,6, 13 ,6137,1127,1025,8289
7/6/2014,2014,7,6, 14 ,6155,1133,1020,8308
7/6/2014,2014,7,6, 15 ,6036,1111,1012,8159
7/6/2014,2014,7,6, 16 ,5851,1092,989,7932
7/6/2014,2014,7,6, 17 ,5784,1113,1052,7949
7/6/2014,2014,7,6, 18 ,5881,1184,1106,8171
7/6/2014,2014,7,6, 19 ,6558,1357,1236,9151
7/6/2014,2014,7,6, 20 ,6677,1311,1236,9224
7/6/2014,2014,7,6, 21 ,6581,1265,1181,9027
7/6/2014,2014,7,6, 22 ,6278,1169,1089,8536
7/6/2014,2014,7,6, 23 ,5967,1080,999,8046
7/6/2014,2014,7,6, 24 ,5640,1018,927,7585
7/7/2014,2014,7,7, 1 ,5318,974,884,7176
7/7/2014,2014,7,7, 2 ,5116,929,859,6904
7/7/2014,2014,7,7, 3 ,4972,910,840,6722
7/7/2014,2014,7,7, 4 ,4919,914,825,6658
7/7/2014,2014,7,7, 5 ,5088,947,873,6908
7/7/2014,2014,7,7, 6 ,5175,973,890,7038
7/7/2014,2014,7,7, 7 ,5416,949,830,7195
7/7/2014,2014,7,7, 8 ,6148,1082,967,8197
7/7/2014,2014,7,7, 9 ,7022,1269,1129,9420
7/7/2014,2014,7,7, 10 ,7436,1332,1233,10001
7/7/2014,2014,7,7, 11 ,7719,1371,1285,10375
7/7/2014,2014,7,7, 12 ,7565,1333,1278,10176
7/7/2014,2014,7,7, 13 ,7476,1329,1282,10087
7/7/2014,2014,7,7, 14 ,7696,1387,1319,10402
7/7/2014,2014,7,7, 15 ,7605,1385,1298,10288
7/7/2014,2014,7,7, 16 ,7473,1376,1286,10135
7/7/2014,2014,7,7, 17 ,7143,1326,1245,9714
7/7/2014,2014,7,7, 18 ,6941,1322,1284,9547
7/7/2014,2014,7,7, 19 ,7230,1471,1361,10062
7/7/2014,2014,7,7, 20 ,7189,1418,1317,9924
7/7/2014,2014,7,7, 21 ,6993,1351,1267,9611
7/7/2014,2014,7,7, 22 ,6736,1254,1161,9151
7/7/2014,2014,7,7, 23 ,6165,1125,1040,8330
7/7/2014,2014,7,7, 24 ,5835,1055,959,7849
7/8/2014,2014,7,8, 1 ,5578,1019,923,7520
7/8/2014,2014,7,8, 2 ,5395,991,905,7291
7/8/2014,2014,7,8, 3 ,5250,971,889,7110
7/8/2014,2014,7,8, 4 ,5192,959,877,7028
7/8/2014,2014,7,8, 5 ,5366,994,912,7272
7/8/2014,2014,7,8, 6 ,5358,1006,911,7275
7/8/2014,2014,7,8, 7 ,5491,982,847,7320
7/8/2014,2014,7,8, 8 ,6318,1143,990,8451
7/8/2014,2014,7,8, 9 ,7093,1336,1147,9576
7/8/2014,2014,7,8, 10 ,7484,1394,1246,10124
7/8/2014,2014,7,8, 11 ,7745,1415,1302,10462
7/8/2014,2014,7,8, 12 ,7507,1367,1270,10144
7/8/2014,2014,7,8, 13 ,7471,1350,1222,10043
7/8/2014,2014,7,8, 14 ,7769,1418,1205,10392
7/8/2014,2014,7,8, 15 ,7583,1391,1207,10181
7/8/2014,2014,7,8, 16 ,7455,1396,1237,10088
7/8/2014,2014,7,8, 17 ,7129,1327,1215,9671
7/8/2014,2014,7,8, 18 ,6988,1353,1282,9623
7/8/2014,2014,7,8, 19 ,7282,1480,1280,10042
7/8/2014,2014,7,8, 20 ,7270,1424,1288,9982
7/8/2014,2014,7,8, 21 ,7053,1348,1268,9669
7/8/2014,2014,7,8, 22 ,6707,1223,1156,9086
7/8/2014,2014,7,8, 23 ,6292,1117,1062,8471
7/8/2014,2014,7,8, 24 ,5856,1048,979,7883
7/9/2014,2014,7,9, 1 ,5599,1007,932,7538
7/9/2014,2014,7,9, 2 ,5471,969,915,7355
7/9/2014,2014,7,9, 3 ,5328,951,902,7181
7/9/2014,2014,7,9, 4 ,5250,940,894,7084
7/9/2014,2014,7,9, 5 ,5380,977,938,7295
7/9/2014,2014,7,9, 6 ,5370,992,941,7303
7/9/2014,2014,7,9, 7 ,5530,957,875,7362
7/9/2014,2014,7,9, 8 ,6264,1116,1019,8399
7/9/2014,2014,7,9, 9 ,7002,1298,1185,9485
7/9/2014,2014,7,9, 10 ,7447,1378,1276,10101
7/9/2014,2014,7,9, 11 ,7640,1438,1325,10403
7/9/2014,2014,7,9, 12 ,7436,1397,1318,10151
7/9/2014,2014,7,9, 13 ,7297,1399,1326,10022
7/9/2014,2014,7,9, 14 ,7600,1460,1357,10417
7/9/2014,2014,7,9, 15 ,7429,1426,1339,10194
7/9/2014,2014,7,9, 16 ,7359,1399,1302,10060
7/9/2014,2014,7,9, 17 ,7140,1339,1304,9783
7/9/2014,2014,7,9, 18 ,6958,1366,1313,9637
7/9/2014,2014,7,9, 19 ,7184,1481,1326,9991
7/9/2014,2014,7,9, 20 ,7182,1438,1292,9912
7/9/2014,2014,7,9, 21 ,7046,1362,1229,9637
7/9/2014,2014,7,9, 22 ,6731,1250,1109,9090
7/9/2014,2014,7,9, 23 ,6313,1163,1027,8503
7/9/2014,2014,7,9, 24 ,5848,1068,983,7899
7/10/2014,2014,7,10, 1 ,5605,1029,907,7541
7/10/2014,2014,7,10, 2 ,5422,986,894,7302
7/10/2014,2014,7,10, 3 ,5303,972,878,7153
7/10/2014,2014,7,10, 4 ,5278,966,866,7110
7/10/2014,2014,7,10, 5 ,5401,1007,918,7326
7/10/2014,2014,7,10, 6 ,5362,1006,926,7294
7/10/2014,2014,7,10, 7 ,5552,983,862,7397
7/10/2014,2014,7,10, 8 ,6338,1148,1011,8497
7/10/2014,2014,7,10, 9 ,7107,1321,1179,9607
7/10/2014,2014,7,10, 10 ,7562,1406,1277,10245
7/10/2014,2014,7,10, 11 ,7759,1440,1321,10520
7/10/2014,2014,7,10, 12 ,7604,1402,1306,10312
7/10/2014,2014,7,10, 13 ,7555,1407,1300,10262
7/10/2014,2014,7,10, 14 ,7771,1475,1208,10454
7/10/2014,2014,7,10, 15 ,7631,1429,1205,10265
7/10/2014,2014,7,10, 16 ,7502,1389,1247,10138
7/10/2014,2014,7,10, 17 ,7153,1351,1231,9735
7/10/2014,2014,7,10, 18 ,6944,1375,1264,9583
7/10/2014,2014,7,10, 19 ,7324,1471,1203,9998
7/10/2014,2014,7,10, 20 ,7313,1403,1262,9978
7/10/2014,2014,7,10, 21 ,7148,1341,1219,9708
7/10/2014,2014,7,10, 22 ,6866,1229,1143,9238
7/10/2014,2014,7,10, 23 ,6375,1129,1028,8532
7/10/2014,2014,7,10, 24 ,5976,1063,919,7958
7/11/2014,2014,7,11, 1 ,5749,1013,915,7677
7/11/2014,2014,7,11, 2 ,5575,985,895,7455
7/11/2014,2014,7,11, 3 ,5417,958,887,7262
7/11/2014,2014,7,11, 4 ,5301,952,878,7131
7/11/2014,2014,7,11, 5 ,5474,985,919,7378
7/11/2014,2014,7,11, 6 ,5399,992,925,7316
7/11/2014,2014,7,11, 7 ,5535,959,865,7359
7/11/2014,2014,7,11, 8 ,6404,1129,975,8508
7/11/2014,2014,7,11, 9 ,7111,1329,1134,9574
7/11/2014,2014,7,11, 10 ,7619,1416,1239,10274
7/11/2014,2014,7,11, 11 ,7845,1446,1306,10597
7/11/2014,2014,7,11, 12 ,7704,1416,1274,10394
7/11/2014,2014,7,11, 13 ,7729,1426,1301,10456
7/11/2014,2014,7,11, 14 ,8058,1486,1353,10897
7/11/2014,2014,7,11, 15 ,7815,1462,1325,10602
7/11/2014,2014,7,11, 16 ,7706,1422,1298,10426
7/11/2014,2014,7,11, 17 ,7369,1365,1255,9989
7/11/2014,2014,7,11, 18 ,7037,1383,1276,9696
7/11/2014,2014,7,11, 19 ,7393,1505,1326,10224
7/11/2014,2014,7,11, 20 ,7406,1459,1290,10155
7/11/2014,2014,7,11, 21 ,7222,1405,1240,9867
7/11/2014,2014,7,11, 22 ,6905,1296,1131,9332
7/11/2014,2014,7,11, 23 ,6554,1193,1031,8778
7/11/2014,2014,7,11, 24 ,6102,1125,991,8218
7/12/2014,2014,7,12, 1 ,5864,1073,924,7861
7/12/2014,2014,7,12, 2 ,5685,1043,885,7613
7/12/2014,2014,7,12, 3 ,5514,1015,882,7411
7/12/2014,2014,7,12, 4 ,5352,999,867,7218
7/12/2014,2014,7,12, 5 ,5321,1003,872,7196
7/12/2014,2014,7,12, 6 ,5192,978,882,7052
7/12/2014,2014,7,12, 7 ,5391,997,879,7267
7/12/2014,2014,7,12, 8 ,6001,1102,967,8070
7/12/2014,2014,7,12, 9 ,6504,1249,1067,8820
7/12/2014,2014,7,12, 10 ,7089,1323,1164,9576
7/12/2014,2014,7,12, 11 ,7264,1368,1234,9866
7/12/2014,2014,7,12, 12 ,7128,1354,1205,9687
7/12/2014,2014,7,12, 13 ,7147,1368,1234,9749
7/12/2014,2014,7,12, 14 ,7378,1414,1273,10065
7/12/2014,2014,7,12, 15 ,7187,1375,1243,9805
7/12/2014,2014,7,12, 16 ,7037,1321,1214,9572
7/12/2014,2014,7,12, 17 ,6998,1262,1169,9429
7/12/2014,2014,7,12, 18 ,6851,1283,1229,9363
7/12/2014,2014,7,12, 19 ,7118,1443,1324,9885
7/12/2014,2014,7,12, 20 ,7102,1407,1284,9793
7/12/2014,2014,7,12, 21 ,7078,1363,1240,9681
7/12/2014,2014,7,12, 22 ,6955,1269,1143,9367
7/12/2014,2014,7,12, 23 ,6622,1174,1044,8840
7/12/2014,2014,7,12, 24 ,6286,1081,961,8328
7/13/2014,2014,7,13, 1 ,5930,1034,921,7885
7/13/2014,2014,7,13, 2 ,5748,1004,895,7647
7/13/2014,2014,7,13, 3 ,5590,983,874,7447
7/13/2014,2014,7,13, 4 ,5475,961,852,7288
7/13/2014,2014,7,13, 5 ,5364,950,846,7160
7/13/2014,2014,7,13, 6 ,5056,924,815,6795
7/13/2014,2014,7,13, 7 ,5103,939,770,6812
7/13/2014,2014,7,13, 8 ,5424,984,854,7262
7/13/2014,2014,7,13, 9 ,5805,1071,929,7805
7/13/2014,2014,7,13, 10 ,6172,1145,972,8289
7/13/2014,2014,7,13, 11 ,6410,1192,1069,8671
7/13/2014,2014,7,13, 12 ,6496,1191,1084,8771
7/13/2014,2014,7,13, 13 ,6496,1204,1090,8790
7/13/2014,2014,7,13, 14 ,6562,1202,1095,8859
7/13/2014,2014,7,13, 15 ,6443,1174,1078,8695
7/13/2014,2014,7,13, 16 ,6154,1146,1059,8359
7/13/2014,2014,7,13, 17 ,6071,1138,1012,8221
7/13/2014,2014,7,13, 18 ,6193,1215,1113,8521
7/13/2014,2014,7,13, 19 ,6767,1402,1256,9425
7/13/2014,2014,7,13, 20 ,6942,1310,1231,9483
7/13/2014,2014,7,13, 21 ,6738,1291,1171,9200
7/13/2014,2014,7,13, 22 ,6651,1199,1073,8923
7/13/2014,2014,7,13, 23 ,6350,1118,976,8444
7/13/2014,2014,7,13, 24 ,5982,1053,978,8013
7/14/2014,2014,7,14, 1 ,5752,1013,880,7645
7/14/2014,2014,7,14, 2 ,5470,970,858,7298
7/14/2014,2014,7,14, 3 ,5330,948,840,7118
7/14/2014,2014,7,14, 4 ,5267,944,831,7042
7/14/2014,2014,7,14, 5 ,5401,981,875,7257
7/14/2014,2014,7,14, 6 ,5331,988,884,7203
7/14/2014,2014,7,14, 7 ,5520,973,826,7319
7/14/2014,2014,7,14, 8 ,6473,1133,972,8578
7/14/2014,2014,7,14, 9 ,7303,1334,1145,9782
7/14/2014,2014,7,14, 10 ,7805,1411,1211,10427
7/14/2014,2014,7,14, 11 ,8019,1436,1316,10771
7/14/2014,2014,7,14, 12 ,7918,1433,1298,10649
7/14/2014,2014,7,14, 13 ,7962,1420,1280,10662
7/14/2014,2014,7,14, 14 ,8246,1456,1349,11051
7/14/2014,2014,7,14, 15 ,8136,1428,1316,10880
7/14/2014,2014,7,14, 16 ,7936,1388,1278,10602
7/14/2014,2014,7,14, 17 ,7583,1354,1240,10177
7/14/2014,2014,7,14, 18 ,7332,1375,1256,9963
7/14/2014,2014,7,14, 19 ,7667,1488,1330,10485
7/14/2014,2014,7,14, 20 ,7629,1439,1274,10342
7/14/2014,2014,7,14, 21 ,7474,1357,1219,10050
7/14/2014,2014,7,14, 22 ,7100,1238,1130,9468
7/14/2014,2014,7,14, 23 ,6735,1124,1029,8888
7/14/2014,2014,7,14, 24 ,6340,1056,955,8351
7/15/2014,2014,7,15, 1 ,6006,1013,921,7940
7/15/2014,2014,7,15, 2 ,5768,990,900,7658
7/15/2014,2014,7,15, 3 ,5644,957,881,7482
7/15/2014,2014,7,15, 4 ,5586,924,866,7376
7/15/2014,2014,7,15, 5 ,5596,974,912,7482
7/15/2014,2014,7,15, 6 ,5590,1012,926,7528
7/15/2014,2014,7,15, 7 ,5700,978,866,7544
7/15/2014,2014,7,15, 8 ,6592,1083,993,8668
7/15/2014,2014,7,15, 9 ,7250,1189,1151,9590
7/15/2014,2014,7,15, 10 ,7649,1243,1220,10112
7/15/2014,2014,7,15, 11 ,7908,1276,1235,10419
7/15/2014,2014,7,15, 12 ,7714,1221,1213,10148
7/15/2014,2014,7,15, 13 ,7679,1203,1185,10067
7/15/2014,2014,7,15, 14 ,7783,1236,1243,10262
7/15/2014,2014,7,15, 15 ,7511,1229,1234,9974
7/15/2014,2014,7,15, 16 ,7230,1220,1201,9651
7/15/2014,2014,7,15, 17 ,6890,1218,1193,9301
7/15/2014,2014,7,15, 18 ,6568,1250,1239,9057
7/15/2014,2014,7,15, 19 ,6832,1309,1288,9429
7/15/2014,2014,7,15, 20 ,6716,1238,1282,9236
7/15/2014,2014,7,15, 21 ,6400,1189,1163,8752
7/15/2014,2014,7,15, 22 ,6063,1086,1050,8199
7/15/2014,2014,7,15, 23 ,5683,996,979,7658
7/15/2014,2014,7,15, 24 ,5257,929,906,7092
7/16/2014,2014,7,16, 1 ,4948,903,865,6716
7/16/2014,2014,7,16, 2 ,4533,885,855,6273
7/16/2014,2014,7,16, 3 ,3932,873,845,5650
7/16/2014,2014,7,16, 4 ,3183,866,838,4887
7/16/2014,2014,7,16, 5 ,2103,903,886,3892
7/16/2014,2014,7,16, 6 ,2163,948,901,4012
7/16/2014,2014,7,16, 7 ,1448,929,832,3209
7/16/2014,2014,7,16, 8 ,1238,1060,968,3266
7/16/2014,2014,7,16, 9 ,1068,1214,1153,3435
7/16/2014,2014,7,16, 10 ,1010,1303,1208,3521
7/16/2014,2014,7,16, 11 ,974,1314,1300,3588
7/16/2014,2014,7,16, 12 ,1013,1267,1285,3565
7/16/2014,2014,7,16, 13 ,1184,1272,1282,3738
7/16/2014,2014,7,16, 14 ,1363,1325,1330,4018
7/16/2014,2014,7,16, 15 ,1574,1322,1316,4212
7/16/2014,2014,7,16, 16 ,1827,1307,1278,4412
7/16/2014,2014,7,16, 17 ,2077,1255,1240,4572
7/16/2014,2014,7,16, 18 ,2295,1273,1274,4842
7/16/2014,2014,7,16, 19 ,2824,1404,1358,5586
7/16/2014,2014,7,16, 20 ,3017,1349,1323,5689
7/16/2014,2014,7,16, 21 ,3125,1277,1265,5667
7/16/2014,2014,7,16, 22 ,3100,1146,1141,5387
7/16/2014,2014,7,16, 23 ,2975,1053,1051,5079
7/16/2014,2014,7,16, 24 ,2908,974,912,4794
7/17/2014,2014,7,17, 1 ,2806,937,923,4666
7/17/2014,2014,7,17, 2 ,2753,904,901,4558
7/17/2014,2014,7,17, 3 ,2727,880,890,4497
7/17/2014,2014,7,17, 4 ,2757,870,868,4495
7/17/2014,2014,7,17, 5 ,2874,910,911,4695
7/17/2014,2014,7,17, 6 ,3042,949,927,4918
7/17/2014,2014,7,17, 7 ,3331,931,858,5120
7/17/2014,2014,7,17, 8 ,3917,1090,1013,6020
7/17/2014,2014,7,17, 9 ,4006,1287,1186,6479
7/17/2014,2014,7,17, 10 ,4192,1366,1258,6816
7/17/2014,2014,7,17, 11 ,4243,1415,1332,6990
7/17/2014,2014,7,17, 12 ,4121,1380,1302,6803
7/17/2014,2014,7,17, 13 ,4161,1390,1313,6864
7/17/2014,2014,7,17, 14 ,4178,1456,1354,6988
7/17/2014,2014,7,17, 15 ,4174,1436,913,6523
7/17/2014,2014,7,17, 16 ,4070,1392,1147,6609
7/17/2014,2014,7,17, 17 ,3993,1340,1215,6548
7/17/2014,2014,7,17, 18 ,3958,1358,1205,6521
7/17/2014,2014,7,17, 19 ,4046,1459,1333,6838
7/17/2014,2014,7,17, 20 ,4035,1430,1317,6782
7/17/2014,2014,7,17, 21 ,4065,1375,1283,6723
7/17/2014,2014,7,17, 22 ,4054,1265,1177,6496
7/17/2014,2014,7,17, 23 ,4142,1152,1060,6354
7/17/2014,2014,7,17, 24 ,4026,1080,976,6082
7/18/2014,2014,7,18, 1 ,3836,1030,947,5813
7/18/2014,2014,7,18, 2 ,3753,997,922,5672
7/18/2014,2014,7,18, 3 ,2999,962,904,4865
7/18/2014,2014,7,18, 4 ,3558,947,883,5388
7/18/2014,2014,7,18, 5 ,3680,983,920,5583
7/18/2014,2014,7,18, 6 ,3811,1005,924,5740
7/18/2014,2014,7,18, 7 ,4093,971,860,5924
7/18/2014,2014,7,18, 8 ,4661,1131,999,6791
7/18/2014,2014,7,18, 9 ,4533,1328,1178,7039
7/18/2014,2014,7,18, 10 ,4706,1420,1245,7371
7/18/2014,2014,7,18, 11 ,4737,1465,1317,7519
7/18/2014,2014,7,18, 12 ,4567,1429,1289,7285
7/18/2014,2014,7,18, 13 ,4596,1409,1291,7296
7/18/2014,2014,7,18, 14 ,4655,1482,1338,7475
7/18/2014,2014,7,18, 15 ,4602,1454,1299,7355
7/18/2014,2014,7,18, 16 ,4621,1420,1267,7308
7/18/2014,2014,7,18, 17 ,4529,1350,1254,7133
7/18/2014,2014,7,18, 18 ,4693,1355,1281,7329
7/18/2014,2014,7,18, 19 ,4875,1490,1341,7706
7/18/2014,2014,7,18, 20 ,4870,1446,1297,7613
7/18/2014,2014,7,18, 21 ,4963,1397,1232,7592
7/18/2014,2014,7,18, 22 ,5135,1288,1135,7558
7/18/2014,2014,7,18, 23 ,4968,1183,1029,7180
7/18/2014,2014,7,18, 24 ,4743,1123,1009,6875
7/19/2014,2014,7,19, 1 ,4591,1078,931,6600
7/19/2014,2014,7,19, 2 ,4430,1038,912,6380
7/19/2014,2014,7,19, 3 ,4307,1004,899,6210
7/19/2014,2014,7,19, 4 ,4218,996,880,6094
7/19/2014,2014,7,19, 5 ,4229,1000,884,6113
7/19/2014,2014,7,19, 6 ,4175,991,888,6054
7/19/2014,2014,7,19, 7 ,4372,990,883,6245
7/19/2014,2014,7,19, 8 ,4877,1045,954,6876
7/19/2014,2014,7,19, 9 ,5205,1190,1059,7454
7/19/2014,2014,7,19, 10 ,5778,1251,1127,8156
7/19/2014,2014,7,19, 11 ,5996,1294,1171,8461
7/19/2014,2014,7,19, 12 ,5937,1260,1171,8368
7/19/2014,2014,7,19, 13 ,5926,1247,1158,8331
7/19/2014,2014,7,19, 14 ,6031,1268,1203,8502
7/19/2014,2014,7,19, 15 ,5969,1234,1186,8389
7/19/2014,2014,7,19, 16 ,5753,1184,1145,8082
7/19/2014,2014,7,19, 17 ,5660,1150,1147,7957
7/19/2014,2014,7,19, 18 ,5562,1235,1206,8003
7/19/2014,2014,7,19, 19 ,5833,1319,1236,8388
7/19/2014,2014,7,19, 20 ,4870,1277,1150,7297
7/19/2014,2014,7,19, 21 ,4963,1218,1069,7250
7/19/2014,2014,7,19, 22 ,5135,1127,999,7261
7/19/2014,2014,7,19, 23 ,4968,1037,911,6916
7/19/2014,2014,7,19, 24 ,4743,965,844,6552
7/20/2014,2014,7,20, 1 ,4606,926,814,6346
7/20/2014,2014,7,20, 2 ,4420,905,794,6119
7/20/2014,2014,7,20, 3 ,4251,886,786,5923
7/20/2014,2014,7,20, 4 ,4190,876,766,5832
7/20/2014,2014,7,20, 5 ,4231,871,767,5869
7/20/2014,2014,7,20, 6 ,4101,866,772,5739
7/20/2014,2014,7,20, 7 ,4193,875,755,5823
7/20/2014,2014,7,20, 8 ,4402,904,788,6094
7/20/2014,2014,7,20, 9 ,4799,960,808,6567
7/20/2014,2014,7,20, 10 ,5259,1015,894,7168
7/20/2014,2014,7,20, 11 ,5477,1045,942,7464
7/20/2014,2014,7,20, 12 ,5484,1030,954,7468
7/20/2014,2014,7,20, 13 ,5475,1020,932,7427
7/20/2014,2014,7,20, 14 ,5568,1009,952,7529
7/20/2014,2014,7,20, 15 ,5548,993,919,7460
7/20/2014,2014,7,20, 16 ,5393,994,916,7303
7/20/2014,2014,7,20, 17 ,5276,1035,932,7243
7/20/2014,2014,7,20, 18 ,5335,1133,1034,7502
7/20/2014,2014,7,20, 19 ,5852,1212,1145,8209
7/20/2014,2014,7,20, 20 ,5884,1170,1134,8188
7/20/2014,2014,7,20, 21 ,5783,1098,1059,7940
7/20/2014,2014,7,20, 22 ,5547,993,965,7505
7/20/2014,2014,7,20, 23 ,5272,922,890,7084
7/20/2014,2014,7,20, 24 ,4900,874,874,6648
7/21/2014,2014,7,21, 1 ,4900,840,784,6524
7/21/2014,2014,7,21, 2 ,4565,828,773,6166
7/21/2014,2014,7,21, 3 ,4458,809,765,6032
7/21/2014,2014,7,21, 4 ,4404,812,749,5965
7/21/2014,2014,7,21, 5 ,4550,866,795,6211
7/21/2014,2014,7,21, 6 ,4671,936,836,6443
7/21/2014,2014,7,21, 7 ,4887,917,783,6587
7/21/2014,2014,7,21, 8 ,5656,1034,894,7584
7/21/2014,2014,7,21, 9 ,6277,1209,1083,8569
7/21/2014,2014,7,21, 10 ,6747,1272,1193,9212
7/21/2014,2014,7,21, 11 ,6948,1301,1188,9437
7/21/2014,2014,7,21, 12 ,6809,1275,1229,9313
7/21/2014,2014,7,21, 13 ,6780,1266,1217,9263
7/21/2014,2014,7,21, 14 ,6977,1297,1246,9520
7/21/2014,2014,7,21, 15 ,6797,1281,1253,9331
7/21/2014,2014,7,21, 16 ,6728,1262,1243,9233
7/21/2014,2014,7,21, 17 ,6505,1239,1201,8945
7/21/2014,2014,7,21, 18 ,6322,1289,1221,8832
7/21/2014,2014,7,21, 19 ,6604,1387,1312,9303
7/21/2014,2014,7,21, 20 ,6521,1309,1281,9111
7/21/2014,2014,7,21, 21 ,6355,1225,1251,8831
7/21/2014,2014,7,21, 22 ,5949,1119,1156,8224
7/21/2014,2014,7,21, 23 ,5654,1024,1043,7721
7/21/2014,2014,7,21, 24 ,5348,944,897,7189
7/22/2014,2014,7,22, 1 ,4975,908,919,6802
7/22/2014,2014,7,22, 2 ,4918,891,897,6706
7/22/2014,2014,7,22, 3 ,4684,876,879,6439
7/22/2014,2014,7,22, 4 ,4716,872,869,6457
7/22/2014,2014,7,22, 5 ,4816,907,905,6628
7/22/2014,2014,7,22, 6 ,4864,957,920,6741
7/22/2014,2014,7,22, 7 ,5066,938,850,6854
7/22/2014,2014,7,22, 8 ,5745,1085,1002,7832
7/22/2014,2014,7,22, 9 ,6308,1256,1134,8698
7/22/2014,2014,7,22, 10 ,6819,1345,1222,9386
7/22/2014,2014,7,22, 11 ,6913,1345,1266,9524
7/22/2014,2014,7,22, 12 ,6566,1317,1233,9116
7/22/2014,2014,7,22, 13 ,6484,1311,1245,9040
7/22/2014,2014,7,22, 14 ,6610,1372,1297,9279
7/22/2014,2014,7,22, 15 ,6622,1377,1317,9316
7/22/2014,2014,7,22, 16 ,6546,1351,1283,9180
7/22/2014,2014,7,22, 17 ,6449,1303,1252,9004
7/22/2014,2014,7,22, 18 ,6334,1308,1280,8922
7/22/2014,2014,7,22, 19 ,6439,1436,1390,9265
7/22/2014,2014,7,22, 20 ,6336,1370,1354,9060
7/22/2014,2014,7,22, 21 ,6126,1287,1307,8720
7/22/2014,2014,7,22, 22 ,5798,1202,1212,8212
7/22/2014,2014,7,22, 23 ,5417,1092,1098,7607
7/22/2014,2014,7,22, 24 ,5081,1040,990,7111
7/23/2014,2014,7,23, 1 ,4848,992,965,6805
7/23/2014,2014,7,23, 2 ,4753,956,938,6647
7/23/2014,2014,7,23, 3 ,4578,939,914,6431
7/23/2014,2014,7,23, 4 ,4530,926,899,6355
7/23/2014,2014,7,23, 5 ,4713,960,933,6606
7/23/2014,2014,7,23, 6 ,4854,984,936,6774
7/23/2014,2014,7,23, 7 ,4974,961,876,6811
7/23/2014,2014,7,23, 8 ,5621,1119,1018,7758
7/23/2014,2014,7,23, 9 ,6288,1302,1176,8766
7/23/2014,2014,7,23, 10 ,6660,1399,1288,9347
7/23/2014,2014,7,23, 11 ,6926,1366,1329,9621
7/23/2014,2014,7,23, 12 ,6690,1322,1309,9321
7/23/2014,2014,7,23, 13 ,6690,1348,1326,9364
7/23/2014,2014,7,23, 14 ,7000,1417,1345,9762
7/23/2014,2014,7,23, 15 ,6910,1423,1344,9677
7/23/2014,2014,7,23, 16 ,6809,1398,1305,9512
7/23/2014,2014,7,23, 17 ,6540,1321,1245,9106
7/23/2014,2014,7,23, 18 ,6394,1336,1247,8977
7/23/2014,2014,7,23, 19 ,6574,1501,1386,9461
7/23/2014,2014,7,23, 20 ,6455,1459,1342,9256
7/23/2014,2014,7,23, 21 ,6161,1398,1298,8857
7/23/2014,2014,7,23, 22 ,5866,1272,1182,8320
7/23/2014,2014,7,23, 23 ,5455,1173,1080,7708
7/23/2014,2014,7,23, 24 ,5079,1101,1003,7183
7/24/2014,2014,7,24, 1 ,4914,1047,951,6912
7/24/2014,2014,7,24, 2 ,4784,1010,935,6729
7/24/2014,2014,7,24, 3 ,4609,979,920,6508
7/24/2014,2014,7,24, 4 ,4628,970,904,6502
7/24/2014,2014,7,24, 5 ,4809,1007,948,6764
7/24/2014,2014,7,24, 6 ,4916,1016,941,6873
7/24/2014,2014,7,24, 7 ,5100,980,882,6962
7/24/2014,2014,7,24, 8 ,5795,1145,1024,7964
7/24/2014,2014,7,24, 9 ,6531,1315,1169,9015
7/24/2014,2014,7,24, 10 ,6941,1407,1265,9613
7/24/2014,2014,7,24, 11 ,7228,1450,1287,9965
7/24/2014,2014,7,24, 12 ,7029,1403,1300,9732
7/24/2014,2014,7,24, 13 ,6976,1408,1292,9676
7/24/2014,2014,7,24, 14 ,7111,1461,1333,9905
7/24/2014,2014,7,24, 15 ,7047,1418,1278,9743
7/24/2014,2014,7,24, 16 ,6961,1371,1239,9571
7/24/2014,2014,7,24, 17 ,6774,1350,1205,9329
7/24/2014,2014,7,24, 18 ,6595,1390,1251,9236
7/24/2014,2014,7,24, 19 ,6834,1460,1252,9546
7/24/2014,2014,7,24, 20 ,6687,1406,1213,9306
7/24/2014,2014,7,24, 21 ,6501,1320,1175,8996
7/24/2014,2014,7,24, 22 ,6124,1218,1104,8446
7/24/2014,2014,7,24, 23 ,5733,1136,1008,7877
7/24/2014,2014,7,24, 24 ,5300,1056,1018,7374
7/25/2014,2014,7,25, 1 ,5114,1020,894,7028
7/25/2014,2014,7,25, 2 ,4946,984,886,6816
7/25/2014,2014,7,25, 3 ,4826,955,865,6646
7/25/2014,2014,7,25, 4 ,4783,946,852,6581
7/25/2014,2014,7,25, 5 ,4908,990,897,6795
7/25/2014,2014,7,25, 6 ,4941,1012,924,6877
7/25/2014,2014,7,25, 7 ,5140,979,867,6986
7/25/2014,2014,7,25, 8 ,5939,1120,974,8033
7/25/2014,2014,7,25, 9 ,6756,1292,1134,9182
7/25/2014,2014,7,25, 10 ,7176,1394,1225,9795
7/25/2014,2014,7,25, 11 ,7444,1434,1268,10146
7/25/2014,2014,7,25, 12 ,7181,1388,1244,9813
7/25/2014,2014,7,25, 13 ,7103,1384,1245,9732
7/25/2014,2014,7,25, 14 ,7206,1439,1297,9942
7/25/2014,2014,7,25, 15 ,7100,1384,1257,9741
7/25/2014,2014,7,25, 16 ,6943,1363,1250,9556
7/25/2014,2014,7,25, 17 ,6669,1314,1223,9206
7/25/2014,2014,7,25, 18 ,6445,1335,1266,9046
7/25/2014,2014,7,25, 19 ,6819,1409,1292,9520
7/25/2014,2014,7,25, 20 ,6766,1359,1224,9349
7/25/2014,2014,7,25, 21 ,6546,1288,1154,8988
7/25/2014,2014,7,25, 22 ,6233,1188,1055,8476
7/25/2014,2014,7,25, 23 ,5848,1092,963,7903
7/25/2014,2014,7,25, 24 ,5489,1031,905,7425
7/26/2014,2014,7,26, 1 ,5211,989,864,7064
7/26/2014,2014,7,26, 2 ,5053,956,842,6851
7/26/2014,2014,7,26, 3 ,4945,938,830,6713
7/26/2014,2014,7,26, 4 ,4815,928,820,6563
7/26/2014,2014,7,26, 5 ,4819,939,827,6585
7/26/2014,2014,7,26, 6 ,4756,934,827,6517
7/26/2014,2014,7,26, 7 ,4901,952,833,6686
7/26/2014,2014,7,26, 8 ,5401,1026,888,7315
7/26/2014,2014,7,26, 9 ,6058,1133,981,8172
7/26/2014,2014,7,26, 10 ,6577,1203,1054,8834
7/26/2014,2014,7,26, 11 ,6878,1253,1104,9235
7/26/2014,2014,7,26, 12 ,6688,1223,1094,9005
7/26/2014,2014,7,26, 13 ,6674,1230,1095,8999
7/26/2014,2014,7,26, 14 ,6840,1261,1109,9210
7/26/2014,2014,7,26, 15 ,6636,1235,1086,8957
7/26/2014,2014,7,26, 16 ,6442,1198,1091,8731
7/26/2014,2014,7,26, 17 ,6311,1196,1099,8606
7/26/2014,2014,7,26, 18 ,6266,1249,1186,8701
7/26/2014,2014,7,26, 19 ,6622,1347,1225,9194
7/26/2014,2014,7,26, 20 ,6482,1296,1168,8946
7/26/2014,2014,7,26, 21 ,6368,1231,1139,8738
7/26/2014,2014,7,26, 22 ,6036,1153,1054,8243
7/26/2014,2014,7,26, 23 ,5696,1046,917,7659
7/26/2014,2014,7,26, 24 ,5309,974,871,7154
7/27/2014,2014,7,27, 1 ,5070,929,840,6839
7/27/2014,2014,7,27, 2 ,4857,902,816,6575
7/27/2014,2014,7,27, 3 ,4735,876,800,6411
7/27/2014,2014,7,27, 4 ,4703,864,781,6348
7/27/2014,2014,7,27, 5 ,4575,861,786,6222
7/27/2014,2014,7,27, 6 ,4431,852,779,6062
7/27/2014,2014,7,27, 7 ,4460,863,784,6107
7/27/2014,2014,7,27, 8 ,4738,912,819,6469
7/27/2014,2014,7,27, 9 ,5136,988,848,6972
7/27/2014,2014,7,27, 10 ,5558,1041,918,7517
7/27/2014,2014,7,27, 11 ,5830,1075,958,7863
7/27/2014,2014,7,27, 12 ,5794,1071,967,7832
7/27/2014,2014,7,27, 13 ,5798,1062,955,7815
7/27/2014,2014,7,27, 14 ,5838,1059,944,7841
7/27/2014,2014,7,27, 15 ,5725,1034,931,7690
7/27/2014,2014,7,27, 16 ,5607,1022,924,7553
7/27/2014,2014,7,27, 17 ,5521,1048,957,7526
7/27/2014,2014,7,27, 18 ,5643,1147,1072,7862
7/27/2014,2014,7,27, 19 ,6240,1283,1166,8689
7/27/2014,2014,7,27, 20 ,6248,1226,1152,8626
7/27/2014,2014,7,27, 21 ,6106,1168,1088,8362
7/27/2014,2014,7,27, 22 ,5860,1085,995,7940
7/27/2014,2014,7,27, 23 ,5434,995,909,7338
7/27/2014,2014,7,27, 24 ,5103,936,843,6882
7/28/2014,2014,7,28, 1 ,4933,896,803,6632
7/28/2014,2014,7,28, 2 ,4697,871,777,6345
7/28/2014,2014,7,28, 3 ,4563,843,764,6170
7/28/2014,2014,7,28, 4 ,4504,847,766,6117
7/28/2014,2014,7,28, 5 ,4714,896,831,6441
7/28/2014,2014,7,28, 6 ,4797,908,869,6574
7/28/2014,2014,7,28, 7 ,4943,885,805,6633
7/28/2014,2014,7,28, 8 ,5803,1023,907,7733
7/28/2014,2014,7,28, 9 ,6576,1214,1066,8856
7/28/2014,2014,7,28, 10 ,7086,1307,1176,9569
7/28/2014,2014,7,28, 11 ,7234,1387,1241,9862
7/28/2014,2014,7,28, 12 ,7079,1359,1229,9667
7/28/2014,2014,7,28, 13 ,7019,1343,1220,9582
7/28/2014,2014,7,28, 14 ,7194,1375,1267,9836
7/28/2014,2014,7,28, 15 ,7156,1361,1205,9722
7/28/2014,2014,7,28, 16 ,7030,1332,1215,9577
7/28/2014,2014,7,28, 17 ,6739,1278,1192,9209
7/28/2014,2014,7,28, 18 ,6459,1306,1218,8983
7/28/2014,2014,7,28, 19 ,6793,1439,1305,9537
7/28/2014,2014,7,28, 20 ,6726,1378,1255,9359
7/28/2014,2014,7,28, 21 ,6748,1301,1205,9254
7/28/2014,2014,7,28, 22 ,6135,1184,1088,8407
7/28/2014,2014,7,28, 23 ,5695,1083,984,7762
7/28/2014,2014,7,28, 24 ,5414,1010,919,7343
7/29/2014,2014,7,29, 1 ,5209,936,875,7020
7/29/2014,2014,7,29, 2 ,5017,927,849,6793
7/29/2014,2014,7,29, 3 ,4807,912,834,6553
7/29/2014,2014,7,29, 4 ,4787,897,820,6504
7/29/2014,2014,7,29, 5 ,4755,909,836,6500
7/29/2014,2014,7,29, 6 ,4699,922,853,6474
7/29/2014,2014,7,29, 7 ,4808,930,853,6591
7/29/2014,2014,7,29, 8 ,5231,1001,922,7154
7/29/2014,2014,7,29, 9 ,5675,1125,1008,7808
7/29/2014,2014,7,29, 10 ,6182,1208,1088,8478
7/29/2014,2014,7,29, 11 ,6422,1225,1135,8782
7/29/2014,2014,7,29, 12 ,6253,1184,1137,8574
7/29/2014,2014,7,29, 13 ,6250,1188,1131,8569
7/29/2014,2014,7,29, 14 ,6340,1220,1143,8703
7/29/2014,2014,7,29, 15 ,6220,1202,1116,8538
7/29/2014,2014,7,29, 16 ,6076,1170,1104,8350
7/29/2014,2014,7,29, 17 ,5938,1176,1077,8191
7/29/2014,2014,7,29, 18 ,6001,1264,1151,8416
7/29/2014,2014,7,29, 19 ,6601,1374,1291,9266
7/29/2014,2014,7,29, 20 ,6645,1320,1255,9220
7/29/2014,2014,7,29, 21 ,6475,1258,1213,8946
7/29/2014,2014,7,29, 22 ,6197,1151,1154,8502
7/29/2014,2014,7,29, 23 ,5770,1038,1014,7822
7/29/2014,2014,7,29, 24 ,5391,974,923,7288
7/30/2014,2014,7,30, 1 ,5193,939,875,7007
7/30/2014,2014,7,30, 2 ,5050,913,851,6814
7/30/2014,2014,7,30, 3 ,4927,900,817,6644
7/30/2014,2014,7,30, 4 ,4916,891,822,6629
7/30/2014,2014,7,30, 5 ,4998,936,868,6802
7/30/2014,2014,7,30, 6 ,5064,978,900,6942
7/30/2014,2014,7,30, 7 ,5242,948,838,7028
7/30/2014,2014,7,30, 8 ,6031,1083,967,8081
7/30/2014,2014,7,30, 9 ,6732,1229,1105,9066
7/30/2014,2014,7,30, 10 ,7171,1345,1189,9705
7/30/2014,2014,7,30, 11 ,7430,1395,1272,10097
7/30/2014,2014,7,30, 12 ,7231,1331,1257,9819
7/30/2014,2014,7,30, 13 ,7238,1333,1205,9776
7/30/2014,2014,7,30, 14 ,7514,1436,1306,10256
7/30/2014,2014,7,30, 15 ,7307,1379,1279,9965
7/30/2014,2014,7,30, 16 ,7153,1347,1256,9756
7/30/2014,2014,7,30, 17 ,6935,1290,1217,9442
7/30/2014,2014,7,30, 18 ,6824,1332,1257,9413
7/30/2014,2014,7,30, 19 ,7075,1442,1352,9869
7/30/2014,2014,7,30, 20 ,6911,1382,1306,9599
7/30/2014,2014,7,30, 21 ,6696,1315,1275,9286
7/30/2014,2014,7,30, 22 ,6368,1186,1141,8695
7/30/2014,2014,7,30, 23 ,5990,1092,1031,8113
7/30/2014,2014,7,30, 24 ,5615,1016,949,7580
7/31/2014,2014,7,31, 1 ,5375,966,914,7255
7/31/2014,2014,7,31, 2 ,5221,935,880,7036
7/31/2014,2014,7,31, 3 ,5047,920,853,6820
7/31/2014,2014,7,31, 4 ,5061,918,849,6828
7/31/2014,2014,7,31, 5 ,5184,962,889,7035
7/31/2014,2014,7,31, 6 ,5208,991,919,7118
7/31/2014,2014,7,31, 7 ,5360,952,852,7164
7/31/2014,2014,7,31, 8 ,6069,1096,986,8151
7/31/2014,2014,7,31, 9 ,6773,1279,1144,9196
7/31/2014,2014,7,31, 10 ,7197,1375,1254,9826
7/31/2014,2014,7,31, 11 ,7306,1412,1306,10024
7/31/2014,2014,7,31, 12 ,7032,1383,1280,9695
7/31/2014,2014,7,31, 13 ,7053,1384,1291,9728
7/31/2014,2014,7,31, 14 ,7292,1449,1332,10073
7/31/2014,2014,7,31, 15 ,7125,1420,1308,9853
7/31/2014,2014,7,31, 16 ,6968,1385,1293,9646
7/31/2014,2014,7,31, 17 ,6813,1327,1246,9386
7/31/2014,2014,7,31, 18 ,6791,1359,1290,9440
7/31/2014,2014,7,31, 19 ,7031,1472,1339,9842
7/31/2014,2014,7,31, 20 ,6905,1424,1322,9651
7/31/2014,2014,7,31, 21 ,6703,1355,1278,9336
7/31/2014,2014,7,31, 22 ,6392,1241,1173,8806
7/31/2014,2014,7,31, 23 ,5990,1131,1076,8197
7/31/2014,2014,7,31, 24 ,5597,1064,958,7619
8/1/2014,2014,8,1, 1 ,5407,1030,944,7381
8/1/2014,2014,8,1, 2 ,5227,995,906,7128
8/1/2014,2014,8,1, 3 ,5108,973,879,6960
8/1/2014,2014,8,1, 4 ,5298,956,877,7131
8/1/2014,2014,8,1, 5 ,5200,980,913,7093
8/1/2014,2014,8,1, 6 ,5255,996,923,7174
8/1/2014,2014,8,1, 7 ,5349,974,869,7192
8/1/2014,2014,8,1, 8 ,6038,1110,1018,8166
8/1/2014,2014,8,1, 9 ,6773,1316,1168,9257
8/1/2014,2014,8,1, 10 ,7228,1402,1270,9900
8/1/2014,2014,8,1, 11 ,7424,1430,1304,10158
8/1/2014,2014,8,1, 12 ,7029,1385,1267,9681
8/1/2014,2014,8,1, 13 ,6974,1360,1291,9625
8/1/2014,2014,8,1, 14 ,7101,1398,1322,9821
8/1/2014,2014,8,1, 15 ,7000,1405,1289,9694
8/1/2014,2014,8,1, 16 ,6947,1379,1258,9584
8/1/2014,2014,8,1, 17 ,6683,1304,1176,9163
8/1/2014,2014,8,1, 18 ,6694,1321,1233,9248
8/1/2014,2014,8,1, 19 ,6953,1476,1291,9720
8/1/2014,2014,8,1, 20 ,6752,1410,1278,9440
8/1/2014,2014,8,1, 21 ,6582,1358,1262,9202
8/1/2014,2014,8,1, 22 ,6259,1246,1170,8675
8/1/2014,2014,8,1, 23 ,5841,1137,1055,8033
8/1/2014,2014,8,1, 24 ,5476,1068,1021,7565
8/2/2014,2014,8,2, 1 ,5212,1020,933,7165
8/2/2014,2014,8,2, 2 ,5111,989,908,7008
8/2/2014,2014,8,2, 3 ,4993,966,887,6846
8/2/2014,2014,8,2, 4 ,4930,950,876,6756
8/2/2014,2014,8,2, 5 ,4934,962,861,6757
8/2/2014,2014,8,2, 6 ,4913,955,854,6722
8/2/2014,2014,8,2, 7 ,5050,953,815,6818
8/2/2014,2014,8,2, 8 ,5544,1032,883,7459
8/2/2014,2014,8,2, 9 ,6135,1201,1017,8353
8/2/2014,2014,8,2, 10 ,6515,1284,1090,8889
8/2/2014,2014,8,2, 11 ,6774,1322,1151,9247
8/2/2014,2014,8,2, 12 ,6626,1292,1150,9068
8/2/2014,2014,8,2, 13 ,6531,1298,1175,9004
8/2/2014,2014,8,2, 14 ,6743,1373,1198,9314
8/2/2014,2014,8,2, 15 ,6590,1333,1131,9054
8/2/2014,2014,8,2, 16 ,6474,1309,1105,8888
8/2/2014,2014,8,2, 17 ,6230,1249,1056,8535
8/2/2014,2014,8,2, 18 ,6210,1275,1116,8601
8/2/2014,2014,8,2, 19 ,6722,1443,1250,9415
8/2/2014,2014,8,2, 20 ,6599,1425,1233,9257
8/2/2014,2014,8,2, 21 ,6356,1363,1213,8932
8/2/2014,2014,8,2, 22 ,6100,1267,1153,8520
8/2/2014,2014,8,2, 23 ,5774,1176,1053,8003
8/2/2014,2014,8,2, 24 ,5389,1089,956,7434
8/3/2014,2014,8,3, 1 ,5146,1045,903,7094
8/3/2014,2014,8,3, 2 ,4914,1003,874,6791
8/3/2014,2014,8,3, 3 ,4830,980,847,6657
8/3/2014,2014,8,3, 4 ,4759,962,838,6559
8/3/2014,2014,8,3, 5 ,4692,957,841,6490
8/3/2014,2014,8,3, 6 ,4584,928,838,6350
8/3/2014,2014,8,3, 7 ,4614,932,824,6370
8/3/2014,2014,8,3, 8 ,4889,976,864,6729
8/3/2014,2014,8,3, 9 ,5294,1049,940,7283
8/3/2014,2014,8,3, 10 ,5594,1107,1007,7708
8/3/2014,2014,8,3, 11 ,5875,1140,1062,8077
8/3/2014,2014,8,3, 12 ,5836,1154,1076,8066
8/3/2014,2014,8,3, 13 ,5807,1178,1097,8082
8/3/2014,2014,8,3, 14 ,5776,1165,1094,8035
8/3/2014,2014,8,3, 15 ,5712,1144,1060,7916
8/3/2014,2014,8,3, 16 ,5600,1122,1044,7766
8/3/2014,2014,8,3, 17 ,5658,1133,1051,7842
8/3/2014,2014,8,3, 18 ,5790,1217,1148,8155
8/3/2014,2014,8,3, 19 ,6263,1395,1276,8934
8/3/2014,2014,8,3, 20 ,6361,1352,1259,8972
8/3/2014,2014,8,3, 21 ,6167,1310,1203,8680
8/3/2014,2014,8,3, 22 ,5849,1210,1105,8164
8/3/2014,2014,8,3, 23 ,5487,1128,1015,7630
8/3/2014,2014,8,3, 24 ,5187,1066,993,7246
8/4/2014,2014,8,4, 1 ,4932,999,904,6835
8/4/2014,2014,8,4, 2 ,4724,971,871,6566
8/4/2014,2014,8,4, 3 ,4588,949,854,6391
8/4/2014,2014,8,4, 4 ,4548,950,846,6344
8/4/2014,2014,8,4, 5 ,4705,987,892,6584
8/4/2014,2014,8,4, 6 ,4960,1031,926,6917
8/4/2014,2014,8,4, 7 ,5211,986,855,7052
8/4/2014,2014,8,4, 8 ,5965,1131,1000,8096
8/4/2014,2014,8,4, 9 ,6637,1323,1156,9116
8/4/2014,2014,8,4, 10 ,7140,1401,1276,9817
8/4/2014,2014,8,4, 11 ,7406,1446,1287,10139
8/4/2014,2014,8,4, 12 ,7168,1422,1274,9864
8/4/2014,2014,8,4, 13 ,7185,1408,1290,9883
8/4/2014,2014,8,4, 14 ,7369,1490,1326,10185
8/4/2014,2014,8,4, 15 ,7190,1459,1288,9937
8/4/2014,2014,8,4, 16 ,7043,1434,1263,9740
8/4/2014,2014,8,4, 17 ,6705,1360,1219,9284
8/4/2014,2014,8,4, 18 ,6696,1384,1246,9326
8/4/2014,2014,8,4, 19 ,6887,1518,1320,9725
8/4/2014,2014,8,4, 20 ,6663,1452,1280,9395
8/4/2014,2014,8,4, 21 ,6351,1390,1275,9016
8/4/2014,2014,8,4, 22 ,5996,1270,1174,8440
8/4/2014,2014,8,4, 23 ,5630,1173,1059,7862
8/4/2014,2014,8,4, 24 ,5292,1093,971,7356
8/5/2014,2014,8,5, 1 ,5055,1048,939,7042
8/5/2014,2014,8,5, 2 ,4891,1020,905,6816
8/5/2014,2014,8,5, 3 ,4788,1003,884,6675
8/5/2014,2014,8,5, 4 ,4784,995,872,6651
8/5/2014,2014,8,5, 5 ,4933,1034,912,6879
8/5/2014,2014,8,5, 6 ,5076,1058,917,7051
8/5/2014,2014,8,5, 7 ,5289,1022,860,7171
8/5/2014,2014,8,5, 8 ,5973,1174,1006,8153
8/5/2014,2014,8,5, 9 ,6671,1360,1166,9197
8/5/2014,2014,8,5, 10 ,6994,1441,1240,9675
8/5/2014,2014,8,5, 11 ,7219,1495,1296,10010
8/5/2014,2014,8,5, 12 ,6876,1449,1251,9576
8/5/2014,2014,8,5, 13 ,6759,1447,1286,9492
8/5/2014,2014,8,5, 14 ,7032,1533,1296,9861
8/5/2014,2014,8,5, 15 ,6968,1498,1272,9738
8/5/2014,2014,8,5, 16 ,6843,1470,1271,9584
8/5/2014,2014,8,5, 17 ,6622,1381,1225,9228
8/5/2014,2014,8,5, 18 ,6517,1396,1284,9197
8/5/2014,2014,8,5, 19 ,6731,1539,1292,9562
8/5/2014,2014,8,5, 20 ,6548,1486,1270,9304
8/5/2014,2014,8,5, 21 ,6256,1427,1240,8923
8/5/2014,2014,8,5, 22 ,5973,1309,1120,8402
8/5/2014,2014,8,5, 23 ,5529,1215,1023,7767
8/5/2014,2014,8,5, 24 ,5224,1133,978,7335
8/6/2014,2014,8,6, 1 ,4956,1081,935,6972
8/6/2014,2014,8,6, 2 ,4830,1035,903,6768
8/6/2014,2014,8,6, 3 ,4726,1013,879,6618
8/6/2014,2014,8,6, 4 ,4718,1000,873,6591
8/6/2014,2014,8,6, 5 ,4950,1029,925,6904
8/6/2014,2014,8,6, 6 ,5106,1026,930,7062
8/6/2014,2014,8,6, 7 ,5257,1005,856,7118
8/6/2014,2014,8,6, 8 ,5873,1141,990,8004
8/6/2014,2014,8,6, 9 ,6655,1300,1169,9124
8/6/2014,2014,8,6, 10 ,7158,1387,1242,9787
8/6/2014,2014,8,6, 11 ,7403,1421,1317,10141
8/6/2014,2014,8,6, 12 ,7227,1362,1286,9875
8/6/2014,2014,8,6, 13 ,7317,1377,1275,9969
8/6/2014,2014,8,6, 14 ,7404,1457,1355,10216
8/6/2014,2014,8,6, 15 ,7376,1423,1322,10121
8/6/2014,2014,8,6, 16 ,7268,1392,1295,9955
8/6/2014,2014,8,6, 17 ,6930,1305,1240,9475
8/6/2014,2014,8,6, 18 ,6842,1331,1276,9449
8/6/2014,2014,8,6, 19 ,7206,1509,1381,10096
8/6/2014,2014,8,6, 20 ,7011,1475,1328,9814
8/6/2014,2014,8,6, 21 ,6839,1423,1293,9555
8/6/2014,2014,8,6, 22 ,6512,1306,1190,9008
8/6/2014,2014,8,6, 23 ,6076,1198,1086,8360
8/6/2014,2014,8,6, 24 ,5683,1128,996,7807
8/7/2014,2014,8,7, 1 ,5391,1067,955,7413
8/7/2014,2014,8,7, 2 ,5227,1032,925,7184
8/7/2014,2014,8,7, 3 ,5083,1013,896,6992
8/7/2014,2014,8,7, 4 ,5054,1005,884,6943
8/7/2014,2014,8,7, 5 ,5207,1028,923,7158
8/7/2014,2014,8,7, 6 ,5275,1035,949,7259
8/7/2014,2014,8,7, 7 ,5421,1011,854,7286
8/7/2014,2014,8,7, 8 ,6287,1184,1009,8480
8/7/2014,2014,8,7, 9 ,6997,1378,1134,9509
8/7/2014,2014,8,7, 10 ,7491,1484,1220,10195
8/7/2014,2014,8,7, 11 ,7688,1520,1270,10478
8/7/2014,2014,8,7, 12 ,7548,1499,1270,10317
8/7/2014,2014,8,7, 13 ,7550,1490,1286,10326
8/7/2014,2014,8,7, 14 ,7803,1546,1302,10651
8/7/2014,2014,8,7, 15 ,7691,1534,1281,10506
8/7/2014,2014,8,7, 16 ,7550,1506,1268,10324
8/7/2014,2014,8,7, 17 ,7173,1405,1239,9817
8/7/2014,2014,8,7, 18 ,6835,1393,1246,9474
8/7/2014,2014,8,7, 19 ,7293,1558,1301,10152
8/7/2014,2014,8,7, 20 ,7208,1504,1292,10004
8/7/2014,2014,8,7, 21 ,7007,1453,1278,9738
8/7/2014,2014,8,7, 22 ,6650,1330,1192,9172
8/7/2014,2014,8,7, 23 ,6265,1224,1096,8585
8/7/2014,2014,8,7, 24 ,5859,1131,1013,8003
8/8/2014,2014,8,8, 1 ,5590,1081,968,7639
8/8/2014,2014,8,8, 2 ,5398,1053,932,7383
8/8/2014,2014,8,8, 3 ,5250,1022,910,7182
8/8/2014,2014,8,8, 4 ,5192,1015,887,7094
8/8/2014,2014,8,8, 5 ,5329,1037,929,7295
8/8/2014,2014,8,8, 6 ,5321,1040,944,7305
8/8/2014,2014,8,8, 7 ,5444,1011,893,7348
8/8/2014,2014,8,8, 8 ,6309,1174,1033,8516
8/8/2014,2014,8,8, 9 ,7030,1374,1185,9589
8/8/2014,2014,8,8, 10 ,7469,1464,1273,10206
8/8/2014,2014,8,8, 11 ,7669,1512,1342,10523
8/8/2014,2014,8,8, 12 ,7523,1469,1319,10311
8/8/2014,2014,8,8, 13 ,7656,1491,1287,10434
8/8/2014,2014,8,8, 14 ,7893,1548,1360,10801
8/8/2014,2014,8,8, 15 ,7748,1522,1323,10593
8/8/2014,2014,8,8, 16 ,7516,1480,1296,10292
8/8/2014,2014,8,8, 17 ,7177,1383,1239,9799
8/8/2014,2014,8,8, 18 ,6862,1377,1227,9466
8/8/2014,2014,8,8, 19 ,7299,1551,1307,10157
8/8/2014,2014,8,8, 20 ,7206,1516,1274,9996
8/8/2014,2014,8,8, 21 ,7066,1450,1282,9798
8/8/2014,2014,8,8, 22 ,6721,1350,1178,9249
8/8/2014,2014,8,8, 23 ,6293,1237,1087,8617
8/8/2014,2014,8,8, 24 ,6011,1152,1009,8172
8/9/2014,2014,8,9, 1 ,5688,1102,971,7761
8/9/2014,2014,8,9, 2 ,5521,1066,948,7535
8/9/2014,2014,8,9, 3 ,5327,1032,913,7272
8/9/2014,2014,8,9, 4 ,5264,1004,890,7158
8/9/2014,2014,8,9, 5 ,5230,1009,902,7141
8/9/2014,2014,8,9, 6 ,5109,990,892,6991
8/9/2014,2014,8,9, 7 ,5297,1006,871,7174
8/9/2014,2014,8,9, 8 ,5894,1124,980,7998
8/9/2014,2014,8,9, 9 ,6412,1262,1105,8779
8/9/2014,2014,8,9, 10 ,6847,1330,1195,9372
8/9/2014,2014,8,9, 11 ,7150,1399,1239,9788
8/9/2014,2014,8,9, 12 ,6997,1370,1249,9616
8/9/2014,2014,8,9, 13 ,7004,1404,1246,9654
8/9/2014,2014,8,9, 14 ,7195,1431,1266,9892
8/9/2014,2014,8,9, 15 ,7081,1400,1255,9736
8/9/2014,2014,8,9, 16 ,6860,1358,1226,9444
8/9/2014,2014,8,9, 17 ,6463,1275,1171,8909
8/9/2014,2014,8,9, 18 ,6352,1319,1230,8901
8/9/2014,2014,8,9, 19 ,6943,1504,1313,9760
8/9/2014,2014,8,9, 20 ,6876,1472,1304,9652
8/9/2014,2014,8,9, 21 ,6885,1425,1286,9596
8/9/2014,2014,8,9, 22 ,6609,1324,1189,9122
8/9/2014,2014,8,9, 23 ,6333,1226,1096,8655
8/9/2014,2014,8,9, 24 ,5899,1147,930,7976
8/10/2014,2014,8,10, 1 ,5669,1093,971,7733
8/10/2014,2014,8,10, 2 ,5439,1055,929,7423
8/10/2014,2014,8,10, 3 ,5250,1015,902,7167
8/10/2014,2014,8,10, 4 ,5145,991,882,7018
8/10/2014,2014,8,10, 5 ,5074,990,883,6947
8/10/2014,2014,8,10, 6 ,4893,960,859,6712
8/10/2014,2014,8,10, 7 ,4891,960,845,6696
8/10/2014,2014,8,10, 8 ,5149,1021,900,7070
8/10/2014,2014,8,10, 9 ,5533,1111,962,7606
8/10/2014,2014,8,10, 10 ,5948,1185,1046,8179
8/10/2014,2014,8,10, 11 ,6176,1236,1125,8537
8/10/2014,2014,8,10, 12 ,6131,1247,1131,8509
8/10/2014,2014,8,10, 13 ,6193,1261,1147,8601
8/10/2014,2014,8,10, 14 ,6257,1269,1159,8685
8/10/2014,2014,8,10, 15 ,6135,1249,1136,8520
8/10/2014,2014,8,10, 16 ,6015,1217,1104,8336
8/10/2014,2014,8,10, 17 ,5793,1191,1083,8067
8/10/2014,2014,8,10, 18 ,5871,1245,1138,8254
8/10/2014,2014,8,10, 19 ,6598,1445,1199,9242
8/10/2014,2014,8,10, 20 ,6730,1428,1194,9352
8/10/2014,2014,8,10, 21 ,6624,1373,1191,9188
8/10/2014,2014,8,10, 22 ,6388,1281,1107,8776
8/10/2014,2014,8,10, 23 ,5990,1171,1008,8169
8/10/2014,2014,8,10, 24 ,5592,1101,1014,7707
8/11/2014,2014,8,11, 1 ,5361,1046,911,7318
8/11/2014,2014,8,11, 2 ,5200,1004,880,7084
8/11/2014,2014,8,11, 3 ,5030,977,851,6858
8/11/2014,2014,8,11, 4 ,4993,959,842,6794
8/11/2014,2014,8,11, 5 ,5118,995,886,6999
8/11/2014,2014,8,11, 6 ,5132,1016,899,7047
8/11/2014,2014,8,11, 7 ,5312,996,828,7136
8/11/2014,2014,8,11, 8 ,6348,1168,999,8515
8/11/2014,2014,8,11, 9 ,7128,1375,1145,9648
8/11/2014,2014,8,11, 10 ,7521,1467,1227,10215
8/11/2014,2014,8,11, 11 ,7810,1508,1298,10616
8/11/2014,2014,8,11, 12 ,7728,1491,1278,10497
8/11/2014,2014,8,11, 13 ,7691,1509,1279,10479
8/11/2014,2014,8,11, 14 ,7949,1550,1319,10818
8/11/2014,2014,8,11, 15 ,7842,1545,1309,10696
8/11/2014,2014,8,11, 16 ,7624,1513,1298,10435
8/11/2014,2014,8,11, 17 ,7240,1416,1229,9885
8/11/2014,2014,8,11, 18 ,6930,1412,1271,9613
8/11/2014,2014,8,11, 19 ,7449,1572,1290,10311
8/11/2014,2014,8,11, 20 ,7255,1541,1259,10055
8/11/2014,2014,8,11, 21 ,7179,1477,1278,9934
8/11/2014,2014,8,11, 22 ,6872,1364,1175,9411
8/11/2014,2014,8,11, 23 ,6389,1212,1084,8685
8/11/2014,2014,8,11, 24 ,6041,1156,961,8158
8/12/2014,2014,8,12, 1 ,5699,1097,958,7754
8/12/2014,2014,8,12, 2 ,5547,1068,932,7547
8/12/2014,2014,8,12, 3 ,5409,1039,910,7358
8/12/2014,2014,8,12, 4 ,5293,1022,897,7212
8/12/2014,2014,8,12, 5 ,5439,1050,946,7435
8/12/2014,2014,8,12, 6 ,5443,1052,962,7457
8/12/2014,2014,8,12, 7 ,5529,1022,884,7435
8/12/2014,2014,8,12, 8 ,6314,1201,1036,8551
8/12/2014,2014,8,12, 9 ,7070,1399,1166,9635
8/12/2014,2014,8,12, 10 ,7426,1474,1289,10189
8/12/2014,2014,8,12, 11 ,7711,1528,1317,10556
8/12/2014,2014,8,12, 12 ,7493,1493,1302,10288
8/12/2014,2014,8,12, 13 ,7494,1508,1307,10309
8/12/2014,2014,8,12, 14 ,7870,1561,1331,10762
8/12/2014,2014,8,12, 15 ,7749,1525,1299,10573
8/12/2014,2014,8,12, 16 ,7573,1489,1255,10317
8/12/2014,2014,8,12, 17 ,7114,1401,1210,9725
8/12/2014,2014,8,12, 18 ,6882,1412,1242,9536
8/12/2014,2014,8,12, 19 ,7285,1547,1311,10143
8/12/2014,2014,8,12, 20 ,7290,1509,1277,10076
8/12/2014,2014,8,12, 21 ,7101,1451,1229,9781
8/12/2014,2014,8,12, 22 ,6808,1343,1141,9292
8/12/2014,2014,8,12, 23 ,6417,1218,1050,8685
8/12/2014,2014,8,12, 24 ,5954,1135,967,8056
8/13/2014,2014,8,13, 1 ,5646,1087,924,7657
8/13/2014,2014,8,13, 2 ,5528,1056,901,7485
8/13/2014,2014,8,13, 3 ,5354,1034,875,7263
8/13/2014,2014,8,13, 4 ,5302,983,872,7157
8/13/2014,2014,8,13, 5 ,5347,1010,926,7283
8/13/2014,2014,8,13, 6 ,5365,1022,948,7335
8/13/2014,2014,8,13, 7 ,5450,984,880,7314
8/13/2014,2014,8,13, 8 ,6251,1153,1022,8426
8/13/2014,2014,8,13, 9 ,7035,1373,1180,9588
8/13/2014,2014,8,13, 10 ,7587,1451,1236,10274
8/13/2014,2014,8,13, 11 ,7795,1511,1259,10565
8/13/2014,2014,8,13, 12 ,7680,1471,1247,10398
8/13/2014,2014,8,13, 13 ,7697,1489,1265,10451
8/13/2014,2014,8,13, 14 ,8041,1501,1310,10852
8/13/2014,2014,8,13, 15 ,7863,1469,1284,10616
8/13/2014,2014,8,13, 16 ,7731,1440,1263,10434
8/13/2014,2014,8,13, 17 ,7266,1379,1222,9867
8/13/2014,2014,8,13, 18 ,6905,1406,1254,9565
8/13/2014,2014,8,13, 19 ,7444,1548,1301,10293
8/13/2014,2014,8,13, 20 ,7257,1502,1263,10022
8/13/2014,2014,8,13, 21 ,7194,1459,1246,9899
8/13/2014,2014,8,13, 22 ,6794,1337,1151,9282
8/13/2014,2014,8,13, 23 ,6492,1226,1059,8777
8/13/2014,2014,8,13, 24 ,6086,1139,1043,8268
8/14/2014,2014,8,14, 1 ,5772,1084,949,7805
8/14/2014,2014,8,14, 2 ,5599,1047,902,7548
8/14/2014,2014,8,14, 3 ,5465,1029,867,7361
8/14/2014,2014,8,14, 4 ,5358,1011,859,7228
8/14/2014,2014,8,14, 5 ,5435,1041,912,7388
8/14/2014,2014,8,14, 6 ,5451,1047,946,7444
8/14/2014,2014,8,14, 7 ,5542,1020,877,7439
8/14/2014,2014,8,14, 8 ,6502,1184,1011,8697
8/14/2014,2014,8,14, 9 ,7273,1371,1191,9835
8/14/2014,2014,8,14, 10 ,7630,1446,1277,10353
8/14/2014,2014,8,14, 11 ,7925,1481,1309,10715
8/14/2014,2014,8,14, 12 ,7810,1437,1294,10541
8/14/2014,2014,8,14, 13 ,7857,1450,1314,10621
8/14/2014,2014,8,14, 14 ,8181,1513,1319,11013
8/14/2014,2014,8,14, 15 ,8062,1477,1297,10836
8/14/2014,2014,8,14, 16 ,7825,1432,1280,10537
8/14/2014,2014,8,14, 17 ,7452,1380,1251,10083
8/14/2014,2014,8,14, 18 ,7190,1390,1289,9869
8/14/2014,2014,8,14, 19 ,7537,1522,1338,10397
8/14/2014,2014,8,14, 20 ,7397,1464,1298,10159
8/14/2014,2014,8,14, 21 ,7286,1404,1235,9925
8/14/2014,2014,8,14, 22 ,7068,1286,1116,9470
8/14/2014,2014,8,14, 23 ,6599,1189,1062,8850
8/14/2014,2014,8,14, 24 ,6248,1105,932,8285
8/15/2014,2014,8,15, 1 ,5951,1067,952,7970
8/15/2014,2014,8,15, 2 ,5790,1025,871,7686
8/15/2014,2014,8,15, 3 ,5553,1006,864,7423
8/15/2014,2014,8,15, 4 ,5478,1002,853,7333
8/15/2014,2014,8,15, 5 ,5532,1024,903,7459
8/15/2014,2014,8,15, 6 ,5509,1038,923,7470
8/15/2014,2014,8,15, 7 ,5614,1012,876,7502
8/15/2014,2014,8,15, 8 ,6453,1170,981,8604
8/15/2014,2014,8,15, 9 ,7251,1368,1165,9784
8/15/2014,2014,8,15, 10 ,7679,1438,1246,10363
8/15/2014,2014,8,15, 11 ,7868,1473,1297,10638
8/15/2014,2014,8,15, 12 ,7791,1424,1289,10504
8/15/2014,2014,8,15, 13 ,7860,1421,1305,10586
8/15/2014,2014,8,15, 14 ,8114,1491,1326,10931
8/15/2014,2014,8,15, 15 ,7974,1448,1280,10702
8/15/2014,2014,8,15, 16 ,7549,1405,1249,10203
8/15/2014,2014,8,15, 17 ,7244,1341,1226,9811
8/15/2014,2014,8,15, 18 ,6945,1369,1253,9567
8/15/2014,2014,8,15, 19 ,7289,1454,1292,10035
8/15/2014,2014,8,15, 20 ,7248,1404,1231,9883
8/15/2014,2014,8,15, 21 ,7205,1360,1189,9754
8/15/2014,2014,8,15, 22 ,6944,1247,1089,9280
8/15/2014,2014,8,15, 23 ,6496,1155,998,8649
8/15/2014,2014,8,15, 24 ,6107,1082,902,8091
8/16/2014,2014,8,16, 1 ,5845,1033,881,7759
8/16/2014,2014,8,16, 2 ,5667,1000,854,7521
8/16/2014,2014,8,16, 3 ,5477,975,829,7281
8/16/2014,2014,8,16, 4 ,5378,961,810,7149
8/16/2014,2014,8,16, 5 ,5348,968,836,7152
8/16/2014,2014,8,16, 6 ,5203,965,826,6994
8/16/2014,2014,8,16, 7 ,5384,984,854,7222
8/16/2014,2014,8,16, 8 ,5869,1071,924,7864
8/16/2014,2014,8,16, 9 ,6485,1230,1037,8752
8/16/2014,2014,8,16, 10 ,7052,1298,1131,9481
8/16/2014,2014,8,16, 11 ,7211,1350,1184,9745
8/16/2014,2014,8,16, 12 ,7105,1321,1175,9601
8/16/2014,2014,8,16, 13 ,7116,1324,1169,9609
8/16/2014,2014,8,16, 14 ,7226,1369,1196,9791
8/16/2014,2014,8,16, 15 ,7008,1319,1164,9491
8/16/2014,2014,8,16, 16 ,6724,1278,1142,9144
8/16/2014,2014,8,16, 17 ,6561,1235,1133,8929
8/16/2014,2014,8,16, 18 ,6672,1310,1221,9203
8/16/2014,2014,8,16, 19 ,6851,1406,1278,9535
8/16/2014,2014,8,16, 20 ,6806,1371,1249,9426
8/16/2014,2014,8,16, 21 ,6604,1319,1195,9118
8/16/2014,2014,8,16, 22 ,6307,1230,1093,8630
8/16/2014,2014,8,16, 23 ,6035,1119,919,8073
8/16/2014,2014,8,16, 24 ,5685,1043,917,7645
8/17/2014,2014,8,17, 1 ,5452,996,881,7329
8/17/2014,2014,8,17, 2 ,5270,968,848,7086
8/17/2014,2014,8,17, 3 ,5095,944,819,6858
8/17/2014,2014,8,17, 4 ,5003,929,808,6740
8/17/2014,2014,8,17, 5 ,4965,933,818,6716
8/17/2014,2014,8,17, 6 ,4831,911,819,6561
8/17/2014,2014,8,17, 7 ,4819,921,816,6556
8/17/2014,2014,8,17, 8 ,4996,970,855,6821
8/17/2014,2014,8,17, 9 ,5410,1061,941,7412
8/17/2014,2014,8,17, 10 ,5802,1125,997,7924
8/17/2014,2014,8,17, 11 ,6097,1181,1063,8341
8/17/2014,2014,8,17, 12 ,5967,1184,1076,8227
8/17/2014,2014,8,17, 13 ,5919,1195,1089,8203
8/17/2014,2014,8,17, 14 ,5867,1206,1095,8168
8/17/2014,2014,8,17, 15 ,5799,1175,1048,8022
8/17/2014,2014,8,17, 16 ,5650,1143,1034,7827
8/17/2014,2014,8,17, 17 ,5627,1144,1057,7828
8/17/2014,2014,8,17, 18 ,5793,1215,1170,8178
8/17/2014,2014,8,17, 19 ,6362,1380,1228,8970
8/17/2014,2014,8,17, 20 ,6411,1350,1194,8955
8/17/2014,2014,8,17, 21 ,6252,1288,1139,8679
8/17/2014,2014,8,17, 22 ,5972,1209,1056,8237
8/17/2014,2014,8,17, 23 ,5676,1112,955,7743
8/17/2014,2014,8,17, 24 ,5291,1036,886,7213
8/18/2014,2014,8,18, 1 ,5046,988,844,6878
8/18/2014,2014,8,18, 2 ,4862,950,819,6631
8/18/2014,2014,8,18, 3 ,4750,933,801,6484
8/18/2014,2014,8,18, 4 ,4697,923,799,6419
8/18/2014,2014,8,18, 5 ,4865,964,858,6687
8/18/2014,2014,8,18, 6 ,4952,1000,903,6855
8/18/2014,2014,8,18, 7 ,5210,963,829,7002
8/18/2014,2014,8,18, 8 ,6046,1092,967,8105
8/18/2014,2014,8,18, 9 ,6797,1312,1151,9260
8/18/2014,2014,8,18, 10 ,7343,1407,1262,10012
8/18/2014,2014,8,18, 11 ,7557,1480,1282,10319
8/18/2014,2014,8,18, 12 ,7455,1457,1273,10185
8/18/2014,2014,8,18, 13 ,7300,1459,1274,10033
8/18/2014,2014,8,18, 14 ,7542,1524,1304,10370
8/18/2014,2014,8,18, 15 ,7426,1482,1293,10201
8/18/2014,2014,8,18, 16 ,7284,1445,1300,10029
8/18/2014,2014,8,18, 17 ,7043,1388,1242,9673
8/18/2014,2014,8,18, 18 ,6836,1446,1280,9562
8/18/2014,2014,8,18, 19 ,7244,1529,1324,10097
8/18/2014,2014,8,18, 20 ,7124,1455,1298,9877
8/18/2014,2014,8,18, 21 ,6865,1410,1261,9536
8/18/2014,2014,8,18, 22 ,6580,1281,1141,9002
8/18/2014,2014,8,18, 23 ,6172,1177,1036,8385
8/18/2014,2014,8,18, 24 ,5770,1094,954,7818
8/19/2014,2014,8,19, 1 ,5516,1056,913,7485
8/19/2014,2014,8,19, 2 ,5361,1014,877,7252
8/19/2014,2014,8,19, 3 ,5210,990,857,7057
8/19/2014,2014,8,19, 4 ,5084,974,851,6909
8/19/2014,2014,8,19, 5 ,5210,1010,900,7120
8/19/2014,2014,8,19, 6 ,5274,1024,919,7217
8/19/2014,2014,8,19, 7 ,5390,999,849,7238
8/19/2014,2014,8,19, 8 ,6203,1169,1006,8378
8/19/2014,2014,8,19, 9 ,6855,1377,1181,9413
8/19/2014,2014,8,19, 10 ,7378,1455,1289,10122
8/19/2014,2014,8,19, 11 ,7674,1512,1323,10509
8/19/2014,2014,8,19, 12 ,7548,1473,1295,10316
8/19/2014,2014,8,19, 13 ,7596,1482,1312,10390
8/19/2014,2014,8,19, 14 ,7931,1560,1339,10830
8/19/2014,2014,8,19, 15 ,7569,1538,1325,10432
8/19/2014,2014,8,19, 16 ,7239,1490,1333,10062
8/19/2014,2014,8,19, 17 ,7075,1421,1253,9749
8/19/2014,2014,8,19, 18 ,6874,1427,1283,9584
8/19/2014,2014,8,19, 19 ,7208,1548,1355,10111
8/19/2014,2014,8,19, 20 ,7152,1508,1263,9923
8/19/2014,2014,8,19, 21 ,6952,1435,1233,9620
8/19/2014,2014,8,19, 22 ,6622,1322,1136,9080
8/19/2014,2014,8,19, 23 ,6179,1216,1055,8450
8/19/2014,2014,8,19, 24 ,5708,1129,970,7807
8/20/2014,2014,8,20, 1 ,5537,1077,949,7563
8/20/2014,2014,8,20, 2 ,5363,1035,898,7296
8/20/2014,2014,8,20, 3 ,5248,987,872,7107
8/20/2014,2014,8,20, 4 ,5151,995,869,7015
8/20/2014,2014,8,20, 5 ,5320,1019,923,7262
8/20/2014,2014,8,20, 6 ,5347,1041,942,7330
8/20/2014,2014,8,20, 7 ,5542,1018,875,7435
8/20/2014,2014,8,20, 8 ,6234,1178,1010,8422
8/20/2014,2014,8,20, 9 ,7121,1385,1177,9683
8/20/2014,2014,8,20, 10 ,7610,1465,1266,10341
8/20/2014,2014,8,20, 11 ,7828,1518,1298,10644
8/20/2014,2014,8,20, 12 ,7680,1488,1271,10439
8/20/2014,2014,8,20, 13 ,7688,1494,1288,10470
8/20/2014,2014,8,20, 14 ,7896,1562,1329,10787
8/20/2014,2014,8,20, 15 ,7725,1497,1312,10534
8/20/2014,2014,8,20, 16 ,7528,1459,1280,10267
8/20/2014,2014,8,20, 17 ,7204,1379,1275,9858
8/20/2014,2014,8,20, 18 ,7015,1437,1308,9760
8/20/2014,2014,8,20, 19 ,7359,1541,1330,10230
8/20/2014,2014,8,20, 20 ,7209,1487,1270,9966
8/20/2014,2014,8,20, 21 ,7073,1411,1228,9712
8/20/2014,2014,8,20, 22 ,6745,1307,1087,9139
8/20/2014,2014,8,20, 23 ,6412,1170,979,8561
8/20/2014,2014,8,20, 24 ,6412,1062,948,8422
8/21/2014,2014,8,21, 1 ,5682,1030,870,7582
8/21/2014,2014,8,21, 2 ,5548,998,844,7390
8/21/2014,2014,8,21, 3 ,5367,954,814,7135
8/21/2014,2014,8,21, 4 ,5271,937,803,7011
8/21/2014,2014,8,21, 5 ,5197,948,826,6971
8/21/2014,2014,8,21, 6 ,5062,963,850,6875
8/21/2014,2014,8,21, 7 ,5103,969,846,6918
8/21/2014,2014,8,21, 8 ,5652,1040,933,7625
8/21/2014,2014,8,21, 9 ,6021,1150,1032,8203
8/21/2014,2014,8,21, 10 ,6572,1211,1131,8914
8/21/2014,2014,8,21, 11 ,6817,1256,1188,9261
8/21/2014,2014,8,21, 12 ,6769,1237,1167,9173
8/21/2014,2014,8,21, 13 ,6825,1230,1205,9260
8/21/2014,2014,8,21, 14 ,6841,1262,1226,9329
8/21/2014,2014,8,21, 15 ,6748,1258,1210,9216
8/21/2014,2014,8,21, 16 ,6618,1234,1174,9026
8/21/2014,2014,8,21, 17 ,6463,1224,1165,8852
8/21/2014,2014,8,21, 18 ,6500,1327,1264,9091
8/21/2014,2014,8,21, 19 ,6945,1446,1313,9704
8/21/2014,2014,8,21, 20 ,7008,1391,1277,9676
8/21/2014,2014,8,21, 21 ,6895,1318,1220,9433
8/21/2014,2014,8,21, 22 ,6454,1203,1111,8768
8/21/2014,2014,8,21, 23 ,6051,1099,997,8147
8/21/2014,2014,8,21, 24 ,5741,1022,912,7675
8/22/2014,2014,8,22, 1 ,5411,989,866,7266
8/22/2014,2014,8,22, 2 ,5279,966,859,7104
8/22/2014,2014,8,22, 3 ,5099,939,840,6878
8/22/2014,2014,8,22, 4 ,5035,932,830,6797
8/22/2014,2014,8,22, 5 ,5189,966,877,7032
8/22/2014,2014,8,22, 6 ,5182,1006,908,7096
8/22/2014,2014,8,22, 7 ,5357,983,846,7186
8/22/2014,2014,8,22, 8 ,6229,1120,993,8342
8/22/2014,2014,8,22, 9 ,6980,1325,1153,9458
8/22/2014,2014,8,22, 10 ,7397,1420,1275,10092
8/22/2014,2014,8,22, 11 ,7620,1475,1321,10416
8/22/2014,2014,8,22, 12 ,7411,1444,1255,10110
8/22/2014,2014,8,22, 13 ,7332,1425,1273,10030
8/22/2014,2014,8,22, 14 ,7519,1507,1343,10369
8/22/2014,2014,8,22, 15 ,7412,1467,1302,10181
8/22/2014,2014,8,22, 16 ,7256,1424,1254,9934
8/22/2014,2014,8,22, 17 ,6935,1357,1220,9512
8/22/2014,2014,8,22, 18 ,6792,1384,1276,9452
8/22/2014,2014,8,22, 19 ,7166,1495,1344,10005
8/22/2014,2014,8,22, 20 ,7021,1445,1300,9766
8/22/2014,2014,8,22, 21 ,6893,1351,1261,9505
8/22/2014,2014,8,22, 22 ,6547,1219,1129,8895
8/22/2014,2014,8,22, 23 ,6139,1160,1050,8349
8/22/2014,2014,8,22, 24 ,5746,1083,964,7793
8/23/2014,2014,8,23, 1 ,5442,1036,904,7382
8/23/2014,2014,8,23, 2 ,5336,992,875,7203
8/23/2014,2014,8,23, 3 ,5207,975,847,7029
8/23/2014,2014,8,23, 4 ,5104,955,839,6898
8/23/2014,2014,8,23, 5 ,5084,975,851,6910
8/23/2014,2014,8,23, 6 ,4969,968,850,6787
8/23/2014,2014,8,23, 7 ,5075,988,850,6913
8/23/2014,2014,8,23, 8 ,5653,1085,913,7651
8/23/2014,2014,8,23, 9 ,6253,1244,1055,8552
8/23/2014,2014,8,23, 10 ,6753,1339,1141,9233
8/23/2014,2014,8,23, 11 ,7040,1387,1217,9644
8/23/2014,2014,8,23, 12 ,6876,1349,1195,9420
8/23/2014,2014,8,23, 13 ,6909,1355,1213,9477
8/23/2014,2014,8,23, 14 ,7079,1397,1258,9734
8/23/2014,2014,8,23, 15 ,6847,1379,1223,9449
8/23/2014,2014,8,23, 16 ,6685,1352,1136,9173
8/23/2014,2014,8,23, 17 ,6399,1285,1119,8803
8/23/2014,2014,8,23, 18 ,6403,1324,1222,8949
8/23/2014,2014,8,23, 19 ,6894,1462,1323,9679
8/23/2014,2014,8,23, 20 ,6865,1432,1290,9587
8/23/2014,2014,8,23, 21 ,6739,1367,1226,9332
8/23/2014,2014,8,23, 22 ,6502,1280,1131,8913
8/23/2014,2014,8,23, 23 ,6182,1186,1041,8409
8/23/2014,2014,8,23, 24 ,5801,1091,948,7840
8/24/2014,2014,8,24, 1 ,5543,1051,901,7495
8/24/2014,2014,8,24, 2 ,5386,1002,875,7263
8/24/2014,2014,8,24, 3 ,5188,977,846,7011
8/24/2014,2014,8,24, 4 ,5090,957,830,6877
8/24/2014,2014,8,24, 5 ,5031,958,837,6826
8/24/2014,2014,8,24, 6 ,4824,921,832,6577
8/24/2014,2014,8,24, 7 ,4860,928,820,6608
8/24/2014,2014,8,24, 8 ,5106,1006,859,6971
8/24/2014,2014,8,24, 9 ,5575,1078,949,7602
8/24/2014,2014,8,24, 10 ,6004,1167,1039,8210
8/24/2014,2014,8,24, 11 ,6274,1214,1095,8583
8/24/2014,2014,8,24, 12 ,6174,1204,1091,8469
8/24/2014,2014,8,24, 13 ,6136,1216,1104,8456
8/24/2014,2014,8,24, 14 ,6191,1223,1105,8519
8/24/2014,2014,8,24, 15 ,6145,1195,1079,8419
8/24/2014,2014,8,24, 16 ,6019,1164,1038,8221
8/24/2014,2014,8,24, 17 ,5915,1146,1039,8100
8/24/2014,2014,8,24, 18 ,5902,1239,1160,8301
8/24/2014,2014,8,24, 19 ,6580,1358,1239,9177
8/24/2014,2014,8,24, 20 ,6680,1375,1211,9266
8/24/2014,2014,8,24, 21 ,6589,1318,1148,9055
8/24/2014,2014,8,24, 22 ,6302,1255,1097,8654
8/24/2014,2014,8,24, 23 ,6021,1167,1006,8194
8/24/2014,2014,8,24, 24 ,5721,1081,952,7754
8/25/2014,2014,8,25, 1 ,5387,1025,861,7273
8/25/2014,2014,8,25, 2 ,5187,989,844,7020
8/25/2014,2014,8,25, 3 ,5043,952,815,6810
8/25/2014,2014,8,25, 4 ,4967,938,802,6707
8/25/2014,2014,8,25, 5 ,4888,942,821,6651
8/25/2014,2014,8,25, 6 ,4756,938,829,6523
8/25/2014,2014,8,25, 7 ,4796,946,833,6575
8/25/2014,2014,8,25, 8 ,5103,1025,892,7020
8/25/2014,2014,8,25, 9 ,5535,1138,1007,7680
8/25/2014,2014,8,25, 10 ,6095,1214,1090,8399
8/25/2014,2014,8,25, 11 ,6385,1244,1152,8781
8/25/2014,2014,8,25, 12 ,6322,1244,1141,8707
8/25/2014,2014,8,25, 13 ,6454,1232,1130,8816
8/25/2014,2014,8,25, 14 ,6482,1261,1151,8894
8/25/2014,2014,8,25, 15 ,6417,1236,1126,8779
8/25/2014,2014,8,25, 16 ,6169,1202,1111,8482
8/25/2014,2014,8,25, 17 ,6067,1202,1114,8383
8/25/2014,2014,8,25, 18 ,6272,1289,1201,8762
8/25/2014,2014,8,25, 19 ,6714,1372,1233,9319
8/25/2014,2014,8,25, 20 ,6573,1330,1187,9090
8/25/2014,2014,8,25, 21 ,6386,1244,1104,8734
8/25/2014,2014,8,25, 22 ,6070,1140,942,8152
8/25/2014,2014,8,25, 23 ,5697,1045,902,7644
8/25/2014,2014,8,25, 24 ,5350,983,900,7233
8/26/2014,2014,8,26, 1 ,5136,945,823,6904
8/26/2014,2014,8,26, 2 ,5010,924,792,6726
8/26/2014,2014,8,26, 3 ,4857,903,775,6535
8/26/2014,2014,8,26, 4 ,4839,887,775,6501
8/26/2014,2014,8,26, 5 ,4962,930,831,6723
8/26/2014,2014,8,26, 6 ,5095,988,877,6960
8/26/2014,2014,8,26, 7 ,5298,954,812,7064
8/26/2014,2014,8,26, 8 ,5923,1092,957,7972
8/26/2014,2014,8,26, 9 ,6650,1302,1113,9065
8/26/2014,2014,8,26, 10 ,7067,1384,1205,9656
8/26/2014,2014,8,26, 11 ,7361,1423,1277,10061
8/26/2014,2014,8,26, 12 ,7253,1398,1256,9907
8/26/2014,2014,8,26, 13 ,7093,1401,1237,9731
8/26/2014,2014,8,26, 14 ,7323,1462,1308,10093
8/26/2014,2014,8,26, 15 ,7165,1423,1285,9873
8/26/2014,2014,8,26, 16 ,7069,1381,1252,9702
8/26/2014,2014,8,26, 17 ,6851,1334,1218,9403
8/26/2014,2014,8,26, 18 ,6787,1401,1292,9480
8/26/2014,2014,8,26, 19 ,7028,1468,1329,9825
8/26/2014,2014,8,26, 20 ,6810,1406,1270,9486
8/26/2014,2014,8,26, 21 ,6543,1337,1218,9098
8/26/2014,2014,8,26, 22 ,6198,1219,1082,8499
8/26/2014,2014,8,26, 23 ,5791,1113,981,7885
8/26/2014,2014,8,26, 24 ,5445,1033,909,7387
8/27/2014,2014,8,27, 1 ,5157,993,877,7027
8/27/2014,2014,8,27, 2 ,4997,955,846,6798
8/27/2014,2014,8,27, 3 ,4911,933,824,6668
8/27/2014,2014,8,27, 4 ,4830,925,822,6577
8/27/2014,2014,8,27, 5 ,5002,957,879,6838
8/27/2014,2014,8,27, 6 ,5133,997,907,7037
8/27/2014,2014,8,27, 7 ,5336,955,836,7127
8/27/2014,2014,8,27, 8 ,6119,1109,979,8207
8/27/2014,2014,8,27, 9 ,6913,1321,1147,9381
8/27/2014,2014,8,27, 10 ,7398,1397,1266,10061
8/27/2014,2014,8,27, 11 ,7702,1451,1315,10468
8/27/2014,2014,8,27, 12 ,7595,1429,1302,10326
8/27/2014,2014,8,27, 13 ,7593,1432,1316,10341
8/27/2014,2014,8,27, 14 ,7860,1492,1354,10706
8/27/2014,2014,8,27, 15 ,7735,1452,1268,10455
8/27/2014,2014,8,27, 16 ,7645,1417,1250,10312
8/27/2014,2014,8,27, 17 ,7266,1339,1237,9842
8/27/2014,2014,8,27, 18 ,7120,1375,1291,9786
8/27/2014,2014,8,27, 19 ,7443,1486,1298,10227
8/27/2014,2014,8,27, 20 ,7306,1373,1236,9915
8/27/2014,2014,8,27, 21 ,7161,1308,1165,9634
8/27/2014,2014,8,27, 22 ,6760,1215,1031,9006
8/27/2014,2014,8,27, 23 ,6350,1115,959,8424
8/27/2014,2014,8,27, 24 ,5886,1020,908,7814
8/28/2014,2014,8,28, 1 ,5624,980,866,7470
8/28/2014,2014,8,28, 2 ,5386,967,841,7194
8/28/2014,2014,8,28, 3 ,5239,951,817,7007
8/28/2014,2014,8,28, 4 ,5184,943,814,6941
8/28/2014,2014,8,28, 5 ,5278,976,886,7140
8/28/2014,2014,8,28, 6 ,5408,1011,895,7314
8/28/2014,2014,8,28, 7 ,5471,976,831,7278
8/28/2014,2014,8,28, 8 ,6144,1117,944,8205
8/28/2014,2014,8,28, 9 ,6789,1298,1099,9186
8/28/2014,2014,8,28, 10 ,7236,1388,1202,9826
8/28/2014,2014,8,28, 11 ,7452,1445,1280,10177
8/28/2014,2014,8,28, 12 ,7239,1407,1245,9891
8/28/2014,2014,8,28, 13 ,7104,1395,1237,9736
8/28/2014,2014,8,28, 14 ,7098,1437,1259,9794
8/28/2014,2014,8,28, 15 ,6930,1401,1248,9579
8/28/2014,2014,8,28, 16 ,6812,1367,1193,9372
8/28/2014,2014,8,28, 17 ,6691,1310,1194,9195
8/28/2014,2014,8,28, 18 ,6598,1391,1279,9268
8/28/2014,2014,8,28, 19 ,6851,1405,1281,9537
8/28/2014,2014,8,28, 20 ,6640,1343,1255,9238
8/28/2014,2014,8,28, 21 ,6440,1289,1170,8899
8/28/2014,2014,8,28, 22 ,6099,1190,1053,8342
8/28/2014,2014,8,28, 23 ,5680,1060,954,7694
8/28/2014,2014,8,28, 24 ,5267,993,934,7194
8/29/2014,2014,8,29, 1 ,5036,934,871,6841
8/29/2014,2014,8,29, 2 ,4957,921,851,6729
8/29/2014,2014,8,29, 3 ,4795,909,824,6528
8/29/2014,2014,8,29, 4 ,4757,914,826,6497
8/29/2014,2014,8,29, 5 ,4934,944,870,6748
8/29/2014,2014,8,29, 6 ,5076,995,902,6973
8/29/2014,2014,8,29, 7 ,5177,973,848,6998
8/29/2014,2014,8,29, 8 ,5829,1102,990,7921
8/29/2014,2014,8,29, 9 ,6576,1290,1138,9004
8/29/2014,2014,8,29, 10 ,7056,1388,1249,9693
8/29/2014,2014,8,29, 11 ,7281,1436,1306,10023
8/29/2014,2014,8,29, 12 ,7185,1420,1298,9903
8/29/2014,2014,8,29, 13 ,7105,1418,1304,9827
8/29/2014,2014,8,29, 14 ,7313,1483,1346,10142
8/29/2014,2014,8,29, 15 ,7173,1450,1309,9932
8/29/2014,2014,8,29, 16 ,7003,1413,1282,9698
8/29/2014,2014,8,29, 17 ,6754,1361,1235,9350
8/29/2014,2014,8,29, 18 ,6768,1431,1319,9518
8/29/2014,2014,8,29, 19 ,6934,1478,1337,9749
8/29/2014,2014,8,29, 20 ,6691,1412,1275,9378
8/29/2014,2014,8,29, 21 ,6485,1344,1194,9023
8/29/2014,2014,8,29, 22 ,6089,1235,1097,8421
8/29/2014,2014,8,29, 23 ,5666,1141,990,7797
8/29/2014,2014,8,29, 24 ,5331,1059,915,7305
8/30/2014,2014,8,30, 1 ,5123,1016,889,7028
8/30/2014,2014,8,30, 2 ,4975,981,864,6820
8/30/2014,2014,8,30, 3 ,4848,961,794,6603
8/30/2014,2014,8,30, 4 ,4728,947,809,6484
8/30/2014,2014,8,30, 5 ,4799,951,825,6575
8/30/2014,2014,8,30, 6 ,4790,954,843,6587
8/30/2014,2014,8,30, 7 ,4949,965,851,6765
8/30/2014,2014,8,30, 8 ,5338,1071,954,7363
8/30/2014,2014,8,30, 9 ,5866,1231,1075,8172
8/30/2014,2014,8,30, 10 ,6395,1309,1163,8867
8/30/2014,2014,8,30, 11 ,6736,1363,1239,9338
8/30/2014,2014,8,30, 12 ,6632,1347,1232,9211
8/30/2014,2014,8,30, 13 ,6594,1349,1242,9185
8/30/2014,2014,8,30, 14 ,6808,1390,1287,9485
8/30/2014,2014,8,30, 15 ,6671,1356,1261,9288
8/30/2014,2014,8,30, 16 ,6545,1314,1230,9089
8/30/2014,2014,8,30, 17 ,6258,1258,1168,8684
8/30/2014,2014,8,30, 18 ,6348,1351,1296,8995
8/30/2014,2014,8,30, 19 ,6827,1468,1333,9628
8/30/2014,2014,8,30, 20 ,6772,1419,1280,9471
8/30/2014,2014,8,30, 21 ,6602,1353,1206,9161
8/30/2014,2014,8,30, 22 ,6364,1265,1096,8725
8/30/2014,2014,8,30, 23 ,5987,1163,991,8141
8/30/2014,2014,8,30, 24 ,5630,1088,896,7614
8/31/2014,2014,8,31, 1 ,5349,1024,873,7246
8/31/2014,2014,8,31, 2 ,5174,984,849,7007
8/31/2014,2014,8,31, 3 ,5020,933,826,6779
8/31/2014,2014,8,31, 4 ,4894,870,823,6587
8/31/2014,2014,8,31, 5 ,4796,887,821,6504
8/31/2014,2014,8,31, 6 ,4652,885,820,6357
8/31/2014,2014,8,31, 7 ,4681,884,804,6369
8/31/2014,2014,8,31, 8 ,5019,925,853,6797
8/31/2014,2014,8,31, 9 ,5409,1012,921,7342
8/31/2014,2014,8,31, 10 ,5866,1078,1000,7944
8/31/2014,2014,8,31, 11 ,6068,1134,1049,8251
8/31/2014,2014,8,31, 12 ,6068,1145,1050,8263
8/31/2014,2014,8,31, 13 ,6104,1152,1038,8294
8/31/2014,2014,8,31, 14 ,6156,1143,1032,8331
8/31/2014,2014,8,31, 15 ,6001,1118,991,8110
8/31/2014,2014,8,31, 16 ,5734,1106,971,7811
8/31/2014,2014,8,31, 17 ,5692,1109,1013,7814
8/31/2014,2014,8,31, 18 ,5999,1248,1182,8429
8/31/2014,2014,8,31, 19 ,6328,1338,1175,8841
8/31/2014,2014,8,31, 20 ,6339,1305,1126,8770
8/31/2014,2014,8,31, 21 ,6262,1229,1041,8532
8/31/2014,2014,8,31, 22 ,5942,1119,955,8016
8/31/2014,2014,8,31, 23 ,5563,1037,879,7479
8/31/2014,2014,8,31, 24 ,5268,970,820,7058
9/1/2014,2014,9,1, 1 ,5002,927,764,6693
9/1/2014,2014,9,1, 2 ,4806,905,751,6462
9/1/2014,2014,9,1, 3 ,4668,887,733,6288
9/1/2014,2014,9,1, 4 ,4626,879,743,6248
9/1/2014,2014,9,1, 5 ,4785,926,790,6501
9/1/2014,2014,9,1, 6 ,4945,984,848,6777
9/1/2014,2014,9,1, 7 ,5086,967,809,6862
9/1/2014,2014,9,1, 8 ,5870,1059,897,7826
9/1/2014,2014,9,1, 9 ,6714,1253,1029,8996
9/1/2014,2014,9,1, 10 ,7180,1336,1121,9637
9/1/2014,2014,9,1, 11 ,7462,1379,1186,10027
9/1/2014,2014,9,1, 12 ,7314,1340,1146,9800
9/1/2014,2014,9,1, 13 ,7303,1318,1173,9794
9/1/2014,2014,9,1, 14 ,7612,1354,1226,10192
9/1/2014,2014,9,1, 15 ,7477,1337,1205,10019
9/1/2014,2014,9,1, 16 ,7245,1318,1184,9747
9/1/2014,2014,9,1, 17 ,6972,1307,1174,9453
9/1/2014,2014,9,1, 18 ,6866,1393,1268,9527
9/1/2014,2014,9,1, 19 ,7166,1428,1298,9892
9/1/2014,2014,9,1, 20 ,6968,1359,1224,9551
9/1/2014,2014,9,1, 21 ,6744,1284,1134,9162
9/1/2014,2014,9,1, 22 ,6390,1150,1035,8575
9/1/2014,2014,9,1, 23 ,5965,1050,928,7943
9/1/2014,2014,9,1, 24 ,5670,987,874,7531
9/2/2014,2014,9,2, 1 ,5336,961,831,7128
9/2/2014,2014,9,2, 2 ,5173,921,804,6898
9/2/2014,2014,9,2, 3 ,5062,904,782,6748
9/2/2014,2014,9,2, 4 ,4968,893,779,6640
9/2/2014,2014,9,2, 5 ,5132,935,839,6906
9/2/2014,2014,9,2, 6 ,5160,991,884,7035
9/2/2014,2014,9,2, 7 ,5315,958,831,7104
9/2/2014,2014,9,2, 8 ,6062,1085,923,8070
9/2/2014,2014,9,2, 9 ,6758,1274,1112,9144
9/2/2014,2014,9,2, 10 ,7213,1382,1232,9827
9/2/2014,2014,9,2, 11 ,7328,1369,1295,9992
9/2/2014,2014,9,2, 12 ,7145,1345,1247,9737
9/2/2014,2014,9,2, 13 ,7154,1353,1257,9764
9/2/2014,2014,9,2, 14 ,7421,1420,1337,10178
9/2/2014,2014,9,2, 15 ,7354,1399,1303,10056
9/2/2014,2014,9,2, 16 ,7222,1371,1268,9861
9/2/2014,2014,9,2, 17 ,6905,1322,1227,9454
9/2/2014,2014,9,2, 18 ,6863,1391,1301,9555
9/2/2014,2014,9,2, 19 ,7196,1475,1340,10011
9/2/2014,2014,9,2, 20 ,7103,1410,1288,9801
9/2/2014,2014,9,2, 21 ,6847,1331,1206,9384
9/2/2014,2014,9,2, 22 ,6435,1218,1080,8733
9/2/2014,2014,9,2, 23 ,6069,1101,989,8159
9/2/2014,2014,9,2, 24 ,5632,1020,923,7575
9/3/2014,2014,9,3, 1 ,5062,983,878,6923
9/3/2014,2014,9,3, 2 ,4968,956,859,6783
9/3/2014,2014,9,3, 3 ,5132,936,825,6893
9/3/2014,2014,9,3, 4 ,5160,925,821,6906
9/3/2014,2014,9,3, 5 ,5292,965,880,7137
9/3/2014,2014,9,3, 6 ,5196,1010,910,7116
9/3/2014,2014,9,3, 7 ,5324,974,845,7143
9/3/2014,2014,9,3, 8 ,6061,1082,971,8114
9/3/2014,2014,9,3, 9 ,6853,1272,1141,9266
9/3/2014,2014,9,3, 10 ,7285,1357,1247,9889
9/3/2014,2014,9,3, 11 ,7439,1407,1316,10162
9/3/2014,2014,9,3, 12 ,7384,1377,1279,10040
9/3/2014,2014,9,3, 13 ,7378,1380,1291,10049
9/3/2014,2014,9,3, 14 ,7503,1410,1335,10248
9/3/2014,2014,9,3, 15 ,7336,1380,1310,10026
9/3/2014,2014,9,3, 16 ,7230,1357,1234,9821
9/3/2014,2014,9,3, 17 ,7017,1318,1180,9515
9/3/2014,2014,9,3, 18 ,6935,1429,1308,9672
9/3/2014,2014,9,3, 19 ,7111,1458,1330,9899
9/3/2014,2014,9,3, 20 ,6913,1394,1287,9594
9/3/2014,2014,9,3, 21 ,6497,1314,1232,9043
9/3/2014,2014,9,3, 22 ,6188,1180,1120,8488
9/3/2014,2014,9,3, 23 ,5795,1083,1014,7892
9/3/2014,2014,9,3, 24 ,5422,1014,939,7375
9/4/2014,2014,9,4, 1 ,5176,976,890,7042
9/4/2014,2014,9,4, 2 ,4982,945,853,6780
9/4/2014,2014,9,4, 3 ,4902,915,827,6644
9/4/2014,2014,9,4, 4 ,4878,912,826,6616
9/4/2014,2014,9,4, 5 ,5093,949,877,6919
9/4/2014,2014,9,4, 6 ,5172,1001,923,7096
9/4/2014,2014,9,4, 7 ,5213,962,853,7028
9/4/2014,2014,9,4, 8 ,5913,1080,967,7960
9/4/2014,2014,9,4, 9 ,6549,1271,1119,8939
9/4/2014,2014,9,4, 10 ,7065,1352,1214,9631
9/4/2014,2014,9,4, 11 ,7367,1410,1261,10038
9/4/2014,2014,9,4, 12 ,7218,1353,1242,9813
9/4/2014,2014,9,4, 13 ,7088,1293,1228,9609
9/4/2014,2014,9,4, 14 ,7218,1341,1272,9831
9/4/2014,2014,9,4, 15 ,7170,1337,1250,9757
9/4/2014,2014,9,4, 16 ,7074,1332,1233,9639
9/4/2014,2014,9,4, 17 ,6881,1299,1196,9376
9/4/2014,2014,9,4, 18 ,6903,1406,1298,9607
9/4/2014,2014,9,4, 19 ,7060,1442,1271,9773
9/4/2014,2014,9,4, 20 ,6878,1374,1230,9482
9/4/2014,2014,9,4, 21 ,6705,1309,1180,9194
9/4/2014,2014,9,4, 22 ,6352,1184,1087,8623
9/4/2014,2014,9,4, 23 ,5898,1086,968,7952
9/4/2014,2014,9,4, 24 ,5475,1024,927,7426
9/5/2014,2014,9,5, 1 ,5281,979,874,7134
9/5/2014,2014,9,5, 2 ,5079,947,841,6867
9/5/2014,2014,9,5, 3 ,4969,928,818,6715
9/5/2014,2014,9,5, 4 ,4975,928,816,6719
9/5/2014,2014,9,5, 5 ,5052,965,858,6875
9/5/2014,2014,9,5, 6 ,5181,999,902,7082
9/5/2014,2014,9,5, 7 ,5259,970,845,7074
9/5/2014,2014,9,5, 8 ,6098,1110,950,8158
9/5/2014,2014,9,5, 9 ,6868,1296,1117,9281
9/5/2014,2014,9,5, 10 ,7246,1368,1227,9841
9/5/2014,2014,9,5, 11 ,7464,1418,1299,10181
9/5/2014,2014,9,5, 12 ,7294,1379,1235,9908
9/5/2014,2014,9,5, 13 ,7302,1344,1235,9881
9/5/2014,2014,9,5, 14 ,7548,1400,1222,10170
9/5/2014,2014,9,5, 15 ,7400,1375,1208,9983
9/5/2014,2014,9,5, 16 ,7215,1354,1149,9718
9/5/2014,2014,9,5, 17 ,6901,1303,1138,9342
9/5/2014,2014,9,5, 18 ,6883,1388,1247,9518
9/5/2014,2014,9,5, 19 ,7093,1443,1275,9811
9/5/2014,2014,9,5, 20 ,6890,1378,1224,9492
9/5/2014,2014,9,5, 21 ,6841,1312,1161,9314
9/5/2014,2014,9,5, 22 ,6491,1189,1065,8745
9/5/2014,2014,9,5, 23 ,6105,1092,957,8154
9/5/2014,2014,9,5, 24 ,5679,1031,891,7601
9/6/2014,2014,9,6, 1 ,5426,989,902,7317
9/6/2014,2014,9,6, 2 ,5351,961,879,7191
9/6/2014,2014,9,6, 3 ,5172,933,843,6948
9/6/2014,2014,9,6, 4 ,5090,921,836,6847
9/6/2014,2014,9,6, 5 ,5068,941,816,6825
9/6/2014,2014,9,6, 6 ,5007,946,829,6782
9/6/2014,2014,9,6, 7 ,5192,960,817,6969
9/6/2014,2014,9,6, 8 ,5708,1064,909,7681
9/6/2014,2014,9,6, 9 ,6317,1177,1050,8544
9/6/2014,2014,9,6, 10 ,6756,1259,1160,9175
9/6/2014,2014,9,6, 11 ,6975,1322,1201,9498
9/6/2014,2014,9,6, 12 ,6781,1299,1188,9268
9/6/2014,2014,9,6, 13 ,6766,1290,1191,9247
9/6/2014,2014,9,6, 14 ,6914,1320,1236,9470
9/6/2014,2014,9,6, 15 ,6839,1315,1200,9354
9/6/2014,2014,9,6, 16 ,6714,1290,1163,9167
9/6/2014,2014,9,6, 17 ,6491,1234,1137,8862
9/6/2014,2014,9,6, 18 ,6408,1352,1264,9024
9/6/2014,2014,9,6, 19 ,6883,1444,1277,9604
9/6/2014,2014,9,6, 20 ,6831,1399,1244,9474
9/6/2014,2014,9,6, 21 ,6696,1330,1183,9209
9/6/2014,2014,9,6, 22 ,6364,1245,1078,8687
9/6/2014,2014,9,6, 23 ,6118,1154,977,8249
9/6/2014,2014,9,6, 24 ,5695,1070,913,7678
9/7/2014,2014,9,7, 1 ,5516,1016,869,7401
9/7/2014,2014,9,7, 2 ,5308,983,836,7127
9/7/2014,2014,9,7, 3 ,5149,952,810,6911
9/7/2014,2014,9,7, 4 ,5017,932,799,6748
9/7/2014,2014,9,7, 5 ,4932,938,814,6684
9/7/2014,2014,9,7, 6 ,4790,911,820,6521
9/7/2014,2014,9,7, 7 ,4870,920,796,6586
9/7/2014,2014,9,7, 8 ,5150,981,811,6942
9/7/2014,2014,9,7, 9 ,5549,1072,891,7512
9/7/2014,2014,9,7, 10 ,5962,1144,951,8057
9/7/2014,2014,9,7, 11 ,6173,1185,992,8350
9/7/2014,2014,9,7, 12 ,6160,1170,1000,8330
9/7/2014,2014,9,7, 13 ,6192,1183,1014,8389
9/7/2014,2014,9,7, 14 ,6223,1173,1028,8424
9/7/2014,2014,9,7, 15 ,6103,1142,1010,8255
9/7/2014,2014,9,7, 16 ,5991,1118,993,8102
9/7/2014,2014,9,7, 17 ,5865,1148,1006,8019
9/7/2014,2014,9,7, 18 ,6005,1287,1191,8483
9/7/2014,2014,9,7, 19 ,6565,1355,1240,9160
9/7/2014,2014,9,7, 20 ,6611,1323,1190,9124
9/7/2014,2014,9,7, 21 ,6578,1255,1116,8949
9/7/2014,2014,9,7, 22 ,6222,1149,1045,8416
9/7/2014,2014,9,7, 23 ,5900,1056,961,7917
9/7/2014,2014,9,7, 24 ,5666,997,914,7577
9/8/2014,2014,9,8, 1 ,5309,941,846,7096
9/8/2014,2014,9,8, 2 ,5118,917,808,6843
9/8/2014,2014,9,8, 3 ,4955,909,785,6649
9/8/2014,2014,9,8, 4 ,4881,908,778,6567
9/8/2014,2014,9,8, 5 ,5015,939,836,6790
9/8/2014,2014,9,8, 6 ,5121,979,897,6997
9/8/2014,2014,9,8, 7 ,5242,945,828,7015
9/8/2014,2014,9,8, 8 ,6119,1077,932,8128
9/8/2014,2014,9,8, 9 ,6939,1277,1073,9289
9/8/2014,2014,9,8, 10 ,7358,1359,1155,9872
9/8/2014,2014,9,8, 11 ,7649,1420,1213,10282
9/8/2014,2014,9,8, 12 ,7462,1370,1203,10035
9/8/2014,2014,9,8, 13 ,7455,1362,1199,10016
9/8/2014,2014,9,8, 14 ,7298,1334,1241,9873
9/8/2014,2014,9,8, 15 ,7246,1326,1221,9793
9/8/2014,2014,9,8, 16 ,7214,1299,1209,9722
9/8/2014,2014,9,8, 17 ,7115,1280,1190,9585
9/8/2014,2014,9,8, 18 ,7006,1364,1297,9667
9/8/2014,2014,9,8, 19 ,7111,1389,1274,9774
9/8/2014,2014,9,8, 20 ,6932,1323,1216,9471
9/8/2014,2014,9,8, 21 ,6673,1257,1136,9066
9/8/2014,2014,9,8, 22 ,6378,1143,1021,8542
9/8/2014,2014,9,8, 23 ,5921,1048,919,7888
9/8/2014,2014,9,8, 24 ,5581,989,855,7425
9/9/2014,2014,9,9, 1 ,5380,950,824,7154
9/9/2014,2014,9,9, 2 ,5178,924,803,6905
9/9/2014,2014,9,9, 3 ,5042,904,788,6734
9/9/2014,2014,9,9, 4 ,5024,890,786,6700
9/9/2014,2014,9,9, 5 ,5159,929,841,6929
9/9/2014,2014,9,9, 6 ,5238,970,899,7107
9/9/2014,2014,9,9, 7 ,5372,953,828,7153
9/9/2014,2014,9,9, 8 ,6043,1070,941,8054
9/9/2014,2014,9,9, 9 ,6726,1218,1099,9043
9/9/2014,2014,9,9, 10 ,7208,1295,1205,9708
9/9/2014,2014,9,9, 11 ,7622,1334,1254,10210
9/9/2014,2014,9,9, 12 ,7287,1306,1241,9834
9/9/2014,2014,9,9, 13 ,7148,1288,1247,9683
9/9/2014,2014,9,9, 14 ,7340,1334,1273,9947
9/9/2014,2014,9,9, 15 ,7161,1310,1289,9760
9/9/2014,2014,9,9, 16 ,7026,1282,1259,9567
9/9/2014,2014,9,9, 17 ,6801,1259,1199,9259
9/9/2014,2014,9,9, 18 ,6846,1380,1308,9534
9/9/2014,2014,9,9, 19 ,6920,1430,1317,9667
9/9/2014,2014,9,9, 20 ,6687,1370,1272,9329
9/9/2014,2014,9,9, 21 ,6452,1293,1194,8939
9/9/2014,2014,9,9, 22 ,6096,1177,1097,8370
9/9/2014,2014,9,9, 23 ,5742,1076,983,7801
9/9/2014,2014,9,9, 24 ,5359,1004,907,7270
9/10/2014,2014,9,10, 1 ,5142,979,873,6994
9/10/2014,2014,9,10, 2 ,5032,947,834,6813
9/10/2014,2014,9,10, 3 ,4920,928,818,6666
9/10/2014,2014,9,10, 4 ,4907,923,817,6647
9/10/2014,2014,9,10, 5 ,5052,965,876,6893
9/10/2014,2014,9,10, 6 ,5160,1004,905,7069
9/10/2014,2014,9,10, 7 ,5280,978,843,7101
9/10/2014,2014,9,10, 8 ,5967,1129,983,8079
9/10/2014,2014,9,10, 9 ,6767,1319,1132,9218
9/10/2014,2014,9,10, 10 ,7192,1414,1237,9843
9/10/2014,2014,9,10, 11 ,7366,1452,1299,10117
9/10/2014,2014,9,10, 12 ,7195,1421,1288,9904
9/10/2014,2014,9,10, 13 ,7029,1404,1302,9735
9/10/2014,2014,9,10, 14 ,7349,1464,1345,10158
9/10/2014,2014,9,10, 15 ,7309,1463,1310,10082
9/10/2014,2014,9,10, 16 ,7134,1435,1303,9872
9/10/2014,2014,9,10, 17 ,6834,1348,1243,9425
9/10/2014,2014,9,10, 18 ,6817,1413,1320,9550
9/10/2014,2014,9,10, 19 ,7063,1500,1330,9893
9/10/2014,2014,9,10, 20 ,6866,1446,1299,9611
9/10/2014,2014,9,10, 21 ,6593,1377,1236,9206
9/10/2014,2014,9,10, 22 ,6259,1258,1118,8635
9/10/2014,2014,9,10, 23 ,5934,1137,1012,8083
9/10/2014,2014,9,10, 24 ,5458,1062,920,7440
9/11/2014,2014,9,11, 1 ,5278,1017,905,7200
9/11/2014,2014,9,11, 2 ,5100,988,866,6954
9/11/2014,2014,9,11, 3 ,4964,961,851,6776
9/11/2014,2014,9,11, 4 ,4934,958,839,6731
9/11/2014,2014,9,11, 5 ,5084,985,900,6969
9/11/2014,2014,9,11, 6 ,5169,994,922,7085
9/11/2014,2014,9,11, 7 ,5322,956,854,7132
9/11/2014,2014,9,11, 8 ,6138,1122,1005,8265
9/11/2014,2014,9,11, 9 ,6783,1325,1133,9241
9/11/2014,2014,9,11, 10 ,7248,1397,1227,9872
9/11/2014,2014,9,11, 11 ,7524,1421,1302,10247
9/11/2014,2014,9,11, 12 ,7262,1399,1277,9938
9/11/2014,2014,9,11, 13 ,7340,1421,1300,10061
9/11/2014,2014,9,11, 14 ,7633,1479,1347,10459
9/11/2014,2014,9,11, 15 ,7524,1467,1303,10294
9/11/2014,2014,9,11, 16 ,7428,1444,1275,10147
9/11/2014,2014,9,11, 17 ,7049,1354,1227,9630
9/11/2014,2014,9,11, 18 ,7068,1444,1332,9844
9/11/2014,2014,9,11, 19 ,7443,1518,1315,10276
9/11/2014,2014,9,11, 20 ,7301,1463,1302,10066
9/11/2014,2014,9,11, 21 ,7058,1405,1235,9698
9/11/2014,2014,9,11, 22 ,6721,1293,1093,9107
9/11/2014,2014,9,11, 23 ,6323,1170,1021,8514
9/11/2014,2014,9,11, 24 ,5876,1113,882,7871
9/12/2014,2014,9,12, 1 ,5631,1066,844,7541
9/12/2014,2014,9,12, 2 ,5470,1033,816,7319
9/12/2014,2014,9,12, 3 ,5288,1006,831,7125
9/12/2014,2014,9,12, 4 ,5234,992,841,7067
9/12/2014,2014,9,12, 5 ,5296,1021,889,7206
9/12/2014,2014,9,12, 6 ,5314,1044,921,7279
9/12/2014,2014,9,12, 7 ,5363,1003,861,7227
9/12/2014,2014,9,12, 8 ,6173,1147,980,8300
9/12/2014,2014,9,12, 9 ,7051,1316,1127,9494
9/12/2014,2014,9,12, 10 ,7461,1395,1239,10095
9/12/2014,2014,9,12, 11 ,7694,1485,1288,10467
9/12/2014,2014,9,12, 12 ,7580,1438,1236,10254
9/12/2014,2014,9,12, 13 ,7531,1431,1243,10205
9/12/2014,2014,9,12, 14 ,7764,1486,1272,10522
9/12/2014,2014,9,12, 15 ,7687,1456,1203,10346
9/12/2014,2014,9,12, 16 ,7526,1422,1214,10162
9/12/2014,2014,9,12, 17 ,7132,1367,1219,9718
9/12/2014,2014,9,12, 18 ,7024,1482,1286,9792
9/12/2014,2014,9,12, 19 ,7365,1516,1268,10149
9/12/2014,2014,9,12, 20 ,7194,1461,1211,9866
9/12/2014,2014,9,12, 21 ,7058,1389,1146,9593
9/12/2014,2014,9,12, 22 ,6746,1276,1034,9056
9/12/2014,2014,9,12, 23 ,6405,1176,945,8526
9/12/2014,2014,9,12, 24 ,6015,1092,878,7985
9/13/2014,2014,9,13, 1 ,5799,1061,848,7708
9/13/2014,2014,9,13, 2 ,5624,1027,831,7482
9/13/2014,2014,9,13, 3 ,5498,1007,809,7314
9/13/2014,2014,9,13, 4 ,5398,1001,806,7205
9/13/2014,2014,9,13, 5 ,5333,1007,838,7178
9/13/2014,2014,9,13, 6 ,5295,1009,862,7166
9/13/2014,2014,9,13, 7 ,5377,996,841,7214
9/13/2014,2014,9,13, 8 ,5835,1051,927,7813
9/13/2014,2014,9,13, 9 ,6353,1159,1018,8530
9/13/2014,2014,9,13, 10 ,6719,1233,1096,9048
9/13/2014,2014,9,13, 11 ,6997,1250,1164,9411
9/13/2014,2014,9,13, 12 ,6739,1212,1135,9086
9/13/2014,2014,9,13, 13 ,6638,1184,1149,8971
9/13/2014,2014,9,13, 14 ,6723,1201,1173,9097
9/13/2014,2014,9,13, 15 ,6556,1157,1149,8862
9/13/2014,2014,9,13, 16 ,6346,1142,1122,8610
9/13/2014,2014,9,13, 17 ,6361,1148,1117,8626
9/13/2014,2014,9,13, 18 ,6618,1280,1277,9175
9/13/2014,2014,9,13, 19 ,6698,1282,1261,9241
9/13/2014,2014,9,13, 20 ,6629,1231,1221,9081
9/13/2014,2014,9,13, 21 ,6348,1164,1165,8677
9/13/2014,2014,9,13, 22 ,5947,1048,1041,8036
9/13/2014,2014,9,13, 23 ,5616,968,966,7550
9/13/2014,2014,9,13, 24 ,5305,915,939,7159
9/14/2014,2014,9,14, 1 ,5074,889,861,6824
9/14/2014,2014,9,14, 2 ,4929,865,835,6629
9/14/2014,2014,9,14, 3 ,4798,842,806,6446
9/14/2014,2014,9,14, 4 ,4790,828,795,6413
9/14/2014,2014,9,14, 5 ,4693,836,813,6342
9/14/2014,2014,9,14, 6 ,4636,836,820,6292
9/14/2014,2014,9,14, 7 ,4671,851,800,6322
9/14/2014,2014,9,14, 8 ,4875,901,814,6590
9/14/2014,2014,9,14, 9 ,5097,955,899,6951
9/14/2014,2014,9,14, 10 ,5513,1026,979,7518
9/14/2014,2014,9,14, 11 ,5605,1050,1022,7677
9/14/2014,2014,9,14, 12 ,5500,1058,1026,7584
9/14/2014,2014,9,14, 13 ,5443,1027,1028,7498
9/14/2014,2014,9,14, 14 ,5407,1040,1035,7482
9/14/2014,2014,9,14, 15 ,5276,1034,1022,7332
9/14/2014,2014,9,14, 16 ,5278,1035,980,7293
9/14/2014,2014,9,14, 17 ,5366,1069,997,7432
9/14/2014,2014,9,14, 18 ,5725,1228,1190,8143
9/14/2014,2014,9,14, 19 ,5821,1266,1241,8328
9/14/2014,2014,9,14, 20 ,5676,1229,1209,8114
9/14/2014,2014,9,14, 21 ,5402,1133,1125,7660
9/14/2014,2014,9,14, 22 ,5041,1044,1027,7112
9/14/2014,2014,9,14, 23 ,4724,968,947,6639
9/14/2014,2014,9,14, 24 ,4435,921,872,6228
9/15/2014,2014,9,15, 1 ,4193,890,871,5954
9/15/2014,2014,9,15, 2 ,4158,865,820,5843
9/15/2014,2014,9,15, 3 ,4051,847,778,5676
9/15/2014,2014,9,15, 4 ,4029,851,775,5655
9/15/2014,2014,9,15, 5 ,4174,904,826,5904
9/15/2014,2014,9,15, 6 ,4399,952,874,6225
9/15/2014,2014,9,15, 7 ,4812,930,802,6544
9/15/2014,2014,9,15, 8 ,5478,1067,933,7478
9/15/2014,2014,9,15, 9 ,6172,1257,1120,8549
9/15/2014,2014,9,15, 10 ,6663,1354,1181,9198
9/15/2014,2014,9,15, 11 ,6977,1403,1284,9664
9/15/2014,2014,9,15, 12 ,6827,1374,1253,9454
9/15/2014,2014,9,15, 13 ,6630,1363,1259,9252
9/15/2014,2014,9,15, 14 ,6841,1425,1311,9577
9/15/2014,2014,9,15, 15 ,6776,1390,1291,9457
9/15/2014,2014,9,15, 16 ,6759,1367,1274,9400
9/15/2014,2014,9,15, 17 ,6621,1301,1229,9151
9/15/2014,2014,9,15, 18 ,6653,1419,1341,9413
9/15/2014,2014,9,15, 19 ,6813,1472,1306,9591
9/15/2014,2014,9,15, 20 ,6586,1376,1293,9255
9/15/2014,2014,9,15, 21 ,6319,1340,1258,8917
9/15/2014,2014,9,15, 22 ,6052,1174,1124,8350
9/15/2014,2014,9,15, 23 ,5667,1096,1025,7788
9/15/2014,2014,9,15, 24 ,5233,1006,946,7185
9/16/2014,2014,9,16, 1 ,4959,943,904,6806
9/16/2014,2014,9,16, 2 ,4890,929,871,6690
9/16/2014,2014,9,16, 3 ,4759,916,839,6514
9/16/2014,2014,9,16, 4 ,4744,900,842,6486
9/16/2014,2014,9,16, 5 ,4972,940,893,6805
9/16/2014,2014,9,16, 6 ,5078,965,918,6961
9/16/2014,2014,9,16, 7 ,5169,947,856,6972
9/16/2014,2014,9,16, 8 ,5932,1104,997,8033
9/16/2014,2014,9,16, 9 ,6752,1303,1136,9191
9/16/2014,2014,9,16, 10 ,7235,1380,1263,9878
9/16/2014,2014,9,16, 11 ,7458,1447,1310,10215
9/16/2014,2014,9,16, 12 ,7359,1421,1279,10059
9/16/2014,2014,9,16, 13 ,7368,1411,1291,10070
9/16/2014,2014,9,16, 14 ,7623,1480,1323,10426
9/16/2014,2014,9,16, 15 ,7480,1468,1283,10231
9/16/2014,2014,9,16, 16 ,7356,1435,1264,10055
9/16/2014,2014,9,16, 17 ,7004,1356,1226,9586
9/16/2014,2014,9,16, 18 ,7038,1456,1302,9796
9/16/2014,2014,9,16, 19 ,7282,1499,1250,10031
9/16/2014,2014,9,16, 20 ,7059,1435,1224,9718
9/16/2014,2014,9,16, 21 ,6858,1360,1186,9404
9/16/2014,2014,9,16, 22 ,6487,1248,1051,8786
9/16/2014,2014,9,16, 23 ,6050,1143,951,8144
9/16/2014,2014,9,16, 24 ,5622,1074,901,7597
9/17/2014,2014,9,17, 1 ,5370,1022,889,7281
9/17/2014,2014,9,17, 2 ,5225,993,830,7048
9/17/2014,2014,9,17, 3 ,5047,976,809,6832
9/17/2014,2014,9,17, 4 ,4990,965,804,6759
9/17/2014,2014,9,17, 5 ,5073,998,853,6924
9/17/2014,2014,9,17, 6 ,5164,1019,900,7083
9/17/2014,2014,9,17, 7 ,5263,980,844,7087
9/17/2014,2014,9,17, 8 ,6113,1123,929,8165
9/17/2014,2014,9,17, 9 ,6934,1304,1080,9318
9/17/2014,2014,9,17, 10 ,7484,1374,1176,10034
9/17/2014,2014,9,17, 11 ,7665,1400,1237,10302
9/17/2014,2014,9,17, 12 ,7503,1352,1201,10056
9/17/2014,2014,9,17, 13 ,7604,1347,1180,10131
9/17/2014,2014,9,17, 14 ,7850,1404,1216,10470
9/17/2014,2014,9,17, 15 ,7725,1384,1193,10302
9/17/2014,2014,9,17, 16 ,7555,1362,1195,10112
9/17/2014,2014,9,17, 17 ,7182,1328,1191,9701
9/17/2014,2014,9,17, 18 ,7107,1466,1310,9883
9/17/2014,2014,9,17, 19 ,7304,1466,1274,10044
9/17/2014,2014,9,17, 20 ,7188,1408,1180,9776
9/17/2014,2014,9,17, 21 ,6982,1334,1121,9437
9/17/2014,2014,9,17, 22 ,6711,1226,990,8927
9/17/2014,2014,9,17, 23 ,6267,1116,908,8291
9/17/2014,2014,9,17, 24 ,5860,1034,844,7738
9/18/2014,2014,9,18, 1 ,5693,950,819,7462
9/18/2014,2014,9,18, 2 ,5411,918,803,7132
9/18/2014,2014,9,18, 3 ,5306,901,792,6999
9/18/2014,2014,9,18, 4 ,5233,885,799,6917
9/18/2014,2014,9,18, 5 ,5369,917,850,7136
9/18/2014,2014,9,18, 6 ,5455,954,903,7312
9/18/2014,2014,9,18, 7 ,5539,926,841,7306
9/18/2014,2014,9,18, 8 ,6318,975,946,8239
9/18/2014,2014,9,18, 9 ,6993,1114,1056,9163
9/18/2014,2014,9,18, 10 ,7356,1174,1173,9703
9/18/2014,2014,9,18, 11 ,7551,1198,1225,9974
9/18/2014,2014,9,18, 12 ,7374,1171,1218,9763
9/18/2014,2014,9,18, 13 ,7419,1147,1219,9785
9/18/2014,2014,9,18, 14 ,7668,1176,1261,10105
9/18/2014,2014,9,18, 15 ,7561,1193,1261,10015
9/18/2014,2014,9,18, 16 ,7464,1181,1241,9886
9/18/2014,2014,9,18, 17 ,7208,1182,1187,9577
9/18/2014,2014,9,18, 18 ,7308,1300,1326,9934
9/18/2014,2014,9,18, 19 ,7379,1286,1316,9981
9/18/2014,2014,9,18, 20 ,7172,1216,1267,9655
9/18/2014,2014,9,18, 21 ,6934,1136,1189,9259
9/18/2014,2014,9,18, 22 ,6561,1028,1007,8596
9/18/2014,2014,9,18, 23 ,6152,947,984,8083
9/18/2014,2014,9,18, 24 ,5783,889,908,7580
9/19/2014,2014,9,19, 1 ,5485,846,888,7219
9/19/2014,2014,9,19, 2 ,5375,828,844,7047
9/19/2014,2014,9,19, 3 ,5125,808,809,6742
9/19/2014,2014,9,19, 4 ,5020,808,820,6648
9/19/2014,2014,9,19, 5 ,5132,856,865,6853
9/19/2014,2014,9,19, 6 ,5172,912,901,6985
9/19/2014,2014,9,19, 7 ,5262,887,844,6993
9/19/2014,2014,9,19, 8 ,5774,1018,994,7786
9/19/2014,2014,9,19, 9 ,6157,1197,1121,8475
9/19/2014,2014,9,19, 10 ,6375,1282,1248,8905
9/19/2014,2014,9,19, 11 ,6362,1336,1310,9008
9/19/2014,2014,9,19, 12 ,6080,1309,1290,8679
9/19/2014,2014,9,19, 13 ,5793,1303,1318,8414
9/19/2014,2014,9,19, 14 ,5771,1346,1362,8479
9/19/2014,2014,9,19, 15 ,5509,1330,1332,8171
9/19/2014,2014,9,19, 16 ,5443,1311,1308,8062
9/19/2014,2014,9,19, 17 ,5314,1247,1235,7796
9/19/2014,2014,9,19, 18 ,5507,1379,1382,8268
9/19/2014,2014,9,19, 19 ,5537,1390,1365,8292
9/19/2014,2014,9,19, 20 ,5437,1340,1323,8100
9/19/2014,2014,9,19, 21 ,5217,1269,1269,7755
9/19/2014,2014,9,19, 22 ,4941,1170,1147,7258
9/19/2014,2014,9,19, 23 ,4657,1070,1044,6771
9/19/2014,2014,9,19, 24 ,4327,997,922,6246
9/20/2014,2014,9,20, 1 ,4113,953,939,6005
9/20/2014,2014,9,20, 2 ,4080,932,896,5908
9/20/2014,2014,9,20, 3 ,4018,919,866,5803
9/20/2014,2014,9,20, 4 ,3998,905,852,5755
9/20/2014,2014,9,20, 5 ,4075,912,874,5861
9/20/2014,2014,9,20, 6 ,4087,908,871,5866
9/20/2014,2014,9,20, 7 ,4323,913,859,6095
9/20/2014,2014,9,20, 8 ,4902,1028,944,6874
9/20/2014,2014,9,20, 9 ,5447,1172,1068,7687
9/20/2014,2014,9,20, 10 ,5857,1250,1166,8273
9/20/2014,2014,9,20, 11 ,6246,1294,1245,8785
9/20/2014,2014,9,20, 12 ,6066,1278,1233,8577
9/20/2014,2014,9,20, 13 ,6000,1281,1227,8508
9/20/2014,2014,9,20, 14 ,6134,1326,1267,8727
9/20/2014,2014,9,20, 15 ,6051,1292,1223,8566
9/20/2014,2014,9,20, 16 ,5932,1244,1203,8379
9/20/2014,2014,9,20, 17 ,5871,1188,1163,8222
9/20/2014,2014,9,20, 18 ,6196,1339,1308,8843
9/20/2014,2014,9,20, 19 ,6377,1388,1321,9086
9/20/2014,2014,9,20, 20 ,6330,1348,1299,8977
9/20/2014,2014,9,20, 21 ,6165,1301,1245,8711
9/20/2014,2014,9,20, 22 ,5791,1183,1135,8109
9/20/2014,2014,9,20, 23 ,5416,1094,1042,7552
9/20/2014,2014,9,20, 24 ,5135,1020,959,7114
9/21/2014,2014,9,21, 1 ,4874,980,905,6759
9/21/2014,2014,9,21, 2 ,4741,948,819,6508
9/21/2014,2014,9,21, 3 ,4595,917,849,6361
9/21/2014,2014,9,21, 4 ,4531,901,830,6262
9/21/2014,2014,9,21, 5 ,4508,903,844,6255
9/21/2014,2014,9,21, 6 ,4461,875,840,6176
9/21/2014,2014,9,21, 7 ,4481,882,809,6172
9/21/2014,2014,9,21, 8 ,4783,932,860,6575
9/21/2014,2014,9,21, 9 ,5239,1020,947,7206
9/21/2014,2014,9,21, 10 ,5601,1077,1023,7701
9/21/2014,2014,9,21, 11 ,5814,1132,1078,8024
9/21/2014,2014,9,21, 12 ,5800,1138,1089,8027
9/21/2014,2014,9,21, 13 ,5791,1147,1103,8041
9/21/2014,2014,9,21, 14 ,5862,1147,1094,8103
9/21/2014,2014,9,21, 15 ,5719,1132,1065,7916
9/21/2014,2014,9,21, 16 ,5562,1090,1039,7691
9/21/2014,2014,9,21, 17 ,5544,1089,1049,7682
9/21/2014,2014,9,21, 18 ,5906,1293,1252,8451
9/21/2014,2014,9,21, 19 ,6242,1342,1258,8842
9/21/2014,2014,9,21, 20 ,6220,1319,1213,8752
9/21/2014,2014,9,21, 21 ,6051,1243,1126,8420
9/21/2014,2014,9,21, 22 ,5761,1153,1017,7931
9/21/2014,2014,9,21, 23 ,5586,1058,935,7579
9/21/2014,2014,9,21, 24 ,5209,991,873,7073
9/22/2014,2014,9,22, 1 ,4936,940,845,6721
9/22/2014,2014,9,22, 2 ,4790,913,797,6500
9/22/2014,2014,9,22, 3 ,4656,890,781,6327
9/22/2014,2014,9,22, 4 ,4571,887,780,6238
9/22/2014,2014,9,22, 5 ,4782,921,840,6543
9/22/2014,2014,9,22, 6 ,4969,949,877,6795
9/22/2014,2014,9,22, 7 ,5097,921,819,6837
9/22/2014,2014,9,22, 8 ,5939,1048,964,7951
9/22/2014,2014,9,22, 9 ,6715,1260,1137,9112
9/22/2014,2014,9,22, 10 ,7204,1372,1223,9799
9/22/2014,2014,9,22, 11 ,7434,1442,1277,10153
9/22/2014,2014,9,22, 12 ,7372,1418,1254,10044
9/22/2014,2014,9,22, 13 ,7338,1411,1258,10007
9/22/2014,2014,9,22, 14 ,7605,1466,1298,10369
9/22/2014,2014,9,22, 15 ,7357,1438,1268,10063
9/22/2014,2014,9,22, 16 ,7296,1401,1249,9946
9/22/2014,2014,9,22, 17 ,6979,1336,1256,9571
9/22/2014,2014,9,22, 18 ,7046,1444,1309,9799
9/22/2014,2014,9,22, 19 ,7176,1458,1270,9904
9/22/2014,2014,9,22, 20 ,6989,1405,1214,9608
9/22/2014,2014,9,22, 21 ,6829,1336,1152,9317
9/22/2014,2014,9,22, 22 ,6430,1219,1080,8729
9/22/2014,2014,9,22, 23 ,6128,1118,961,8207
9/22/2014,2014,9,22, 24 ,5714,1047,904,7665
9/23/2014,2014,9,23, 1 ,5461,1001,876,7338
9/23/2014,2014,9,23, 2 ,5325,974,841,7140
9/23/2014,2014,9,23, 3 ,5180,947,819,6946
9/23/2014,2014,9,23, 4 ,5100,944,825,6869
9/23/2014,2014,9,23, 5 ,5232,979,891,7102
9/23/2014,2014,9,23, 6 ,5250,989,938,7177
9/23/2014,2014,9,23, 7 ,5411,956,867,7234
9/23/2014,2014,9,23, 8 ,6188,1098,986,8272
9/23/2014,2014,9,23, 9 ,7022,1298,1144,9464
9/23/2014,2014,9,23, 10 ,7476,1382,1215,10073
9/23/2014,2014,9,23, 11 ,7731,1457,1285,10473
9/23/2014,2014,9,23, 12 ,7582,1422,1260,10264
9/23/2014,2014,9,23, 13 ,7660,1410,1283,10353
9/23/2014,2014,9,23, 14 ,7950,1477,1301,10728
9/23/2014,2014,9,23, 15 ,7835,1429,1291,10555
9/23/2014,2014,9,23, 16 ,7714,1400,1266,10380
9/23/2014,2014,9,23, 17 ,7296,1357,1235,9888
9/23/2014,2014,9,23, 18 ,7222,1470,1337,10029
9/23/2014,2014,9,23, 19 ,7496,1469,1321,10286
9/23/2014,2014,9,23, 20 ,7364,1416,1301,10081
9/23/2014,2014,9,23, 21 ,7216,1351,1198,9765
9/23/2014,2014,9,23, 22 ,6835,1237,1114,9186
9/23/2014,2014,9,23, 23 ,6362,1132,1029,8523
9/23/2014,2014,9,23, 24 ,5979,1057,966,8002
9/24/2014,2014,9,24, 1 ,5665,1010,884,7559
9/24/2014,2014,9,24, 2 ,5509,976,875,7360
9/24/2014,2014,9,24, 3 ,5309,948,861,7118
9/24/2014,2014,9,24, 4 ,5257,935,859,7051
9/24/2014,2014,9,24, 5 ,5345,979,915,7239
9/24/2014,2014,9,24, 6 ,5365,1003,913,7281
9/24/2014,2014,9,24, 7 ,5488,961,863,7312
9/24/2014,2014,9,24, 8 ,6358,1124,999,8481
9/24/2014,2014,9,24, 9 ,7075,1317,1131,9523
9/24/2014,2014,9,24, 10 ,7596,1406,1214,10216
9/24/2014,2014,9,24, 11 ,7832,1462,1278,10572
9/24/2014,2014,9,24, 12 ,7749,1426,1276,10451
9/24/2014,2014,9,24, 13 ,7769,1431,1273,10473
9/24/2014,2014,9,24, 14 ,7844,1467,1319,10630
9/24/2014,2014,9,24, 15 ,7685,1435,1276,10396
9/24/2014,2014,9,24, 16 ,7548,1396,1265,10209
9/24/2014,2014,9,24, 17 ,7307,1346,1247,9900
9/24/2014,2014,9,24, 18 ,7359,1490,1343,10192
9/24/2014,2014,9,24, 19 ,7527,1500,1321,10348
9/24/2014,2014,9,24, 20 ,7322,1446,1325,10093
9/24/2014,2014,9,24, 21 ,7117,1372,1250,9739
9/24/2014,2014,9,24, 22 ,6746,1247,1047,9040
9/24/2014,2014,9,24, 23 ,6315,1140,1080,8535
9/24/2014,2014,9,24, 24 ,5862,1060,986,7908
9/25/2014,2014,9,25, 1 ,5583,1021,951,7555
9/25/2014,2014,9,25, 2 ,5495,985,913,7393
9/25/2014,2014,9,25, 3 ,5332,959,892,7183
9/25/2014,2014,9,25, 4 ,5251,948,873,7072
9/25/2014,2014,9,25, 5 ,5388,982,937,7307
9/25/2014,2014,9,25, 6 ,5416,1008,964,7388
9/25/2014,2014,9,25, 7 ,5483,973,901,7357
9/25/2014,2014,9,25, 8 ,6269,1092,1042,8403
9/25/2014,2014,9,25, 9 ,7074,1273,1164,9511
9/25/2014,2014,9,25, 10 ,7543,1374,1244,10161
9/25/2014,2014,9,25, 11 ,7780,1405,1291,10476
9/25/2014,2014,9,25, 12 ,7538,1388,1251,10177
9/25/2014,2014,9,25, 13 ,7443,1393,1280,10116
9/25/2014,2014,9,25, 14 ,7629,1464,1306,10399
9/25/2014,2014,9,25, 15 ,7504,1424,1277,10205
9/25/2014,2014,9,25, 16 ,7313,1368,1254,9935
9/25/2014,2014,9,25, 17 ,7100,1335,1248,9683
9/25/2014,2014,9,25, 18 ,7168,1469,1346,9983
9/25/2014,2014,9,25, 19 ,7304,1480,1321,10105
9/25/2014,2014,9,25, 20 ,7110,1415,1301,9826
9/25/2014,2014,9,25, 21 ,6901,1356,1231,9488
9/25/2014,2014,9,25, 22 ,6505,1249,1151,8905
9/25/2014,2014,9,25, 23 ,6094,1141,1034,8269
9/25/2014,2014,9,25, 24 ,5689,1051,965,7705
9/26/2014,2014,9,26, 1 ,5450,1008,932,7390
9/26/2014,2014,9,26, 2 ,5274,983,907,7164
9/26/2014,2014,9,26, 3 ,5102,944,879,6925
9/26/2014,2014,9,26, 4 ,5003,930,880,6813
9/26/2014,2014,9,26, 5 ,5192,971,916,7079
9/26/2014,2014,9,26, 6 ,5200,1000,908,7108
9/26/2014,2014,9,26, 7 ,5294,968,866,7128
9/26/2014,2014,9,26, 8 ,6168,1097,1019,8284
9/26/2014,2014,9,26, 9 ,6952,1295,1188,9435
9/26/2014,2014,9,26, 10 ,7359,1383,1267,10009
9/26/2014,2014,9,26, 11 ,7554,1418,1300,10272
9/26/2014,2014,9,26, 12 ,7352,1356,1289,9997
9/26/2014,2014,9,26, 13 ,7364,1385,1326,10075
9/26/2014,2014,9,26, 14 ,7413,1323,1354,10090
9/26/2014,2014,9,26, 15 ,7327,1335,1317,9979
9/26/2014,2014,9,26, 16 ,7261,1320,1324,9905
9/26/2014,2014,9,26, 17 ,6959,1279,1295,9533
9/26/2014,2014,9,26, 18 ,7026,1432,1372,9830
9/26/2014,2014,9,26, 19 ,7209,1414,1330,9953
9/26/2014,2014,9,26, 20 ,7055,1355,1261,9671
9/26/2014,2014,9,26, 21 ,6831,1274,1233,9338
9/26/2014,2014,9,26, 22 ,6572,1177,1089,8838
9/26/2014,2014,9,26, 23 ,6169,1073,994,8236
9/26/2014,2014,9,26, 24 ,5777,1007,927,7711
9/27/2014,2014,9,27, 1 ,5517,962,874,7353
9/27/2014,2014,9,27, 2 ,5343,934,848,7125
9/27/2014,2014,9,27, 3 ,5148,905,824,6877
9/27/2014,2014,9,27, 4 ,5076,892,812,6780
9/27/2014,2014,9,27, 5 ,5070,911,849,6830
9/27/2014,2014,9,27, 6 ,4965,906,879,6750
9/27/2014,2014,9,27, 7 ,5156,914,867,6937
9/27/2014,2014,9,27, 8 ,5713,1016,961,7690
9/27/2014,2014,9,27, 9 ,6339,1169,1074,8582
9/27/2014,2014,9,27, 10 ,6856,1238,1160,9254
9/27/2014,2014,9,27, 11 ,7167,1310,1208,9685
9/27/2014,2014,9,27, 12 ,7024,1301,1217,9542
9/27/2014,2014,9,27, 13 ,7019,1299,1228,9546
9/27/2014,2014,9,27, 14 ,7173,1350,1226,9749
9/27/2014,2014,9,27, 15 ,7000,1300,1175,9475
9/27/2014,2014,9,27, 16 ,6942,1261,1180,9383
9/27/2014,2014,9,27, 17 ,6594,1218,1193,9005
9/27/2014,2014,9,27, 18 ,6694,1375,1317,9386
9/27/2014,2014,9,27, 19 ,6962,1405,1292,9659
9/27/2014,2014,9,27, 20 ,6939,1362,1246,9547
9/27/2014,2014,9,27, 21 ,6893,1305,1156,9354
9/27/2014,2014,9,27, 22 ,6581,1190,1049,8820
9/27/2014,2014,9,27, 23 ,6276,1090,997,8363
9/27/2014,2014,9,27, 24 ,5907,1019,955,7881
9/28/2014,2014,9,28, 1 ,5676,972,884,7532
9/28/2014,2014,9,28, 2 ,5404,931,859,7194
9/28/2014,2014,9,28, 3 ,5292,903,837,7032
9/28/2014,2014,9,28, 4 ,5147,887,824,6858
9/28/2014,2014,9,28, 5 ,5015,882,844,6741
9/28/2014,2014,9,28, 6 ,4851,866,852,6569
9/28/2014,2014,9,28, 7 ,4796,868,834,6498
9/28/2014,2014,9,28, 8 ,5157,937,846,6940
9/28/2014,2014,9,28, 9 ,5523,1034,927,7484
9/28/2014,2014,9,28, 10 ,5960,1108,997,8065
9/28/2014,2014,9,28, 11 ,6187,1164,1055,8406
9/28/2014,2014,9,28, 12 ,6203,1171,1063,8437
9/28/2014,2014,9,28, 13 ,6164,1181,1066,8411
9/28/2014,2014,9,28, 14 ,6229,1188,1070,8487
9/28/2014,2014,9,28, 15 ,6113,1162,1051,8326
9/28/2014,2014,9,28, 16 ,5985,1128,1037,8150
9/28/2014,2014,9,28, 17 ,5833,1113,1067,8013
9/28/2014,2014,9,28, 18 ,6221,1318,1261,8800
9/28/2014,2014,9,28, 19 ,6591,1348,1267,9206
9/28/2014,2014,9,28, 20 ,6618,1314,1245,9177
9/28/2014,2014,9,28, 21 ,6515,1244,1149,8908
9/28/2014,2014,9,28, 22 ,6236,1142,1045,8423
9/28/2014,2014,9,28, 23 ,5849,1063,954,7866
9/28/2014,2014,9,28, 24 ,5492,1001,931,7424
9/29/2014,2014,9,29, 1 ,5282,954,858,7094
9/29/2014,2014,9,29, 2 ,5084,924,829,6837
9/29/2014,2014,9,29, 3 ,4979,897,809,6685
9/29/2014,2014,9,29, 4 ,4889,891,807,6587
9/29/2014,2014,9,29, 5 ,5037,923,866,6826
9/29/2014,2014,9,29, 6 ,5127,938,894,6959
9/29/2014,2014,9,29, 7 ,5239,912,846,6997
9/29/2014,2014,9,29, 8 ,6023,1061,991,8075
9/29/2014,2014,9,29, 9 ,7046,1257,1162,9465
9/29/2014,2014,9,29, 10 ,7502,1351,1280,10133
9/29/2014,2014,9,29, 11 ,7750,1393,1321,10464
9/29/2014,2014,9,29, 12 ,7619,1368,1315,10302
9/29/2014,2014,9,29, 13 ,7601,1364,1316,10281
9/29/2014,2014,9,29, 14 ,7913,1413,1355,10681
9/29/2014,2014,9,29, 15 ,7785,1379,1316,10480
9/29/2014,2014,9,29, 16 ,7650,1353,1301,10304
9/29/2014,2014,9,29, 17 ,7244,1314,1281,9839
9/29/2014,2014,9,29, 18 ,7430,1433,1396,10259
9/29/2014,2014,9,29, 19 ,7470,1420,1359,10249
9/29/2014,2014,9,29, 20 ,7315,1361,1334,10010
9/29/2014,2014,9,29, 21 ,7060,1285,1257,9602
9/29/2014,2014,9,29, 22 ,6703,1184,1157,9044
9/29/2014,2014,9,29, 23 ,6278,1070,1049,8397
9/29/2014,2014,9,29, 24 ,5831,994,968,7793
9/30/2014,2014,9,30, 1 ,5564,956,930,7450
9/30/2014,2014,9,30, 2 ,5390,921,898,7209
9/30/2014,2014,9,30, 3 ,5255,897,877,7029
9/30/2014,2014,9,30, 4 ,5166,887,874,6927
9/30/2014,2014,9,30, 5 ,5324,926,916,7166
9/30/2014,2014,9,30, 6 ,5372,953,940,7265
9/30/2014,2014,9,30, 7 ,5382,917,880,7179
9/30/2014,2014,9,30, 8 ,6243,1067,1018,8328
9/30/2014,2014,9,30, 9 ,6665,1260,1186,9111
9/30/2014,2014,9,30, 10 ,7302,1345,1287,9934
9/30/2014,2014,9,30, 11 ,7615,1403,1356,10374
9/30/2014,2014,9,30, 12 ,7442,1364,1330,10136
9/30/2014,2014,9,30, 13 ,7496,1364,1325,10185
9/30/2014,2014,9,30, 14 ,7744,1398,1355,10497
9/30/2014,2014,9,30, 15 ,7620,1354,1329,10303
9/30/2014,2014,9,30, 16 ,7439,1249,1313,10001
9/30/2014,2014,9,30, 17 ,7171,1267,1262,9700
9/30/2014,2014,9,30, 18 ,7289,1391,1392,10072
9/30/2014,2014,9,30, 19 ,7404,1405,1358,10167
9/30/2014,2014,9,30, 20 ,7286,1346,1295,9927
9/30/2014,2014,9,30, 21 ,7123,1281,1240,9644
9/30/2014,2014,9,30, 22 ,6687,1175,1124,8986
9/30/2014,2014,9,30, 23 ,6365,1069,1018,8452
9/30/2014,2014,9,30, 24 ,5969,989,996,7954
10/1/2014,2014,10,1, 1 ,5690,949,913,7552
10/1/2014,2014,10,1, 2 ,5468,919,881,7268
10/1/2014,2014,10,1, 3 ,5315,907,859,7081
10/1/2014,2014,10,1, 4 ,5260,898,860,7018
10/1/2014,2014,10,1, 5 ,5350,934,911,7195
10/1/2014,2014,10,1, 6 ,5412,950,946,7308
10/1/2014,2014,10,1, 7 ,5485,921,877,7283
10/1/2014,2014,10,1, 8 ,6271,1081,1027,8379
10/1/2014,2014,10,1, 9 ,6978,1280,1176,9434
10/1/2014,2014,10,1, 10 ,7491,1368,1269,10128
10/1/2014,2014,10,1, 11 ,7758,1428,1361,10547
10/1/2014,2014,10,1, 12 ,7621,1393,1317,10331
10/1/2014,2014,10,1, 13 ,7580,1369,1266,10215
10/1/2014,2014,10,1, 14 ,7820,1450,1325,10595
10/1/2014,2014,10,1, 15 ,7774,1393,1305,10472
10/1/2014,2014,10,1, 16 ,7536,1352,1286,10174
10/1/2014,2014,10,1, 17 ,6960,1311,1259,9530
10/1/2014,2014,10,1, 18 ,7176,1450,1401,10027
10/1/2014,2014,10,1, 19 ,7126,1432,1382,9940
10/1/2014,2014,10,1, 20 ,7126,1388,1324,9838
10/1/2014,2014,10,1, 21 ,6795,1312,1256,9363
10/1/2014,2014,10,1, 22 ,6463,1205,1153,8821
10/1/2014,2014,10,1, 23 ,6025,1086,1035,8146
10/1/2014,2014,10,1, 24 ,5713,1010,957,7680
10/2/2014,2014,10,2, 1 ,5417,962,926,7305
10/2/2014,2014,10,2, 2 ,5241,935,888,7064
10/2/2014,2014,10,2, 3 ,5094,911,876,6881
10/2/2014,2014,10,2, 4 ,5052,911,871,6834
10/2/2014,2014,10,2, 5 ,5141,944,920,7005
10/2/2014,2014,10,2, 6 ,5242,964,955,7161
10/2/2014,2014,10,2, 7 ,5352,939,887,7178
10/2/2014,2014,10,2, 8 ,6181,1107,1046,8334
10/2/2014,2014,10,2, 9 ,6874,1251,1197,9322
10/2/2014,2014,10,2, 10 ,7456,1376,1292,10124
10/2/2014,2014,10,2, 11 ,7668,1451,1354,10473
10/2/2014,2014,10,2, 12 ,7428,1419,1320,10167
10/2/2014,2014,10,2, 13 ,7520,1408,1334,10262
10/2/2014,2014,10,2, 14 ,7715,1455,1367,10537
10/2/2014,2014,10,2, 15 ,7545,1418,1304,10267
10/2/2014,2014,10,2, 16 ,7457,1391,1321,10169
10/2/2014,2014,10,2, 17 ,7125,1359,1300,9784
10/2/2014,2014,10,2, 18 ,7211,1489,1357,10057
10/2/2014,2014,10,2, 19 ,7259,1453,1317,10029
10/2/2014,2014,10,2, 20 ,7201,1420,1306,9927
10/2/2014,2014,10,2, 21 ,6990,1336,1246,9572
10/2/2014,2014,10,2, 22 ,6630,1221,1151,9002
10/2/2014,2014,10,2, 23 ,6217,1119,1046,8382
10/2/2014,2014,10,2, 24 ,5838,1054,988,7880
10/3/2014,2014,10,3, 1 ,5598,999,942,7539
10/3/2014,2014,10,3, 2 ,5479,963,905,7347
10/3/2014,2014,10,3, 3 ,5296,942,891,7129
10/3/2014,2014,10,3, 4 ,5145,923,885,6953
10/3/2014,2014,10,3, 5 ,5284,957,923,7164
10/3/2014,2014,10,3, 6 ,5333,963,941,7237
10/3/2014,2014,10,3, 7 ,5484,947,903,7334
10/3/2014,2014,10,3, 8 ,6295,1115,1051,8461
10/3/2014,2014,10,3, 9 ,7173,1304,1203,9680
10/3/2014,2014,10,3, 10 ,7509,1398,1315,10222
10/3/2014,2014,10,3, 11 ,7750,1460,1349,10559
10/3/2014,2014,10,3, 12 ,7643,1402,1295,10340
10/3/2014,2014,10,3, 13 ,7608,1412,1308,10328
10/3/2014,2014,10,3, 14 ,7793,1460,1344,10597
10/3/2014,2014,10,3, 15 ,7679,1400,1315,10394
10/3/2014,2014,10,3, 16 ,7548,1377,1289,10214
10/3/2014,2014,10,3, 17 ,7199,1341,1274,9814
10/3/2014,2014,10,3, 18 ,7335,1459,1405,10199
10/3/2014,2014,10,3, 19 ,7336,1438,1349,10123
10/3/2014,2014,10,3, 20 ,7224,1386,1305,9915
10/3/2014,2014,10,3, 21 ,6970,1301,1242,9513
10/3/2014,2014,10,3, 22 ,6658,1179,1132,8969
10/3/2014,2014,10,3, 23 ,6258,1098,1047,8403
10/3/2014,2014,10,3, 24 ,5840,1024,975,7839
10/4/2014,2014,10,4, 1 ,5598,987,935,7520
10/4/2014,2014,10,4, 2 ,5407,958,901,7266
10/4/2014,2014,10,4, 3 ,5296,933,874,7103
10/4/2014,2014,10,4, 4 ,5204,925,872,7001
10/4/2014,2014,10,4, 5 ,5170,936,905,7011
10/4/2014,2014,10,4, 6 ,5055,915,899,6869
10/4/2014,2014,10,4, 7 ,5179,928,852,6959
10/4/2014,2014,10,4, 8 ,5662,1053,963,7678
10/4/2014,2014,10,4, 9 ,6349,1193,1057,8599
10/4/2014,2014,10,4, 10 ,6870,1258,1151,9279
10/4/2014,2014,10,4, 11 ,7133,1322,1203,9658
10/4/2014,2014,10,4, 12 ,7053,1275,1181,9509
10/4/2014,2014,10,4, 13 ,6875,1252,1174,9301
10/4/2014,2014,10,4, 14 ,6990,1269,1207,9466
10/4/2014,2014,10,4, 15 ,6742,1237,1160,9139
10/4/2014,2014,10,4, 16 ,6624,1204,1148,8976
10/4/2014,2014,10,4, 17 ,6402,1192,1157,8751
10/4/2014,2014,10,4, 18 ,6782,1381,1319,9482
10/4/2014,2014,10,4, 19 ,6941,1364,1310,9615
10/4/2014,2014,10,4, 20 ,6876,1311,1265,9452
10/4/2014,2014,10,4, 21 ,6734,1243,1205,9182
10/4/2014,2014,10,4, 22 ,6384,1170,1125,8679
10/4/2014,2014,10,4, 23 ,6029,1065,1020,8114
10/4/2014,2014,10,4, 24 ,5680,1005,932,7617
10/5/2014,2014,10,5, 1 ,5395,952,927,7274
10/5/2014,2014,10,5, 2 ,5265,919,882,7066
10/5/2014,2014,10,5, 3 ,5119,889,835,6843
10/5/2014,2014,10,5, 4 ,4955,872,826,6653
10/5/2014,2014,10,5, 5 ,4900,865,818,6583
10/5/2014,2014,10,5, 6 ,4753,826,828,6407
10/5/2014,2014,10,5, 7 ,4746,851,818,6415
10/5/2014,2014,10,5, 8 ,5072,916,877,6865
10/5/2014,2014,10,5, 9 ,5467,1002,920,7389
10/5/2014,2014,10,5, 10 ,5866,1074,1011,7951
10/5/2014,2014,10,5, 11 ,6118,1124,1061,8303
10/5/2014,2014,10,5, 12 ,6078,1097,1066,8241
10/5/2014,2014,10,5, 13 ,6046,1085,1072,8203
10/5/2014,2014,10,5, 14 ,5903,1088,1061,8052
10/5/2014,2014,10,5, 15 ,5784,1053,1026,7863
10/5/2014,2014,10,5, 16 ,5655,1037,1003,7695
10/5/2014,2014,10,5, 17 ,5611,1063,1045,7719
10/5/2014,2014,10,5, 18 ,6157,1260,1235,8652
10/5/2014,2014,10,5, 19 ,6344,1248,1220,8812
10/5/2014,2014,10,5, 20 ,6295,1200,1185,8680
10/5/2014,2014,10,5, 21 ,6170,1136,1120,8426
10/5/2014,2014,10,5, 22 ,5863,1054,1035,7952
10/5/2014,2014,10,5, 23 ,5531,980,958,7469
10/5/2014,2014,10,5, 24 ,5183,931,903,7017
10/6/2014,2014,10,6, 1 ,4951,887,849,6687
10/6/2014,2014,10,6, 2 ,4728,858,829,6415
10/6/2014,2014,10,6, 3 ,4651,836,807,6294
10/6/2014,2014,10,6, 4 ,4543,826,790,6159
10/6/2014,2014,10,6, 5 ,4561,848,810,6219
10/6/2014,2014,10,6, 6 ,4544,847,822,6213
10/6/2014,2014,10,6, 7 ,4575,856,862,6293
10/6/2014,2014,10,6, 8 ,4957,963,874,6794
10/6/2014,2014,10,6, 9 ,5440,1091,1023,7554
10/6/2014,2014,10,6, 10 ,5935,1167,1097,8199
10/6/2014,2014,10,6, 11 ,6284,1232,1166,8682
10/6/2014,2014,10,6, 12 ,6243,1191,1153,8587
10/6/2014,2014,10,6, 13 ,6228,1193,1153,8574
10/6/2014,2014,10,6, 14 ,6440,1230,1170,8840
10/6/2014,2014,10,6, 15 ,6311,1214,1154,8679
10/6/2014,2014,10,6, 16 ,6152,1177,1143,8472
10/6/2014,2014,10,6, 17 ,6047,1175,1169,8391
10/6/2014,2014,10,6, 18 ,6576,1340,1334,9250
10/6/2014,2014,10,6, 19 ,6770,1340,1255,9365
10/6/2014,2014,10,6, 20 ,6762,1290,1241,9293
10/6/2014,2014,10,6, 21 ,6604,1214,1198,9016
10/6/2014,2014,10,6, 22 ,6149,1112,1095,8356
10/6/2014,2014,10,6, 23 ,5668,998,987,7653
10/6/2014,2014,10,6, 24 ,5343,938,859,7140
10/7/2014,2014,10,7, 1 ,5135,899,884,6918
10/7/2014,2014,10,7, 2 ,5013,877,862,6752
10/7/2014,2014,10,7, 3 ,4853,860,839,6552
10/7/2014,2014,10,7, 4 ,4810,857,845,6512
10/7/2014,2014,10,7, 5 ,4989,904,899,6792
10/7/2014,2014,10,7, 6 ,5060,931,933,6924
10/7/2014,2014,10,7, 7 ,5246,905,880,7031
10/7/2014,2014,10,7, 8 ,6120,1088,1002,8210
10/7/2014,2014,10,7, 9 ,6918,1281,1152,9351
10/7/2014,2014,10,7, 10 ,7488,1366,1262,10116
10/7/2014,2014,10,7, 11 ,7718,1418,1320,10456
10/7/2014,2014,10,7, 12 ,7605,1381,1293,10279
10/7/2014,2014,10,7, 13 ,7597,1376,1288,10261
10/7/2014,2014,10,7, 14 ,7807,1421,1310,10538
10/7/2014,2014,10,7, 15 ,7582,1385,1295,10262
10/7/2014,2014,10,7, 16 ,7303,1363,1274,9940
10/7/2014,2014,10,7, 17 ,7072,1302,1274,9648
10/7/2014,2014,10,7, 18 ,7338,1451,1382,10171
10/7/2014,2014,10,7, 19 ,7351,1424,1308,10083
10/7/2014,2014,10,7, 20 ,7133,1357,1238,9728
10/7/2014,2014,10,7, 21 ,6931,1277,1194,9402
10/7/2014,2014,10,7, 22 ,6526,1168,1093,8787
10/7/2014,2014,10,7, 23 ,6119,1075,969,8163
10/7/2014,2014,10,7, 24 ,5797,1005,972,7774
10/8/2014,2014,10,8, 1 ,5546,953,877,7376
10/8/2014,2014,10,8, 2 ,5330,916,856,7102
10/8/2014,2014,10,8, 3 ,5232,894,834,6960
10/8/2014,2014,10,8, 4 ,5102,897,835,6834
10/8/2014,2014,10,8, 5 ,5251,930,880,7061
10/8/2014,2014,10,8, 6 ,5387,954,932,7273
10/8/2014,2014,10,8, 7 ,5483,921,878,7282
10/8/2014,2014,10,8, 8 ,6205,1061,1000,8266
10/8/2014,2014,10,8, 9 ,6920,1262,1166,9348
10/8/2014,2014,10,8, 10 ,7173,1333,1268,9774
10/8/2014,2014,10,8, 11 ,7458,1355,1318,10131
10/8/2014,2014,10,8, 12 ,7357,1320,1282,9959
10/8/2014,2014,10,8, 13 ,7257,1309,1254,9820
10/8/2014,2014,10,8, 14 ,7514,1355,1245,10114
10/8/2014,2014,10,8, 15 ,7425,1317,1209,9951
10/8/2014,2014,10,8, 16 ,7209,1306,1209,9724
10/8/2014,2014,10,8, 17 ,6939,1276,1231,9446
10/8/2014,2014,10,8, 18 ,7233,1416,1364,10013
10/8/2014,2014,10,8, 19 ,7179,1356,1301,9836
10/8/2014,2014,10,8, 20 ,7035,1301,1247,9583
10/8/2014,2014,10,8, 21 ,6816,1222,1197,9235
10/8/2014,2014,10,8, 22 ,6442,1109,1079,8630
10/8/2014,2014,10,8, 23 ,6030,1014,990,8034
10/8/2014,2014,10,8, 24 ,5677,948,902,7527
10/9/2014,2014,10,9, 1 ,5425,907,876,7208
10/9/2014,2014,10,9, 2 ,5281,881,851,7013
10/9/2014,2014,10,9, 3 ,5117,867,835,6819
10/9/2014,2014,10,9, 4 ,5038,861,800,6699
10/9/2014,2014,10,9, 5 ,5198,910,860,6968
10/9/2014,2014,10,9, 6 ,5254,946,897,7097
10/9/2014,2014,10,9, 7 ,5403,899,877,7179
10/9/2014,2014,10,9, 8 ,6124,1028,942,8094
10/9/2014,2014,10,9, 9 ,6811,1205,1108,9124
10/9/2014,2014,10,9, 10 ,7223,1300,1196,9719
10/9/2014,2014,10,9, 11 ,7504,1361,1250,10115
10/9/2014,2014,10,9, 12 ,7335,1289,1231,9855
10/9/2014,2014,10,9, 13 ,7350,1264,1189,9803
10/9/2014,2014,10,9, 14 ,7632,1303,1220,10155
10/9/2014,2014,10,9, 15 ,7549,1275,1202,10026
10/9/2014,2014,10,9, 16 ,7384,1255,1189,9828
10/9/2014,2014,10,9, 17 ,7112,1267,1221,9600
10/9/2014,2014,10,9, 18 ,7485,1379,1359,10223
10/9/2014,2014,10,9, 19 ,7403,1358,1290,10051
10/9/2014,2014,10,9, 20 ,7222,1245,1270,9737
10/9/2014,2014,10,9, 21 ,7067,1179,1206,9452
10/9/2014,2014,10,9, 22 ,6681,1062,1102,8845
10/9/2014,2014,10,9, 23 ,6251,949,985,8185
10/9/2014,2014,10,9, 24 ,5831,901,958,7690
10/10/2014,2014,10,10, 1 ,5513,875,887,7275
10/10/2014,2014,10,10, 2 ,5376,845,853,7074
10/10/2014,2014,10,10, 3 ,5183,834,850,6867
10/10/2014,2014,10,10, 4 ,5132,830,850,6812
10/10/2014,2014,10,10, 5 ,5219,866,897,6982
10/10/2014,2014,10,10, 6 ,5353,915,893,7161
10/10/2014,2014,10,10, 7 ,5395,910,869,7174
10/10/2014,2014,10,10, 8 ,6163,1030,1001,8194
10/10/2014,2014,10,10, 9 ,6976,1175,1169,9320
10/10/2014,2014,10,10, 10 ,7388,1261,1252,9901
10/10/2014,2014,10,10, 11 ,7714,1299,1297,10310
10/10/2014,2014,10,10, 12 ,7506,1210,1270,9986
10/10/2014,2014,10,10, 13 ,7486,1192,1261,9939
10/10/2014,2014,10,10, 14 ,7756,1248,1305,10309
10/10/2014,2014,10,10, 15 ,7656,1225,1287,10168
10/10/2014,2014,10,10, 16 ,7434,1222,1235,9891
10/10/2014,2014,10,10, 17 ,7047,1221,1190,9458
10/10/2014,2014,10,10, 18 ,7266,1379,1389,10034
10/10/2014,2014,10,10, 19 ,7218,1335,1314,9867
10/10/2014,2014,10,10, 20 ,7018,1268,1270,9556
10/10/2014,2014,10,10, 21 ,6875,1192,1219,9286
10/10/2014,2014,10,10, 22 ,6647,1092,1138,8877
10/10/2014,2014,10,10, 23 ,6237,993,1021,8251
10/10/2014,2014,10,10, 24 ,5811,932,982,7725
10/11/2014,2014,10,11, 1 ,5515,899,917,7331
10/11/2014,2014,10,11, 2 ,5410,876,885,7171
10/11/2014,2014,10,11, 3 ,5345,851,866,7062
10/11/2014,2014,10,11, 4 ,5198,835,857,6890
10/11/2014,2014,10,11, 5 ,5148,853,869,6870
10/11/2014,2014,10,11, 6 ,5123,864,888,6875
10/11/2014,2014,10,11, 7 ,5259,877,880,7016
10/11/2014,2014,10,11, 8 ,5805,963,968,7736
10/11/2014,2014,10,11, 9 ,6451,1101,1065,8617
10/11/2014,2014,10,11, 10 ,6947,1172,1169,9288
10/11/2014,2014,10,11, 11 ,7249,1231,1218,9698
10/11/2014,2014,10,11, 12 ,7092,1199,1208,9499
10/11/2014,2014,10,11, 13 ,7035,1169,1194,9398
10/11/2014,2014,10,11, 14 ,7137,1214,1230,9581
10/11/2014,2014,10,11, 15 ,6904,1198,1191,9293
10/11/2014,2014,10,11, 16 ,6661,1188,1169,9018
10/11/2014,2014,10,11, 17 ,6445,1161,1178,8784
10/11/2014,2014,10,11, 18 ,6806,1345,1330,9481
10/11/2014,2014,10,11, 19 ,6729,1320,1306,9355
10/11/2014,2014,10,11, 20 ,6694,1268,1259,9221
10/11/2014,2014,10,11, 21 ,6508,1191,1163,8862
10/11/2014,2014,10,11, 22 ,6244,1095,1129,8468
10/11/2014,2014,10,11, 23 ,5895,1001,1000,7896
10/11/2014,2014,10,11, 24 ,5570,936,939,7445
10/12/2014,2014,10,12, 1 ,5287,900,895,7082
10/12/2014,2014,10,12, 2 ,5192,864,870,6926
10/12/2014,2014,10,12, 3 ,5020,845,839,6704
10/12/2014,2014,10,12, 4 ,4927,833,824,6584
10/12/2014,2014,10,12, 5 ,4879,828,841,6548
10/12/2014,2014,10,12, 6 ,4715,815,841,6371
10/12/2014,2014,10,12, 7 ,4763,835,822,6420
10/12/2014,2014,10,12, 8 ,5023,890,864,6777
10/12/2014,2014,10,12, 9 ,5378,977,949,7304
10/12/2014,2014,10,12, 10 ,5846,1039,1010,7895
10/12/2014,2014,10,12, 11 ,6081,1109,1078,8268
10/12/2014,2014,10,12, 12 ,6041,1104,1088,8233
10/12/2014,2014,10,12, 13 ,6005,1100,1094,8199
10/12/2014,2014,10,12, 14 ,5968,1118,1106,8192
10/12/2014,2014,10,12, 15 ,5810,1094,1070,7974
10/12/2014,2014,10,12, 16 ,5655,1053,1037,7745
10/12/2014,2014,10,12, 17 ,5667,1092,1052,7811
10/12/2014,2014,10,12, 18 ,6195,1314,1234,8743
10/12/2014,2014,10,12, 19 ,6301,1315,1194,8810
10/12/2014,2014,10,12, 20 ,6284,1277,1216,8777
10/12/2014,2014,10,12, 21 ,6112,1186,1165,8463
10/12/2014,2014,10,12, 22 ,5840,1078,1070,7988
10/12/2014,2014,10,12, 23 ,5495,995,1002,7492
10/12/2014,2014,10,12, 24 ,5169,934,1026,7129
10/13/2014,2014,10,13, 1 ,4912,893,865,6670
10/13/2014,2014,10,13, 2 ,4769,856,832,6457
10/13/2014,2014,10,13, 3 ,4582,835,794,6211
10/13/2014,2014,10,13, 4 ,4589,831,787,6207
10/13/2014,2014,10,13, 5 ,4778,878,843,6499
10/13/2014,2014,10,13, 6 ,4938,912,885,6735
10/13/2014,2014,10,13, 7 ,5138,887,829,6854
10/13/2014,2014,10,13, 8 ,6027,1052,988,8067
10/13/2014,2014,10,13, 9 ,6864,1260,1187,9311
10/13/2014,2014,10,13, 10 ,7303,1354,1275,9932
10/13/2014,2014,10,13, 11 ,7600,1413,1325,10338
10/13/2014,2014,10,13, 12 ,7430,1381,1273,10084
10/13/2014,2014,10,13, 13 ,7424,1378,1290,10092
10/13/2014,2014,10,13, 14 ,7678,1428,1323,10429
10/13/2014,2014,10,13, 15 ,7546,1407,1305,10258
10/13/2014,2014,10,13, 16 ,7305,1350,1282,9937
10/13/2014,2014,10,13, 17 ,7098,1291,1257,9646
10/13/2014,2014,10,13, 18 ,7311,1448,1386,10145
10/13/2014,2014,10,13, 19 ,7269,1437,1323,10029
10/13/2014,2014,10,13, 20 ,7104,1380,1316,9800
10/13/2014,2014,10,13, 21 ,6910,1322,1259,9491
10/13/2014,2014,10,13, 22 ,6491,1186,1149,8826
10/13/2014,2014,10,13, 23 ,6064,1077,1044,8185
10/13/2014,2014,10,13, 24 ,5640,1003,948,7591
10/14/2014,2014,10,14, 1 ,5438,956,940,7334
10/14/2014,2014,10,14, 2 ,5239,928,905,7072
10/14/2014,2014,10,14, 3 ,5083,896,879,6858
10/14/2014,2014,10,14, 4 ,5073,886,872,6831
10/14/2014,2014,10,14, 5 ,5177,926,922,7025
10/14/2014,2014,10,14, 6 ,5256,944,948,7148
10/14/2014,2014,10,14, 7 ,5343,918,887,7148
10/14/2014,2014,10,14, 8 ,6193,1080,1032,8305
10/14/2014,2014,10,14, 9 ,6860,1287,1183,9330
10/14/2014,2014,10,14, 10 ,7392,1380,1237,10009
10/14/2014,2014,10,14, 11 ,7568,1418,1262,10248
10/14/2014,2014,10,14, 12 ,7401,1386,1242,10029
10/14/2014,2014,10,14, 13 ,7381,1390,1278,10049
10/14/2014,2014,10,14, 14 ,7658,1436,1313,10407
10/14/2014,2014,10,14, 15 ,7412,1398,1271,10081
10/14/2014,2014,10,14, 16 ,7157,1355,1225,9737
10/14/2014,2014,10,14, 17 ,6960,1304,1208,9472
10/14/2014,2014,10,14, 18 ,7292,1467,1348,10107
10/14/2014,2014,10,14, 19 ,7264,1444,1288,9996
10/14/2014,2014,10,14, 20 ,7019,1385,1208,9612
10/14/2014,2014,10,14, 21 ,6867,1310,1161,9338
10/14/2014,2014,10,14, 22 ,6404,1193,1066,8663
10/14/2014,2014,10,14, 23 ,5914,1086,986,7986
10/14/2014,2014,10,14, 24 ,5518,1025,911,7454
10/15/2014,2014,10,15, 1 ,5282,980,867,7129
10/15/2014,2014,10,15, 2 ,5095,950,857,6902
10/15/2014,2014,10,15, 3 ,4934,931,830,6695
10/15/2014,2014,10,15, 4 ,4976,920,823,6719
10/15/2014,2014,10,15, 5 ,5086,959,873,6918
10/15/2014,2014,10,15, 6 ,5270,975,895,7140
10/15/2014,2014,10,15, 7 ,5314,942,855,7111
10/15/2014,2014,10,15, 8 ,5966,1083,1020,8069
10/15/2014,2014,10,15, 9 ,6578,1276,1176,9030
10/15/2014,2014,10,15, 10 ,7063,1352,1266,9681
10/15/2014,2014,10,15, 11 ,7362,1411,1325,10098
10/15/2014,2014,10,15, 12 ,7108,1343,1296,9747
10/15/2014,2014,10,15, 13 ,6986,1323,1296,9605
10/15/2014,2014,10,15, 14 ,7201,1364,1344,9909
10/15/2014,2014,10,15, 15 ,7228,1358,1336,9922
10/15/2014,2014,10,15, 16 ,7109,1322,1312,9743
10/15/2014,2014,10,15, 17 ,6871,1281,1314,9466
10/15/2014,2014,10,15, 18 ,7184,1453,1361,9998
10/15/2014,2014,10,15, 19 ,7104,1420,1341,9865
10/15/2014,2014,10,15, 20 ,6892,1359,1300,9551
10/15/2014,2014,10,15, 21 ,6606,1283,1203,9092
10/15/2014,2014,10,15, 22 ,6262,1163,1102,8527
10/15/2014,2014,10,15, 23 ,5793,1074,994,7861
10/15/2014,2014,10,15, 24 ,5397,983,937,7317
10/16/2014,2014,10,16, 1 ,5155,946,890,6991
10/16/2014,2014,10,16, 2 ,4998,931,861,6790
10/16/2014,2014,10,16, 3 ,4847,905,841,6593
10/16/2014,2014,10,16, 4 ,4830,903,842,6575
10/16/2014,2014,10,16, 5 ,5003,926,904,6833
10/16/2014,2014,10,16, 6 ,4964,966,934,6864
10/16/2014,2014,10,16, 7 ,5240,946,886,7072
10/16/2014,2014,10,16, 8 ,5858,1038,1040,7936
10/16/2014,2014,10,16, 9 ,6614,1199,1172,8985
10/16/2014,2014,10,16, 10 ,7041,1260,1285,9586
10/16/2014,2014,10,16, 11 ,7301,1284,1339,9924
10/16/2014,2014,10,16, 12 ,7093,1249,1257,9599
10/16/2014,2014,10,16, 13 ,7106,1236,1293,9635
10/16/2014,2014,10,16, 14 ,7351,1299,1325,9975
10/16/2014,2014,10,16, 15 ,7375,1278,1311,9964
10/16/2014,2014,10,16, 16 ,7094,1262,1274,9630
10/16/2014,2014,10,16, 17 ,6903,1243,1244,9390
10/16/2014,2014,10,16, 18 ,7153,1401,1410,9964
10/16/2014,2014,10,16, 19 ,7165,1366,1334,9865
10/16/2014,2014,10,16, 20 ,6953,1296,1314,9563
10/16/2014,2014,10,16, 21 ,6702,1215,1247,9164
10/16/2014,2014,10,16, 22 ,6306,1085,1136,8527
10/16/2014,2014,10,16, 23 ,5885,989,1068,7942
10/16/2014,2014,10,16, 24 ,5544,925,972,7441
10/17/2014,2014,10,17, 1 ,5337,887,944,7168
10/17/2014,2014,10,17, 2 ,5163,864,911,6938
10/17/2014,2014,10,17, 3 ,4965,845,891,6701
10/17/2014,2014,10,17, 4 ,4953,852,891,6696
10/17/2014,2014,10,17, 5 ,4931,888,942,6761
10/17/2014,2014,10,17, 6 ,5026,926,949,6901
10/17/2014,2014,10,17, 7 ,5181,901,912,6994
10/17/2014,2014,10,17, 8 ,5898,1042,1055,7995
10/17/2014,2014,10,17, 9 ,6716,1237,1218,9171
10/17/2014,2014,10,17, 10 ,7095,1329,1311,9735
10/17/2014,2014,10,17, 11 ,7350,1383,1353,10086
10/17/2014,2014,10,17, 12 ,7141,1343,1332,9816
10/17/2014,2014,10,17, 13 ,6966,1336,1340,9642
10/17/2014,2014,10,17, 14 ,7182,1389,1393,9964
10/17/2014,2014,10,17, 15 ,7105,1375,1387,9867
10/17/2014,2014,10,17, 16 ,6992,1354,1347,9693
10/17/2014,2014,10,17, 17 ,6794,1282,1289,9365
10/17/2014,2014,10,17, 18 ,7128,1443,1425,9996
10/17/2014,2014,10,17, 19 ,7054,1424,1372,9850
10/17/2014,2014,10,17, 20 ,6821,1364,1336,9521
10/17/2014,2014,10,17, 21 ,6651,1308,1301,9260
10/17/2014,2014,10,17, 22 ,6179,1198,1195,8572
10/17/2014,2014,10,17, 23 ,5703,1081,1078,7862
10/17/2014,2014,10,17, 24 ,5348,1001,1026,7375
10/18/2014,2014,10,18, 1 ,5148,963,945,7056
10/18/2014,2014,10,18, 2 ,4956,932,931,6819
10/18/2014,2014,10,18, 3 ,4880,901,915,6696
10/18/2014,2014,10,18, 4 ,4784,890,905,6579
10/18/2014,2014,10,18, 5 ,4820,906,920,6646
10/18/2014,2014,10,18, 6 ,4832,902,910,6644
10/18/2014,2014,10,18, 7 ,5026,916,900,6842
10/18/2014,2014,10,18, 8 ,5439,1032,984,7455
10/18/2014,2014,10,18, 9 ,5907,1162,1016,8085
10/18/2014,2014,10,18, 10 ,6332,1232,1103,8667
10/18/2014,2014,10,18, 11 ,6615,1321,1219,9155
10/18/2014,2014,10,18, 12 ,6496,1269,1210,8975
10/18/2014,2014,10,18, 13 ,6411,1291,1216,8918
10/18/2014,2014,10,18, 14 ,6534,1325,1254,9113
10/18/2014,2014,10,18, 15 ,6385,1274,1249,8908
10/18/2014,2014,10,18, 16 ,6202,1211,1167,8580
10/18/2014,2014,10,18, 17 ,6110,1216,1201,8527
10/18/2014,2014,10,18, 18 ,6660,1396,1373,9429
10/18/2014,2014,10,18, 19 ,6587,1375,1345,9307
10/18/2014,2014,10,18, 20 ,6450,1329,1319,9098
10/18/2014,2014,10,18, 21 ,6271,1256,1242,8769
10/18/2014,2014,10,18, 22 ,5916,1174,1172,8262
10/18/2014,2014,10,18, 23 ,5595,1071,1062,7728
10/18/2014,2014,10,18, 24 ,5240,988,996,7224
10/19/2014,2014,10,19, 1 ,5064,944,953,6961
10/19/2014,2014,10,19, 2 ,4788,916,913,6617
10/19/2014,2014,10,19, 3 ,4652,893,896,6441
10/19/2014,2014,10,19, 4 ,4525,880,875,6280
10/19/2014,2014,10,19, 5 ,4527,885,898,6310
10/19/2014,2014,10,19, 6 ,4507,873,857,6237
10/19/2014,2014,10,19, 7 ,4580,878,841,6299
10/19/2014,2014,10,19, 8 ,4977,914,881,6772
10/19/2014,2014,10,19, 9 ,5382,1000,838,7220
10/19/2014,2014,10,19, 10 ,5803,1069,1033,7905
10/19/2014,2014,10,19, 11 ,5981,1137,1085,8203
10/19/2014,2014,10,19, 12 ,6005,1127,1096,8228
10/19/2014,2014,10,19, 13 ,5942,1105,1082,8129
10/19/2014,2014,10,19, 14 ,5983,1100,1073,8156
10/19/2014,2014,10,19, 15 ,5906,1073,1042,8021
10/19/2014,2014,10,19, 16 ,5739,1053,1040,7832
10/19/2014,2014,10,19, 17 ,5695,1135,1060,7890
10/19/2014,2014,10,19, 18 ,6342,1320,1291,8953
10/19/2014,2014,10,19, 19 ,6393,1305,1168,8866
10/19/2014,2014,10,19, 20 ,6358,1259,1232,8849
10/19/2014,2014,10,19, 21 ,6340,1169,1121,8630
10/19/2014,2014,10,19, 22 ,5879,1079,1036,7994
10/19/2014,2014,10,19, 23 ,5617,1007,965,7589
10/19/2014,2014,10,19, 24 ,5291,938,929,7158
10/20/2014,2014,10,20, 1 ,4984,903,925,6812
10/20/2014,2014,10,20, 2 ,4866,872,888,6626
10/20/2014,2014,10,20, 3 ,4730,846,862,6438
10/20/2014,2014,10,20, 4 ,4660,846,876,6382
10/20/2014,2014,10,20, 5 ,4808,876,874,6558
10/20/2014,2014,10,20, 6 ,4921,895,884,6700
10/20/2014,2014,10,20, 7 ,5217,909,897,7023
10/20/2014,2014,10,20, 8 ,6069,1071,1011,8151
10/20/2014,2014,10,20, 9 ,6895,1274,1186,9355
10/20/2014,2014,10,20, 10 ,7406,1390,1311,10107
10/20/2014,2014,10,20, 11 ,7659,1433,1351,10443
10/20/2014,2014,10,20, 12 ,7545,1411,1313,10269
10/20/2014,2014,10,20, 13 ,7546,1417,1342,10305
10/20/2014,2014,10,20, 14 ,7734,1471,1366,10571
10/20/2014,2014,10,20, 15 ,7649,1441,1366,10456
10/20/2014,2014,10,20, 16 ,7405,1399,1347,10151
10/20/2014,2014,10,20, 17 ,7137,1357,1295,9789
10/20/2014,2014,10,20, 18 ,7467,1505,1401,10373
10/20/2014,2014,10,20, 19 ,7431,1477,1368,10276
10/20/2014,2014,10,20, 20 ,7222,1422,1343,9987
10/20/2014,2014,10,20, 21 ,7036,1355,1280,9671
10/20/2014,2014,10,20, 22 ,6599,1233,1158,8990
10/20/2014,2014,10,20, 23 ,6229,1123,1055,8407
10/20/2014,2014,10,20, 24 ,5712,1048,888,7648
10/21/2014,2014,10,21, 1 ,5468,1002,945,7415
10/21/2014,2014,10,21, 2 ,5311,959,915,7185
10/21/2014,2014,10,21, 3 ,5147,936,887,6970
10/21/2014,2014,10,21, 4 ,5166,926,877,6969
10/21/2014,2014,10,21, 5 ,5219,950,920,7089
10/21/2014,2014,10,21, 6 ,5276,948,908,7132
10/21/2014,2014,10,21, 7 ,5436,967,901,7304
10/21/2014,2014,10,21, 8 ,6216,1132,1074,8422
10/21/2014,2014,10,21, 9 ,7053,1331,1169,9553
10/21/2014,2014,10,21, 10 ,7541,1440,1327,10308
10/21/2014,2014,10,21, 11 ,7814,1485,1377,10676
10/21/2014,2014,10,21, 12 ,7668,1448,1360,10476
10/21/2014,2014,10,21, 13 ,7621,1454,1367,10442
10/21/2014,2014,10,21, 14 ,7845,1500,1386,10731
10/21/2014,2014,10,21, 15 ,7683,1457,1360,10500
10/21/2014,2014,10,21, 16 ,7542,1407,1338,10287
10/21/2014,2014,10,21, 17 ,7282,1366,1311,9959
10/21/2014,2014,10,21, 18 ,7572,1505,1403,10480
10/21/2014,2014,10,21, 19 ,7369,1477,1360,10206
10/21/2014,2014,10,21, 20 ,7293,1425,1341,10059
10/21/2014,2014,10,21, 21 ,7066,1344,1268,9678
10/21/2014,2014,10,21, 22 ,6687,1234,1151,9072
10/21/2014,2014,10,21, 23 ,6194,1113,1075,8382
10/21/2014,2014,10,21, 24 ,5818,1038,999,7855
10/22/2014,2014,10,22, 1 ,5502,1000,939,7441
10/22/2014,2014,10,22, 2 ,5340,968,912,7220
10/22/2014,2014,10,22, 3 ,5195,942,891,7028
10/22/2014,2014,10,22, 4 ,5196,937,883,7016
10/22/2014,2014,10,22, 5 ,5268,957,927,7152
10/22/2014,2014,10,22, 6 ,5293,962,923,7178
10/22/2014,2014,10,22, 7 ,5471,968,915,7354
10/22/2014,2014,10,22, 8 ,6293,1154,1045,8492
10/22/2014,2014,10,22, 9 ,7122,1271,1241,9634
10/22/2014,2014,10,22, 10 ,7581,1444,1333,10358
10/22/2014,2014,10,22, 11 ,7846,1465,1397,10708
10/22/2014,2014,10,22, 12 ,7716,1420,1348,10484
10/22/2014,2014,10,22, 13 ,7684,1407,1359,10450
10/22/2014,2014,10,22, 14 ,7911,1469,1399,10779
10/22/2014,2014,10,22, 15 ,7754,1444,1393,10591
10/22/2014,2014,10,22, 16 ,7552,1419,1366,10337
10/22/2014,2014,10,22, 17 ,7241,1355,1314,9910
10/22/2014,2014,10,22, 18 ,7589,1514,1426,10529
10/22/2014,2014,10,22, 19 ,7448,1491,1366,10305
10/22/2014,2014,10,22, 20 ,7288,1424,1336,10048
10/22/2014,2014,10,22, 21 ,7045,1343,1167,9555
10/22/2014,2014,10,22, 22 ,6636,1217,1071,8924
10/22/2014,2014,10,22, 23 ,6202,1122,1034,8358
10/22/2014,2014,10,22, 24 ,5846,1045,955,7846
10/23/2014,2014,10,23, 1 ,5546,1005,933,7484
10/23/2014,2014,10,23, 2 ,5394,978,895,7267
10/23/2014,2014,10,23, 3 ,5196,948,867,7011
10/23/2014,2014,10,23, 4 ,5127,931,873,6931
10/23/2014,2014,10,23, 5 ,5183,959,929,7071
10/23/2014,2014,10,23, 6 ,5263,967,909,7139
10/23/2014,2014,10,23, 7 ,5471,973,908,7352
10/23/2014,2014,10,23, 8 ,6253,1152,1069,8474
10/23/2014,2014,10,23, 9 ,6924,1337,1220,9481
10/23/2014,2014,10,23, 10 ,7270,1422,1320,10012
10/23/2014,2014,10,23, 11 ,7510,1460,1374,10344
10/23/2014,2014,10,23, 12 ,7394,1430,1330,10154
10/23/2014,2014,10,23, 13 ,7420,1413,1309,10142
10/23/2014,2014,10,23, 14 ,7688,1465,1337,10490
10/23/2014,2014,10,23, 15 ,7539,1435,1281,10255
10/23/2014,2014,10,23, 16 ,7340,1393,1315,10048
10/23/2014,2014,10,23, 17 ,7077,1308,1296,9681
10/23/2014,2014,10,23, 18 ,7393,1479,1366,10238
10/23/2014,2014,10,23, 19 ,7338,1449,1306,10093
10/23/2014,2014,10,23, 20 ,7115,1376,1265,9756
10/23/2014,2014,10,23, 21 ,6869,1308,1185,9362
10/23/2014,2014,10,23, 22 ,6478,1198,1100,8776
10/23/2014,2014,10,23, 23 ,6095,1098,1003,8196
10/23/2014,2014,10,23, 24 ,5670,1017,955,7642
10/24/2014,2014,10,24, 1 ,5403,973,872,7248
10/24/2014,2014,10,24, 2 ,5315,944,840,7099
10/24/2014,2014,10,24, 3 ,5113,910,835,6858
10/24/2014,2014,10,24, 4 ,5049,901,842,6792
10/24/2014,2014,10,24, 5 ,5124,924,883,6931
10/24/2014,2014,10,24, 6 ,5125,944,898,6967
10/24/2014,2014,10,24, 7 ,5356,946,892,7194
10/24/2014,2014,10,24, 8 ,6178,1085,1027,8290
10/24/2014,2014,10,24, 9 ,6929,1278,1176,9383
10/24/2014,2014,10,24, 10 ,7398,1381,1307,10086
10/24/2014,2014,10,24, 11 ,7711,1427,1363,10501
10/24/2014,2014,10,24, 12 ,7527,1374,1326,10227
10/24/2014,2014,10,24, 13 ,7448,1380,1349,10177
10/24/2014,2014,10,24, 14 ,7666,1444,1384,10494
10/24/2014,2014,10,24, 15 ,7543,1412,1353,10308
10/24/2014,2014,10,24, 16 ,7372,1370,1329,10071
10/24/2014,2014,10,24, 17 ,6993,1299,1308,9600
10/24/2014,2014,10,24, 18 ,7345,1474,1403,10222
10/24/2014,2014,10,24, 19 ,7261,1435,1338,10034
10/24/2014,2014,10,24, 20 ,7025,1372,1263,9660
10/24/2014,2014,10,24, 21 ,6771,1311,1199,9281
10/24/2014,2014,10,24, 22 ,6461,1184,1111,8756
10/24/2014,2014,10,24, 23 ,5983,1090,1000,8073
10/24/2014,2014,10,24, 24 ,5596,1013,963,7572
10/25/2014,2014,10,25, 1 ,5368,976,910,7254
10/25/2014,2014,10,25, 2 ,5218,949,883,7050
10/25/2014,2014,10,25, 3 ,5096,925,858,6879
10/25/2014,2014,10,25, 4 ,5007,914,853,6774
10/25/2014,2014,10,25, 5 ,4980,924,878,6782
10/25/2014,2014,10,25, 6 ,4938,923,900,6761
10/25/2014,2014,10,25, 7 ,5055,939,883,6877
10/25/2014,2014,10,25, 8 ,5616,1040,914,7570
10/25/2014,2014,10,25, 9 ,6265,1171,952,8388
10/25/2014,2014,10,25, 10 ,6763,1247,996,9006
10/25/2014,2014,10,25, 11 ,7079,1330,1166,9575
10/25/2014,2014,10,25, 12 ,6885,1280,1196,9361
10/25/2014,2014,10,25, 13 ,6859,1288,1185,9332
10/25/2014,2014,10,25, 14 ,7075,1324,1244,9643
10/25/2014,2014,10,25, 15 ,6950,1294,1213,9457
10/25/2014,2014,10,25, 16 ,6704,1221,1186,9111
10/25/2014,2014,10,25, 17 ,6384,1214,1171,8769
10/25/2014,2014,10,25, 18 ,6997,1419,1328,9744
10/25/2014,2014,10,25, 19 ,7007,1407,1327,9741
10/25/2014,2014,10,25, 20 ,6917,1369,1280,9566
10/25/2014,2014,10,25, 21 ,6724,1292,1213,9229
10/25/2014,2014,10,25, 22 ,6459,1197,1117,8773
10/25/2014,2014,10,25, 23 ,6010,1112,1049,8171
10/25/2014,2014,10,25, 24 ,5693,1039,969,7701
10/26/2014,2014,10,26, 1 ,5396,1003,902,7301
10/26/2014,2014,10,26, 2 ,5276,972,892,7140
10/26/2014,2014,10,26, 3 ,5105,948,862,6915
10/26/2014,2014,10,26, 4 ,5011,935,881,6827
10/26/2014,2014,10,26, 5 ,4972,938,901,6811
10/26/2014,2014,10,26, 6 ,4793,906,855,6554
10/26/2014,2014,10,26, 7 ,4828,917,848,6593
10/26/2014,2014,10,26, 8 ,5207,977,894,7078
10/26/2014,2014,10,26, 9 ,5534,1042,974,7550
10/26/2014,2014,10,26, 10 ,5979,1114,1034,8127
10/26/2014,2014,10,26, 11 ,6269,1178,1102,8549
10/26/2014,2014,10,26, 12 ,6190,1174,1103,8467
10/26/2014,2014,10,26, 13 ,6150,1173,1098,8421
10/26/2014,2014,10,26, 14 ,6157,1181,1102,8440
10/26/2014,2014,10,26, 15 ,6040,1145,1069,8254
10/26/2014,2014,10,26, 16 ,5808,1124,1058,7990
10/26/2014,2014,10,26, 17 ,5838,1148,1081,8067
10/26/2014,2014,10,26, 18 ,6546,1389,1267,9202
10/26/2014,2014,10,26, 19 ,6515,1369,1248,9132
10/26/2014,2014,10,26, 20 ,6529,1296,1209,9034
10/26/2014,2014,10,26, 21 ,6344,1241,1132,8717
10/26/2014,2014,10,26, 22 ,6062,1163,1052,8277
10/26/2014,2014,10,26, 23 ,5765,1066,970,7801
10/26/2014,2014,10,26, 24 ,5385,993,890,7268
10/27/2014,2014,10,27, 1 ,5160,941,895,6996
10/27/2014,2014,10,27, 2 ,5013,904,837,6754
10/27/2014,2014,10,27, 3 ,4781,885,810,6476
10/27/2014,2014,10,27, 4 ,4737,881,807,6425
10/27/2014,2014,10,27, 5 ,4917,916,864,6697
10/27/2014,2014,10,27, 6 ,5028,945,878,6851
10/27/2014,2014,10,27, 7 ,5329,944,852,7125
10/27/2014,2014,10,27, 8 ,6045,1078,979,8102
10/27/2014,2014,10,27, 9 ,6853,1275,1141,9269
10/27/2014,2014,10,27, 10 ,7342,1382,1259,9983
10/27/2014,2014,10,27, 11 ,7517,1434,1340,10291
10/27/2014,2014,10,27, 12 ,7421,1396,1336,10153
10/27/2014,2014,10,27, 13 ,7372,1380,1342,10094
10/27/2014,2014,10,27, 14 ,7511,1422,1381,10314
10/27/2014,2014,10,27, 15 ,7339,1391,1346,10076
10/27/2014,2014,10,27, 16 ,7201,1370,1326,9897
10/27/2014,2014,10,27, 17 ,6993,1344,1299,9636
10/27/2014,2014,10,27, 18 ,7340,1503,1367,10210
10/27/2014,2014,10,27, 19 ,7167,1453,1335,9955
10/27/2014,2014,10,27, 20 ,7056,1391,1286,9733
10/27/2014,2014,10,27, 21 ,6809,1304,1220,9333
10/27/2014,2014,10,27, 22 ,6353,1198,1116,8667
10/27/2014,2014,10,27, 23 ,5990,1085,1015,8090
10/27/2014,2014,10,27, 24 ,5524,1018,947,7489
10/28/2014,2014,10,28, 1 ,5338,986,905,7229
10/28/2014,2014,10,28, 2 ,5161,961,886,7008
10/28/2014,2014,10,28, 3 ,5043,924,871,6838
10/28/2014,2014,10,28, 4 ,5047,922,865,6834
10/28/2014,2014,10,28, 5 ,5138,949,918,7005
10/28/2014,2014,10,28, 6 ,5202,966,930,7098
10/28/2014,2014,10,28, 7 ,5367,956,938,7261
10/28/2014,2014,10,28, 8 ,6090,1113,997,8200
10/28/2014,2014,10,28, 9 ,6790,1305,1143,9238
10/28/2014,2014,10,28, 10 ,7360,1399,1259,10018
10/28/2014,2014,10,28, 11 ,7510,1464,1322,10296
10/28/2014,2014,10,28, 12 ,7465,1429,1216,10110
10/28/2014,2014,10,28, 13 ,7397,1435,1289,10121
10/28/2014,2014,10,28, 14 ,7643,1484,1350,10477
10/28/2014,2014,10,28, 15 ,7506,1464,1321,10291
10/28/2014,2014,10,28, 16 ,7356,1435,1295,10086
10/28/2014,2014,10,28, 17 ,7118,1358,1283,9759
10/28/2014,2014,10,28, 18 ,7472,1545,1359,10376
10/28/2014,2014,10,28, 19 ,7296,1501,1340,10137
10/28/2014,2014,10,28, 20 ,7090,1444,1321,9855
10/28/2014,2014,10,28, 21 ,6875,1375,1264,9514
10/28/2014,2014,10,28, 22 ,6418,1251,1150,8819
10/28/2014,2014,10,28, 23 ,6072,1158,1060,8290
10/28/2014,2014,10,28, 24 ,5725,1082,976,7783
10/29/2014,2014,10,29, 1 ,5508,1035,940,7483
10/29/2014,2014,10,29, 2 ,5326,1007,908,7241
10/29/2014,2014,10,29, 3 ,5228,966,876,7070
10/29/2014,2014,10,29, 4 ,5135,968,864,6967
10/29/2014,2014,10,29, 5 ,5246,998,922,7166
10/29/2014,2014,10,29, 6 ,5258,1005,930,7193
10/29/2014,2014,10,29, 7 ,5462,998,902,7362
10/29/2014,2014,10,29, 8 ,6060,1152,1052,8264
10/29/2014,2014,10,29, 9 ,6798,1334,1195,9327
10/29/2014,2014,10,29, 10 ,7261,1424,1295,9980
10/29/2014,2014,10,29, 11 ,7409,1480,1362,10251
10/29/2014,2014,10,29, 12 ,7172,1421,1321,9914
10/29/2014,2014,10,29, 13 ,6981,1412,1336,9729
10/29/2014,2014,10,29, 14 ,7246,1478,1395,10119
10/29/2014,2014,10,29, 15 ,7156,1450,1367,9973
10/29/2014,2014,10,29, 16 ,7049,1401,1355,9805
10/29/2014,2014,10,29, 17 ,6905,1363,1316,9584
10/29/2014,2014,10,29, 18 ,7349,1515,1410,10274
10/29/2014,2014,10,29, 19 ,7110,1471,1348,9929
10/29/2014,2014,10,29, 20 ,6897,1409,1230,9536
10/29/2014,2014,10,29, 21 ,6598,1331,1165,9094
10/29/2014,2014,10,29, 22 ,6262,1218,1135,8615
10/29/2014,2014,10,29, 23 ,5885,1125,1018,8028
10/29/2014,2014,10,29, 24 ,5520,1058,936,7514
10/30/2014,2014,10,30, 1 ,5316,1011,900,7227
10/30/2014,2014,10,30, 2 ,5136,986,868,6990
10/30/2014,2014,10,30, 3 ,4977,955,853,6785
10/30/2014,2014,10,30, 4 ,4900,936,850,6686
10/30/2014,2014,10,30, 5 ,5060,966,875,6901
10/30/2014,2014,10,30, 6 ,5086,973,882,6941
10/30/2014,2014,10,30, 7 ,5261,950,871,7082
10/30/2014,2014,10,30, 8 ,6030,1081,1007,8118
10/30/2014,2014,10,30, 9 ,6774,1269,1164,9207
10/30/2014,2014,10,30, 10 ,7194,1354,1243,9791
10/30/2014,2014,10,30, 11 ,7453,1409,1277,10139
10/30/2014,2014,10,30, 12 ,7240,1378,1243,9861
10/30/2014,2014,10,30, 13 ,7225,1368,1234,9827
10/30/2014,2014,10,30, 14 ,7528,1409,1302,10239
10/30/2014,2014,10,30, 15 ,7403,1380,1277,10060
10/30/2014,2014,10,30, 16 ,7244,1364,1275,9883
10/30/2014,2014,10,30, 17 ,6839,1328,1240,9407
10/30/2014,2014,10,30, 18 ,7334,1480,1382,10196
10/30/2014,2014,10,30, 19 ,7083,1437,1325,9845
10/30/2014,2014,10,30, 20 ,6890,1376,1273,9539
10/30/2014,2014,10,30, 21 ,6654,1304,1214,9172
10/30/2014,2014,10,30, 22 ,6319,1178,1108,8605
10/30/2014,2014,10,30, 23 ,5954,1092,1059,8105
10/30/2014,2014,10,30, 24 ,5665,1018,941,7624
10/31/2014,2014,10,31, 1 ,5367,973,891,7231
10/31/2014,2014,10,31, 2 ,5261,948,888,7097
10/31/2014,2014,10,31, 3 ,5094,916,865,6875
10/31/2014,2014,10,31, 4 ,4987,909,861,6757
10/31/2014,2014,10,31, 5 ,4971,931,883,6785
10/31/2014,2014,10,31, 6 ,5055,935,912,6902
10/31/2014,2014,10,31, 7 ,5233,946,873,7052
10/31/2014,2014,10,31, 8 ,5875,1090,994,7959
10/31/2014,2014,10,31, 9 ,5875,1276,1152,8303
10/31/2014,2014,10,31, 10 ,7064,1373,1204,9641
10/31/2014,2014,10,31, 11 ,7348,1418,1298,10064
10/31/2014,2014,10,31, 12 ,7083,1365,1295,9743
10/31/2014,2014,10,31, 13 ,6943,1342,1267,9552
10/31/2014,2014,10,31, 14 ,7100,1382,1302,9784
10/31/2014,2014,10,31, 15 ,6873,1346,1275,9494
10/31/2014,2014,10,31, 16 ,6688,1298,1241,9227
10/31/2014,2014,10,31, 17 ,6274,1247,1218,8739
10/31/2014,2014,10,31, 18 ,6811,1446,1322,9579
10/31/2014,2014,10,31, 19 ,6744,1422,1335,9501
10/31/2014,2014,10,31, 20 ,6578,1376,1288,9242
10/31/2014,2014,10,31, 21 ,6463,1316,1250,9029
10/31/2014,2014,10,31, 22 ,6196,1216,1129,8541
10/31/2014,2014,10,31, 23 ,5873,1114,1048,8035
10/31/2014,2014,10,31, 24 ,5480,1047,928,7455
11/1/2014,2014,11,1, 1 ,5245,1001,897,7143
11/1/2014,2014,11,1, 2 ,5112,972,861,6945
11/1/2014,2014,11,1, 3 ,4964,943,841,6748
11/1/2014,2014,11,1, 4 ,4824,929,826,6579
11/1/2014,2014,11,1, 5 ,4760,927,870,6557
11/1/2014,2014,11,1, 6 ,4425,888,816,6129
11/1/2014,2014,11,1, 7 ,4277,882,802,5961
11/1/2014,2014,11,1, 8 ,4433,925,855,6213
11/1/2014,2014,11,1, 9 ,4594,973,935,6502
11/1/2014,2014,11,1, 10 ,4802,1011,1004,6817
11/1/2014,2014,11,1, 11 ,5053,1063,1042,7158
11/1/2014,2014,11,1, 12 ,5244,1089,1069,7402
11/1/2014,2014,11,1, 13 ,5251,1091,1060,7402
11/1/2014,2014,11,1, 14 ,5245,1100,1065,7410
11/1/2014,2014,11,1, 15 ,5134,1073,1045,7252
11/1/2014,2014,11,1, 16 ,4939,1042,1013,6994
11/1/2014,2014,11,1, 17 ,4789,1045,1019,6853
11/1/2014,2014,11,1, 18 ,5534,1237,1239,8010
11/1/2014,2014,11,1, 19 ,5582,1242,1217,8041
11/1/2014,2014,11,1, 20 ,5667,1240,1182,8089
11/1/2014,2014,11,1, 21 ,5628,1196,1122,7946
11/1/2014,2014,11,1, 22 ,5412,1125,1048,7585
11/1/2014,2014,11,1, 23 ,5110,1055,974,7139
11/1/2014,2014,11,1, 24 ,4804,996,937,6737
11/2/2014,2014,11,2, 1 ,4640,945,874,6459
11/2/2014,2014,11,2, 2 ,4442,911,849,6202
11/2/2014,2014,11,2, 3 ,4326,882,830,6038
11/2/2014,2014,11,2, 4 ,4193,866,809,5868
11/2/2014,2014,11,2, 5 ,4187,864,820,5871
11/2/2014,2014,11,2, 6 ,4130,839,799,5768
11/2/2014,2014,11,2, 7 ,4176,847,791,5814
11/2/2014,2014,11,2, 8 ,4449,899,830,6178
11/2/2014,2014,11,2, 9 ,4868,968,873,6709
11/2/2014,2014,11,2, 10 ,5331,1034,937,7302
11/2/2014,2014,11,2, 11 ,5660,1093,991,7744
11/2/2014,2014,11,2, 12 ,5590,1101,984,7675
11/2/2014,2014,11,2, 13 ,5625,1109,1002,7736
11/2/2014,2014,11,2, 14 ,5723,1106,1002,7831
11/2/2014,2014,11,2, 15 ,5609,1088,1005,7702
11/2/2014,2014,11,2, 16 ,5504,1048,972,7524
11/2/2014,2014,11,2, 17 ,5462,1068,1021,7551
11/2/2014,2014,11,2, 18 ,6278,1328,1230,8836
11/2/2014,2014,11,2, 19 ,6264,1321,1202,8787
11/2/2014,2014,11,2, 20 ,6302,1289,1154,8745
11/2/2014,2014,11,2, 21 ,6169,1219,1101,8489
11/2/2014,2014,11,2, 22 ,5971,1144,1010,8125
11/2/2014,2014,11,2, 23 ,5592,1052,921,7565
11/2/2014,2014,11,2, 24 ,5318,991,855,7164
11/3/2014,2014,11,3, 1 ,5010,943,836,6789
11/3/2014,2014,11,3, 2 ,4829,923,815,6567
11/3/2014,2014,11,3, 3 ,4729,894,798,6421
11/3/2014,2014,11,3, 4 ,4642,886,798,6326
11/3/2014,2014,11,3, 5 ,4716,915,829,6460
11/3/2014,2014,11,3, 6 ,4849,948,882,6679
11/3/2014,2014,11,3, 7 ,5115,935,826,6876
11/3/2014,2014,11,3, 8 ,5894,1100,970,7964
11/3/2014,2014,11,3, 9 ,6791,1284,1158,9233
11/3/2014,2014,11,3, 10 ,7279,1363,1286,9928
11/3/2014,2014,11,3, 11 ,7598,1422,1355,10375
11/3/2014,2014,11,3, 12 ,7447,1385,1318,10150
11/3/2014,2014,11,3, 13 ,7443,1367,1317,10127
11/3/2014,2014,11,3, 14 ,7743,1434,1346,10523
11/3/2014,2014,11,3, 15 ,7615,1412,1332,10359
11/3/2014,2014,11,3, 16 ,7458,1380,1316,10154
11/3/2014,2014,11,3, 17 ,7115,1327,1304,9746
11/3/2014,2014,11,3, 18 ,7482,1511,1412,10405
11/3/2014,2014,11,3, 19 ,7347,1459,1322,10128
11/3/2014,2014,11,3, 20 ,7222,1399,1301,9922
11/3/2014,2014,11,3, 21 ,6987,1320,1233,9540
11/3/2014,2014,11,3, 22 ,6594,1203,1061,8858
11/3/2014,2014,11,3, 23 ,6173,1091,962,8226
11/3/2014,2014,11,3, 24 ,5784,1021,859,7664
11/4/2014,2014,11,4, 1 ,5557,984,917,7458
11/4/2014,2014,11,4, 2 ,5396,950,900,7246
11/4/2014,2014,11,4, 3 ,5301,928,876,7105
11/4/2014,2014,11,4, 4 ,5197,913,868,6978
11/4/2014,2014,11,4, 5 ,5341,953,923,7217
11/4/2014,2014,11,4, 6 ,5465,966,935,7366
11/4/2014,2014,11,4, 7 ,5567,933,906,7406
11/4/2014,2014,11,4, 8 ,6299,1072,1044,8415
11/4/2014,2014,11,4, 9 ,6946,1283,1201,9430
11/4/2014,2014,11,4, 10 ,7360,1373,1287,10020
11/4/2014,2014,11,4, 11 ,7545,1437,1338,10320
11/4/2014,2014,11,4, 12 ,7367,1391,1299,10057
11/4/2014,2014,11,4, 13 ,7337,1382,1292,10011
11/4/2014,2014,11,4, 14 ,7584,1445,1346,10375
11/4/2014,2014,11,4, 15 ,7473,1420,1334,10227
11/4/2014,2014,11,4, 16 ,7385,1382,1314,10081
11/4/2014,2014,11,4, 17 ,7120,1339,1289,9748
11/4/2014,2014,11,4, 18 ,7467,1519,1385,10371
11/4/2014,2014,11,4, 19 ,7278,1474,1324,10076
11/4/2014,2014,11,4, 20 ,7134,1430,1295,9859
11/4/2014,2014,11,4, 21 ,6862,1353,1238,9453
11/4/2014,2014,11,4, 22 ,6441,1240,1125,8806
11/4/2014,2014,11,4, 23 ,6086,1116,1022,8224
11/4/2014,2014,11,4, 24 ,5707,1045,958,7710
11/5/2014,2014,11,5, 1 ,5432,1007,913,7352
11/5/2014,2014,11,5, 2 ,5287,975,893,7155
11/5/2014,2014,11,5, 3 ,5181,958,855,6994
11/5/2014,2014,11,5, 4 ,5104,941,867,6912
11/5/2014,2014,11,5, 5 ,5314,980,921,7215
11/5/2014,2014,11,5, 6 ,5418,995,952,7365
11/5/2014,2014,11,5, 7 ,5498,961,886,7345
11/5/2014,2014,11,5, 8 ,6159,1102,1026,8287
11/5/2014,2014,11,5, 9 ,7001,1282,1203,9486
11/5/2014,2014,11,5, 10 ,7441,1367,1299,10107
11/5/2014,2014,11,5, 11 ,7666,1430,1335,10431
11/5/2014,2014,11,5, 12 ,7489,1389,1311,10189
11/5/2014,2014,11,5, 13 ,7482,1390,1313,10185
11/5/2014,2014,11,5, 14 ,7713,1447,1350,10510
11/5/2014,2014,11,5, 15 ,7581,1430,1326,10337
11/5/2014,2014,11,5, 16 ,7422,1382,1295,10099
11/5/2014,2014,11,5, 17 ,7101,1347,1332,9780
11/5/2014,2014,11,5, 18 ,7522,1529,1408,10459
11/5/2014,2014,11,5, 19 ,7351,1504,1346,10201
11/5/2014,2014,11,5, 20 ,7096,1435,1276,9807
11/5/2014,2014,11,5, 21 ,6874,1356,1213,9443
11/5/2014,2014,11,5, 22 ,6473,1232,1126,8831
11/5/2014,2014,11,5, 23 ,6076,1132,1030,8238
11/5/2014,2014,11,5, 24 ,5685,1055,949,7689
11/6/2014,2014,11,6, 1 ,5425,1022,893,7340
11/6/2014,2014,11,6, 2 ,5293,978,858,7129
11/6/2014,2014,11,6, 3 ,5136,954,845,6935
11/6/2014,2014,11,6, 4 ,5103,949,852,6904
11/6/2014,2014,11,6, 5 ,5251,984,923,7158
11/6/2014,2014,11,6, 6 ,5345,995,929,7269
11/6/2014,2014,11,6, 7 ,5395,973,883,7251
11/6/2014,2014,11,6, 8 ,6142,1122,1010,8274
11/6/2014,2014,11,6, 9 ,6916,1296,1136,9348
11/6/2014,2014,11,6, 10 ,7347,1402,1236,9985
11/6/2014,2014,11,6, 11 ,7624,1461,1295,10380
11/6/2014,2014,11,6, 12 ,7445,1417,1264,10126
11/6/2014,2014,11,6, 13 ,7358,1408,1280,10046
11/6/2014,2014,11,6, 14 ,7658,1463,1324,10445
11/6/2014,2014,11,6, 15 ,7461,1443,1295,10199
11/6/2014,2014,11,6, 16 ,7306,1393,1268,9967
11/6/2014,2014,11,6, 17 ,6962,1337,1269,9568
11/6/2014,2014,11,6, 18 ,7351,1528,1379,10258
11/6/2014,2014,11,6, 19 ,7121,1483,1312,9916
11/6/2014,2014,11,6, 20 ,6887,1430,1250,9567
11/6/2014,2014,11,6, 21 ,6590,1347,1171,9108
11/6/2014,2014,11,6, 22 ,6174,1219,1097,8490
11/6/2014,2014,11,6, 23 ,5734,1128,952,7814
11/6/2014,2014,11,6, 24 ,5421,1047,912,7380
11/7/2014,2014,11,7, 1 ,5209,1012,870,7091
11/7/2014,2014,11,7, 2 ,4992,975,852,6819
11/7/2014,2014,11,7, 3 ,4892,952,834,6678
11/7/2014,2014,11,7, 4 ,4846,948,831,6625
11/7/2014,2014,11,7, 5 ,4932,981,903,6816
11/7/2014,2014,11,7, 6 ,5100,987,933,7020
11/7/2014,2014,11,7, 7 ,5171,975,881,7027
11/7/2014,2014,11,7, 8 ,5886,1123,1010,8019
11/7/2014,2014,11,7, 9 ,6579,1313,1163,9055
11/7/2014,2014,11,7, 10 ,7090,1401,1281,9772
11/7/2014,2014,11,7, 11 ,7405,1457,1333,10195
11/7/2014,2014,11,7, 12 ,7195,1411,1298,9904
11/7/2014,2014,11,7, 13 ,7162,1410,1295,9867
11/7/2014,2014,11,7, 14 ,7407,1460,1336,10203
11/7/2014,2014,11,7, 15 ,7307,1431,1318,10056
11/7/2014,2014,11,7, 16 ,7142,1391,1293,9826
11/7/2014,2014,11,7, 17 ,6805,1341,1262,9408
11/7/2014,2014,11,7, 18 ,7286,1523,1419,10228
11/7/2014,2014,11,7, 19 ,7048,1477,1372,9897
11/7/2014,2014,11,7, 20 ,6822,1424,1323,9569
11/7/2014,2014,11,7, 21 ,6539,1333,1236,9108
11/7/2014,2014,11,7, 22 ,6239,1219,1135,8593
11/7/2014,2014,11,7, 23 ,5818,1132,1027,7977
11/7/2014,2014,11,7, 24 ,5437,1059,973,7469
11/8/2014,2014,11,8, 1 ,5196,1012,912,7120
11/8/2014,2014,11,8, 2 ,5062,981,893,6936
11/8/2014,2014,11,8, 3 ,4889,954,865,6708
11/8/2014,2014,11,8, 4 ,4890,944,819,6653
11/8/2014,2014,11,8, 5 ,4855,960,860,6675
11/8/2014,2014,11,8, 6 ,4872,947,892,6711
11/8/2014,2014,11,8, 7 ,4913,959,888,6760
11/8/2014,2014,11,8, 8 ,5545,1065,975,7585
11/8/2014,2014,11,8, 9 ,6093,1237,1115,8445
11/8/2014,2014,11,8, 10 ,6615,1317,1214,9146
11/8/2014,2014,11,8, 11 ,6913,1384,1278,9575
11/8/2014,2014,11,8, 12 ,6760,1339,1262,9361
11/8/2014,2014,11,8, 13 ,6703,1358,1277,9338
11/8/2014,2014,11,8, 14 ,6890,1390,1318,9598
11/8/2014,2014,11,8, 15 ,6687,1345,1270,9302
11/8/2014,2014,11,8, 16 ,6491,1300,1218,9009
11/8/2014,2014,11,8, 17 ,6425,1265,1227,8917
11/8/2014,2014,11,8, 18 ,6898,1498,1376,9772
11/8/2014,2014,11,8, 19 ,6861,1470,1321,9652
11/8/2014,2014,11,8, 20 ,6723,1425,1297,9445
11/8/2014,2014,11,8, 21 ,6571,1325,1245,9141
11/8/2014,2014,11,8, 22 ,6300,1242,1153,8695
11/8/2014,2014,11,8, 23 ,5914,1142,1061,8117
11/8/2014,2014,11,8, 24 ,5501,1048,971,7520
11/9/2014,2014,11,9, 1 ,5253,1000,921,7174
11/9/2014,2014,11,9, 2 ,5136,971,892,6999
11/9/2014,2014,11,9, 3 ,4979,944,868,6791
11/9/2014,2014,11,9, 4 ,4858,930,857,6645
11/9/2014,2014,11,9, 5 ,4799,924,878,6601
11/9/2014,2014,11,9, 6 ,4702,909,863,6474
11/9/2014,2014,11,9, 7 ,4725,914,856,6495
11/9/2014,2014,11,9, 8 ,5006,974,901,6881
11/9/2014,2014,11,9, 9 ,5322,1047,973,7342
11/9/2014,2014,11,9, 10 ,5778,1123,1034,7935
11/9/2014,2014,11,9, 11 ,6022,1182,1115,8319
11/9/2014,2014,11,9, 12 ,5954,1169,1127,8250
11/9/2014,2014,11,9, 13 ,5961,1182,1158,8301
11/9/2014,2014,11,9, 14 ,5964,1184,1151,8299
11/9/2014,2014,11,9, 15 ,5929,1153,1117,8199
11/9/2014,2014,11,9, 16 ,5797,1126,1090,8013
11/9/2014,2014,11,9, 17 ,5782,1139,1092,8013
11/9/2014,2014,11,9, 18 ,6491,1391,1286,9168
11/9/2014,2014,11,9, 19 ,6572,1388,1287,9247
11/9/2014,2014,11,9, 20 ,6511,1358,1258,9127
11/9/2014,2014,11,9, 21 ,6361,1283,1187,8831
11/9/2014,2014,11,9, 22 ,6040,1184,1126,8350
11/9/2014,2014,11,9, 23 ,5685,1082,1021,7788
11/9/2014,2014,11,9, 24 ,5340,1007,975,7322
11/10/2014,2014,11,10, 1 ,5054,964,894,6912
11/10/2014,2014,11,10, 2 ,4883,928,859,6670
11/10/2014,2014,11,10, 3 ,4662,909,839,6410
11/10/2014,2014,11,10, 4 ,4676,900,833,6409
11/10/2014,2014,11,10, 5 ,4903,953,900,6756
11/10/2014,2014,11,10, 6 ,5082,979,929,6990
11/10/2014,2014,11,10, 7 ,5253,961,875,7089
11/10/2014,2014,11,10, 8 ,6064,1119,1039,8222
11/10/2014,2014,11,10, 9 ,6854,1329,1191,9374
11/10/2014,2014,11,10, 10 ,7333,1423,1319,10075
11/10/2014,2014,11,10, 11 ,7542,1506,1357,10405
11/10/2014,2014,11,10, 12 ,7428,1449,1336,10213
11/10/2014,2014,11,10, 13 ,7360,1443,1334,10137
11/10/2014,2014,11,10, 14 ,7620,1500,1344,10464
11/10/2014,2014,11,10, 15 ,7514,1461,1276,10251
11/10/2014,2014,11,10, 16 ,7330,1421,1270,10021
11/10/2014,2014,11,10, 17 ,7042,1365,1302,9709
11/10/2014,2014,11,10, 18 ,7450,1553,1407,10410
11/10/2014,2014,11,10, 19 ,7241,1512,1358,10111
11/10/2014,2014,11,10, 20 ,7111,1445,1303,9859
11/10/2014,2014,11,10, 21 ,6822,1361,1235,9418
11/10/2014,2014,11,10, 22 ,6450,1234,1140,8824
11/10/2014,2014,11,10, 23 ,6047,1138,1039,8224
11/10/2014,2014,11,10, 24 ,5675,1056,955,7686
11/11/2014,2014,11,11, 1 ,5383,1013,904,7300
11/11/2014,2014,11,11, 2 ,5152,993,894,7039
11/11/2014,2014,11,11, 3 ,5071,971,871,6913
11/11/2014,2014,11,11, 4 ,5013,957,874,6844
11/11/2014,2014,11,11, 5 ,5180,998,927,7105
11/11/2014,2014,11,11, 6 ,5281,1013,947,7241
11/11/2014,2014,11,11, 7 ,5356,981,892,7229
11/11/2014,2014,11,11, 8 ,6145,1146,1033,8324
11/11/2014,2014,11,11, 9 ,6823,1338,1150,9311
11/11/2014,2014,11,11, 10 ,7168,1417,1302,9887
11/11/2014,2014,11,11, 11 ,7588,1470,1344,10402
11/11/2014,2014,11,11, 12 ,7319,1419,1324,10062
11/11/2014,2014,11,11, 13 ,7223,1413,1328,9964
11/11/2014,2014,11,11, 14 ,7469,1475,1352,10296
11/11/2014,2014,11,11, 15 ,7380,1452,1342,10174
11/11/2014,2014,11,11, 16 ,7217,1410,1323,9950
11/11/2014,2014,11,11, 17 ,6973,1350,1301,9624
11/11/2014,2014,11,11, 18 ,7376,1549,1430,10355
11/11/2014,2014,11,11, 19 ,7142,1518,1366,10026
11/11/2014,2014,11,11, 20 ,7033,1441,1337,9811
11/11/2014,2014,11,11, 21 ,6790,1344,1264,9398
11/11/2014,2014,11,11, 22 ,6431,1239,1158,8828
11/11/2014,2014,11,11, 23 ,6008,1143,1005,8156
11/11/2014,2014,11,11, 24 ,5613,1067,965,7645
11/12/2014,2014,11,12, 1 ,5395,1026,937,7358
11/12/2014,2014,11,12, 2 ,5275,999,910,7184
11/12/2014,2014,11,12, 3 ,5079,977,886,6942
11/12/2014,2014,11,12, 4 ,5043,954,879,6876
11/12/2014,2014,11,12, 5 ,5194,989,937,7120
11/12/2014,2014,11,12, 6 ,5289,1003,955,7247
11/12/2014,2014,11,12, 7 ,5402,987,868,7257
11/12/2014,2014,11,12, 8 ,6107,1151,1015,8273
11/12/2014,2014,11,12, 9 ,6855,1336,1188,9379
11/12/2014,2014,11,12, 10 ,7432,1422,1288,10142
11/12/2014,2014,11,12, 11 ,7561,1474,1352,10387
11/12/2014,2014,11,12, 12 ,7417,1423,1330,10170
11/12/2014,2014,11,12, 13 ,7421,1431,1324,10176
11/12/2014,2014,11,12, 14 ,7592,1482,1384,10458
11/12/2014,2014,11,12, 15 ,7486,1434,1365,10285
11/12/2014,2014,11,12, 16 ,7272,1389,1337,9998
11/12/2014,2014,11,12, 17 ,6988,1326,1286,9600
11/12/2014,2014,11,12, 18 ,7501,1518,1459,10478
11/12/2014,2014,11,12, 19 ,7277,1489,1392,10158
11/12/2014,2014,11,12, 20 ,7079,1435,1362,9876
11/12/2014,2014,11,12, 21 ,6820,1350,1295,9465
11/12/2014,2014,11,12, 22 ,6387,1244,1178,8809
11/12/2014,2014,11,12, 23 ,5960,1129,1072,8161
11/12/2014,2014,11,12, 24 ,5606,1050,968,7624
11/13/2014,2014,11,13, 1 ,5368,1009,953,7330
11/13/2014,2014,11,13, 2 ,5159,973,922,7054
11/13/2014,2014,11,13, 3 ,5040,938,893,6871
11/13/2014,2014,11,13, 4 ,4980,927,887,6794
11/13/2014,2014,11,13, 5 ,5169,966,943,7078
11/13/2014,2014,11,13, 6 ,5279,981,960,7220
11/13/2014,2014,11,13, 7 ,5322,953,895,7170
11/13/2014,2014,11,13, 8 ,6064,1117,1054,8235
11/13/2014,2014,11,13, 9 ,6857,1299,1201,9357
11/13/2014,2014,11,13, 10 ,7272,1394,1304,9970
11/13/2014,2014,11,13, 11 ,7528,1452,1371,10351
11/13/2014,2014,11,13, 12 ,7387,1391,1338,10116
11/13/2014,2014,11,13, 13 ,7407,1375,1363,10145
11/13/2014,2014,11,13, 14 ,7715,1441,1385,10541
11/13/2014,2014,11,13, 15 ,7580,1427,1364,10371
11/13/2014,2014,11,13, 16 ,7402,1397,1306,10105
11/13/2014,2014,11,13, 17 ,7072,1359,1274,9705
11/13/2014,2014,11,13, 18 ,7512,1546,1456,10514
11/13/2014,2014,11,13, 19 ,7289,1511,1386,10186
11/13/2014,2014,11,13, 20 ,7100,1439,1338,9877
11/13/2014,2014,11,13, 21 ,6808,1344,1269,9421
11/13/2014,2014,11,13, 22 ,6405,1240,1178,8823
11/13/2014,2014,11,13, 23 ,5948,1114,1068,8130
11/13/2014,2014,11,13, 24 ,5535,1032,1044,7611
11/14/2014,2014,11,14, 1 ,5313,999,956,7268
11/14/2014,2014,11,14, 2 ,5163,1001,925,7089
11/14/2014,2014,11,14, 3 ,5037,986,895,6918
11/14/2014,2014,11,14, 4 ,4939,961,892,6792
11/14/2014,2014,11,14, 5 ,5132,1001,943,7076
11/14/2014,2014,11,14, 6 ,5244,986,963,7193
11/14/2014,2014,11,14, 7 ,5288,989,919,7196
11/14/2014,2014,11,14, 8 ,6008,1125,1072,8205
11/14/2014,2014,11,14, 9 ,6798,1311,1189,9298
11/14/2014,2014,11,14, 10 ,7280,1397,1310,9987
11/14/2014,2014,11,14, 11 ,7535,1433,1350,10318
11/14/2014,2014,11,14, 12 ,7370,1377,1333,10080
11/14/2014,2014,11,14, 13 ,7308,1359,1327,9994
11/14/2014,2014,11,14, 14 ,7540,1408,1317,10265
11/14/2014,2014,11,14, 15 ,7409,1394,1342,10145
11/14/2014,2014,11,14, 16 ,7213,1360,1308,9881
11/14/2014,2014,11,14, 17 ,6942,1311,1327,9580
11/14/2014,2014,11,14, 18 ,7399,1491,1419,10309
11/14/2014,2014,11,14, 19 ,7200,1451,1338,9989
11/14/2014,2014,11,14, 20 ,6952,1403,1316,9671
11/14/2014,2014,11,14, 21 ,6789,1315,1261,9365
11/14/2014,2014,11,14, 22 ,6395,1223,1168,8786
11/14/2014,2014,11,14, 23 ,5994,1110,1065,8169
11/14/2014,2014,11,14, 24 ,5662,1047,951,7660
11/15/2014,2014,11,15, 1 ,5409,998,976,7383
11/15/2014,2014,11,15, 2 ,5238,960,937,7135
11/15/2014,2014,11,15, 3 ,5145,941,910,6996
11/15/2014,2014,11,15, 4 ,5007,951,907,6865
11/15/2014,2014,11,15, 5 ,5046,963,925,6934
11/15/2014,2014,11,15, 6 ,5035,958,932,6925
11/15/2014,2014,11,15, 7 ,5162,989,915,7066
11/15/2014,2014,11,15, 8 ,5639,1083,1027,7749
11/15/2014,2014,11,15, 9 ,6167,1193,1128,8488
11/15/2014,2014,11,15, 10 ,6553,1290,1191,9034
11/15/2014,2014,11,15, 11 ,6679,1352,1215,9246
11/15/2014,2014,11,15, 12 ,6565,1305,1192,9062
11/15/2014,2014,11,15, 13 ,6435,1312,1198,8945
11/15/2014,2014,11,15, 14 ,6593,1350,1235,9178
11/15/2014,2014,11,15, 15 ,6429,1294,1220,8943
11/15/2014,2014,11,15, 16 ,6323,1264,1229,8816
11/15/2014,2014,11,15, 17 ,6217,1237,1208,8662
11/15/2014,2014,11,15, 18 ,6857,1443,1282,9582
11/15/2014,2014,11,15, 19 ,6755,1438,1279,9472
11/15/2014,2014,11,15, 20 ,6595,1392,1241,9228
11/15/2014,2014,11,15, 21 ,6413,1343,1209,8965
11/15/2014,2014,11,15, 22 ,6132,1257,1148,8537
11/15/2014,2014,11,15, 23 ,5763,1154,1047,7964
11/15/2014,2014,11,15, 24 ,5344,1071,985,7400
11/16/2014,2014,11,16, 1 ,5165,1022,935,7122
11/16/2014,2014,11,16, 2 ,4985,997,906,6888
11/16/2014,2014,11,16, 3 ,4893,963,876,6732
11/16/2014,2014,11,16, 4 ,4772,943,870,6585
11/16/2014,2014,11,16, 5 ,4721,942,872,6535
11/16/2014,2014,11,16, 6 ,4669,921,854,6444
11/16/2014,2014,11,16, 7 ,4661,903,823,6387
11/16/2014,2014,11,16, 8 ,4984,976,843,6803
11/16/2014,2014,11,16, 9 ,5453,1062,916,7431
11/16/2014,2014,11,16, 10 ,5839,1125,1013,7977
11/16/2014,2014,11,16, 11 ,6086,1183,1074,8343
11/16/2014,2014,11,16, 12 ,6086,1189,1080,8355
11/16/2014,2014,11,16, 13 ,6084,1179,1062,8325
11/16/2014,2014,11,16, 14 ,6020,1188,1069,8277
11/16/2014,2014,11,16, 15 ,5982,1133,1057,8172
11/16/2014,2014,11,16, 16 ,5829,1129,1078,8036
11/16/2014,2014,11,16, 17 ,5807,1144,1090,8041
11/16/2014,2014,11,16, 18 ,6672,1323,1251,9246
11/16/2014,2014,11,16, 19 ,6669,1394,1245,9308
11/16/2014,2014,11,16, 20 ,6612,1364,1204,9180
11/16/2014,2014,11,16, 21 ,6377,1287,1144,8808
11/16/2014,2014,11,16, 22 ,6090,1186,1068,8344
11/16/2014,2014,11,16, 23 ,5684,1108,968,7760
11/16/2014,2014,11,16, 24 ,5279,1036,955,7270
11/17/2014,2014,11,17, 1 ,5019,991,865,6875
11/17/2014,2014,11,17, 2 ,4812,966,832,6610
11/17/2014,2014,11,17, 3 ,4685,939,820,6444
11/17/2014,2014,11,17, 4 ,4606,930,806,6342
11/17/2014,2014,11,17, 5 ,4887,971,869,6727
11/17/2014,2014,11,17, 6 ,5036,987,914,6937
11/17/2014,2014,11,17, 7 ,5157,957,860,6974
11/17/2014,2014,11,17, 8 ,5952,1145,1005,8102
11/17/2014,2014,11,17, 9 ,6827,1342,1180,9349
11/17/2014,2014,11,17, 10 ,7333,1450,1270,10053
11/17/2014,2014,11,17, 11 ,7689,1508,1334,10531
11/17/2014,2014,11,17, 12 ,7587,1486,1303,10376
11/17/2014,2014,11,17, 13 ,7544,1478,1307,10329
11/17/2014,2014,11,17, 14 ,7830,1558,1378,10766
11/17/2014,2014,11,17, 15 ,7718,1527,1344,10589
11/17/2014,2014,11,17, 16 ,7618,1482,1307,10407
11/17/2014,2014,11,17, 17 ,7271,1425,1299,9995
11/17/2014,2014,11,17, 18 ,7707,1598,1396,10701
11/17/2014,2014,11,17, 19 ,7570,1540,1356,10466
11/17/2014,2014,11,17, 20 ,7297,1479,1326,10102
11/17/2014,2014,11,17, 21 ,7100,1404,1257,9761
11/17/2014,2014,11,17, 22 ,6676,1288,1169,9133
11/17/2014,2014,11,17, 23 ,6222,1172,1064,8458
11/17/2014,2014,11,17, 24 ,5883,1076,1036,7995
11/18/2014,2014,11,18, 1 ,5597,1039,947,7583
11/18/2014,2014,11,18, 2 ,5465,1017,920,7402
11/18/2014,2014,11,18, 3 ,5203,991,896,7090
11/18/2014,2014,11,18, 4 ,5198,975,886,7059
11/18/2014,2014,11,18, 5 ,5307,1016,943,7266
11/18/2014,2014,11,18, 6 ,5438,1024,972,7434
11/18/2014,2014,11,18, 7 ,5478,1000,900,7378
11/18/2014,2014,11,18, 8 ,6345,1155,1060,8560
11/18/2014,2014,11,18, 9 ,7110,1353,1249,9712
11/18/2014,2014,11,18, 10 ,7583,1442,1331,10356
11/18/2014,2014,11,18, 11 ,7841,1478,1382,10701
11/18/2014,2014,11,18, 12 ,7685,1464,1353,10502
11/18/2014,2014,11,18, 13 ,7702,1462,1340,10504
11/18/2014,2014,11,18, 14 ,7975,1540,1399,10914
11/18/2014,2014,11,18, 15 ,7834,1506,1377,10717
11/18/2014,2014,11,18, 16 ,7728,1457,1340,10525
11/18/2014,2014,11,18, 17 ,7433,1389,1332,10154
11/18/2014,2014,11,18, 18 ,7918,1591,1416,10925
11/18/2014,2014,11,18, 19 ,7558,1546,1370,10474
11/18/2014,2014,11,18, 20 ,7393,1487,1349,10229
11/18/2014,2014,11,18, 21 ,7169,1398,1298,9865
11/18/2014,2014,11,18, 22 ,6779,1295,1203,9277
11/18/2014,2014,11,18, 23 ,6392,1178,1094,8664
11/18/2014,2014,11,18, 24 ,5921,1076,1051,8048
11/19/2014,2014,11,19, 1 ,5708,1046,972,7726
11/19/2014,2014,11,19, 2 ,5502,1016,930,7448
11/19/2014,2014,11,19, 3 ,5374,990,898,7262
11/19/2014,2014,11,19, 4 ,5312,982,900,7194
11/19/2014,2014,11,19, 5 ,5440,1013,963,7416
11/19/2014,2014,11,19, 6 ,5525,1022,978,7525
11/19/2014,2014,11,19, 7 ,5629,992,916,7537
11/19/2014,2014,11,19, 8 ,6350,1157,1101,8608
11/19/2014,2014,11,19, 9 ,7091,1355,1238,9684
11/19/2014,2014,11,19, 10 ,7556,1468,1333,10357
11/19/2014,2014,11,19, 11 ,7779,1506,1378,10663
11/19/2014,2014,11,19, 12 ,7639,1456,1343,10438
11/19/2014,2014,11,19, 13 ,7557,1469,1360,10386
11/19/2014,2014,11,19, 14 ,7857,1523,1385,10765
11/19/2014,2014,11,19, 15 ,7735,1497,1332,10564
11/19/2014,2014,11,19, 16 ,7558,1463,1330,10351
11/19/2014,2014,11,19, 17 ,7311,1365,1311,9987
11/19/2014,2014,11,19, 18 ,7697,1559,1406,10662
11/19/2014,2014,11,19, 19 ,7513,1533,1386,10432
11/19/2014,2014,11,19, 20 ,7340,1463,1315,10118
11/19/2014,2014,11,19, 21 ,7066,1410,1290,9766
11/19/2014,2014,11,19, 22 ,6620,1269,1186,9075
11/19/2014,2014,11,19, 23 ,6195,1162,1114,8471
11/19/2014,2014,11,19, 24 ,5804,1093,1005,7902
11/20/2014,2014,11,20, 1 ,5567,1052,952,7571
11/20/2014,2014,11,20, 2 ,5414,1007,938,7359
11/20/2014,2014,11,20, 3 ,5294,991,906,7191
11/20/2014,2014,11,20, 4 ,5249,976,910,7135
11/20/2014,2014,11,20, 5 ,5448,1005,962,7415
11/20/2014,2014,11,20, 6 ,5509,1016,991,7516
11/20/2014,2014,11,20, 7 ,5598,984,937,7519
11/20/2014,2014,11,20, 8 ,6236,1143,1083,8462
11/20/2014,2014,11,20, 9 ,7044,1339,1244,9627
11/20/2014,2014,11,20, 10 ,7464,1430,1332,10226
11/20/2014,2014,11,20, 11 ,7686,1498,1405,10589
11/20/2014,2014,11,20, 12 ,7438,1446,1351,10235
11/20/2014,2014,11,20, 13 ,7400,1442,1364,10206
11/20/2014,2014,11,20, 14 ,7707,1498,1387,10592
11/20/2014,2014,11,20, 15 ,7554,1462,1349,10365
11/20/2014,2014,11,20, 16 ,7276,1390,1334,10000
11/20/2014,2014,11,20, 17 ,7187,1363,1335,9885
11/20/2014,2014,11,20, 18 ,7538,1500,1421,10459
11/20/2014,2014,11,20, 19 ,7345,1435,1368,10148
11/20/2014,2014,11,20, 20 ,7140,1371,1328,9839
11/20/2014,2014,11,20, 21 ,6993,1292,1260,9545
11/20/2014,2014,11,20, 22 ,6570,1192,1168,8930
11/20/2014,2014,11,20, 23 ,6165,1099,1067,8331
11/20/2014,2014,11,20, 24 ,5778,1026,1022,7826
11/21/2014,2014,11,21, 1 ,5489,984,959,7432
11/21/2014,2014,11,21, 2 ,5335,955,925,7215
11/21/2014,2014,11,21, 3 ,5177,939,907,7023
11/21/2014,2014,11,21, 4 ,5088,922,907,6917
11/21/2014,2014,11,21, 5 ,5263,962,955,7180
11/21/2014,2014,11,21, 6 ,5386,979,965,7330
11/21/2014,2014,11,21, 7 ,5496,966,915,7377
11/21/2014,2014,11,21, 8 ,6224,1092,1077,8393
11/21/2014,2014,11,21, 9 ,7048,1299,1222,9569
11/21/2014,2014,11,21, 10 ,7454,1382,1303,10139
11/21/2014,2014,11,21, 11 ,7737,1438,1340,10515
11/21/2014,2014,11,21, 12 ,7510,1405,1337,10252
11/21/2014,2014,11,21, 13 ,7542,1409,1353,10304
11/21/2014,2014,11,21, 14 ,7826,1486,1342,10654
11/21/2014,2014,11,21, 15 ,7684,1465,1354,10503
11/21/2014,2014,11,21, 16 ,7492,1415,1329,10236
11/21/2014,2014,11,21, 17 ,7206,1347,1321,9874
11/21/2014,2014,11,21, 18 ,7636,1533,1440,10609
11/21/2014,2014,11,21, 19 ,7484,1496,1388,10368
11/21/2014,2014,11,21, 20 ,7278,1426,1348,10052
11/21/2014,2014,11,21, 21 ,7112,1348,1288,9748
11/21/2014,2014,11,21, 22 ,6708,1243,1197,9148
11/21/2014,2014,11,21, 23 ,6310,1137,1086,8533
11/21/2014,2014,11,21, 24 ,5898,1050,1070,8018
11/22/2014,2014,11,22, 1 ,5608,1026,977,7611
11/22/2014,2014,11,22, 2 ,5424,992,934,7350
11/22/2014,2014,11,22, 3 ,5269,971,902,7142
11/22/2014,2014,11,22, 4 ,5204,958,903,7065
11/22/2014,2014,11,22, 5 ,5233,970,914,7117
11/22/2014,2014,11,22, 6 ,5178,958,910,7046
11/22/2014,2014,11,22, 7 ,5285,982,908,7175
11/22/2014,2014,11,22, 8 ,5852,1083,1007,7942
11/22/2014,2014,11,22, 9 ,6436,1241,1145,8822
11/22/2014,2014,11,22, 10 ,6978,1323,1241,9542
11/22/2014,2014,11,22, 11 ,7303,1384,1304,9991
11/22/2014,2014,11,22, 12 ,7129,1332,1264,9725
11/22/2014,2014,11,22, 13 ,7041,1337,1283,9661
11/22/2014,2014,11,22, 14 ,7276,1369,1320,9965
11/22/2014,2014,11,22, 15 ,7135,1342,1303,9780
11/22/2014,2014,11,22, 16 ,6910,1293,1246,9449
11/22/2014,2014,11,22, 17 ,6574,1251,1232,9057
11/22/2014,2014,11,22, 18 ,7228,1486,1349,10063
11/22/2014,2014,11,22, 19 ,7141,1478,1295,9914
11/22/2014,2014,11,22, 20 ,7044,1442,1283,9769
11/22/2014,2014,11,22, 21 ,6900,1379,1272,9551
11/22/2014,2014,11,22, 22 ,6663,1298,1197,9158
11/22/2014,2014,11,22, 23 ,6166,1180,1115,8461
11/22/2014,2014,11,22, 24 ,5815,1079,1005,7899
11/23/2014,2014,11,23, 1 ,5546,1041,987,7574
11/23/2014,2014,11,23, 2 ,5407,1008,952,7367
11/23/2014,2014,11,23, 3 ,5183,979,921,7083
11/23/2014,2014,11,23, 4 ,5119,966,908,6993
11/23/2014,2014,11,23, 5 ,5116,965,920,7001
11/23/2014,2014,11,23, 6 ,4944,933,903,6780
11/23/2014,2014,11,23, 7 ,4946,941,886,6773
11/23/2014,2014,11,23, 8 ,5222,998,929,7149
11/23/2014,2014,11,23, 9 ,5665,1097,1028,7790
11/23/2014,2014,11,23, 10 ,6111,1183,1113,8407
11/23/2014,2014,11,23, 11 ,6422,1238,1192,8852
11/23/2014,2014,11,23, 12 ,6379,1251,1206,8836
11/23/2014,2014,11,23, 13 ,6355,1239,1201,8795
11/23/2014,2014,11,23, 14 ,6405,1251,1192,8848
11/23/2014,2014,11,23, 15 ,6347,1227,1183,8757
11/23/2014,2014,11,23, 16 ,6203,1183,1144,8530
11/23/2014,2014,11,23, 17 ,5911,1145,1118,8174
11/23/2014,2014,11,23, 18 ,6771,1404,1318,9493
11/23/2014,2014,11,23, 19 ,6834,1396,1293,9523
11/23/2014,2014,11,23, 20 ,6749,1372,1258,9379
11/23/2014,2014,11,23, 21 ,6628,1300,1210,9138
11/23/2014,2014,11,23, 22 ,6265,1214,1124,8603
11/23/2014,2014,11,23, 23 ,5873,1107,1038,8018
11/23/2014,2014,11,23, 24 ,5497,1035,963,7495
11/24/2014,2014,11,24, 1 ,5184,1003,924,7111
11/24/2014,2014,11,24, 2 ,5012,974,894,6880
11/24/2014,2014,11,24, 3 ,4908,956,869,6733
11/24/2014,2014,11,24, 4 ,4862,944,859,6665
11/24/2014,2014,11,24, 5 ,5045,991,909,6945
11/24/2014,2014,11,24, 6 ,5183,1013,957,7153
11/24/2014,2014,11,24, 7 ,5323,987,883,7193
11/24/2014,2014,11,24, 8 ,6109,1140,1033,8282
11/24/2014,2014,11,24, 9 ,6928,1309,1200,9437
11/24/2014,2014,11,24, 10 ,7513,1437,1315,10265
11/24/2014,2014,11,24, 11 ,7808,1477,1324,10609
11/24/2014,2014,11,24, 12 ,7662,1435,1297,10394
11/24/2014,2014,11,24, 13 ,7558,1425,1304,10287
11/24/2014,2014,11,24, 14 ,7923,1494,1337,10754
11/24/2014,2014,11,24, 15 ,7788,1479,1294,10561
11/24/2014,2014,11,24, 16 ,7618,1441,1322,10381
11/24/2014,2014,11,24, 17 ,7278,1376,1293,9947
11/24/2014,2014,11,24, 18 ,7775,1554,1400,10729
11/24/2014,2014,11,24, 19 ,7630,1519,1361,10510
11/24/2014,2014,11,24, 20 ,7443,1450,1342,10235
11/24/2014,2014,11,24, 21 ,7146,1400,1300,9846
11/24/2014,2014,11,24, 22 ,6712,1282,1242,9236
11/24/2014,2014,11,24, 23 ,6221,1166,1106,8493
11/24/2014,2014,11,24, 24 ,5909,1098,1023,8030
11/25/2014,2014,11,25, 1 ,5611,1049,987,7647
11/25/2014,2014,11,25, 2 ,5448,1009,962,7419
11/25/2014,2014,11,25, 3 ,5293,989,924,7206
11/25/2014,2014,11,25, 4 ,5233,984,928,7145
11/25/2014,2014,11,25, 5 ,5378,1009,955,7342
11/25/2014,2014,11,25, 6 ,5434,1031,978,7443
11/25/2014,2014,11,25, 7 ,5514,987,930,7431
11/25/2014,2014,11,25, 8 ,6231,1131,1186,8548
11/25/2014,2014,11,25, 9 ,7050,1317,1227,9594
11/25/2014,2014,11,25, 10 ,7538,1403,1299,10240
11/25/2014,2014,11,25, 11 ,7785,1463,1347,10595
11/25/2014,2014,11,25, 12 ,7629,1431,1277,10337
11/25/2014,2014,11,25, 13 ,7636,1433,1339,10408
11/25/2014,2014,11,25, 14 ,7828,1490,1327,10645
11/25/2014,2014,11,25, 15 ,7746,1455,1292,10493
11/25/2014,2014,11,25, 16 ,7625,1420,1326,10371
11/25/2014,2014,11,25, 17 ,7295,1375,1328,9998
11/25/2014,2014,11,25, 18 ,7776,1561,1391,10728
11/25/2014,2014,11,25, 19 ,7613,1523,1332,10468
11/25/2014,2014,11,25, 20 ,7447,1451,1319,10217
11/25/2014,2014,11,25, 21 ,7207,1378,1334,9919
11/25/2014,2014,11,25, 22 ,6805,1256,1165,9226
11/25/2014,2014,11,25, 23 ,6385,1146,1068,8599
11/25/2014,2014,11,25, 24 ,5956,1053,1000,8009
11/26/2014,2014,11,26, 1 ,5689,1024,972,7685
11/26/2014,2014,11,26, 2 ,5568,990,973,7531
11/26/2014,2014,11,26, 3 ,5412,969,953,7334
11/26/2014,2014,11,26, 4 ,5315,945,943,7203
11/26/2014,2014,11,26, 5 ,5493,989,1014,7496
11/26/2014,2014,11,26, 6 ,5534,1020,1042,7596
11/26/2014,2014,11,26, 7 ,5572,972,986,7530
11/26/2014,2014,11,26, 8 ,6253,1112,1124,8489
11/26/2014,2014,11,26, 9 ,7057,1322,1204,9583
11/26/2014,2014,11,26, 10 ,7577,1401,1263,10241
11/26/2014,2014,11,26, 11 ,7810,1435,1264,10509
11/26/2014,2014,11,26, 12 ,7760,1377,1265,10402
11/26/2014,2014,11,26, 13 ,7652,1364,1260,10276
11/26/2014,2014,11,26, 14 ,7987,1407,1288,10682
11/26/2014,2014,11,26, 15 ,7761,1398,1276,10435
11/26/2014,2014,11,26, 16 ,7600,1366,1278,10244
11/26/2014,2014,11,26, 17 ,7370,1362,1303,10035
11/26/2014,2014,11,26, 18 ,7835,1487,1323,10645
11/26/2014,2014,11,26, 19 ,7677,1408,1292,10377
11/26/2014,2014,11,26, 20 ,7440,1328,1228,9996
11/26/2014,2014,11,26, 21 ,7261,1259,1170,9690
11/26/2014,2014,11,26, 22 ,6821,1128,1100,9049
11/26/2014,2014,11,26, 23 ,6315,1018,969,8302
11/26/2014,2014,11,26, 24 ,5937,963,902,7802
11/27/2014,2014,11,27, 1 ,5651,910,887,7448
11/27/2014,2014,11,27, 2 ,5540,886,866,7292
11/27/2014,2014,11,27, 3 ,5400,858,836,7094
11/27/2014,2014,11,27, 4 ,5304,844,840,6988
11/27/2014,2014,11,27, 5 ,5436,885,895,7216
11/27/2014,2014,11,27, 6 ,5544,908,935,7387
11/27/2014,2014,11,27, 7 ,5593,923,890,7406
11/27/2014,2014,11,27, 8 ,6323,1037,958,8318
11/27/2014,2014,11,27, 9 ,7136,1182,1124,9442
11/27/2014,2014,11,27, 10 ,7524,1249,1185,9958
11/27/2014,2014,11,27, 11 ,7750,1289,1252,10291
11/27/2014,2014,11,27, 12 ,7418,1263,1247,9928
11/27/2014,2014,11,27, 13 ,7462,1244,1227,9933
11/27/2014,2014,11,27, 14 ,7762,1265,1301,10328
11/27/2014,2014,11,27, 15 ,7611,1279,1277,10167
11/27/2014,2014,11,27, 16 ,7478,1267,1262,10007
11/27/2014,2014,11,27, 17 ,7358,1278,1255,9891
11/27/2014,2014,11,27, 18 ,7751,1354,1324,10429
11/27/2014,2014,11,27, 19 ,7436,1338,1348,10122
11/27/2014,2014,11,27, 20 ,7246,1273,1300,9819
11/27/2014,2014,11,27, 21 ,7029,1189,1230,9448
11/27/2014,2014,11,27, 22 ,6511,1089,1107,8707
11/27/2014,2014,11,27, 23 ,6103,998,994,8095
11/27/2014,2014,11,27, 24 ,5725,942,941,7608
11/28/2014,2014,11,28, 1 ,5432,922,877,7231
11/28/2014,2014,11,28, 2 ,5349,893,857,7099
11/28/2014,2014,11,28, 3 ,5178,870,836,6884
11/28/2014,2014,11,28, 4 ,5158,861,846,6865
11/28/2014,2014,11,28, 5 ,5353,898,870,7121
11/28/2014,2014,11,28, 6 ,5472,925,941,7338
11/28/2014,2014,11,28, 7 ,5609,905,890,7404
11/28/2014,2014,11,28, 8 ,6232,1069,1018,8319
11/28/2014,2014,11,28, 9 ,6975,1252,1213,9440
11/28/2014,2014,11,28, 10 ,7513,1339,1293,10145
11/28/2014,2014,11,28, 11 ,7731,1384,1354,10469
11/28/2014,2014,11,28, 12 ,7554,1356,1333,10243
11/28/2014,2014,11,28, 13 ,7541,1351,1315,10207
11/28/2014,2014,11,28, 14 ,7850,1418,1341,10609
11/28/2014,2014,11,28, 15 ,7743,1361,1331,10435
11/28/2014,2014,11,28, 16 ,7519,1336,1284,10139
11/28/2014,2014,11,28, 17 ,7263,1268,1280,9811
11/28/2014,2014,11,28, 18 ,7689,1472,1409,10570
11/28/2014,2014,11,28, 19 ,7536,1412,1365,10313
11/28/2014,2014,11,28, 20 ,7276,1366,1299,9941
11/28/2014,2014,11,28, 21 ,7145,1289,1248,9682
11/28/2014,2014,11,28, 22 ,6829,1194,1132,9155
11/28/2014,2014,11,28, 23 ,6326,1086,1023,8435
11/28/2014,2014,11,28, 24 ,5936,1007,956,7899
11/29/2014,2014,11,29, 1 ,5634,970,929,7533
11/29/2014,2014,11,29, 2 ,5457,953,904,7314
11/29/2014,2014,11,29, 3 ,5291,944,889,7124
11/29/2014,2014,11,29, 4 ,5238,929,876,7043
11/29/2014,2014,11,29, 5 ,5231,945,903,7079
11/29/2014,2014,11,29, 6 ,5176,946,906,7028
11/29/2014,2014,11,29, 7 ,5277,951,910,7138
11/29/2014,2014,11,29, 8 ,5772,1010,969,7751
11/29/2014,2014,11,29, 9 ,6373,1090,1082,8545
11/29/2014,2014,11,29, 10 ,6738,1155,1160,9053
11/29/2014,2014,11,29, 11 ,7011,1188,1205,9404
11/29/2014,2014,11,29, 12 ,6835,1142,1190,9167
11/29/2014,2014,11,29, 13 ,6801,1193,1189,9183
11/29/2014,2014,11,29, 14 ,6975,1229,1205,9409
11/29/2014,2014,11,29, 15 ,6811,1203,1174,9188
11/29/2014,2014,11,29, 16 ,6677,1164,1149,8990
11/29/2014,2014,11,29, 17 ,6450,1180,1197,8827
11/29/2014,2014,11,29, 18 ,7070,1362,1323,9755
11/29/2014,2014,11,29, 19 ,7025,1323,1313,9661
11/29/2014,2014,11,29, 20 ,6928,1275,1251,9454
11/29/2014,2014,11,29, 21 ,6819,1210,1184,9213
11/29/2014,2014,11,29, 22 ,6486,1122,1080,8688
11/29/2014,2014,11,29, 23 ,6079,1011,994,8084
11/29/2014,2014,11,29, 24 ,5635,956,947,7538
11/30/2014,2014,11,30, 1 ,5336,922,870,7128
11/30/2014,2014,11,30, 2 ,5175,892,853,6920
11/30/2014,2014,11,30, 3 ,5036,868,834,6738
11/30/2014,2014,11,30, 4 ,4887,854,829,6570
11/30/2014,2014,11,30, 5 ,4866,864,837,6567
11/30/2014,2014,11,30, 6 ,4784,862,848,6494
11/30/2014,2014,11,30, 7 ,4710,869,781,6360
11/30/2014,2014,11,30, 8 ,4911,897,829,6637
11/30/2014,2014,11,30, 9 ,5200,950,889,7039
11/30/2014,2014,11,30, 10 ,5567,1018,950,7535
11/30/2014,2014,11,30, 11 ,5878,1064,986,7928
11/30/2014,2014,11,30, 12 ,5775,1061,981,7817
11/30/2014,2014,11,30, 13 ,5729,1055,986,7770
11/30/2014,2014,11,30, 14 ,5742,1063,979,7784
11/30/2014,2014,11,30, 15 ,5638,1045,957,7640
11/30/2014,2014,11,30, 16 ,5581,1032,948,7561
11/30/2014,2014,11,30, 17 ,5672,1077,1012,7761
11/30/2014,2014,11,30, 18 ,6497,1273,1278,9048
11/30/2014,2014,11,30, 19 ,6497,1264,1259,9020
11/30/2014,2014,11,30, 20 ,6508,1217,1215,8940
11/30/2014,2014,11,30, 21 ,6388,1166,1139,8693
11/30/2014,2014,11,30, 22 ,6108,1083,1027,8218
11/30/2014,2014,11,30, 23 ,5615,967,955,7537
11/30/2014,2014,11,30, 24 ,5175,886,933,6994
12/1/2014,2014,12,1, 1 ,4845,878,857,6580
12/1/2014,2014,12,1, 2 ,4687,857,827,6371
12/1/2014,2014,12,1, 3 ,4574,847,806,6227
12/1/2014,2014,12,1, 4 ,4670,844,807,6321
12/1/2014,2014,12,1, 5 ,4739,885,844,6468
12/1/2014,2014,12,1, 6 ,5088,931,915,6934
12/1/2014,2014,12,1, 7 ,5213,883,838,6934
12/1/2014,2014,12,1, 8 ,5924,1026,961,7911
12/1/2014,2014,12,1, 9 ,6675,1242,1148,9065
12/1/2014,2014,12,1, 10 ,7106,1339,1195,9640
12/1/2014,2014,12,1, 11 ,7414,1356,1247,10017
12/1/2014,2014,12,1, 12 ,7288,1354,1265,9907
12/1/2014,2014,12,1, 13 ,7294,1368,1279,9941
12/1/2014,2014,12,1, 14 ,7583,1429,1301,10313
12/1/2014,2014,12,1, 15 ,7493,1399,1280,10172
12/1/2014,2014,12,1, 16 ,7287,1359,1257,9903
12/1/2014,2014,12,1, 17 ,7110,1329,1246,9685
12/1/2014,2014,12,1, 18 ,7606,1505,1391,10502
12/1/2014,2014,12,1, 19 ,7368,1459,1345,10172
12/1/2014,2014,12,1, 20 ,7224,1400,1320,9944
12/1/2014,2014,12,1, 21 ,7003,1313,1232,9548
12/1/2014,2014,12,1, 22 ,6623,1210,1168,9001
12/1/2014,2014,12,1, 23 ,6138,1064,1043,8245
12/1/2014,2014,12,1, 24 ,5682,1012,971,7665
12/2/2014,2014,12,2, 1 ,5442,991,923,7356
12/2/2014,2014,12,2, 2 ,5255,954,886,7095
12/2/2014,2014,12,2, 3 ,5090,941,850,6881
12/2/2014,2014,12,2, 4 ,5067,938,865,6870
12/2/2014,2014,12,2, 5 ,5262,983,919,7164
12/2/2014,2014,12,2, 6 ,5400,1012,960,7372
12/2/2014,2014,12,2, 7 ,5441,979,875,7295
12/2/2014,2014,12,2, 8 ,6177,1103,1018,8298
12/2/2014,2014,12,2, 9 ,6972,1290,1188,9450
12/2/2014,2014,12,2, 10 ,7380,1365,1294,10039
12/2/2014,2014,12,2, 11 ,7591,1410,1338,10339
12/2/2014,2014,12,2, 12 ,7390,1373,1331,10094
12/2/2014,2014,12,2, 13 ,7276,1404,1314,9994
12/2/2014,2014,12,2, 14 ,7570,1447,1355,10372
12/2/2014,2014,12,2, 15 ,7391,1400,1348,10139
12/2/2014,2014,12,2, 16 ,7290,1380,1322,9992
12/2/2014,2014,12,2, 17 ,7094,1302,1292,9688
12/2/2014,2014,12,2, 18 ,7575,1476,1407,10458
12/2/2014,2014,12,2, 19 ,7431,1469,1358,10258
12/2/2014,2014,12,2, 20 ,7180,1408,1349,9937
12/2/2014,2014,12,2, 21 ,6943,1349,1294,9586
12/2/2014,2014,12,2, 22 ,6520,1238,1233,8991
12/2/2014,2014,12,2, 23 ,6039,1113,1097,8249
12/2/2014,2014,12,2, 24 ,5574,1042,949,7565
12/3/2014,2014,12,3, 1 ,5324,992,945,7261
12/3/2014,2014,12,3, 2 ,5227,946,909,7082
12/3/2014,2014,12,3, 3 ,5069,914,885,6868
12/3/2014,2014,12,3, 4 ,4987,903,873,6763
12/3/2014,2014,12,3, 5 ,5238,957,939,7134
12/3/2014,2014,12,3, 6 ,5380,985,984,7349
12/3/2014,2014,12,3, 7 ,5415,967,911,7293
12/3/2014,2014,12,3, 8 ,6152,1093,1026,8271
12/3/2014,2014,12,3, 9 ,6937,1260,1202,9399
12/3/2014,2014,12,3, 10 ,7337,1343,1238,9918
12/3/2014,2014,12,3, 11 ,7635,1399,1281,10315
12/3/2014,2014,12,3, 12 ,7453,1363,1280,10096
12/3/2014,2014,12,3, 13 ,7421,1369,1332,10122
12/3/2014,2014,12,3, 14 ,7746,1433,1345,10524
12/3/2014,2014,12,3, 15 ,7668,1431,1348,10447
12/3/2014,2014,12,3, 16 ,7498,1374,1309,10181
12/3/2014,2014,12,3, 17 ,7194,1343,1308,9845
12/3/2014,2014,12,3, 18 ,7643,1504,1422,10569
12/3/2014,2014,12,3, 19 ,7476,1459,1389,10324
12/3/2014,2014,12,3, 20 ,7300,1414,1376,10090
12/3/2014,2014,12,3, 21 ,7028,1356,1309,9693
12/3/2014,2014,12,3, 22 ,6680,1227,1181,9088
12/3/2014,2014,12,3, 23 ,6174,1118,1051,8343
12/3/2014,2014,12,3, 24 ,5719,1028,978,7725
12/4/2014,2014,12,4, 1 ,5469,991,942,7402
12/4/2014,2014,12,4, 2 ,5305,961,900,7166
12/4/2014,2014,12,4, 3 ,5144,939,876,6959
12/4/2014,2014,12,4, 4 ,5104,929,874,6907
12/4/2014,2014,12,4, 5 ,5345,976,926,7247
12/4/2014,2014,12,4, 6 ,5487,1018,983,7488
12/4/2014,2014,12,4, 7 ,5517,980,909,7406
12/4/2014,2014,12,4, 8 ,6231,1102,1005,8338
12/4/2014,2014,12,4, 9 ,6945,1285,1160,9390
12/4/2014,2014,12,4, 10 ,7390,1379,1287,10056
12/4/2014,2014,12,4, 11 ,7731,1441,1342,10514
12/4/2014,2014,12,4, 12 ,7491,1405,1243,10139
12/4/2014,2014,12,4, 13 ,7492,1419,1320,10231
12/4/2014,2014,12,4, 14 ,7859,1464,1367,10690
12/4/2014,2014,12,4, 15 ,7748,1433,1322,10503
12/4/2014,2014,12,4, 16 ,7608,1383,1297,10288
12/4/2014,2014,12,4, 17 ,7360,1345,1300,10005
12/4/2014,2014,12,4, 18 ,7832,1525,1385,10742
12/4/2014,2014,12,4, 19 ,7676,1490,1377,10543
12/4/2014,2014,12,4, 20 ,7525,1435,1353,10313
12/4/2014,2014,12,4, 21 ,7261,1355,1286,9902
12/4/2014,2014,12,4, 22 ,6917,1245,1169,9331
12/4/2014,2014,12,4, 23 ,6367,1134,1066,8567
12/4/2014,2014,12,4, 24 ,5886,1050,998,7934
12/5/2014,2014,12,5, 1 ,5610,1016,934,7560
12/5/2014,2014,12,5, 2 ,5421,978,903,7302
12/5/2014,2014,12,5, 3 ,5275,953,884,7112
12/5/2014,2014,12,5, 4 ,5198,932,872,7002
12/5/2014,2014,12,5, 5 ,5364,962,912,7238
12/5/2014,2014,12,5, 6 ,5469,1012,972,7453
12/5/2014,2014,12,5, 7 ,5524,995,910,7429
12/5/2014,2014,12,5, 8 ,6157,1086,999,8242
12/5/2014,2014,12,5, 9 ,7004,1242,1178,9424
12/5/2014,2014,12,5, 10 ,7430,1318,1235,9983
12/5/2014,2014,12,5, 11 ,7719,1351,1296,10366
12/5/2014,2014,12,5, 12 ,7513,1317,1283,10113
12/5/2014,2014,12,5, 13 ,7429,1294,1281,10004
12/5/2014,2014,12,5, 14 ,7686,1324,1350,10360
12/5/2014,2014,12,5, 15 ,7531,1288,1334,10153
12/5/2014,2014,12,5, 16 ,7370,1244,1272,9886
12/5/2014,2014,12,5, 17 ,7149,1234,1275,9658
12/5/2014,2014,12,5, 18 ,7655,1404,1393,10452
12/5/2014,2014,12,5, 19 ,7414,1377,1349,10140
12/5/2014,2014,12,5, 20 ,7205,1304,1329,9838
12/5/2014,2014,12,5, 21 ,6995,1230,1283,9508
12/5/2014,2014,12,5, 22 ,6625,1122,1172,8919
12/5/2014,2014,12,5, 23 ,6238,1036,1071,8345
12/5/2014,2014,12,5, 24 ,5810,962,1032,7804
12/6/2014,2014,12,6, 1 ,5517,914,940,7371
12/6/2014,2014,12,6, 2 ,5327,892,889,7108
12/6/2014,2014,12,6, 3 ,5185,862,858,6905
12/6/2014,2014,12,6, 4 ,5073,838,847,6758
12/6/2014,2014,12,6, 5 ,5048,848,870,6766
12/6/2014,2014,12,6, 6 ,5062,858,880,6800
12/6/2014,2014,12,6, 7 ,5150,847,879,6876
12/6/2014,2014,12,6, 8 ,5581,879,956,7416
12/6/2014,2014,12,6, 9 ,6121,960,1060,8141
12/6/2014,2014,12,6, 10 ,6486,1016,1158,8660
12/6/2014,2014,12,6, 11 ,6731,1065,1215,9011
12/6/2014,2014,12,6, 12 ,6607,1024,1196,8827
12/6/2014,2014,12,6, 13 ,6467,1001,1195,8663
12/6/2014,2014,12,6, 14 ,6556,991,1219,8766
12/6/2014,2014,12,6, 15 ,6386,960,1208,8554
12/6/2014,2014,12,6, 16 ,6257,948,1177,8382
12/6/2014,2014,12,6, 17 ,6206,977,1172,8355
12/6/2014,2014,12,6, 18 ,6798,1064,1366,9228
12/6/2014,2014,12,6, 19 ,6626,1016,1301,8943
12/6/2014,2014,12,6, 20 ,6495,949,1257,8701
12/6/2014,2014,12,6, 21 ,6329,888,1218,8435
12/6/2014,2014,12,6, 22 ,6039,832,1160,8031
12/6/2014,2014,12,6, 23 ,5594,743,1018,7355
12/6/2014,2014,12,6, 24 ,5186,682,938,6806
12/7/2014,2014,12,7, 1 ,4935,639,887,6461
12/7/2014,2014,12,7, 2 ,4755,618,850,6223
12/7/2014,2014,12,7, 3 ,4630,552,829,6011
12/7/2014,2014,12,7, 4 ,4510,550,812,5872
12/7/2014,2014,12,7, 5 ,4530,566,835,5931
12/7/2014,2014,12,7, 6 ,4505,590,824,5919
12/7/2014,2014,12,7, 7 ,4470,622,819,5911
12/7/2014,2014,12,7, 8 ,4740,665,857,6262
12/7/2014,2014,12,7, 9 ,4931,674,933,6538
12/7/2014,2014,12,7, 10 ,5263,684,1007,6954
12/7/2014,2014,12,7, 11 ,5594,708,1063,7365
12/7/2014,2014,12,7, 12 ,5503,704,1077,7284
12/7/2014,2014,12,7, 13 ,5419,690,1068,7177
12/7/2014,2014,12,7, 14 ,5350,694,1073,7117
12/7/2014,2014,12,7, 15 ,5255,689,1051,6995
12/7/2014,2014,12,7, 16 ,5119,700,1033,6852
12/7/2014,2014,12,7, 17 ,5278,760,1122,7160
12/7/2014,2014,12,7, 18 ,6008,896,1290,8194
12/7/2014,2014,12,7, 19 ,5974,871,1274,8119
12/7/2014,2014,12,7, 20 ,5925,829,1250,8004
12/7/2014,2014,12,7, 21 ,5691,782,1181,7654
12/7/2014,2014,12,7, 22 ,5346,727,1081,7154
12/7/2014,2014,12,7, 23 ,4943,686,971,6600
12/7/2014,2014,12,7, 24 ,4650,643,931,6224
12/8/2014,2014,12,8, 1 ,4443,629,848,5920
12/8/2014,2014,12,8, 2 ,4286,625,809,5720
12/8/2014,2014,12,8, 3 ,4191,609,787,5587
12/8/2014,2014,12,8, 4 ,4129,609,793,5531
12/8/2014,2014,12,8, 5 ,4284,648,848,5780
12/8/2014,2014,12,8, 6 ,4530,701,890,6121
12/8/2014,2014,12,8, 7 ,4783,736,834,6353
12/8/2014,2014,12,8, 8 ,5232,837,969,7038
12/8/2014,2014,12,8, 9 ,5731,996,1152,7879
12/8/2014,2014,12,8, 10 ,3071,1095,1262,5428
12/8/2014,2014,12,8, 11 ,6261,1130,1309,8700
12/8/2014,2014,12,8, 12 ,6070,1101,1313,8484
12/8/2014,2014,12,8, 13 ,5932,1111,1312,8355
12/8/2014,2014,12,8, 14 ,5981,1161,1374,8516
12/8/2014,2014,12,8, 15 ,5904,1149,1340,8393
12/8/2014,2014,12,8, 16 ,5771,1134,1307,8212
12/8/2014,2014,12,8, 17 ,5740,1115,1272,8127
12/8/2014,2014,12,8, 18 ,6092,1252,1395,8739
12/8/2014,2014,12,8, 19 ,5896,1227,1357,8480
12/8/2014,2014,12,8, 20 ,5623,1165,1345,8133
12/8/2014,2014,12,8, 21 ,5220,1099,1278,7597
12/8/2014,2014,12,8, 22 ,4910,1001,1166,7077
12/8/2014,2014,12,8, 23 ,4571,908,1072,6551
12/8/2014,2014,12,8, 24 ,4254,831,997,6082
12/9/2014,2014,12,9, 1 ,4129,801,949,5879
12/9/2014,2014,12,9, 2 ,4041,778,918,5737
12/9/2014,2014,12,9, 3 ,3973,757,892,5622
12/9/2014,2014,12,9, 4 ,3982,755,882,5619
12/9/2014,2014,12,9, 5 ,4090,793,924,5807
12/9/2014,2014,12,9, 6 ,4352,838,971,6161
12/9/2014,2014,12,9, 7 ,4736,791,891,6418
12/9/2014,2014,12,9, 8 ,5350,926,1039,7315
12/9/2014,2014,12,9, 9 ,6065,1092,1213,8370
12/9/2014,2014,12,9, 10 ,6494,1206,1310,9010
12/9/2014,2014,12,9, 11 ,6826,1255,1361,9442
12/9/2014,2014,12,9, 12 ,6600,1295,1340,9235
12/9/2014,2014,12,9, 13 ,6451,1296,1363,9110
12/9/2014,2014,12,9, 14 ,6658,1365,1391,9414
12/9/2014,2014,12,9, 15 ,6586,1323,1363,9272
12/9/2014,2014,12,9, 16 ,6655,1316,1341,9312
12/9/2014,2014,12,9, 17 ,6658,1245,1306,9209
12/9/2014,2014,12,9, 18 ,7007,1405,1436,9848
12/9/2014,2014,12,9, 19 ,6817,1394,1407,9618
12/9/2014,2014,12,9, 20 ,6559,1305,1346,9210
12/9/2014,2014,12,9, 21 ,6331,1220,1343,8894
12/9/2014,2014,12,9, 22 ,5975,1107,1207,8289
12/9/2014,2014,12,9, 23 ,5475,1001,1086,7562
12/9/2014,2014,12,9, 24 ,5091,929,1045,7065
12/10/2014,2014,12,10, 1 ,4844,893,976,6713
12/10/2014,2014,12,10, 2 ,4761,863,934,6558
12/10/2014,2014,12,10, 3 ,4674,843,910,6427
12/10/2014,2014,12,10, 4 ,4613,842,896,6351
12/10/2014,2014,12,10, 5 ,4907,879,956,6742
12/10/2014,2014,12,10, 6 ,5094,904,978,6976
12/10/2014,2014,12,10, 7 ,5192,872,880,6944
12/10/2014,2014,12,10, 8 ,5887,998,970,7855
12/10/2014,2014,12,10, 9 ,6683,1191,1160,9034
12/10/2014,2014,12,10, 10 ,7155,1261,1298,9714
12/10/2014,2014,12,10, 11 ,7457,1330,1333,10120
12/10/2014,2014,12,10, 12 ,7302,1296,1313,9911
12/10/2014,2014,12,10, 13 ,7291,1327,1317,9935
12/10/2014,2014,12,10, 14 ,7580,1359,1375,10314
12/10/2014,2014,12,10, 15 ,7421,1341,1351,10113
12/10/2014,2014,12,10, 16 ,7262,1321,1331,9914
12/10/2014,2014,12,10, 17 ,6987,1275,1291,9553
12/10/2014,2014,12,10, 18 ,7504,1406,1403,10313
12/10/2014,2014,12,10, 19 ,7337,1381,1384,10102
12/10/2014,2014,12,10, 20 ,7049,1336,1334,9719
12/10/2014,2014,12,10, 21 ,6829,1257,1298,9384
12/10/2014,2014,12,10, 22 ,6413,1156,1192,8761
12/10/2014,2014,12,10, 23 ,5933,1046,1088,8067
12/10/2014,2014,12,10, 24 ,5502,972,975,7449
12/11/2014,2014,12,11, 1 ,5218,938,972,7128
12/11/2014,2014,12,11, 2 ,5107,896,945,6948
12/11/2014,2014,12,11, 3 ,4968,878,915,6761
12/11/2014,2014,12,11, 4 ,4930,873,904,6707
12/11/2014,2014,12,11, 5 ,5158,907,940,7005
12/11/2014,2014,12,11, 6 ,5299,940,990,7229
12/11/2014,2014,12,11, 7 ,5373,905,916,7194
12/11/2014,2014,12,11, 8 ,6029,1039,1051,8119
12/11/2014,2014,12,11, 9 ,6811,1232,1230,9273
12/11/2014,2014,12,11, 10 ,7318,1326,1311,9955
12/11/2014,2014,12,11, 11 ,7587,1351,1353,10291
12/11/2014,2014,12,11, 12 ,7427,1323,1307,10057
12/11/2014,2014,12,11, 13 ,7406,1329,1328,10063
12/11/2014,2014,12,11, 14 ,7683,1386,1357,10426
12/11/2014,2014,12,11, 15 ,7613,1368,1353,10334
12/11/2014,2014,12,11, 16 ,7445,1354,1311,10110
12/11/2014,2014,12,11, 17 ,7100,1283,1304,9687
12/11/2014,2014,12,11, 18 ,7648,1440,1417,10505
12/11/2014,2014,12,11, 19 ,7473,1411,1379,10263
12/11/2014,2014,12,11, 20 ,7309,1360,1313,9982
12/11/2014,2014,12,11, 21 ,7073,1280,1281,9634
12/11/2014,2014,12,11, 22 ,6661,1194,1226,9081
12/11/2014,2014,12,11, 23 ,6212,1066,1135,8413
12/11/2014,2014,12,11, 24 ,5704,994,1048,7746
12/12/2014,2014,12,12, 1 ,5469,950,980,7399
12/12/2014,2014,12,12, 2 ,5258,931,950,7139
12/12/2014,2014,12,12, 3 ,5104,911,925,6940
12/12/2014,2014,12,12, 4 ,5042,900,919,6861
12/12/2014,2014,12,12, 5 ,5215,933,958,7106
12/12/2014,2014,12,12, 6 ,5314,957,989,7260
12/12/2014,2014,12,12, 7 ,5425,932,927,7284
12/12/2014,2014,12,12, 8 ,6059,1073,1038,8170
12/12/2014,2014,12,12, 9 ,6898,1255,1184,9337
12/12/2014,2014,12,12, 10 ,7339,1369,1293,10001
12/12/2014,2014,12,12, 11 ,7563,1404,1341,10308
12/12/2014,2014,12,12, 12 ,7449,1371,1315,10135
12/12/2014,2014,12,12, 13 ,7435,1364,1320,10119
12/12/2014,2014,12,12, 14 ,7698,1442,1341,10481
12/12/2014,2014,12,12, 15 ,7615,1409,1318,10342
12/12/2014,2014,12,12, 16 ,7477,1363,1314,10154
12/12/2014,2014,12,12, 17 ,7043,1297,1272,9612
12/12/2014,2014,12,12, 18 ,7598,1462,1378,10438
12/12/2014,2014,12,12, 19 ,7489,1439,1354,10282
12/12/2014,2014,12,12, 20 ,7285,1394,1313,9992
12/12/2014,2014,12,12, 21 ,7083,1312,1286,9681
12/12/2014,2014,12,12, 22 ,6789,1218,1214,9221
12/12/2014,2014,12,12, 23 ,6370,1116,1096,8582
12/12/2014,2014,12,12, 24 ,5909,1029,1077,8015
12/13/2014,2014,12,13, 1 ,5533,989,943,7465
12/13/2014,2014,12,13, 2 ,5395,956,916,7267
12/13/2014,2014,12,13, 3 ,5234,925,896,7055
12/13/2014,2014,12,13, 4 ,5165,917,881,6963
12/13/2014,2014,12,13, 5 ,5196,929,901,7026
12/13/2014,2014,12,13, 6 ,5247,934,908,7089
12/13/2014,2014,12,13, 7 ,5278,927,891,7096
12/13/2014,2014,12,13, 8 ,5697,1008,923,7628
12/13/2014,2014,12,13, 9 ,6284,1122,1047,8453
12/13/2014,2014,12,13, 10 ,6693,1205,1163,9061
12/13/2014,2014,12,13, 11 ,6966,1237,1240,9443
12/13/2014,2014,12,13, 12 ,6886,1214,1206,9306
12/13/2014,2014,12,13, 13 ,6813,1207,1208,9228
12/13/2014,2014,12,13, 14 ,6871,1245,1256,9372
12/13/2014,2014,12,13, 15 ,6558,1195,1242,8995
12/13/2014,2014,12,13, 16 ,6447,1175,1242,8864
12/13/2014,2014,12,13, 17 ,6284,1168,1212,8664
12/13/2014,2014,12,13, 18 ,6945,1356,1338,9639
12/13/2014,2014,12,13, 19 ,6870,1338,1316,9524
12/13/2014,2014,12,13, 20 ,6715,1296,1288,9299
12/13/2014,2014,12,13, 21 ,6626,1251,1263,9140
12/13/2014,2014,12,13, 22 ,6316,1164,1187,8667
12/13/2014,2014,12,13, 23 ,5985,1073,1098,8156
12/13/2014,2014,12,13, 24 ,5562,997,1009,7568
12/14/2014,2014,12,14, 1 ,5238,946,950,7134
12/14/2014,2014,12,14, 2 ,5045,917,914,6876
12/14/2014,2014,12,14, 3 ,4959,887,869,6715
12/14/2014,2014,12,14, 4 ,4903,876,851,6630
12/14/2014,2014,12,14, 5 ,4842,873,864,6579
12/14/2014,2014,12,14, 6 ,4843,869,838,6550
12/14/2014,2014,12,14, 7 ,4800,879,785,6464
12/14/2014,2014,12,14, 8 ,5014,924,849,6787
12/14/2014,2014,12,14, 9 ,5402,1000,910,7312
12/14/2014,2014,12,14, 10 ,5773,1051,971,7795
12/14/2014,2014,12,14, 11 ,5998,1088,998,8084
12/14/2014,2014,12,14, 12 ,5902,1090,1050,8042
12/14/2014,2014,12,14, 13 ,5888,1094,1076,8058
12/14/2014,2014,12,14, 14 ,5914,1105,1099,8118
12/14/2014,2014,12,14, 15 ,5729,1084,1086,7899
12/14/2014,2014,12,14, 16 ,5674,1072,1062,7808
12/14/2014,2014,12,14, 17 ,5660,1102,1075,7837
12/14/2014,2014,12,14, 18 ,6456,1337,1331,9124
12/14/2014,2014,12,14, 19 ,6459,1333,1323,9115
12/14/2014,2014,12,14, 20 ,6427,1307,1314,9048
12/14/2014,2014,12,14, 21 ,6323,1237,1274,8834
12/14/2014,2014,12,14, 22 ,5971,1141,1172,8284
12/14/2014,2014,12,14, 23 ,5573,1049,1061,7683
12/14/2014,2014,12,14, 24 ,5140,958,986,7084
12/15/2014,2014,12,15, 1 ,4898,939,926,6763
12/15/2014,2014,12,15, 2 ,4778,904,893,6575
12/15/2014,2014,12,15, 3 ,4629,883,870,6382
12/15/2014,2014,12,15, 4 ,4641,868,864,6373
12/15/2014,2014,12,15, 5 ,4873,901,907,6681
12/15/2014,2014,12,15, 6 ,5144,941,927,7012
12/15/2014,2014,12,15, 7 ,5286,917,882,7085
12/15/2014,2014,12,15, 8 ,5858,1053,1021,7932
12/15/2014,2014,12,15, 9 ,6566,1247,1206,9019
12/15/2014,2014,12,15, 10 ,7084,1346,1292,9722
12/15/2014,2014,12,15, 11 ,7342,1411,1319,10072
12/15/2014,2014,12,15, 12 ,7130,1395,1308,9833
12/15/2014,2014,12,15, 13 ,7073,1379,1308,9760
12/15/2014,2014,12,15, 14 ,7398,1427,1328,10153
12/15/2014,2014,12,15, 15 ,7280,1415,1303,9998
12/15/2014,2014,12,15, 16 ,7270,1384,1296,9950
12/15/2014,2014,12,15, 17 ,7097,1308,1284,9689
12/15/2014,2014,12,15, 18 ,7496,1492,1361,10349
12/15/2014,2014,12,15, 19 ,7367,1473,1333,10173
12/15/2014,2014,12,15, 20 ,7125,1427,1309,9861
12/15/2014,2014,12,15, 21 ,6923,1363,1279,9565
12/15/2014,2014,12,15, 22 ,6561,1251,1200,9012
12/15/2014,2014,12,15, 23 ,6091,1118,1086,8295
12/15/2014,2014,12,15, 24 ,5663,1052,990,7705
12/16/2014,2014,12,16, 1 ,5274,1000,965,7239
12/16/2014,2014,12,16, 2 ,5104,978,926,7008
12/16/2014,2014,12,16, 3 ,5041,958,918,6917
12/16/2014,2014,12,16, 4 ,4982,944,914,6840
12/16/2014,2014,12,16, 5 ,5091,967,942,7000
12/16/2014,2014,12,16, 6 ,5402,993,972,7367
12/16/2014,2014,12,16, 7 ,5377,975,920,7272
12/16/2014,2014,12,16, 8 ,6067,1074,1008,8149
12/16/2014,2014,12,16, 9 ,6806,1235,1189,9230
12/16/2014,2014,12,16, 10 ,7287,1322,1258,9867
12/16/2014,2014,12,16, 11 ,7568,1335,1289,10192
12/16/2014,2014,12,16, 12 ,7367,1308,1262,9937
12/16/2014,2014,12,16, 13 ,7297,1298,1264,9859
12/16/2014,2014,12,16, 14 ,7524,1355,1292,10171
12/16/2014,2014,12,16, 15 ,7465,1353,1281,10099
12/16/2014,2014,12,16, 16 ,7310,1332,1274,9916
12/16/2014,2014,12,16, 17 ,7185,1301,1275,9761
12/16/2014,2014,12,16, 18 ,7523,1474,1350,10347
12/16/2014,2014,12,16, 19 ,7306,1448,1319,10073
12/16/2014,2014,12,16, 20 ,7169,1400,1301,9870
12/16/2014,2014,12,16, 21 ,6942,1336,1258,9536
12/16/2014,2014,12,16, 22 ,6548,1208,1159,8915
12/16/2014,2014,12,16, 23 ,6133,1099,1055,8287
12/16/2014,2014,12,16, 24 ,5679,1008,992,7679
12/17/2014,2014,12,17, 1 ,5413,982,931,7326
12/17/2014,2014,12,17, 2 ,5293,962,909,7164
12/17/2014,2014,12,17, 3 ,5106,948,895,6949
12/17/2014,2014,12,17, 4 ,5084,934,902,6920
12/17/2014,2014,12,17, 5 ,5158,945,939,7042
12/17/2014,2014,12,17, 6 ,5422,994,954,7370
12/17/2014,2014,12,17, 7 ,5471,973,918,7362
12/17/2014,2014,12,17, 8 ,6024,1097,1034,8155
12/17/2014,2014,12,17, 9 ,6759,1278,1168,9205
12/17/2014,2014,12,17, 10 ,7224,1357,1248,9829
12/17/2014,2014,12,17, 11 ,7420,1379,1301,10100
12/17/2014,2014,12,17, 12 ,7260,1354,1275,9889
12/17/2014,2014,12,17, 13 ,7125,1348,1271,9744
12/17/2014,2014,12,17, 14 ,7333,1386,1311,10030
12/17/2014,2014,12,17, 15 ,7224,1356,1294,9874
12/17/2014,2014,12,17, 16 ,7083,1335,1287,9705
12/17/2014,2014,12,17, 17 ,6818,1324,1312,9454
12/17/2014,2014,12,17, 18 ,7243,1447,1375,10065
12/17/2014,2014,12,17, 19 ,7109,1433,1335,9877
12/17/2014,2014,12,17, 20 ,6869,1379,1306,9554
12/17/2014,2014,12,17, 21 ,6649,1290,1251,9190
12/17/2014,2014,12,17, 22 ,6267,1183,1144,8594
12/17/2014,2014,12,17, 23 ,5825,1055,1038,7918
12/17/2014,2014,12,17, 24 ,5383,999,970,7352
12/18/2014,2014,12,18, 1 ,5145,955,931,7031
12/18/2014,2014,12,18, 2 ,4957,926,895,6778
12/18/2014,2014,12,18, 3 ,4908,912,884,6704
12/18/2014,2014,12,18, 4 ,4878,901,884,6663
12/18/2014,2014,12,18, 5 ,4950,916,908,6774
12/18/2014,2014,12,18, 6 ,5201,949,944,7094
12/18/2014,2014,12,18, 7 ,5308,937,937,7182
12/18/2014,2014,12,18, 8 ,5772,1045,1040,7857
12/18/2014,2014,12,18, 9 ,6487,1219,1184,8890
12/18/2014,2014,12,18, 10 ,6863,1309,1259,9431
12/18/2014,2014,12,18, 11 ,7141,1358,1286,9785
12/18/2014,2014,12,18, 12 ,6982,1310,1255,9547
12/18/2014,2014,12,18, 13 ,6947,1319,1292,9558
12/18/2014,2014,12,18, 14 ,7185,1374,1307,9866
12/18/2014,2014,12,18, 15 ,7073,1342,1287,9702
12/18/2014,2014,12,18, 16 ,6938,1326,1291,9555
12/18/2014,2014,12,18, 17 ,6814,1282,1276,9372
12/18/2014,2014,12,18, 18 ,7208,1463,1412,10083
12/18/2014,2014,12,18, 19 ,7196,1442,1365,10003
12/18/2014,2014,12,18, 20 ,6891,1376,1304,9571
12/18/2014,2014,12,18, 21 ,6548,1311,1238,9097
12/18/2014,2014,12,18, 22 ,6186,1169,1103,8458
12/18/2014,2014,12,18, 23 ,5718,1051,1019,7788
12/18/2014,2014,12,18, 24 ,5327,995,954,7276
12/19/2014,2014,12,19, 1 ,5038,958,913,6909
12/19/2014,2014,12,19, 2 ,4899,921,879,6699
12/19/2014,2014,12,19, 3 ,4806,908,864,6578
12/19/2014,2014,12,19, 4 ,4755,901,867,6523
12/19/2014,2014,12,19, 5 ,4917,908,887,6712
12/19/2014,2014,12,19, 6 ,4998,949,938,6885
12/19/2014,2014,12,19, 7 ,5197,963,916,7076
12/19/2014,2014,12,19, 8 ,5764,1046,984,7794
12/19/2014,2014,12,19, 9 ,6351,1200,1114,8665
12/19/2014,2014,12,19, 10 ,6815,1265,1212,9292
12/19/2014,2014,12,19, 11 ,7112,1296,1251,9659
12/19/2014,2014,12,19, 12 ,6963,1259,1233,9455
12/19/2014,2014,12,19, 13 ,6918,1236,1225,9379
12/19/2014,2014,12,19, 14 ,7119,1273,1279,9671
12/19/2014,2014,12,19, 15 ,7003,1254,1264,9521
12/19/2014,2014,12,19, 16 ,6817,1249,1250,9316
12/19/2014,2014,12,19, 17 ,6704,1252,1231,9187
12/19/2014,2014,12,19, 18 ,7130,1444,1377,9951
12/19/2014,2014,12,19, 19 ,7008,1407,1351,9766
12/19/2014,2014,12,19, 20 ,6799,1343,1298,9440
12/19/2014,2014,12,19, 21 ,6623,1275,1253,9151
12/19/2014,2014,12,19, 22 ,6206,1164,1150,8520
12/19/2014,2014,12,19, 23 ,5766,1046,1040,7852
12/19/2014,2014,12,19, 24 ,5359,972,941,7272
12/20/2014,2014,12,20, 1 ,5099,931,905,6935
12/20/2014,2014,12,20, 2 ,4924,903,864,6691
12/20/2014,2014,12,20, 3 ,4781,892,855,6528
12/20/2014,2014,12,20, 4 ,4771,883,845,6499
12/20/2014,2014,12,20, 5 ,4798,893,861,6552
12/20/2014,2014,12,20, 6 ,4868,912,881,6661
12/20/2014,2014,12,20, 7 ,4880,923,848,6651
12/20/2014,2014,12,20, 8 ,5312,1001,931,7244
12/20/2014,2014,12,20, 9 ,5940,1134,1038,8112
12/20/2014,2014,12,20, 10 ,6340,1207,1126,8673
12/20/2014,2014,12,20, 11 ,6669,1261,1189,9119
12/20/2014,2014,12,20, 12 ,6460,1231,1189,8880
12/20/2014,2014,12,20, 13 ,6374,1238,1193,8805
12/20/2014,2014,12,20, 14 ,6590,1279,1232,9101
12/20/2014,2014,12,20, 15 ,6437,1247,1212,8896
12/20/2014,2014,12,20, 16 ,6347,1213,1186,8746
12/20/2014,2014,12,20, 17 ,6172,1186,1174,8532
12/20/2014,2014,12,20, 18 ,6818,1365,1378,9561
12/20/2014,2014,12,20, 19 ,6857,1390,1339,9586
12/20/2014,2014,12,20, 20 ,6694,1349,1308,9351
12/20/2014,2014,12,20, 21 ,6511,1283,1264,9058
12/20/2014,2014,12,20, 22 ,6282,1209,1178,8669
12/20/2014,2014,12,20, 23 ,5827,1100,1069,7996
12/20/2014,2014,12,20, 24 ,5409,1016,970,7395
12/21/2014,2014,12,21, 1 ,5279,969,892,7140
12/21/2014,2014,12,21, 2 ,4961,937,873,6771
12/21/2014,2014,12,21, 3 ,4796,912,861,6569
12/21/2014,2014,12,21, 4 ,4764,901,840,6505
12/21/2014,2014,12,21, 5 ,4725,901,853,6479
12/21/2014,2014,12,21, 6 ,4723,894,868,6485
12/21/2014,2014,12,21, 7 ,4665,895,839,6399
12/21/2014,2014,12,21, 8 ,4939,935,875,6749
12/21/2014,2014,12,21, 9 ,5347,1019,950,7316
12/21/2014,2014,12,21, 10 ,5762,1079,976,7817
12/21/2014,2014,12,21, 11 ,5985,1117,1042,8144
12/21/2014,2014,12,21, 12 ,5954,1110,1081,8145
12/21/2014,2014,12,21, 13 ,5938,1120,1097,8155
12/21/2014,2014,12,21, 14 ,5987,1121,1103,8211
12/21/2014,2014,12,21, 15 ,5811,1101,1089,8001
12/21/2014,2014,12,21, 16 ,5694,1073,1073,7840
12/21/2014,2014,12,21, 17 ,5705,1093,1093,7891
12/21/2014,2014,12,21, 18 ,6485,1364,1305,9154
12/21/2014,2014,12,21, 19 ,6574,1375,1308,9257
12/21/2014,2014,12,21, 20 ,6550,1352,1285,9187
12/21/2014,2014,12,21, 21 ,6386,1285,1230,8901
12/21/2014,2014,12,21, 22 ,6034,1185,1127,8346
12/21/2014,2014,12,21, 23 ,5581,1080,1030,7691
12/21/2014,2014,12,21, 24 ,5235,1006,951,7192
12/22/2014,2014,12,22, 1 ,4917,963,900,6780
12/22/2014,2014,12,22, 2 ,4789,922,867,6578
12/22/2014,2014,12,22, 3 ,4637,906,851,6394
12/22/2014,2014,12,22, 4 ,4595,907,848,6350
12/22/2014,2014,12,22, 5 ,4699,912,855,6466
12/22/2014,2014,12,22, 6 ,4836,934,871,6641
12/22/2014,2014,12,22, 7 ,5003,950,871,6824
12/22/2014,2014,12,22, 8 ,5599,1065,990,7654
12/22/2014,2014,12,22, 9 ,6310,1245,1158,8713
12/22/2014,2014,12,22, 10 ,6684,1319,1261,9264
12/22/2014,2014,12,22, 11 ,6961,1360,1320,9641
12/22/2014,2014,12,22, 12 ,6784,1330,1303,9417
12/22/2014,2014,12,22, 13 ,6684,1331,1298,9313
12/22/2014,2014,12,22, 14 ,6911,1385,1352,9648
12/22/2014,2014,12,22, 15 ,6782,1358,1334,9474
12/22/2014,2014,12,22, 16 ,6665,1337,1323,9325
12/22/2014,2014,12,22, 17 ,6488,1309,1266,9063
12/22/2014,2014,12,22, 18 ,6935,1485,1415,9835
12/22/2014,2014,12,22, 19 ,6877,1467,1348,9692
12/22/2014,2014,12,22, 20 ,6652,1421,1295,9368
12/22/2014,2014,12,22, 21 ,6426,1349,1274,9049
12/22/2014,2014,12,22, 22 ,6156,1244,1166,8566
12/22/2014,2014,12,22, 23 ,5640,1128,1063,7831
12/22/2014,2014,12,22, 24 ,5262,1046,1010,7318
12/23/2014,2014,12,23, 1 ,4970,998,926,6894
12/23/2014,2014,12,23, 2 ,4799,974,906,6679
12/23/2014,2014,12,23, 3 ,4700,947,882,6529
12/23/2014,2014,12,23, 4 ,4663,941,870,6474
12/23/2014,2014,12,23, 5 ,4642,947,885,6474
12/23/2014,2014,12,23, 6 ,4734,967,890,6591
12/23/2014,2014,12,23, 7 ,4982,973,890,6845
12/23/2014,2014,12,23, 8 ,5465,1081,993,7539
12/23/2014,2014,12,23, 9 ,6122,1230,1143,8495
12/23/2014,2014,12,23, 10 ,6515,1316,1236,9067
12/23/2014,2014,12,23, 11 ,6743,1362,1317,9422
12/23/2014,2014,12,23, 12 ,6624,1331,1301,9256
12/23/2014,2014,12,23, 13 ,6526,1323,1302,9151
12/23/2014,2014,12,23, 14 ,6653,1369,1342,9364
12/23/2014,2014,12,23, 15 ,6490,1341,1322,9153
12/23/2014,2014,12,23, 16 ,6315,1308,1292,8915
12/23/2014,2014,12,23, 17 ,6072,1260,1222,8554
12/23/2014,2014,12,23, 18 ,6632,1446,1403,9481
12/23/2014,2014,12,23, 19 ,6581,1447,1389,9417
12/23/2014,2014,12,23, 20 ,6431,1411,1341,9183
12/23/2014,2014,12,23, 21 ,6281,1345,1291,8917
12/23/2014,2014,12,23, 22 ,6036,1258,1226,8520
12/23/2014,2014,12,23, 23 ,5515,1142,1110,7767
12/23/2014,2014,12,23, 24 ,4837,1050,984,6871
12/24/2014,2014,12,24, 1 ,4837,1017,964,6818
12/24/2014,2014,12,24, 2 ,4692,980,890,6562
12/24/2014,2014,12,24, 3 ,4545,964,872,6381
12/24/2014,2014,12,24, 4 ,4479,940,855,6274
12/24/2014,2014,12,24, 5 ,4443,929,859,6231
12/24/2014,2014,12,24, 6 ,4444,943,900,6287
12/24/2014,2014,12,24, 7 ,4362,930,885,6177
12/24/2014,2014,12,24, 8 ,4494,980,941,6415
12/24/2014,2014,12,24, 9 ,4851,1072,1043,6966
12/24/2014,2014,12,24, 10 ,5053,1118,1117,7288
12/24/2014,2014,12,24, 11 ,5139,1132,1146,7417
12/24/2014,2014,12,24, 12 ,5096,1126,1146,7368
12/24/2014,2014,12,24, 13 ,5000,1123,1159,7282
12/24/2014,2014,12,24, 14 ,4891,1140,1176,7207
12/24/2014,2014,12,24, 15 ,4797,1126,1155,7078
12/24/2014,2014,12,24, 16 ,4778,1102,1109,6989
12/24/2014,2014,12,24, 17 ,4815,1097,1085,6997
12/24/2014,2014,12,24, 18 ,5493,1341,1234,8068
12/24/2014,2014,12,24, 19 ,5534,1338,1291,8163
12/24/2014,2014,12,24, 20 ,5206,1259,1204,7669
12/24/2014,2014,12,24, 21 ,4931,1191,1160,7282
12/24/2014,2014,12,24, 22 ,4690,1137,1106,6933
12/24/2014,2014,12,24, 23 ,4494,1088,1053,6635
12/24/2014,2014,12,24, 24 ,4272,1052,990,6314
12/25/2014,2014,12,25, 1 ,4092,998,854,5944
12/25/2014,2014,12,25, 2 ,3929,954,772,5655
12/25/2014,2014,12,25, 3 ,3816,910,842,5568
12/25/2014,2014,12,25, 4 ,3735,882,830,5447
12/25/2014,2014,12,25, 5 ,3731,875,812,5418
12/25/2014,2014,12,25, 6 ,3751,861,795,5407
12/25/2014,2014,12,25, 7 ,3696,845,781,5322
12/25/2014,2014,12,25, 8 ,3817,858,787,5462
12/25/2014,2014,12,25, 9 ,3929,895,833,5657
12/25/2014,2014,12,25, 10 ,4122,935,897,5954
12/25/2014,2014,12,25, 11 ,4289,987,939,6215
12/25/2014,2014,12,25, 12 ,4404,1008,977,6389
12/25/2014,2014,12,25, 13 ,4429,1013,999,6441
12/25/2014,2014,12,25, 14 ,4400,1017,986,6403
12/25/2014,2014,12,25, 15 ,4375,999,965,6339
12/25/2014,2014,12,25, 16 ,4351,989,978,6318
12/25/2014,2014,12,25, 17 ,4366,1013,998,6377
12/25/2014,2014,12,25, 18 ,5062,1248,1176,7486
12/25/2014,2014,12,25, 19 ,5232,1249,1198,7679
12/25/2014,2014,12,25, 20 ,5141,1192,1147,7480
12/25/2014,2014,12,25, 21 ,5009,1122,1089,7220
12/25/2014,2014,12,25, 22 ,4802,1039,988,6829
12/25/2014,2014,12,25, 23 ,4496,946,916,6358
12/25/2014,2014,12,25, 24 ,4193,888,889,5970
12/26/2014,2014,12,26, 1 ,4000,845,843,5688
12/26/2014,2014,12,26, 2 ,3869,817,790,5476
12/26/2014,2014,12,26, 3 ,3739,798,769,5306
12/26/2014,2014,12,26, 4 ,3699,795,761,5255
12/26/2014,2014,12,26, 5 ,3737,806,769,5312
12/26/2014,2014,12,26, 6 ,3845,820,776,5441
12/26/2014,2014,12,26, 7 ,3928,842,783,5553
12/26/2014,2014,12,26, 8 ,4275,908,840,6023
12/26/2014,2014,12,26, 9 ,4675,1030,952,6657
12/26/2014,2014,12,26, 10 ,5172,1113,1043,7328
12/26/2014,2014,12,26, 11 ,5464,1159,1065,7688
12/26/2014,2014,12,26, 12 ,5453,1141,1084,7678
12/26/2014,2014,12,26, 13 ,5439,1139,1129,7707
12/26/2014,2014,12,26, 14 ,5469,1168,1139,7776
12/26/2014,2014,12,26, 15 ,5474,1157,1155,7786
12/26/2014,2014,12,26, 16 ,5365,1142,1153,7660
12/26/2014,2014,12,26, 17 ,5241,1131,1139,7511
12/26/2014,2014,12,26, 18 ,5904,1369,1339,8612
12/26/2014,2014,12,26, 19 ,6070,1382,1327,8779
12/26/2014,2014,12,26, 20 ,6038,1329,1268,8635
12/26/2014,2014,12,26, 21 ,5837,1255,1266,8358
12/26/2014,2014,12,26, 22 ,5432,1157,1108,7697
12/26/2014,2014,12,26, 23 ,5107,1062,1015,7184
12/26/2014,2014,12,26, 24 ,4763,987,929,6679
12/27/2014,2014,12,27, 1 ,4519,941,896,6356
12/27/2014,2014,12,27, 2 ,4363,910,869,6142
12/27/2014,2014,12,27, 3 ,4279,882,851,6012
12/27/2014,2014,12,27, 4 ,4186,877,842,5905
12/27/2014,2014,12,27, 5 ,4241,887,847,5975
12/27/2014,2014,12,27, 6 ,4261,887,866,6014
12/27/2014,2014,12,27, 7 ,4384,899,856,6139
12/27/2014,2014,12,27, 8 ,4730,972,913,6615
12/27/2014,2014,12,27, 9 ,5232,1098,1073,7403
12/27/2014,2014,12,27, 10 ,5697,1164,1125,7986
12/27/2014,2014,12,27, 11 ,6000,1210,1167,8377
12/27/2014,2014,12,27, 12 ,5906,1186,1102,8194
12/27/2014,2014,12,27, 13 ,5869,1182,1111,8162
12/27/2014,2014,12,27, 14 ,5958,1222,1160,8340
12/27/2014,2014,12,27, 15 ,5793,1168,1131,8092
12/27/2014,2014,12,27, 16 ,5696,1133,1118,7947
12/27/2014,2014,12,27, 17 ,5674,1139,1164,7977
12/27/2014,2014,12,27, 18 ,6256,1346,1332,8934
12/27/2014,2014,12,27, 19 ,6319,1362,1326,9007
12/27/2014,2014,12,27, 20 ,6195,1304,1262,8761
12/27/2014,2014,12,27, 21 ,5955,1242,1187,8384
12/27/2014,2014,12,27, 22 ,5644,1139,1087,7870
12/27/2014,2014,12,27, 23 ,5257,1055,1014,7326
12/27/2014,2014,12,27, 24 ,4879,991,940,6810
12/28/2014,2014,12,28, 1 ,4642,927,937,6506
12/28/2014,2014,12,28, 2 ,4486,913,908,6307
12/28/2014,2014,12,28, 3 ,4414,891,890,6195
12/28/2014,2014,12,28, 4 ,4352,887,867,6106
12/28/2014,2014,12,28, 5 ,4307,893,871,6071
12/28/2014,2014,12,28, 6 ,4373,896,844,6113
12/28/2014,2014,12,28, 7 ,4311,898,837,6046
12/28/2014,2014,12,28, 8 ,4572,934,882,6388
12/28/2014,2014,12,28, 9 ,4983,998,916,6897
12/28/2014,2014,12,28, 10 ,5417,1050,996,7463
12/28/2014,2014,12,28, 11 ,5623,1062,1000,7685
12/28/2014,2014,12,28, 12 ,5615,1061,1008,7684
12/28/2014,2014,12,28, 13 ,5617,1049,990,7656
12/28/2014,2014,12,28, 14 ,5645,1059,977,7681
12/28/2014,2014,12,28, 15 ,5504,1047,972,7523
12/28/2014,2014,12,28, 16 ,5383,1039,990,7412
12/28/2014,2014,12,28, 17 ,5283,1086,1024,7393
12/28/2014,2014,12,28, 18 ,5947,1291,1219,8457
12/28/2014,2014,12,28, 19 ,6144,1304,1216,8664
12/28/2014,2014,12,28, 20 ,6136,1257,1158,8551
12/28/2014,2014,12,28, 21 ,5891,1184,1070,8145
12/28/2014,2014,12,28, 22 ,5592,1085,998,7675
12/28/2014,2014,12,28, 23 ,5185,1002,877,7064
12/28/2014,2014,12,28, 24 ,4787,939,880,6606
12/29/2014,2014,12,29, 1 ,4527,884,795,6206
12/29/2014,2014,12,29, 2 ,4385,861,758,6004
12/29/2014,2014,12,29, 3 ,4225,835,744,5804
12/29/2014,2014,12,29, 4 ,4207,819,720,5746
12/29/2014,2014,12,29, 5 ,4223,836,745,5804
12/29/2014,2014,12,29, 6 ,4325,861,756,5942
12/29/2014,2014,12,29, 7 ,4432,899,765,6096
12/29/2014,2014,12,29, 8 ,4978,970,836,6784
12/29/2014,2014,12,29, 9 ,5584,1084,949,7617
12/29/2014,2014,12,29, 10 ,6008,1150,1037,8195
12/29/2014,2014,12,29, 11 ,6273,1167,1068,8508
12/29/2014,2014,12,29, 12 ,6208,1138,1076,8422
12/29/2014,2014,12,29, 13 ,6178,1109,1047,8334
12/29/2014,2014,12,29, 14 ,6283,1106,1076,8465
12/29/2014,2014,12,29, 15 ,6211,1092,1064,8367
12/29/2014,2014,12,29, 16 ,6021,1092,1040,8153
12/29/2014,2014,12,29, 17 ,5798,1111,1051,7960
12/29/2014,2014,12,29, 18 ,6267,1236,1215,8718
12/29/2014,2014,12,29, 19 ,6226,1178,1185,8589
12/29/2014,2014,12,29, 20 ,6079,1062,1142,8283
12/29/2014,2014,12,29, 21 ,5803,985,1079,7867
12/29/2014,2014,12,29, 22 ,5483,900,969,7352
12/29/2014,2014,12,29, 23 ,5088,800,876,6764
12/29/2014,2014,12,29, 24 ,4704,739,860,6303
12/30/2014,2014,12,30, 1 ,4444,754,779,5977
12/30/2014,2014,12,30, 2 ,4322,703,744,5769
12/30/2014,2014,12,30, 3 ,4174,628,731,5533
12/30/2014,2014,12,30, 4 ,4113,629,725,5467
12/30/2014,2014,12,30, 5 ,4170,646,734,5550
12/30/2014,2014,12,30, 6 ,4183,658,752,5593
12/30/2014,2014,12,30, 7 ,4177,693,739,5609
12/30/2014,2014,12,30, 8 ,4335,735,822,5892
12/30/2014,2014,12,30, 9 ,4681,793,903,6377
12/30/2014,2014,12,30, 10 ,5057,874,1013,6944
12/30/2014,2014,12,30, 11 ,5281,929,1025,7235
12/30/2014,2014,12,30, 12 ,5180,920,1016,7116
12/30/2014,2014,12,30, 13 ,5103,939,1032,7074
12/30/2014,2014,12,30, 14 ,5066,950,1042,7058
12/30/2014,2014,12,30, 15 ,5086,962,1037,7085
12/30/2014,2014,12,30, 16 ,4951,973,1031,6955
12/30/2014,2014,12,30, 17 ,5023,991,1025,7039
12/30/2014,2014,12,30, 18 ,5716,1174,1201,8091
12/30/2014,2014,12,30, 19 ,5813,1184,1231,8228
12/30/2014,2014,12,30, 20 ,5699,1154,1175,8028
12/30/2014,2014,12,30, 21 ,5463,1100,1113,7676
12/30/2014,2014,12,30, 22 ,5097,1003,1021,7121
12/30/2014,2014,12,30, 23 ,4688,926,952,6566
12/30/2014,2014,12,30, 24 ,4396,855,839,6090
12/31/2014,2014,12,31, 1 ,4203,836,821,5860
12/31/2014,2014,12,31, 2 ,4047,805,789,5641
12/31/2014,2014,12,31, 3 ,3933,793,767,5493
12/31/2014,2014,12,31, 4 ,3911,796,755,5462
12/31/2014,2014,12,31, 5 ,3925,804,751,5480
12/31/2014,2014,12,31, 6 ,3922,822,786,5530
12/31/2014,2014,12,31, 7 ,3879,830,773,5482
12/31/2014,2014,12,31, 8 ,4026,881,828,5735
12/31/2014,2014,12,31, 9 ,4412,974,913,6299
12/31/2014,2014,12,31, 10 ,4662,1018,993,6673
12/31/2014,2014,12,31, 11 ,4840,1063,1026,6929
12/31/2014,2014,12,31, 12 ,4774,1045,1033,6852
12/31/2014,2014,12,31, 13 ,4732,1054,1011,6797
12/31/2014,2014,12,31, 14 ,4765,1071,1034,6870
12/31/2014,2014,12,31, 15 ,4674,1059,1017,6750
12/31/2014,2014,12,31, 16 ,4565,1046,988,6599
12/31/2014,2014,12,31, 17 ,4547,1063,978,6588
12/31/2014,2014,12,31, 18 ,5212,1276,1172,7660
12/31/2014,2014,12,31, 19 ,5278,1220,1165,7663
12/31/2014,2014,12,31, 20 ,5002,1175,1118,7295
12/31/2014,2014,12,31, 21 ,4814,1153,1097,7064
12/31/2014,2014,12,31, 22 ,4649,1127,1073,6849
12/31/2014,2014,12,31, 23 ,4552,1103,1049,6704
12/31/2014,2014,12,31, 24 ,4490,1117,1056,6663
1/1/2015,2015,1,1, 1 ,4305,1067,987,6359
1/1/2015,2015,1,1, 2 ,3951,940,894,5785
1/1/2015,2015,1,1, 3 ,3710,873,826,5409
1/1/2015,2015,1,1, 4 ,3585,841,791,5217
1/1/2015,2015,1,1, 5 ,3524,821,758,5103
1/1/2015,2015,1,1, 6 ,3480,788,723,4991
1/1/2015,2015,1,1, 7 ,3336,771,697,4804
1/1/2015,2015,1,1, 8 ,3393,797,715,4905
1/1/2015,2015,1,1, 9 ,3510,827,736,5073
1/1/2015,2015,1,1, 10 ,3632,863,761,5256
1/1/2015,2015,1,1, 11 ,3808,912,789,5509
1/1/2015,2015,1,1, 12 ,3924,957,792,5673
1/1/2015,2015,1,1, 13 ,3915,970,844,5729
1/1/2015,2015,1,1, 14 ,3840,981,848,5669
1/1/2015,2015,1,1, 15 ,3735,981,842,5558
1/1/2015,2015,1,1, 16 ,3725,971,833,5529
1/1/2015,2015,1,1, 17 ,3831,950,863,5644
1/1/2015,2015,1,1, 18 ,4464,1177,1025,6666
1/1/2015,2015,1,1, 19 ,4584,1197,1079,6860
1/1/2015,2015,1,1, 20 ,4466,1164,1044,6674
1/1/2015,2015,1,1, 21 ,4217,1117,991,6325
1/1/2015,2015,1,1, 22 ,3915,1030,915,5860
1/1/2015,2015,1,1, 23 ,3635,939,846,5420
1/1/2015,2015,1,1, 24 ,3419,877,775,5071
1/2/2015,2015,1,2, 1 ,3339,847,750,4936
1/2/2015,2015,1,2, 2 ,3208,822,716,4746
1/2/2015,2015,1,2, 3 ,3100,799,701,4600
1/2/2015,2015,1,2, 4 ,3113,785,692,4590
1/2/2015,2015,1,2, 5 ,3138,785,708,4631
1/2/2015,2015,1,2, 6 ,3296,792,719,4807
1/2/2015,2015,1,2, 7 ,3397,797,732,4926
1/2/2015,2015,1,2, 8 ,3696,853,805,5354
1/2/2015,2015,1,2, 9 ,4056,946,918,5920
1/2/2015,2015,1,2, 10 ,4523,1021,993,6537
1/2/2015,2015,1,2, 11 ,4780,1055,1040,6875
1/2/2015,2015,1,2, 12 ,4794,1046,1040,6880
1/2/2015,2015,1,2, 13 ,4756,1029,1032,6817
1/2/2015,2015,1,2, 14 ,4849,1041,1043,6933
1/2/2015,2015,1,2, 15 ,4744,1041,1041,6826
1/2/2015,2015,1,2, 16 ,4685,1033,1038,6756
1/2/2015,2015,1,2, 17 ,4663,1061,1058,6782
1/2/2015,2015,1,2, 18 ,5265,1205,1209,7679
1/2/2015,2015,1,2, 19 ,5456,1255,1199,7910
1/2/2015,2015,1,2, 20 ,5257,1192,1155,7604
1/2/2015,2015,1,2, 21 ,5041,1115,1103,7259
1/2/2015,2015,1,2, 22 ,4661,1009,1006,6676
1/2/2015,2015,1,2, 23 ,4266,925,901,6092
1/2/2015,2015,1,2, 24 ,3949,861,836,5646
1/3/2015,2015,1,3, 1 ,3794,826,824,5444
1/3/2015,2015,1,3, 2 ,3713,799,796,5308
1/3/2015,2015,1,3, 3 ,3640,790,780,5210
1/3/2015,2015,1,3, 4 ,3609,779,768,5156
1/3/2015,2015,1,3, 5 ,3630,795,767,5192
1/3/2015,2015,1,3, 6 ,3837,819,773,5429
1/3/2015,2015,1,3, 7 ,3935,840,776,5551
1/3/2015,2015,1,3, 8 ,4256,894,908,6058
1/3/2015,2015,1,3, 9 ,4730,992,964,6686
1/3/2015,2015,1,3, 10 ,5183,1047,1057,7287
1/3/2015,2015,1,3, 11 ,5504,1080,1122,7706
1/3/2015,2015,1,3, 12 ,5451,1069,1121,7641
1/3/2015,2015,1,3, 13 ,5411,1054,1132,7597
1/3/2015,2015,1,3, 14 ,5504,1063,1163,7730
1/3/2015,2015,1,3, 15 ,5377,1053,1130,7560
1/3/2015,2015,1,3, 16 ,5314,1047,1125,7486
1/3/2015,2015,1,3, 17 ,5234,1071,1068,7373
1/3/2015,2015,1,3, 18 ,5802,1243,1284,8329
1/3/2015,2015,1,3, 19 ,5855,1267,1273,8395
1/3/2015,2015,1,3, 20 ,5662,1201,1222,8085
1/3/2015,2015,1,3, 21 ,5403,1116,1162,7681
1/3/2015,2015,1,3, 22 ,4998,1010,1035,7043
1/3/2015,2015,1,3, 23 ,4652,927,956,6535
1/3/2015,2015,1,3, 24 ,4299,868,890,6057
1/4/2015,2015,1,4, 1 ,4106,838,846,5790
1/4/2015,2015,1,4, 2 ,3972,822,820,5614
1/4/2015,2015,1,4, 3 ,3875,800,790,5465
1/4/2015,2015,1,4, 4 ,3834,793,784,5411
1/4/2015,2015,1,4, 5 ,3856,805,787,5448
1/4/2015,2015,1,4, 6 ,3970,808,802,5580
1/4/2015,2015,1,4, 7 ,3980,823,792,5595
1/4/2015,2015,1,4, 8 ,4204,865,831,5900
1/4/2015,2015,1,4, 9 ,4601,938,898,6437
1/4/2015,2015,1,4, 10 ,5024,989,975,6988
1/4/2015,2015,1,4, 11 ,5385,1034,1039,7458
1/4/2015,2015,1,4, 12 ,5372,1025,1046,7443
1/4/2015,2015,1,4, 13 ,5279,1021,1053,7353
1/4/2015,2015,1,4, 14 ,5358,1028,1067,7453
1/4/2015,2015,1,4, 15 ,5325,1024,1053,7402
1/4/2015,2015,1,4, 16 ,5258,1011,1023,7292
1/4/2015,2015,1,4, 17 ,5245,1049,1029,7323
1/4/2015,2015,1,4, 18 ,5759,1248,1232,8239
1/4/2015,2015,1,4, 19 ,6000,1270,1254,8524
1/4/2015,2015,1,4, 20 ,5916,1215,1211,8342
1/4/2015,2015,1,4, 21 ,5599,1141,1147,7887
1/4/2015,2015,1,4, 22 ,5278,1046,1036,7360
1/4/2015,2015,1,4, 23 ,4843,944,948,6735
1/4/2015,2015,1,4, 24 ,4539,887,884,6310
1/5/2015,2015,1,5, 1 ,4300,846,843,5989
1/5/2015,2015,1,5, 2 ,4166,821,808,5795
1/5/2015,2015,1,5, 3 ,4039,799,788,5626
1/5/2015,2015,1,5, 4 ,4031,799,786,5616
1/5/2015,2015,1,5, 5 ,4318,847,830,5995
1/5/2015,2015,1,5, 6 ,4643,919,894,6456
1/5/2015,2015,1,5, 7 ,4139,895,838,5872
1/5/2015,2015,1,5, 8 ,5440,992,927,7359
1/5/2015,2015,1,5, 9 ,6127,1167,1077,8371
1/5/2015,2015,1,5, 10 ,6635,1253,1184,9072
1/5/2015,2015,1,5, 11 ,6928,1307,1219,9454
1/5/2015,2015,1,5, 12 ,6775,1282,1202,9259
1/5/2015,2015,1,5, 13 ,6761,1268,1210,9239
1/5/2015,2015,1,5, 14 ,6996,1317,1244,9557
1/5/2015,2015,1,5, 15 ,6943,1307,1238,9488
1/5/2015,2015,1,5, 16 ,6835,1277,1226,9338
1/5/2015,2015,1,5, 17 ,6599,1245,1219,9063
1/5/2015,2015,1,5, 18 ,6873,1388,1282,9543
1/5/2015,2015,1,5, 19 ,6820,1381,1274,9475
1/5/2015,2015,1,5, 20 ,6633,1320,1224,9177
1/5/2015,2015,1,5, 21 ,6227,1228,1139,8594
1/5/2015,2015,1,5, 22 ,5906,1114,1017,8037
1/5/2015,2015,1,5, 23 ,5398,1015,924,7337
1/5/2015,2015,1,5, 24 ,5030,940,871,6841
1/6/2015,2015,1,6, 1 ,4822,930,830,6582
1/6/2015,2015,1,6, 2 ,4680,894,807,6381
1/6/2015,2015,1,6, 3 ,4565,874,792,6231
1/6/2015,2015,1,6, 4 ,4516,863,787,6166
1/6/2015,2015,1,6, 5 ,4735,906,836,6477
1/6/2015,2015,1,6, 6 ,5003,954,908,6865
1/6/2015,2015,1,6, 7 ,5050,908,837,6795
1/6/2015,2015,1,6, 8 ,5661,1020,932,7613
1/6/2015,2015,1,6, 9 ,6395,1184,1115,8694
1/6/2015,2015,1,6, 10 ,6811,1283,1223,9317
1/6/2015,2015,1,6, 11 ,7098,1326,1283,9707
1/6/2015,2015,1,6, 12 ,6903,1287,1269,9459
1/6/2015,2015,1,6, 13 ,6886,1291,1266,9443
1/6/2015,2015,1,6, 14 ,7199,1360,1317,9876
1/6/2015,2015,1,6, 15 ,7099,1341,1267,9707
1/6/2015,2015,1,6, 16 ,6969,1312,1241,9522
1/6/2015,2015,1,6, 17 ,6715,1256,1227,9198
1/6/2015,2015,1,6, 18 ,6931,1393,1352,9676
1/6/2015,2015,1,6, 19 ,6930,1413,1334,9677
1/6/2015,2015,1,6, 20 ,6667,1333,1274,9274
1/6/2015,2015,1,6, 21 ,6324,1248,1200,8772
1/6/2015,2015,1,6, 22 ,5977,1136,1080,8193
1/6/2015,2015,1,6, 23 ,5504,1023,966,7493
1/6/2015,2015,1,6, 24 ,5144,928,867,6939
1/7/2015,2015,1,7, 1 ,4890,907,860,6657
1/7/2015,2015,1,7, 2 ,4725,879,826,6430
1/7/2015,2015,1,7, 3 ,4632,854,810,6296
1/7/2015,2015,1,7, 4 ,4598,849,805,6252
1/7/2015,2015,1,7, 5 ,4795,897,854,6546
1/7/2015,2015,1,7, 6 ,5049,934,924,6907
1/7/2015,2015,1,7, 7 ,5033,893,868,6794
1/7/2015,2015,1,7, 8 ,5647,1004,948,7599
1/7/2015,2015,1,7, 9 ,6439,1172,1096,8707
1/7/2015,2015,1,7, 10 ,6767,1278,1188,9233
1/7/2015,2015,1,7, 11 ,7029,1302,1233,9564
1/7/2015,2015,1,7, 12 ,6870,1291,1223,9384
1/7/2015,2015,1,7, 13 ,6811,1301,1222,9334
1/7/2015,2015,1,7, 14 ,7104,1361,1262,9727
1/7/2015,2015,1,7, 15 ,6973,1331,1247,9551
1/7/2015,2015,1,7, 16 ,6843,1304,1240,9387
1/7/2015,2015,1,7, 17 ,6616,1253,1240,9109
1/7/2015,2015,1,7, 18 ,6865,1396,1345,9606
1/7/2015,2015,1,7, 19 ,6872,1409,1291,9572
1/7/2015,2015,1,7, 20 ,6568,1342,1188,9098
1/7/2015,2015,1,7, 21 ,6345,1253,1195,8793
1/7/2015,2015,1,7, 22 ,5913,1146,1087,8146
1/7/2015,2015,1,7, 23 ,5422,1045,975,7442
1/7/2015,2015,1,7, 24 ,5057,970,915,6942
1/8/2015,2015,1,8, 1 ,4872,945,871,6688
1/8/2015,2015,1,8, 2 ,4756,916,838,6510
1/8/2015,2015,1,8, 3 ,4623,886,818,6327
1/8/2015,2015,1,8, 4 ,4608,878,817,6303
1/8/2015,2015,1,8, 5 ,4777,914,864,6555
1/8/2015,2015,1,8, 6 ,5028,962,939,6929
1/8/2015,2015,1,8, 7 ,5054,924,879,6857
1/8/2015,2015,1,8, 8 ,5662,1026,959,7647
1/8/2015,2015,1,8, 9 ,6301,1198,1094,8593
1/8/2015,2015,1,8, 10 ,6735,1261,1231,9227
1/8/2015,2015,1,8, 11 ,7019,1285,1250,9554
1/8/2015,2015,1,8, 12 ,6884,1235,1220,9339
1/8/2015,2015,1,8, 13 ,6819,1214,1226,9259
1/8/2015,2015,1,8, 14 ,7117,1250,1234,9601
1/8/2015,2015,1,8, 15 ,6976,1235,1173,9384
1/8/2015,2015,1,8, 16 ,6873,1219,1203,9295
1/8/2015,2015,1,8, 17 ,6544,1200,1208,8952
1/8/2015,2015,1,8, 18 ,6850,1346,1320,9516
1/8/2015,2015,1,8, 19 ,6825,1346,1290,9461
1/8/2015,2015,1,8, 20 ,6566,1269,1211,9046
1/8/2015,2015,1,8, 21 ,6242,1191,1180,8613
1/8/2015,2015,1,8, 22 ,5845,1076,1075,7996
1/8/2015,2015,1,8, 23 ,5404,1012,945,7361
1/8/2015,2015,1,8, 24 ,5101,934,851,6886
1/9/2015,2015,1,9, 1 ,4775,898,849,6522
1/9/2015,2015,1,9, 2 ,4703,876,814,6393
1/9/2015,2015,1,9, 3 ,4605,865,798,6268
1/9/2015,2015,1,9, 4 ,4575,865,797,6237
1/9/2015,2015,1,9, 5 ,4787,904,836,6527
1/9/2015,2015,1,9, 6 ,5033,955,935,6923
1/9/2015,2015,1,9, 7 ,5050,938,842,6830
1/9/2015,2015,1,9, 8 ,5575,1014,958,7547
1/9/2015,2015,1,9, 9 ,6176,1175,1063,8414
1/9/2015,2015,1,9, 10 ,6580,1249,1188,9017
1/9/2015,2015,1,9, 11 ,6821,1279,1234,9334
1/9/2015,2015,1,9, 12 ,6612,1230,1187,9029
1/9/2015,2015,1,9, 13 ,6542,1209,1169,8920
1/9/2015,2015,1,9, 14 ,6751,1253,1185,9189
1/9/2015,2015,1,9, 15 ,6695,1236,1165,9096
1/9/2015,2015,1,9, 16 ,6550,1217,1169,8936
1/9/2015,2015,1,9, 17 ,6298,1190,1172,8660
1/9/2015,2015,1,9, 18 ,6570,1332,1274,9176
1/9/2015,2015,1,9, 19 ,6555,1322,1248,9125
1/9/2015,2015,1,9, 20 ,6320,1263,1184,8767
1/9/2015,2015,1,9, 21 ,5981,1182,1137,8300
1/9/2015,2015,1,9, 22 ,5617,1083,992,7692
1/9/2015,2015,1,9, 23 ,5195,972,895,7062
1/9/2015,2015,1,9, 24 ,4822,894,830,6546
1/10/2015,2015,1,10, 1 ,4574,875,793,6242
1/10/2015,2015,1,10, 2 ,4458,850,767,6075
1/10/2015,2015,1,10, 3 ,4389,830,753,5972
1/10/2015,2015,1,10, 4 ,4289,824,753,5866
1/10/2015,2015,1,10, 5 ,4348,850,769,5967
1/10/2015,2015,1,10, 6 ,4525,880,821,6226
1/10/2015,2015,1,10, 7 ,4651,889,822,6362
1/10/2015,2015,1,10, 8 ,5001,952,877,6830
1/10/2015,2015,1,10, 9 ,5624,1080,981,7685
1/10/2015,2015,1,10, 10 ,6026,1115,1073,8214
1/10/2015,2015,1,10, 11 ,6297,1167,1124,8588
1/10/2015,2015,1,10, 12 ,6167,1154,1088,8409
1/10/2015,2015,1,10, 13 ,6071,1150,1093,8314
1/10/2015,2015,1,10, 14 ,6234,1193,1096,8523
1/10/2015,2015,1,10, 15 ,6097,1174,1096,8367
1/10/2015,2015,1,10, 16 ,5975,1152,1106,8233
1/10/2015,2015,1,10, 17 ,5820,1115,1077,8012
1/10/2015,2015,1,10, 18 ,6143,1286,1241,8670
1/10/2015,2015,1,10, 19 ,6319,1322,1258,8899
1/10/2015,2015,1,10, 20 ,6086,1259,1198,8543
1/10/2015,2015,1,10, 21 ,5758,1170,1125,8053
1/10/2015,2015,1,10, 22 ,5470,1064,1029,7563
1/10/2015,2015,1,10, 23 ,5002,963,935,6900
1/10/2015,2015,1,10, 24 ,4705,887,892,6484
1/11/2015,2015,1,11, 1 ,4479,862,807,6148
1/11/2015,2015,1,11, 2 ,4309,833,785,5927
1/11/2015,2015,1,11, 3 ,4235,818,760,5813
1/11/2015,2015,1,11, 4 ,4148,806,745,5699
1/11/2015,2015,1,11, 5 ,4192,818,759,5769
1/11/2015,2015,1,11, 6 ,4229,839,797,5865
1/11/2015,2015,1,11, 7 ,4235,843,801,5879
1/11/2015,2015,1,11, 8 ,4510,876,808,6194
1/11/2015,2015,1,11, 9 ,4761,937,879,6577
1/11/2015,2015,1,11, 10 ,5215,1007,945,7167
1/11/2015,2015,1,11, 11 ,5483,1050,1004,7537
1/11/2015,2015,1,11, 12 ,5378,1041,990,7409
1/11/2015,2015,1,11, 13 ,5311,1047,982,7340
1/11/2015,2015,1,11, 14 ,5333,1044,1001,7378
1/11/2015,2015,1,11, 15 ,5216,1034,963,7213
1/11/2015,2015,1,11, 16 ,5160,1020,920,7100
1/11/2015,2015,1,11, 17 ,5167,1029,991,7187
1/11/2015,2015,1,11, 18 ,5726,1232,1186,8144
1/11/2015,2015,1,11, 19 ,5925,1266,1210,8401
1/11/2015,2015,1,11, 20 ,5794,1228,1163,8185
1/11/2015,2015,1,11, 21 ,5520,1141,1103,7764
1/11/2015,2015,1,11, 22 ,5115,1044,1009,7168
1/11/2015,2015,1,11, 23 ,4703,947,914,6564
1/11/2015,2015,1,11, 24 ,4412,882,834,6128
1/12/2015,2015,1,12, 1 ,4220,841,806,5867
1/12/2015,2015,1,12, 2 ,4090,815,782,5687
1/12/2015,2015,1,12, 3 ,4027,797,764,5588
1/12/2015,2015,1,12, 4 ,4042,803,765,5610
1/12/2015,2015,1,12, 5 ,4350,851,817,6018
1/12/2015,2015,1,12, 6 ,4663,921,897,6481
1/12/2015,2015,1,12, 7 ,4825,912,826,6563
1/12/2015,2015,1,12, 8 ,5389,998,904,7291
1/12/2015,2015,1,12, 9 ,6095,1152,1063,8310
1/12/2015,2015,1,12, 10 ,6569,1215,1161,8945
1/12/2015,2015,1,12, 11 ,6828,1260,1233,9321
1/12/2015,2015,1,12, 12 ,6671,1224,1229,9124
1/12/2015,2015,1,12, 13 ,6625,1199,1226,9050
1/12/2015,2015,1,12, 14 ,6881,1247,1276,9404
1/12/2015,2015,1,12, 15 ,6817,1231,1264,9312
1/12/2015,2015,1,12, 16 ,6659,1218,1252,9129
1/12/2015,2015,1,12, 17 ,6425,1215,1223,8863
1/12/2015,2015,1,12, 18 ,6654,1341,1322,9317
1/12/2015,2015,1,12, 19 ,6721,1334,1302,9357
1/12/2015,2015,1,12, 20 ,6408,1265,1268,8941
1/12/2015,2015,1,12, 21 ,6096,1167,1181,8444
1/12/2015,2015,1,12, 22 ,5698,1065,1058,7821
1/12/2015,2015,1,12, 23 ,5423,973,968,7364
1/12/2015,2015,1,12, 24 ,4891,902,858,6651
1/13/2015,2015,1,13, 1 ,4662,902,853,6417
1/13/2015,2015,1,13, 2 ,4473,848,815,6136
1/13/2015,2015,1,13, 3 ,4459,837,826,6122
1/13/2015,2015,1,13, 4 ,4447,838,810,6095
1/13/2015,2015,1,13, 5 ,4744,888,859,6491
1/13/2015,2015,1,13, 6 ,4993,956,932,6881
1/13/2015,2015,1,13, 7 ,5084,935,867,6886
1/13/2015,2015,1,13, 8 ,5558,1022,957,7537
1/13/2015,2015,1,13, 9 ,6301,1187,1124,8612
1/13/2015,2015,1,13, 10 ,6731,1265,1226,9222
1/13/2015,2015,1,13, 11 ,6930,1315,1276,9521
1/13/2015,2015,1,13, 12 ,6741,1272,1267,9280
1/13/2015,2015,1,13, 13 ,6673,1268,1263,9204
1/13/2015,2015,1,13, 14 ,6970,1339,1313,9622
1/13/2015,2015,1,13, 15 ,6854,1296,1316,9466
1/13/2015,2015,1,13, 16 ,6743,1274,1288,9305
1/13/2015,2015,1,13, 17 ,6569,1228,1244,9041
1/13/2015,2015,1,13, 18 ,6761,1348,1349,9458
1/13/2015,2015,1,13, 19 ,6834,1371,1346,9551
1/13/2015,2015,1,13, 20 ,6572,1294,1292,9158
1/13/2015,2015,1,13, 21 ,6209,1216,1181,8606
1/13/2015,2015,1,13, 22 ,5843,1101,1076,8020
1/13/2015,2015,1,13, 23 ,5436,1010,976,7422
1/13/2015,2015,1,13, 24 ,5016,939,922,6877
1/14/2015,2015,1,14, 1 ,4812,915,890,6617
1/14/2015,2015,1,14, 2 ,4639,889,864,6392
1/14/2015,2015,1,14, 3 ,4607,871,851,6329
1/14/2015,2015,1,14, 4 ,4595,872,847,6314
1/14/2015,2015,1,14, 5 ,4837,910,893,6640
1/14/2015,2015,1,14, 6 ,5088,967,959,7014
1/14/2015,2015,1,14, 7 ,5136,937,908,6981
1/14/2015,2015,1,14, 8 ,5707,1024,988,7719
1/14/2015,2015,1,14, 9 ,6357,1192,1154,8703
1/14/2015,2015,1,14, 10 ,6704,1282,1239,9225
1/14/2015,2015,1,14, 11 ,6891,1332,1272,9495
1/14/2015,2015,1,14, 12 ,6703,1293,1267,9263
1/14/2015,2015,1,14, 13 ,6661,1304,1296,9261
1/14/2015,2015,1,14, 14 ,6827,1342,1204,9373
1/14/2015,2015,1,14, 15 ,6780,1339,1279,9398
1/14/2015,2015,1,14, 16 ,6642,1312,1263,9217
1/14/2015,2015,1,14, 17 ,6488,1252,1238,8978
1/14/2015,2015,1,14, 18 ,6668,1372,1353,9393
1/14/2015,2015,1,14, 19 ,6692,1398,1341,9431
1/14/2015,2015,1,14, 20 ,6499,1337,1290,9126
1/14/2015,2015,1,14, 21 ,6226,1269,1205,8700
1/14/2015,2015,1,14, 22 ,5860,1162,1107,8129
1/14/2015,2015,1,14, 23 ,5502,1071,1033,7606
1/14/2015,2015,1,14, 24 ,5056,975,948,6979
1/15/2015,2015,1,15, 1 ,4862,950,913,6725
1/15/2015,2015,1,15, 2 ,4715,929,887,6531
1/15/2015,2015,1,15, 3 ,4631,907,861,6399
1/15/2015,2015,1,15, 4 ,4604,903,867,6374
1/15/2015,2015,1,15, 5 ,4712,939,915,6566
1/15/2015,2015,1,15, 6 ,4830,994,986,6810
1/15/2015,2015,1,15, 7 ,4898,956,914,6768
1/15/2015,2015,1,15, 8 ,5225,1050,1008,7283
1/15/2015,2015,1,15, 9 ,5753,1229,1165,8147
1/15/2015,2015,1,15, 10 ,6198,1305,1208,8711
1/15/2015,2015,1,15, 11 ,6449,1342,1262,9053
1/15/2015,2015,1,15, 12 ,6353,1309,1245,8907
1/15/2015,2015,1,15, 13 ,6384,1306,1223,8913
1/15/2015,2015,1,15, 14 ,6556,1358,1283,9197
1/15/2015,2015,1,15, 15 ,6475,1348,1282,9105
1/15/2015,2015,1,15, 16 ,6371,1326,1252,8949
1/15/2015,2015,1,15, 17 ,6164,1253,1202,8619
1/15/2015,2015,1,15, 18 ,6428,1379,1313,9120
1/15/2015,2015,1,15, 19 ,6695,1414,1325,9434
1/15/2015,2015,1,15, 20 ,6450,1339,1296,9085
1/15/2015,2015,1,15, 21 ,6144,1254,1219,8617
1/15/2015,2015,1,15, 22 ,5806,1164,1117,8087
1/15/2015,2015,1,15, 23 ,5473,1058,1002,7533
1/15/2015,2015,1,15, 24 ,5095,975,923,6993
1/16/2015,2015,1,16, 1 ,4877,938,870,6685
1/16/2015,2015,1,16, 2 ,4663,913,841,6417
1/16/2015,2015,1,16, 3 ,4638,897,812,6347
1/16/2015,2015,1,16, 4 ,4595,880,810,6285
1/16/2015,2015,1,16, 5 ,4699,913,846,6458
1/16/2015,2015,1,16, 6 ,4885,972,919,6776
1/16/2015,2015,1,16, 7 ,4924,947,847,6718
1/16/2015,2015,1,16, 8 ,5305,1049,938,7292
1/16/2015,2015,1,16, 9 ,5795,1212,1088,8095
1/16/2015,2015,1,16, 10 ,6163,1293,1204,8660
1/16/2015,2015,1,16, 11 ,6341,1349,1244,8934
1/16/2015,2015,1,16, 12 ,6222,1301,1225,8748
1/16/2015,2015,1,16, 13 ,6156,1298,1250,8704
1/16/2015,2015,1,16, 14 ,6305,1341,1304,8950
1/16/2015,2015,1,16, 15 ,6229,1325,1303,8857
1/16/2015,2015,1,16, 16 ,6103,1294,1248,8645
1/16/2015,2015,1,16, 17 ,5894,1233,1235,8362
1/16/2015,2015,1,16, 18 ,6230,1355,1327,8912
1/16/2015,2015,1,16, 19 ,6429,1385,1312,9126
1/16/2015,2015,1,16, 20 ,6259,1329,1294,8882
1/16/2015,2015,1,16, 21 ,6068,1241,1251,8560
1/16/2015,2015,1,16, 22 ,5714,1146,1173,8033
1/16/2015,2015,1,16, 23 ,5327,1042,1047,7416
1/16/2015,2015,1,16, 24 ,5095,960,934,6989
1/17/2015,2015,1,17, 1 ,4706,932,913,6551
1/17/2015,2015,1,17, 2 ,4543,910,879,6332
1/17/2015,2015,1,17, 3 ,4470,882,857,6209
1/17/2015,2015,1,17, 4 ,4373,874,846,6093
1/17/2015,2015,1,17, 5 ,4409,892,858,6159
1/17/2015,2015,1,17, 6 ,4520,928,860,6308
1/17/2015,2015,1,17, 7 ,4616,947,863,6426
1/17/2015,2015,1,17, 8 ,4968,1003,899,6870
1/17/2015,2015,1,17, 9 ,5467,1096,995,7558
1/17/2015,2015,1,17, 10 ,5924,1145,1098,8167
1/17/2015,2015,1,17, 11 ,6114,1163,1178,8455
1/17/2015,2015,1,17, 12 ,5970,1113,1134,8217
1/17/2015,2015,1,17, 13 ,5809,1084,1138,8031
1/17/2015,2015,1,17, 14 ,5905,1083,1167,8155
1/17/2015,2015,1,17, 15 ,5728,1063,1148,7939
1/17/2015,2015,1,17, 16 ,5689,1040,1145,7874
1/17/2015,2015,1,17, 17 ,5503,1062,1097,7662
1/17/2015,2015,1,17, 18 ,6021,1192,1252,8465
1/17/2015,2015,1,17, 19 ,6127,1196,1296,8619
1/17/2015,2015,1,17, 20 ,5961,1136,1263,8360
1/17/2015,2015,1,17, 21 ,5725,1068,1208,8001
1/17/2015,2015,1,17, 22 ,5386,995,1112,7493
1/17/2015,2015,1,17, 23 ,5029,917,1015,6961
1/17/2015,2015,1,17, 24 ,4612,841,941,6394
1/18/2015,2015,1,18, 1 ,4387,817,893,6097
1/18/2015,2015,1,18, 2 ,4260,799,862,5921
1/18/2015,2015,1,18, 3 ,4159,786,839,5784
1/18/2015,2015,1,18, 4 ,4159,778,829,5766
1/18/2015,2015,1,18, 5 ,4131,787,837,5755
1/18/2015,2015,1,18, 6 ,4155,799,850,5804
1/18/2015,2015,1,18, 7 ,4221,823,840,5884
1/18/2015,2015,1,18, 8 ,4413,847,860,6120
1/18/2015,2015,1,18, 9 ,4663,914,938,6515
1/18/2015,2015,1,18, 10 ,4920,972,1015,6907
1/18/2015,2015,1,18, 11 ,5068,1003,1065,7136
1/18/2015,2015,1,18, 12 ,4930,1016,1080,7026
1/18/2015,2015,1,18, 13 ,4870,1011,1102,6983
1/18/2015,2015,1,18, 14 ,4767,1007,1091,6865
1/18/2015,2015,1,18, 15 ,4688,998,1088,6774
1/18/2015,2015,1,18, 16 ,4683,986,1070,6739
1/18/2015,2015,1,18, 17 ,4869,988,1054,6911
1/18/2015,2015,1,18, 18 ,5353,1161,1223,7737
1/18/2015,2015,1,18, 19 ,5357,1214,1280,7851
1/18/2015,2015,1,18, 20 ,5211,1161,1244,7616
1/18/2015,2015,1,18, 21 ,4888,1096,1154,7138
1/18/2015,2015,1,18, 22 ,4452,1011,1077,6540
1/18/2015,2015,1,18, 23 ,4123,924,1012,6059
1/18/2015,2015,1,18, 24 ,3842,860,931,5633
1/19/2015,2015,1,19, 1 ,3661,820,875,5356
1/19/2015,2015,1,19, 2 ,3593,797,853,5243
1/19/2015,2015,1,19, 3 ,3521,777,830,5128
1/19/2015,2015,1,19, 4 ,3503,775,822,5100
1/19/2015,2015,1,19, 5 ,3731,812,865,5408
1/19/2015,2015,1,19, 6 ,4079,879,949,5907
1/19/2015,2015,1,19, 7 ,4299,875,853,6027
1/19/2015,2015,1,19, 8 ,4616,986,980,6582
1/19/2015,2015,1,19, 9 ,5249,1149,1157,7555
1/19/2015,2015,1,19, 10 ,5727,1267,1281,8275
1/19/2015,2015,1,19, 11 ,6021,1308,1306,8635
1/19/2015,2015,1,19, 12 ,6000,1288,1308,8596
1/19/2015,2015,1,19, 13 ,6011,1298,1309,8618
1/19/2015,2015,1,19, 14 ,6208,1345,1332,8885
1/19/2015,2015,1,19, 15 ,6174,1319,1312,8805
1/19/2015,2015,1,19, 16 ,6108,1294,1285,8687
1/19/2015,2015,1,19, 17 ,5911,1235,1261,8407
1/19/2015,2015,1,19, 18 ,6251,1360,1336,8947
1/19/2015,2015,1,19, 19 ,6453,1397,1320,9170
1/19/2015,2015,1,19, 20 ,6312,1335,1290,8937
1/19/2015,2015,1,19, 21 ,6089,1257,1235,8581
1/19/2015,2015,1,19, 22 ,5696,1138,1139,7973
1/19/2015,2015,1,19, 23 ,5349,1038,1033,7420
1/19/2015,2015,1,19, 24 ,4947,946,989,6882
1/20/2015,2015,1,20, 1 ,4682,909,892,6483
1/20/2015,2015,1,20, 2 ,4538,882,865,6285
1/20/2015,2015,1,20, 3 ,4482,860,845,6187
1/20/2015,2015,1,20, 4 ,4431,854,840,6125
1/20/2015,2015,1,20, 5 ,4677,896,882,6455
1/20/2015,2015,1,20, 6 ,4962,949,946,6857
1/20/2015,2015,1,20, 7 ,5032,913,850,6795
1/20/2015,2015,1,20, 8 ,5590,1013,953,7556
1/20/2015,2015,1,20, 9 ,6267,1200,1113,8580
1/20/2015,2015,1,20, 10 ,6681,1291,1218,9190
1/20/2015,2015,1,20, 11 ,6917,1354,1290,9561
1/20/2015,2015,1,20, 12 ,6767,1327,1284,9378
1/20/2015,2015,1,20, 13 ,6788,1344,1294,9426
1/20/2015,2015,1,20, 14 ,7030,1404,1336,9770
1/20/2015,2015,1,20, 15 ,6974,1378,1312,9664
1/20/2015,2015,1,20, 16 ,6868,1352,1306,9526
1/20/2015,2015,1,20, 17 ,6629,1298,1264,9191
1/20/2015,2015,1,20, 18 ,6866,1426,1320,9612
1/20/2015,2015,1,20, 19 ,6991,1462,1343,9796
1/20/2015,2015,1,20, 20 ,6751,1372,1314,9437
1/20/2015,2015,1,20, 21 ,6461,1290,1265,9016
1/20/2015,2015,1,20, 22 ,6070,1177,1160,8407
1/20/2015,2015,1,20, 23 ,5666,1061,1056,7783
1/20/2015,2015,1,20, 24 ,5224,979,958,7161
1/21/2015,2015,1,21, 1 ,4933,944,929,6806
1/21/2015,2015,1,21, 2 ,4829,913,874,6616
1/21/2015,2015,1,21, 3 ,4737,886,879,6502
1/21/2015,2015,1,21, 4 ,4747,881,887,6515
1/21/2015,2015,1,21, 5 ,4930,916,924,6770
1/21/2015,2015,1,21, 6 ,5171,969,986,7126
1/21/2015,2015,1,21, 7 ,5265,929,904,7098
1/21/2015,2015,1,21, 8 ,5721,1028,982,7731
1/21/2015,2015,1,21, 9 ,6421,1215,1132,8768
1/21/2015,2015,1,21, 10 ,6860,1313,1274,9447
1/21/2015,2015,1,21, 11 ,7145,1341,1313,9799
1/21/2015,2015,1,21, 12 ,6964,1312,1276,9552
1/21/2015,2015,1,21, 13 ,6948,1334,1289,9571
1/21/2015,2015,1,21, 14 ,7255,1394,1362,10011
1/21/2015,2015,1,21, 15 ,7167,1362,1347,9876
1/21/2015,2015,1,21, 16 ,7077,1324,1317,9718
1/21/2015,2015,1,21, 17 ,6735,1274,1272,9281
1/21/2015,2015,1,21, 18 ,6932,1381,1353,9666
1/21/2015,2015,1,21, 19 ,7051,1437,1370,9858
1/21/2015,2015,1,21, 20 ,6812,1350,1303,9465
1/21/2015,2015,1,21, 21 ,6585,1292,1239,9116
1/21/2015,2015,1,21, 22 ,6279,1186,1113,8578
1/21/2015,2015,1,21, 23 ,5902,1072,1023,7997
1/21/2015,2015,1,21, 24 ,5494,989,964,7447
1/22/2015,2015,1,22, 1 ,5189,973,895,7057
1/22/2015,2015,1,22, 2 ,5051,932,870,6853
1/22/2015,2015,1,22, 3 ,4894,904,852,6650
1/22/2015,2015,1,22, 4 ,4840,900,845,6585
1/22/2015,2015,1,22, 5 ,5026,940,892,6858
1/22/2015,2015,1,22, 6 ,5240,989,958,7187
1/22/2015,2015,1,22, 7 ,5295,940,902,7137
1/22/2015,2015,1,22, 8 ,5732,1031,996,7759
1/22/2015,2015,1,22, 9 ,6394,1210,1115,8719
1/22/2015,2015,1,22, 10 ,6749,1315,1246,9310
1/22/2015,2015,1,22, 11 ,7043,1385,1304,9732
1/22/2015,2015,1,22, 12 ,6899,1339,1297,9535
1/22/2015,2015,1,22, 13 ,6835,1355,1290,9480
1/22/2015,2015,1,22, 14 ,7147,1418,1331,9896
1/22/2015,2015,1,22, 15 ,7127,1398,1312,9837
1/22/2015,2015,1,22, 16 ,6945,1374,1293,9612
1/22/2015,2015,1,22, 17 ,6698,1313,1244,9255
1/22/2015,2015,1,22, 18 ,6825,1401,1348,9574
1/22/2015,2015,1,22, 19 ,6982,1456,1337,9775
1/22/2015,2015,1,22, 20 ,6684,1382,1306,9372
1/22/2015,2015,1,22, 21 ,6410,1297,1248,8955
1/22/2015,2015,1,22, 22 ,5998,1194,1144,8336
1/22/2015,2015,1,22, 23 ,5641,1088,1047,7776
1/22/2015,2015,1,22, 24 ,5189,1009,966,7164
1/23/2015,2015,1,23, 1 ,4935,959,929,6823
1/23/2015,2015,1,23, 2 ,4793,914,897,6604
1/23/2015,2015,1,23, 3 ,4743,890,866,6499
1/23/2015,2015,1,23, 4 ,4660,884,871,6415
1/23/2015,2015,1,23, 5 ,4877,911,915,6703
1/23/2015,2015,1,23, 6 ,5135,959,972,7066
1/23/2015,2015,1,23, 7 ,5259,935,891,7085
1/23/2015,2015,1,23, 8 ,5734,1031,977,7742
1/23/2015,2015,1,23, 9 ,5373,1198,1121,7692
1/23/2015,2015,1,23, 10 ,6695,1285,1235,9215
1/23/2015,2015,1,23, 11 ,6949,1318,1302,9569
1/23/2015,2015,1,23, 12 ,6709,1291,1278,9278
1/23/2015,2015,1,23, 13 ,6573,1287,1289,9149
1/23/2015,2015,1,23, 14 ,6907,1350,1342,9599
1/23/2015,2015,1,23, 15 ,6747,1317,1329,9393
1/23/2015,2015,1,23, 16 ,6595,1288,1327,9210
1/23/2015,2015,1,23, 17 ,6447,1241,1261,8949
1/23/2015,2015,1,23, 18 ,6479,1344,1332,9155
1/23/2015,2015,1,23, 19 ,6625,1369,1347,9341
1/23/2015,2015,1,23, 20 ,6341,1296,1319,8956
1/23/2015,2015,1,23, 21 ,6055,1224,1278,8557
1/23/2015,2015,1,23, 22 ,5738,1110,1169,8017
1/23/2015,2015,1,23, 23 ,5329,1013,1068,7410
1/23/2015,2015,1,23, 24 ,4931,945,938,6814
1/24/2015,2015,1,24, 1 ,4742,918,931,6591
1/24/2015,2015,1,24, 2 ,4576,883,908,6367
1/24/2015,2015,1,24, 3 ,4520,851,882,6253
1/24/2015,2015,1,24, 4 ,4404,827,866,6097
1/24/2015,2015,1,24, 5 ,4521,834,874,6229
1/24/2015,2015,1,24, 6 ,4683,875,896,6454
1/24/2015,2015,1,24, 7 ,4821,885,879,6585
1/24/2015,2015,1,24, 8 ,5149,937,935,7021
1/24/2015,2015,1,24, 9 ,5604,1050,1057,7711
1/24/2015,2015,1,24, 10 ,5994,1098,1081,8173
1/24/2015,2015,1,24, 11 ,6278,1131,1162,8571
1/24/2015,2015,1,24, 12 ,6110,1092,1153,8355
1/24/2015,2015,1,24, 13 ,6082,1095,1169,8346
1/24/2015,2015,1,24, 14 ,6225,1113,1198,8536
1/24/2015,2015,1,24, 15 ,6090,1090,1163,8343
1/24/2015,2015,1,24, 16 ,5931,1080,1154,8165
1/24/2015,2015,1,24, 17 ,5746,1074,1156,7976
1/24/2015,2015,1,24, 18 ,6033,1221,1274,8528
1/24/2015,2015,1,24, 19 ,6307,1266,1272,8845
1/24/2015,2015,1,24, 20 ,6129,1212,1211,8552
1/24/2015,2015,1,24, 21 ,5914,1146,1169,8229
1/24/2015,2015,1,24, 22 ,5573,1053,1060,7686
1/24/2015,2015,1,24, 23 ,5180,972,951,7103
1/24/2015,2015,1,24, 24 ,4828,885,849,6562
1/25/2015,2015,1,25, 1 ,4535,874,862,6271
1/25/2015,2015,1,25, 2 ,4409,834,838,6081
1/25/2015,2015,1,25, 3 ,4323,818,823,5964
1/25/2015,2015,1,25, 4 ,4303,809,811,5923
1/25/2015,2015,1,25, 5 ,4242,809,828,5879
1/25/2015,2015,1,25, 6 ,4266,822,843,5931
1/25/2015,2015,1,25, 7 ,4335,825,828,5988
1/25/2015,2015,1,25, 8 ,4582,852,845,6279
1/25/2015,2015,1,25, 9 ,4931,906,881,6718
1/25/2015,2015,1,25, 10 ,5297,959,929,7185
1/25/2015,2015,1,25, 11 ,5548,977,1029,7554
1/25/2015,2015,1,25, 12 ,5534,973,1049,7556
1/25/2015,2015,1,25, 13 ,5553,977,1053,7583
1/25/2015,2015,1,25, 14 ,5535,979,1072,7586
1/25/2015,2015,1,25, 15 ,5479,971,1032,7482
1/25/2015,2015,1,25, 16 ,5330,952,1046,7328
1/25/2015,2015,1,25, 17 ,5202,969,1037,7208
1/25/2015,2015,1,25, 18 ,5608,1154,1189,7951
1/25/2015,2015,1,25, 19 ,5969,1215,1213,8397
1/25/2015,2015,1,25, 20 ,5950,1165,1210,8325
1/25/2015,2015,1,25, 21 ,5681,1094,1182,7957
1/25/2015,2015,1,25, 22 ,5306,1009,1065,7380
1/25/2015,2015,1,25, 23 ,4971,925,984,6880
1/25/2015,2015,1,25, 24 ,4591,854,902,6347
1/26/2015,2015,1,26, 1 ,4403,841,870,6114
1/26/2015,2015,1,26, 2 ,4231,804,834,5869
1/26/2015,2015,1,26, 3 ,4137,794,805,5736
1/26/2015,2015,1,26, 4 ,4150,792,809,5751
1/26/2015,2015,1,26, 5 ,4422,846,854,6122
1/26/2015,2015,1,26, 6 ,4715,915,937,6567
1/26/2015,2015,1,26, 7 ,4825,898,871,6594
1/26/2015,2015,1,26, 8 ,5442,987,993,7422
1/26/2015,2015,1,26, 9 ,6098,1157,1163,8418
1/26/2015,2015,1,26, 10 ,6569,1242,1228,9039
1/26/2015,2015,1,26, 11 ,6869,1287,1278,9434
1/26/2015,2015,1,26, 12 ,6682,1245,1228,9155
1/26/2015,2015,1,26, 13 ,6643,1234,1195,9072
1/26/2015,2015,1,26, 14 ,6991,1276,1251,9518
1/26/2015,2015,1,26, 15 ,6900,1256,1237,9393
1/26/2015,2015,1,26, 16 ,6730,1229,1218,9177
1/26/2015,2015,1,26, 17 ,6497,1188,1207,8892
1/26/2015,2015,1,26, 18 ,6598,1316,1250,9164
1/26/2015,2015,1,26, 19 ,6776,1355,1222,9353
1/26/2015,2015,1,26, 20 ,6526,1284,1206,9016
1/26/2015,2015,1,26, 21 ,6277,1197,1159,8633
1/26/2015,2015,1,26, 22 ,5881,1093,1052,8026
1/26/2015,2015,1,26, 23 ,5413,982,968,7363
1/26/2015,2015,1,26, 24 ,5027,933,904,6864
1/27/2015,2015,1,27, 1 ,4777,889,849,6515
1/27/2015,2015,1,27, 2 ,4592,871,842,6305
1/27/2015,2015,1,27, 3 ,4535,853,806,6194
1/27/2015,2015,1,27, 4 ,4462,848,807,6117
1/27/2015,2015,1,27, 5 ,4710,891,856,6457
1/27/2015,2015,1,27, 6 ,5041,957,942,6940
1/27/2015,2015,1,27, 7 ,5108,918,877,6903
1/27/2015,2015,1,27, 8 ,5609,1017,968,7594
1/27/2015,2015,1,27, 9 ,6281,1182,1096,8559
1/27/2015,2015,1,27, 10 ,6688,1270,1188,9146
1/27/2015,2015,1,27, 11 ,6979,1317,1233,9529
1/27/2015,2015,1,27, 12 ,6828,1271,1210,9309
1/27/2015,2015,1,27, 13 ,6806,1281,1221,9308
1/27/2015,2015,1,27, 14 ,7014,1335,1246,9595
1/27/2015,2015,1,27, 15 ,6941,1321,1249,9511
1/27/2015,2015,1,27, 16 ,6796,1296,1237,9329
1/27/2015,2015,1,27, 17 ,6575,1238,1205,9018
1/27/2015,2015,1,27, 18 ,6745,1330,1294,9369
1/27/2015,2015,1,27, 19 ,6857,1391,1300,9548
1/27/2015,2015,1,27, 20 ,6603,1320,1288,9211
1/27/2015,2015,1,27, 21 ,6329,1243,1234,8806
1/27/2015,2015,1,27, 22 ,5954,1130,1124,8208
1/27/2015,2015,1,27, 23 ,5599,1023,1026,7648
1/27/2015,2015,1,27, 24 ,5192,933,986,7111
1/28/2015,2015,1,28, 1 ,4918,917,899,6734
1/28/2015,2015,1,28, 2 ,4831,882,872,6585
1/28/2015,2015,1,28, 3 ,4695,866,848,6409
1/28/2015,2015,1,28, 4 ,4691,864,847,6402
1/28/2015,2015,1,28, 5 ,4916,912,891,6719
1/28/2015,2015,1,28, 6 ,5229,964,969,7162
1/28/2015,2015,1,28, 7 ,5214,924,887,7025
1/28/2015,2015,1,28, 8 ,5757,1028,946,7731
1/28/2015,2015,1,28, 9 ,6382,1200,1116,8698
1/28/2015,2015,1,28, 10 ,6856,1292,1224,9372
1/28/2015,2015,1,28, 11 ,7044,1325,1269,9638
1/28/2015,2015,1,28, 12 ,6926,1289,1247,9462
1/28/2015,2015,1,28, 13 ,6934,1293,1251,9478
1/28/2015,2015,1,28, 14 ,7239,1350,1294,9883
1/28/2015,2015,1,28, 15 ,7148,1319,1284,9751
1/28/2015,2015,1,28, 16 ,7043,1309,1265,9617
1/28/2015,2015,1,28, 17 ,6795,1236,1225,9256
1/28/2015,2015,1,28, 18 ,6830,1339,1305,9474
1/28/2015,2015,1,28, 19 ,6998,1399,1315,9712
1/28/2015,2015,1,28, 20 ,6736,1336,1296,9368
1/28/2015,2015,1,28, 21 ,6463,1272,1246,8981
1/28/2015,2015,1,28, 22 ,6129,1162,1156,8447
1/28/2015,2015,1,28, 23 ,5762,1049,1036,7847
1/28/2015,2015,1,28, 24 ,5342,966,957,7265
1/29/2015,2015,1,29, 1 ,5133,936,920,6989
1/29/2015,2015,1,29, 2 ,4960,910,902,6772
1/29/2015,2015,1,29, 3 ,4827,886,879,6592
1/29/2015,2015,1,29, 4 ,4783,873,874,6530
1/29/2015,2015,1,29, 5 ,5023,916,908,6847
1/29/2015,2015,1,29, 6 ,5207,967,977,7151
1/29/2015,2015,1,29, 7 ,5257,945,880,7082
1/29/2015,2015,1,29, 8 ,5778,1045,989,7812
1/29/2015,2015,1,29, 9 ,6366,1219,1171,8756
1/29/2015,2015,1,29, 10 ,6817,1299,1262,9378
1/29/2015,2015,1,29, 11 ,7041,1358,1324,9723
1/29/2015,2015,1,29, 12 ,6816,1329,1298,9443
1/29/2015,2015,1,29, 13 ,6802,1322,1317,9441
1/29/2015,2015,1,29, 14 ,7050,1385,1328,9763
1/29/2015,2015,1,29, 15 ,6949,1365,1322,9636
1/29/2015,2015,1,29, 16 ,6841,1326,1311,9478
1/29/2015,2015,1,29, 17 ,6604,1262,1251,9117
1/29/2015,2015,1,29, 18 ,6630,1356,1323,9309
1/29/2015,2015,1,29, 19 ,6873,1409,1337,9619
1/29/2015,2015,1,29, 20 ,6618,1334,1346,9298
1/29/2015,2015,1,29, 21 ,6337,1266,1294,8897
1/29/2015,2015,1,29, 22 ,5980,1151,1184,8315
1/29/2015,2015,1,29, 23 ,5579,1043,1063,7685
1/29/2015,2015,1,29, 24 ,5146,973,971,7090
1/30/2015,2015,1,30, 1 ,4914,944,896,6754
1/30/2015,2015,1,30, 2 ,4771,911,846,6528
1/30/2015,2015,1,30, 3 ,4663,883,835,6381
1/30/2015,2015,1,30, 4 ,4636,869,831,6336
1/30/2015,2015,1,30, 5 ,4871,910,872,6653
1/30/2015,2015,1,30, 6 ,5108,961,969,7038
1/30/2015,2015,1,30, 7 ,5111,941,920,6972
1/30/2015,2015,1,30, 8 ,5694,1016,1002,7712
1/30/2015,2015,1,30, 9 ,6417,1183,1140,8740
1/30/2015,2015,1,30, 10 ,6776,1269,1222,9267
1/30/2015,2015,1,30, 11 ,6987,1310,1275,9572
1/30/2015,2015,1,30, 12 ,6778,1259,1210,9247
1/30/2015,2015,1,30, 13 ,6723,1269,1189,9181
1/30/2015,2015,1,30, 14 ,6998,1327,1234,9559
1/30/2015,2015,1,30, 15 ,6917,1311,1213,9441
1/30/2015,2015,1,30, 16 ,6731,1287,1227,9245
1/30/2015,2015,1,30, 17 ,6543,1229,1202,8974
1/30/2015,2015,1,30, 18 ,6607,1310,1261,9178
1/30/2015,2015,1,30, 19 ,6754,1346,1279,9379
1/30/2015,2015,1,30, 20 ,6519,1298,1215,9032
1/30/2015,2015,1,30, 21 ,6283,1220,1159,8662
1/30/2015,2015,1,30, 22 ,5947,1116,1059,8122
1/30/2015,2015,1,30, 23 ,5537,1021,961,7519
1/30/2015,2015,1,30, 24 ,5154,942,958,7054
1/31/2015,2015,1,31, 1 ,4878,900,857,6635
1/31/2015,2015,1,31, 2 ,4712,870,833,6415
1/31/2015,2015,1,31, 3 ,4608,845,816,6269
1/31/2015,2015,1,31, 4 ,4595,834,810,6239
1/31/2015,2015,1,31, 5 ,4629,850,823,6302
1/31/2015,2015,1,31, 6 ,4880,878,867,6625
1/31/2015,2015,1,31, 7 ,4836,876,843,6555
1/31/2015,2015,1,31, 8 ,5263,949,902,7114
1/31/2015,2015,1,31, 9 ,5731,1075,1016,7822
1/31/2015,2015,1,31, 10 ,6136,1161,1128,8425
1/31/2015,2015,1,31, 11 ,6387,1204,1187,8778
1/31/2015,2015,1,31, 12 ,6223,1167,1038,8428
1/31/2015,2015,1,31, 13 ,6138,1161,1121,8420
1/31/2015,2015,1,31, 14 ,6255,1196,1151,8602
1/31/2015,2015,1,31, 15 ,6159,1177,1151,8487
1/31/2015,2015,1,31, 16 ,6027,1143,1102,8272
1/31/2015,2015,1,31, 17 ,5816,1096,1125,8037
1/31/2015,2015,1,31, 18 ,5966,1234,1225,8425
1/31/2015,2015,1,31, 19 ,6297,1290,1264,8851
1/31/2015,2015,1,31, 20 ,6132,1252,1242,8626
1/31/2015,2015,1,31, 21 ,5895,1175,1176,8246
1/31/2015,2015,1,31, 22 ,5684,1087,1070,7841
1/31/2015,2015,1,31, 23 ,5320,991,972,7283
1/31/2015,2015,1,31, 24 ,4999,894,910,6803
2/1/2015,2015,2,1, 1 ,4670,861,816,6347
2/1/2015,2015,2,1, 2 ,4565,839,807,6211
2/1/2015,2015,2,1, 3 ,4415,817,787,6019
2/1/2015,2015,2,1, 4 ,4345,812,773,5930
2/1/2015,2015,2,1, 5 ,4350,815,784,5949
2/1/2015,2015,2,1, 6 ,4358,831,803,5992
2/1/2015,2015,2,1, 7 ,4381,831,801,6013
2/1/2015,2015,2,1, 8 ,4622,847,827,6296
2/1/2015,2015,2,1, 9 ,4924,902,882,6708
2/1/2015,2015,2,1, 10 ,5315,952,951,7218
2/1/2015,2015,2,1, 11 ,5496,995,1008,7499
2/1/2015,2015,2,1, 12 ,5396,981,1006,7383
2/1/2015,2015,2,1, 13 ,5332,989,997,7318
2/1/2015,2015,2,1, 14 ,5287,986,1021,7294
2/1/2015,2015,2,1, 15 ,5185,971,998,7154
2/1/2015,2015,2,1, 16 ,5140,958,1000,7098
2/1/2015,2015,2,1, 17 ,5119,998,1018,7135
2/1/2015,2015,2,1, 18 ,5574,1142,1137,7853
2/1/2015,2015,2,1, 19 ,5937,1256,1228,8421
2/1/2015,2015,2,1, 20 ,5789,1153,1182,8124
2/1/2015,2015,2,1, 21 ,5581,1064,1125,7770
2/1/2015,2015,2,1, 22 ,5191,966,1027,7184
2/1/2015,2015,2,1, 23 ,4769,875,940,6584
2/1/2015,2015,2,1, 24 ,4510,817,770,6097
2/2/2015,2015,2,2, 1 ,4243,789,703,5735
2/2/2015,2015,2,2, 2 ,4092,770,782,5644
2/2/2015,2015,2,2, 3 ,4014,756,777,5547
2/2/2015,2015,2,2, 4 ,4022,759,774,5555
2/2/2015,2015,2,2, 5 ,4315,805,815,5935
2/2/2015,2015,2,2, 6 ,4687,882,923,6492
2/2/2015,2015,2,2, 7 ,4756,871,865,6492
2/2/2015,2015,2,2, 8 ,5337,942,975,7254
2/2/2015,2015,2,2, 9 ,6024,1096,1096,8216
2/2/2015,2015,2,2, 10 ,6556,1172,1183,8911
2/2/2015,2015,2,2, 11 ,6813,1209,1213,9235
2/2/2015,2015,2,2, 12 ,6659,1165,1171,8995
2/2/2015,2015,2,2, 13 ,6608,1146,1164,8918
2/2/2015,2015,2,2, 14 ,6899,1196,1203,9298
2/2/2015,2015,2,2, 15 ,6811,1175,1187,9173
2/2/2015,2015,2,2, 16 ,6658,1179,1186,9023
2/2/2015,2015,2,2, 17 ,6356,1141,1165,8662
2/2/2015,2015,2,2, 18 ,6397,1255,1184,8836
2/2/2015,2015,2,2, 19 ,6679,1294,1252,9225
2/2/2015,2015,2,2, 20 ,6411,1218,1220,8849
2/2/2015,2015,2,2, 21 ,6041,1127,1157,8325
2/2/2015,2015,2,2, 22 ,5646,1003,1042,7691
2/2/2015,2015,2,2, 23 ,5206,906,949,7061
2/2/2015,2015,2,2, 24 ,4776,825,878,6479
2/3/2015,2015,2,3, 1 ,4537,805,837,6179
2/3/2015,2015,2,3, 2 ,4456,787,817,6060
2/3/2015,2015,2,3, 3 ,4352,775,796,5923
2/3/2015,2015,2,3, 4 ,4392,782,804,5978
2/3/2015,2015,2,3, 5 ,4642,835,847,6324
2/3/2015,2015,2,3, 6 ,4898,905,940,6743
2/3/2015,2015,2,3, 7 ,4977,878,877,6732
2/3/2015,2015,2,3, 8 ,5464,963,964,7391
2/3/2015,2015,2,3, 9 ,6095,1136,1124,8355
2/3/2015,2015,2,3, 10 ,6480,1206,1216,8902
2/3/2015,2015,2,3, 11 ,6790,1244,1242,9276
2/3/2015,2015,2,3, 12 ,6614,1199,1218,9031
2/3/2015,2015,2,3, 13 ,6544,1205,1199,8948
2/3/2015,2015,2,3, 14 ,6835,1273,1252,9360
2/3/2015,2015,2,3, 15 ,6719,1279,1258,9256
2/3/2015,2015,2,3, 16 ,6599,1253,1229,9081
2/3/2015,2015,2,3, 17 ,6345,1197,1214,8756
2/3/2015,2015,2,3, 18 ,6484,1295,1284,9063
2/3/2015,2015,2,3, 19 ,6657,1366,1258,9281
2/3/2015,2015,2,3, 20 ,6401,1283,1248,8932
2/3/2015,2015,2,3, 21 ,6087,1188,1212,8487
2/3/2015,2015,2,3, 22 ,5674,1066,1098,7838
2/3/2015,2015,2,3, 23 ,5257,959,989,7205
2/3/2015,2015,2,3, 24 ,4903,876,889,6668
2/4/2015,2015,2,4, 1 ,4628,842,865,6335
2/4/2015,2015,2,4, 2 ,4491,817,843,6151
2/4/2015,2015,2,4, 3 ,4481,808,815,6104
2/4/2015,2015,2,4, 4 ,4428,801,816,6045
2/4/2015,2015,2,4, 5 ,4695,850,881,6426
2/4/2015,2015,2,4, 6 ,5026,923,949,6898
2/4/2015,2015,2,4, 7 ,5058,886,875,6819
2/4/2015,2015,2,4, 8 ,5540,988,966,7494
2/4/2015,2015,2,4, 9 ,6210,1161,1126,8497
2/4/2015,2015,2,4, 10 ,6711,1237,1238,9186
2/4/2015,2015,2,4, 11 ,6893,1287,1286,9466
2/4/2015,2015,2,4, 12 ,6721,1245,1249,9215
2/4/2015,2015,2,4, 13 ,6708,1251,1271,9230
2/4/2015,2015,2,4, 14 ,7010,1331,1312,9653
2/4/2015,2015,2,4, 15 ,6897,1319,1276,9492
2/4/2015,2015,2,4, 16 ,6743,1283,1286,9312
2/4/2015,2015,2,4, 17 ,6484,1218,1222,8924
2/4/2015,2015,2,4, 18 ,6614,1312,1293,9219
2/4/2015,2015,2,4, 19 ,6717,1377,1323,9417
2/4/2015,2015,2,4, 20 ,6482,1312,1282,9076
2/4/2015,2015,2,4, 21 ,6234,1225,1242,8701
2/4/2015,2015,2,4, 22 ,5891,1099,1125,8115
2/4/2015,2015,2,4, 23 ,5467,989,1013,7469
2/4/2015,2015,2,4, 24 ,5071,909,937,6917
2/5/2015,2015,2,5, 1 ,4790,868,881,6539
2/5/2015,2015,2,5, 2 ,4704,835,863,6402
2/5/2015,2015,2,5, 3 ,4537,817,835,6189
2/5/2015,2015,2,5, 4 ,4597,809,835,6241
2/5/2015,2015,2,5, 5 ,4775,858,893,6526
2/5/2015,2015,2,5, 6 ,5031,928,951,6910
2/5/2015,2015,2,5, 7 ,5051,883,875,6809
2/5/2015,2015,2,5, 8 ,5543,979,984,7506
2/5/2015,2015,2,5, 9 ,6202,1155,1122,8479
2/5/2015,2015,2,5, 10 ,6673,1245,1220,9138
2/5/2015,2015,2,5, 11 ,6950,1299,1288,9537
2/5/2015,2015,2,5, 12 ,6767,1262,1253,9282
2/5/2015,2015,2,5, 13 ,6754,1276,1249,9279
2/5/2015,2015,2,5, 14 ,7030,1328,1287,9645
2/5/2015,2015,2,5, 15 ,6966,1330,1288,9584
2/5/2015,2015,2,5, 16 ,6877,1297,1285,9459
2/5/2015,2015,2,5, 17 ,6591,1224,1217,9032
2/5/2015,2015,2,5, 18 ,6661,1293,1275,9229
2/5/2015,2015,2,5, 19 ,6863,1384,1322,9569
2/5/2015,2015,2,5, 20 ,6555,1311,1287,9153
2/5/2015,2015,2,5, 21 ,6277,1210,1231,8718
2/5/2015,2015,2,5, 22 ,5876,1101,1118,8095
2/5/2015,2015,2,5, 23 ,5431,988,1009,7428
2/5/2015,2015,2,5, 24 ,5043,918,922,6883
2/6/2015,2015,2,6, 1 ,4755,872,871,6498
2/6/2015,2015,2,6, 2 ,4664,842,848,6354
2/6/2015,2015,2,6, 3 ,4509,826,833,6168
2/6/2015,2015,2,6, 4 ,4536,817,817,6170
2/6/2015,2015,2,6, 5 ,4767,869,871,6507
2/6/2015,2015,2,6, 6 ,5070,928,943,6941
2/6/2015,2015,2,6, 7 ,5114,891,884,6889
2/6/2015,2015,2,6, 8 ,5727,996,980,7703
2/6/2015,2015,2,6, 9 ,6301,1162,1132,8595
2/6/2015,2015,2,6, 10 ,6741,1262,1244,9247
2/6/2015,2015,2,6, 11 ,6977,1308,1273,9558
2/6/2015,2015,2,6, 12 ,6788,1265,1256,9309
2/6/2015,2015,2,6, 13 ,6824,1286,1266,9376
2/6/2015,2015,2,6, 14 ,7085,1342,1309,9736
2/6/2015,2015,2,6, 15 ,6964,1333,1292,9589
2/6/2015,2015,2,6, 16 ,6813,1310,1284,9407
2/6/2015,2015,2,6, 17 ,6569,1232,1223,9024
2/6/2015,2015,2,6, 18 ,6592,1293,1274,9159
2/6/2015,2015,2,6, 19 ,6806,1400,1314,9520
2/6/2015,2015,2,6, 20 ,6627,1332,1278,9237
2/6/2015,2015,2,6, 21 ,6273,1238,1248,8759
2/6/2015,2015,2,6, 22 ,5920,1137,1127,8184
2/6/2015,2015,2,6, 23 ,5455,1020,1026,7501
2/6/2015,2015,2,6, 24 ,5094,942,948,6984
2/7/2015,2015,2,7, 1 ,4884,900,893,6677
2/7/2015,2015,2,7, 2 ,4744,874,867,6485
2/7/2015,2015,2,7, 3 ,4571,853,850,6274
2/7/2015,2015,2,7, 4 ,4574,846,844,6264
2/7/2015,2015,2,7, 5 ,4620,866,856,6342
2/7/2015,2015,2,7, 6 ,4736,900,889,6525
2/7/2015,2015,2,7, 7 ,4873,899,865,6637
2/7/2015,2015,2,7, 8 ,5354,979,941,7274
2/7/2015,2015,2,7, 9 ,5832,1106,1046,7984
2/7/2015,2015,2,7, 10 ,6241,1184,1123,8548
2/7/2015,2015,2,7, 11 ,6569,1241,1209,9019
2/7/2015,2015,2,7, 12 ,6367,1208,1202,8777
2/7/2015,2015,2,7, 13 ,6345,1217,1232,8794
2/7/2015,2015,2,7, 14 ,6524,1249,1268,9041
2/7/2015,2015,2,7, 15 ,6417,1224,1251,8892
2/7/2015,2015,2,7, 16 ,6307,1201,1215,8723
2/7/2015,2015,2,7, 17 ,6065,1150,1156,8371
2/7/2015,2015,2,7, 18 ,6249,1232,1254,8735
2/7/2015,2015,2,7, 19 ,6735,1353,1325,9413
2/7/2015,2015,2,7, 20 ,6535,1292,1282,9109
2/7/2015,2015,2,7, 21 ,6258,1225,1228,8711
2/7/2015,2015,2,7, 22 ,5964,1129,1142,8235
2/7/2015,2015,2,7, 23 ,5556,1020,1030,7606
2/7/2015,2015,2,7, 24 ,5112,939,937,6988
2/8/2015,2015,2,8, 1 ,4927,920,886,6733
2/8/2015,2015,2,8, 2 ,4730,877,867,6474
2/8/2015,2015,2,8, 3 ,4582,861,833,6276
2/8/2015,2015,2,8, 4 ,4534,846,819,6199
2/8/2015,2015,2,8, 5 ,4519,850,836,6205
2/8/2015,2015,2,8, 6 ,4542,868,850,6260
2/8/2015,2015,2,8, 7 ,4564,871,811,6246
2/8/2015,2015,2,8, 8 ,4680,908,856,6444
2/8/2015,2015,2,8, 9 ,4991,980,920,6891
2/8/2015,2015,2,8, 10 ,5543,1057,1001,7601
2/8/2015,2015,2,8, 11 ,5785,1105,1032,7922
2/8/2015,2015,2,8, 12 ,5767,1119,1071,7957
2/8/2015,2015,2,8, 13 ,5750,1111,1065,7926
2/8/2015,2015,2,8, 14 ,5812,1116,1068,7996
2/8/2015,2015,2,8, 15 ,5672,1106,1056,7834
2/8/2015,2015,2,8, 16 ,5554,1078,1008,7640
2/8/2015,2015,2,8, 17 ,5514,1069,1014,7597
2/8/2015,2015,2,8, 18 ,5725,1179,1131,8035
2/8/2015,2015,2,8, 19 ,6330,1306,1263,8899
2/8/2015,2015,2,8, 20 ,6167,1257,1218,8642
2/8/2015,2015,2,8, 21 ,5933,1179,1165,8277
2/8/2015,2015,2,8, 22 ,5599,1086,1059,7744
2/8/2015,2015,2,8, 23 ,5190,999,976,7165
2/8/2015,2015,2,8, 24 ,4846,889,898,6633
2/9/2015,2015,2,9, 1 ,4561,820,886,6267
2/9/2015,2015,2,9, 2 ,4421,838,854,6113
2/9/2015,2015,2,9, 3 ,4282,822,830,5934
2/9/2015,2015,2,9, 4 ,4303,833,824,5960
2/9/2015,2015,2,9, 5 ,4582,873,874,6329
2/9/2015,2015,2,9, 6 ,4863,947,934,6744
2/9/2015,2015,2,9, 7 ,4989,920,859,6768
2/9/2015,2015,2,9, 8 ,5565,1009,953,7527
2/9/2015,2015,2,9, 9 ,6321,1198,1144,8663
2/9/2015,2015,2,9, 10 ,6753,1278,1231,9262
2/9/2015,2015,2,9, 11 ,7076,1330,1327,9733
2/9/2015,2015,2,9, 12 ,6927,1288,1302,9517
2/9/2015,2015,2,9, 13 ,6893,1292,1291,9476
2/9/2015,2015,2,9, 14 ,7168,1353,1370,9891
2/9/2015,2015,2,9, 15 ,7145,1327,1320,9792
2/9/2015,2015,2,9, 16 ,7054,1287,1318,9659
2/9/2015,2015,2,9, 17 ,6757,1248,1260,9265
2/9/2015,2015,2,9, 18 ,6752,1350,1339,9441
2/9/2015,2015,2,9, 19 ,6978,1411,1351,9740
2/9/2015,2015,2,9, 20 ,6697,1356,1314,9367
2/9/2015,2015,2,9, 21 ,6423,1274,1269,8966
2/9/2015,2015,2,9, 22 ,6009,1180,1172,8361
2/9/2015,2015,2,9, 23 ,5637,1075,1048,7760
2/9/2015,2015,2,9, 24 ,5206,989,966,7161
2/10/2015,2015,2,10, 1 ,4978,938,921,6837
2/10/2015,2015,2,10, 2 ,4775,908,887,6570
2/10/2015,2015,2,10, 3 ,4663,874,863,6400
2/10/2015,2015,2,10, 4 ,4638,873,850,6361
2/10/2015,2015,2,10, 5 ,4841,922,883,6646
2/10/2015,2015,2,10, 6 ,5105,977,956,7038
2/10/2015,2015,2,10, 7 ,5156,935,887,6978
2/10/2015,2015,2,10, 8 ,5739,1061,983,7783
2/10/2015,2015,2,10, 9 ,6366,1231,1147,8744
2/10/2015,2015,2,10, 10 ,6854,1236,1241,9331
2/10/2015,2015,2,10, 11 ,7134,1323,1307,9764
2/10/2015,2015,2,10, 12 ,6973,1284,1278,9535
2/10/2015,2015,2,10, 13 ,7005,1301,1311,9617
2/10/2015,2015,2,10, 14 ,7232,1355,1347,9934
2/10/2015,2015,2,10, 15 ,7178,1349,1341,9868
2/10/2015,2015,2,10, 16 ,7031,1324,1329,9684
2/10/2015,2015,2,10, 17 ,6705,1264,1275,9244
2/10/2015,2015,2,10, 18 ,6662,1328,1309,9299
2/10/2015,2015,2,10, 19 ,7011,1446,1351,9808
2/10/2015,2015,2,10, 20 ,6692,1376,1324,9392
2/10/2015,2015,2,10, 21 ,6415,1290,1298,9003
2/10/2015,2015,2,10, 22 ,5946,1175,1180,8301
2/10/2015,2015,2,10, 23 ,5582,1061,1080,7723
2/10/2015,2015,2,10, 24 ,5122,981,1015,7118
2/11/2015,2015,2,11, 1 ,4628,925,955,6508
2/11/2015,2015,2,11, 2 ,4491,903,921,6315
2/11/2015,2015,2,11, 3 ,4481,883,895,6259
2/11/2015,2015,2,11, 4 ,4428,883,888,6199
2/11/2015,2015,2,11, 5 ,4695,912,933,6540
2/11/2015,2015,2,11, 6 ,5026,954,998,6978
2/11/2015,2015,2,11, 7 ,5257,916,922,7095
2/11/2015,2015,2,11, 8 ,5783,1041,1011,7835
2/11/2015,2015,2,11, 9 ,6413,1206,1160,8779
2/11/2015,2015,2,11, 10 ,6849,1295,1287,9431
2/11/2015,2015,2,11, 11 ,7073,1341,1326,9740
2/11/2015,2015,2,11, 12 ,6885,1304,1294,9483
2/11/2015,2015,2,11, 13 ,6828,1316,1299,9443
2/11/2015,2015,2,11, 14 ,7093,1367,1318,9778
2/11/2015,2015,2,11, 15 ,7040,1342,1352,9734
2/11/2015,2015,2,11, 16 ,6925,1335,1334,9594
2/11/2015,2015,2,11, 17 ,6670,1274,1271,9215
2/11/2015,2015,2,11, 18 ,6685,1363,1318,9366
2/11/2015,2015,2,11, 19 ,6973,1453,1359,9785
2/11/2015,2015,2,11, 20 ,6733,1393,1303,9429
2/11/2015,2015,2,11, 21 ,6477,1303,1315,9095
2/11/2015,2015,2,11, 22 ,5992,1181,1196,8369
2/11/2015,2015,2,11, 23 ,5581,1089,1097,7767
2/11/2015,2015,2,11, 24 ,5242,1007,1006,7255
2/12/2015,2015,2,12, 1 ,4997,970,973,6940
2/12/2015,2015,2,12, 2 ,4837,940,960,6737
2/12/2015,2015,2,12, 3 ,4745,916,927,6588
2/12/2015,2015,2,12, 4 ,4687,913,920,6520
2/12/2015,2015,2,12, 5 ,4971,956,960,6887
2/12/2015,2015,2,12, 6 ,5221,1006,1010,7237
2/12/2015,2015,2,12, 7 ,5218,970,928,7116
2/12/2015,2015,2,12, 8 ,5779,1071,1012,7862
2/12/2015,2015,2,12, 9 ,6431,1234,1170,8835
2/12/2015,2015,2,12, 10 ,6884,1320,1239,9443
2/12/2015,2015,2,12, 11 ,7134,1371,1301,9806
2/12/2015,2015,2,12, 12 ,6949,1319,1305,9573
2/12/2015,2015,2,12, 13 ,6929,1319,1362,9610
2/12/2015,2015,2,12, 14 ,7239,1388,1363,9990
2/12/2015,2015,2,12, 15 ,7174,1358,1347,9879
2/12/2015,2015,2,12, 16 ,7034,1343,1327,9704
2/12/2015,2015,2,12, 17 ,6760,1283,1271,9314
2/12/2015,2015,2,12, 18 ,6767,1334,1270,9371
2/12/2015,2015,2,12, 19 ,7096,1432,1372,9900
2/12/2015,2015,2,12, 20 ,6838,1380,1353,9571
2/12/2015,2015,2,12, 21 ,6592,1306,1287,9185
2/12/2015,2015,2,12, 22 ,6192,1192,1178,8562
2/12/2015,2015,2,12, 23 ,5780,1087,1061,7928
2/12/2015,2015,2,12, 24 ,5353,999,956,7308
2/13/2015,2015,2,13, 1 ,5103,952,913,6968
2/13/2015,2015,2,13, 2 ,4964,917,889,6770
2/13/2015,2015,2,13, 3 ,4804,886,866,6556
2/13/2015,2015,2,13, 4 ,4861,883,867,6611
2/13/2015,2015,2,13, 5 ,5074,939,908,6921
2/13/2015,2015,2,13, 6 ,5332,973,984,7289
2/13/2015,2015,2,13, 7 ,5439,935,924,7298
2/13/2015,2015,2,13, 8 ,5865,1049,1024,7938
2/13/2015,2015,2,13, 9 ,6501,1222,1180,8903
2/13/2015,2015,2,13, 10 ,6923,1322,1279,9524
2/13/2015,2015,2,13, 11 ,7152,1380,1305,9837
2/13/2015,2015,2,13, 12 ,6893,1343,1309,9545
2/13/2015,2015,2,13, 13 ,6831,1348,1316,9495
2/13/2015,2015,2,13, 14 ,7056,1392,1380,9828
2/13/2015,2015,2,13, 15 ,7004,1378,1326,9708
2/13/2015,2015,2,13, 16 ,6869,1351,1306,9526
2/13/2015,2015,2,13, 17 ,6644,1290,1263,9197
2/13/2015,2015,2,13, 18 ,6702,1380,1323,9405
2/13/2015,2015,2,13, 19 ,6918,1454,1358,9730
2/13/2015,2015,2,13, 20 ,6688,1395,1315,9398
2/13/2015,2015,2,13, 21 ,6438,1309,1292,9039
2/13/2015,2015,2,13, 22 ,6121,1205,1201,8527
2/13/2015,2015,2,13, 23 ,5746,1098,1094,7938
2/13/2015,2015,2,13, 24 ,5325,1021,982,7328
2/14/2015,2015,2,14, 1 ,5060,972,928,6960
2/14/2015,2015,2,14, 2 ,4939,947,909,6795
2/14/2015,2015,2,14, 3 ,4846,913,881,6640
2/14/2015,2015,2,14, 4 ,4767,902,854,6523
2/14/2015,2015,2,14, 5 ,4798,920,868,6586
2/14/2015,2015,2,14, 6 ,4948,934,869,6751
2/14/2015,2015,2,14, 7 ,5045,928,868,6841
2/14/2015,2015,2,14, 8 ,5483,1003,965,7451
2/14/2015,2015,2,14, 9 ,5957,1129,1108,8194
2/14/2015,2015,2,14, 10 ,6447,1225,1190,8862
2/14/2015,2015,2,14, 11 ,6722,1274,1247,9243
2/14/2015,2015,2,14, 12 ,6544,1229,1213,8986
2/14/2015,2015,2,14, 13 ,6441,1219,1219,8879
2/14/2015,2015,2,14, 14 ,6576,1270,1248,9094
2/14/2015,2015,2,14, 15 ,6438,1241,1197,8876
2/14/2015,2015,2,14, 16 ,6267,1222,1149,8638
2/14/2015,2015,2,14, 17 ,6096,1180,1130,8406
2/14/2015,2015,2,14, 18 ,6276,1276,1226,8778
2/14/2015,2015,2,14, 19 ,6547,1372,1244,9163
2/14/2015,2015,2,14, 20 ,6374,1302,1256,8932
2/14/2015,2015,2,14, 21 ,6183,1244,1203,8630
2/14/2015,2015,2,14, 22 ,5906,1153,1107,8166
2/14/2015,2015,2,14, 23 ,5494,1058,1020,7572
2/14/2015,2015,2,14, 24 ,5210,986,937,7133
2/15/2015,2015,2,15, 1 ,4886,934,892,6712
2/15/2015,2015,2,15, 2 ,4797,898,855,6550
2/15/2015,2015,2,15, 3 ,4660,874,831,6365
2/15/2015,2015,2,15, 4 ,4645,860,819,6324
2/15/2015,2015,2,15, 5 ,4561,856,829,6246
2/15/2015,2015,2,15, 6 ,4619,864,850,6333
2/15/2015,2015,2,15, 7 ,4651,869,838,6358
2/15/2015,2015,2,15, 8 ,4863,905,885,6653
2/15/2015,2015,2,15, 9 ,5242,975,940,7157
2/15/2015,2015,2,15, 10 ,5557,1035,1011,7603
2/15/2015,2015,2,15, 11 ,5811,1100,1041,7952
2/15/2015,2015,2,15, 12 ,5769,1117,1054,7940
2/15/2015,2015,2,15, 13 ,5716,1126,1054,7896
2/15/2015,2015,2,15, 14 ,5772,1142,1089,8003
2/15/2015,2015,2,15, 15 ,5766,1131,1064,7961
2/15/2015,2015,2,15, 16 ,5607,1090,1044,7741
2/15/2015,2015,2,15, 17 ,5634,1097,1049,7780
2/15/2015,2015,2,15, 18 ,5889,1225,1156,8270
2/15/2015,2015,2,15, 19 ,6382,1381,1265,9028
2/15/2015,2015,2,15, 20 ,6254,1335,1238,8827
2/15/2015,2015,2,15, 21 ,6073,1252,1173,8498
2/15/2015,2015,2,15, 22 ,5718,1159,1075,7952
2/15/2015,2015,2,15, 23 ,5349,1068,973,7390
2/15/2015,2015,2,15, 24 ,5057,988,898,6943
2/16/2015,2015,2,16, 1 ,4799,933,848,6580
2/16/2015,2015,2,16, 2 ,4582,905,814,6301
2/16/2015,2015,2,16, 3 ,4523,882,796,6201
2/16/2015,2015,2,16, 4 ,4453,873,796,6122
2/16/2015,2015,2,16, 5 ,4746,924,841,6511
2/16/2015,2015,2,16, 6 ,5054,972,929,6955
2/16/2015,2015,2,16, 7 ,5145,932,857,6934
2/16/2015,2015,2,16, 8 ,5758,1040,945,7743
2/16/2015,2015,2,16, 9 ,6600,1232,1107,8939
2/16/2015,2015,2,16, 10 ,7078,1329,1213,9620
2/16/2015,2015,2,16, 11 ,7365,1375,1304,10044
2/16/2015,2015,2,16, 12 ,7228,1341,1261,9830
2/16/2015,2015,2,16, 13 ,7186,1340,1212,9738
2/16/2015,2015,2,16, 14 ,7465,1390,1274,10129
2/16/2015,2015,2,16, 15 ,7379,1375,1302,10056
2/16/2015,2015,2,16, 16 ,7231,1335,1287,9853
2/16/2015,2015,2,16, 17 ,6886,1268,1233,9387
2/16/2015,2015,2,16, 18 ,6803,1337,1308,9448
2/16/2015,2015,2,16, 19 ,7165,1437,1318,9920
2/16/2015,2015,2,16, 20 ,6969,1378,1286,9633
2/16/2015,2015,2,16, 21 ,6697,1299,1236,9232
2/16/2015,2015,2,16, 22 ,6287,1195,1108,8590
2/16/2015,2015,2,16, 23 ,5819,1085,1010,7914
2/16/2015,2015,2,16, 24 ,5443,996,953,7392
2/17/2015,2015,2,17, 1 ,5172,965,870,7007
2/17/2015,2015,2,17, 2 ,4972,930,840,6742
2/17/2015,2015,2,17, 3 ,4855,914,814,6583
2/17/2015,2015,2,17, 4 ,4835,908,811,6554
2/17/2015,2015,2,17, 5 ,4995,932,861,6788
2/17/2015,2015,2,17, 6 ,5274,992,940,7206
2/17/2015,2015,2,17, 7 ,5259,949,905,7113
2/17/2015,2015,2,17, 8 ,5826,1065,953,7844
2/17/2015,2015,2,17, 9 ,6550,1235,1109,8894
2/17/2015,2015,2,17, 10 ,7036,1331,1203,9570
2/17/2015,2015,2,17, 11 ,7367,1391,1258,10016
2/17/2015,2015,2,17, 12 ,7210,1346,1238,9794
2/17/2015,2015,2,17, 13 ,7210,1355,1249,9814
2/17/2015,2015,2,17, 14 ,7508,1423,1324,10255
2/17/2015,2015,2,17, 15 ,7454,1402,1257,10113
2/17/2015,2015,2,17, 16 ,7308,1356,1260,9924
2/17/2015,2015,2,17, 17 ,6990,1280,1237,9507
2/17/2015,2015,2,17, 18 ,6905,1354,1277,9536
2/17/2015,2015,2,17, 19 ,7247,1459,1328,10034
2/17/2015,2015,2,17, 20 ,7043,1381,1290,9714
2/17/2015,2015,2,17, 21 ,6770,1326,1215,9311
2/17/2015,2015,2,17, 22 ,6394,1207,1104,8705
2/17/2015,2015,2,17, 23 ,5933,1100,1010,8043
2/17/2015,2015,2,17, 24 ,5570,1018,905,7493
2/18/2015,2015,2,18, 1 ,5311,979,884,7174
2/18/2015,2015,2,18, 2 ,5099,942,857,6898
2/18/2015,2015,2,18, 3 ,4963,915,837,6715
2/18/2015,2015,2,18, 4 ,4896,903,824,6623
2/18/2015,2015,2,18, 5 ,5128,953,882,6963
2/18/2015,2015,2,18, 6 ,5398,1002,950,7350
2/18/2015,2015,2,18, 7 ,5489,952,873,7314
2/18/2015,2015,2,18, 8 ,5909,1079,964,7952
2/18/2015,2015,2,18, 9 ,6584,1244,1107,8935
2/18/2015,2015,2,18, 10 ,7090,1329,1202,9621
2/18/2015,2015,2,18, 11 ,7254,1382,1263,9899
2/18/2015,2015,2,18, 12 ,7093,1334,1240,9667
2/18/2015,2015,2,18, 13 ,7141,1332,1266,9739
2/18/2015,2015,2,18, 14 ,7275,1375,1314,9964
2/18/2015,2015,2,18, 15 ,7197,1349,1313,9859
2/18/2015,2015,2,18, 16 ,7126,1324,1279,9729
2/18/2015,2015,2,18, 17 ,6827,1249,1226,9302
2/18/2015,2015,2,18, 18 ,6762,1274,1256,9292
2/18/2015,2015,2,18, 19 ,7003,1402,1323,9728
2/18/2015,2015,2,18, 20 ,6793,1351,1284,9428
2/18/2015,2015,2,18, 21 ,6507,1264,1242,9013
2/18/2015,2015,2,18, 22 ,6173,1153,1127,8453
2/18/2015,2015,2,18, 23 ,5730,1069,1047,7846
2/18/2015,2015,2,18, 24 ,5368,978,927,7273
2/19/2015,2015,2,19, 1 ,5099,919,918,6936
2/19/2015,2015,2,19, 2 ,4935,463,889,6287
2/19/2015,2015,2,19, 3 ,4858,462,865,6185
2/19/2015,2015,2,19, 4 ,4791,533,856,6180
2/19/2015,2015,2,19, 5 ,4770,638,884,6292
2/19/2015,2015,2,19, 6 ,4900,701,912,6513
2/19/2015,2015,2,19, 7 ,4890,763,892,6545
2/19/2015,2015,2,19, 8 ,5265,869,960,7094
2/19/2015,2015,2,19, 9 ,5676,1035,1069,7780
2/19/2015,2015,2,19, 10 ,6171,1160,1153,8484
2/19/2015,2015,2,19, 11 ,6493,1233,1221,8947
2/19/2015,2015,2,19, 12 ,6355,1185,1172,8712
2/19/2015,2015,2,19, 13 ,6268,1188,1191,8647
2/19/2015,2015,2,19, 14 ,6379,1246,1219,8844
2/19/2015,2015,2,19, 15 ,6297,1231,1216,8744
2/19/2015,2015,2,19, 16 ,6114,1199,1184,8497
2/19/2015,2015,2,19, 17 ,6042,1160,1171,8373
2/19/2015,2015,2,19, 18 ,6230,1237,1246,8713
2/19/2015,2015,2,19, 19 ,6620,1383,1293,9296
2/19/2015,2015,2,19, 20 ,6454,1307,1254,9015
2/19/2015,2015,2,19, 21 ,6236,1254,1218,8708
2/19/2015,2015,2,19, 22 ,5918,1151,1101,8170
2/19/2015,2015,2,19, 23 ,5492,1059,1011,7562
2/19/2015,2015,2,19, 24 ,5148,959,973,7080
2/20/2015,2015,2,20, 1 ,4829,944,896,6669
2/20/2015,2015,2,20, 2 ,4717,916,878,6511
2/20/2015,2015,2,20, 3 ,4615,896,855,6366
2/20/2015,2015,2,20, 4 ,4599,888,839,6326
2/20/2015,2015,2,20, 5 ,4791,924,883,6598
2/20/2015,2015,2,20, 6 ,5049,905,953,6907
2/20/2015,2015,2,20, 7 ,5170,923,894,6987
2/20/2015,2015,2,20, 8 ,5693,1035,991,7719
2/20/2015,2015,2,20, 9 ,6408,1207,1139,8754
2/20/2015,2015,2,20, 10 ,6795,1285,1232,9312
2/20/2015,2015,2,20, 11 ,6992,1319,1292,9603
2/20/2015,2015,2,20, 12 ,6855,1258,1256,9369
2/20/2015,2015,2,20, 13 ,6853,1259,1262,9374
2/20/2015,2015,2,20, 14 ,7086,1320,1287,9693
2/20/2015,2015,2,20, 15 ,6949,1174,1250,9373
2/20/2015,2015,2,20, 16 ,6837,1205,1253,9295
2/20/2015,2015,2,20, 17 ,6531,1196,1211,8938
2/20/2015,2015,2,20, 18 ,6528,1299,1283,9110
2/20/2015,2015,2,20, 19 ,6818,1355,1282,9455
2/20/2015,2015,2,20, 20 ,6526,1293,1273,9092
2/20/2015,2015,2,20, 21 ,6334,1196,1234,8764
2/20/2015,2015,2,20, 22 ,6014,1106,1142,8262
2/20/2015,2015,2,20, 23 ,5570,1017,1021,7608
2/20/2015,2015,2,20, 24 ,5205,949,801,6955
2/21/2015,2015,2,21, 1 ,4952,910,905,6767
2/21/2015,2015,2,21, 2 ,4830,883,869,6582
2/21/2015,2015,2,21, 3 ,4672,861,858,6391
2/21/2015,2015,2,21, 4 ,4667,845,844,6356
2/21/2015,2015,2,21, 5 ,4681,861,858,6400
2/21/2015,2015,2,21, 6 ,4805,896,891,6592
2/21/2015,2015,2,21, 7 ,4820,898,868,6586
2/21/2015,2015,2,21, 8 ,5256,977,928,7161
2/21/2015,2015,2,21, 9 ,5806,1084,1030,7920
2/21/2015,2015,2,21, 10 ,6234,1153,1111,8498
2/21/2015,2015,2,21, 11 ,6499,1209,1159,8867
2/21/2015,2015,2,21, 12 ,6304,1170,1132,8606
2/21/2015,2015,2,21, 13 ,6291,1183,1189,8663
2/21/2015,2015,2,21, 14 ,6426,1219,1206,8851
2/21/2015,2015,2,21, 15 ,6315,1182,1200,8697
2/21/2015,2015,2,21, 16 ,6174,1177,1176,8527
2/21/2015,2015,2,21, 17 ,5968,1134,1128,8230
2/21/2015,2015,2,21, 18 ,6084,1219,1220,8523
2/21/2015,2015,2,21, 19 ,6500,1339,1250,9089
2/21/2015,2015,2,21, 20 ,6320,1291,1237,8848
2/21/2015,2015,2,21, 21 ,6147,1230,1179,8556
2/21/2015,2015,2,21, 22 ,5825,1137,1094,8056
2/21/2015,2015,2,21, 23 ,5377,1041,992,7410
2/21/2015,2015,2,21, 24 ,5111,978,914,7003
2/22/2015,2015,2,22, 1 ,4799,927,891,6617
2/22/2015,2015,2,22, 2 ,4608,892,847,6347
2/22/2015,2015,2,22, 3 ,4442,867,833,6142
2/22/2015,2015,2,22, 4 ,4372,839,823,6034
2/22/2015,2015,2,22, 5 ,4354,845,847,6046
2/22/2015,2015,2,22, 6 ,4406,854,827,6087
2/22/2015,2015,2,22, 7 ,4431,858,776,6065
2/22/2015,2015,2,22, 8 ,4737,905,813,6455
2/22/2015,2015,2,22, 9 ,4978,969,885,6832
2/22/2015,2015,2,22, 10 ,5408,1038,962,7408
2/22/2015,2015,2,22, 11 ,5688,1081,1010,7779
2/22/2015,2015,2,22, 12 ,5676,1080,992,7748
2/22/2015,2015,2,22, 13 ,5648,1077,1019,7744
2/22/2015,2015,2,22, 14 ,5639,1064,1034,7737
2/22/2015,2015,2,22, 15 ,5631,1053,1020,7704
2/22/2015,2015,2,22, 16 ,5418,1023,978,7419
2/22/2015,2015,2,22, 17 ,5379,1019,967,7365
2/22/2015,2015,2,22, 18 ,5621,1125,1130,7876
2/22/2015,2015,2,22, 19 ,6162,1284,1211,8657
2/22/2015,2015,2,22, 20 ,6079,1226,1179,8484
2/22/2015,2015,2,22, 21 ,5824,1159,1147,8130
2/22/2015,2015,2,22, 22 ,5498,1060,1055,7613
2/22/2015,2015,2,22, 23 ,5022,954,949,6925
2/22/2015,2015,2,22, 24 ,4661,883,876,6420
2/23/2015,2015,2,23, 1 ,4402,840,858,6100
2/23/2015,2015,2,23, 2 ,4307,812,814,5933
2/23/2015,2015,2,23, 3 ,4182,797,783,5762
2/23/2015,2015,2,23, 4 ,4182,789,782,5753
2/23/2015,2015,2,23, 5 ,4427,831,823,6081
2/23/2015,2015,2,23, 6 ,4770,908,922,6600
2/23/2015,2015,2,23, 7 ,4842,873,860,6575
2/23/2015,2015,2,23, 8 ,5513,968,932,7413
2/23/2015,2015,2,23, 9 ,6254,1133,1121,8508
2/23/2015,2015,2,23, 10 ,6726,1259,1181,9166
2/23/2015,2015,2,23, 11 ,7045,1310,1228,9583
2/23/2015,2015,2,23, 12 ,6929,1280,1213,9422
2/23/2015,2015,2,23, 13 ,6930,1271,1217,9418
2/23/2015,2015,2,23, 14 ,7240,1304,1258,9802
2/23/2015,2015,2,23, 15 ,7205,1299,1220,9724
2/23/2015,2015,2,23, 16 ,7091,1284,1215,9590
2/23/2015,2015,2,23, 17 ,6708,1225,1193,9126
2/23/2015,2015,2,23, 18 ,6625,1301,1254,9180
2/23/2015,2015,2,23, 19 ,7049,1369,1273,9691
2/23/2015,2015,2,23, 20 ,6770,1325,1259,9354
2/23/2015,2015,2,23, 21 ,6398,1231,1207,8836
2/23/2015,2015,2,23, 22 ,6044,1120,1097,8261
2/23/2015,2015,2,23, 23 ,5651,1017,1030,7698
2/23/2015,2015,2,23, 24 ,5207,930,951,7088
2/24/2015,2015,2,24, 1 ,4960,903,926,6789
2/24/2015,2015,2,24, 2 ,4797,876,895,6568
2/24/2015,2015,2,24, 3 ,4666,854,879,6399
2/24/2015,2015,2,24, 4 ,4628,849,868,6345
2/24/2015,2015,2,24, 5 ,4849,895,920,6664
2/24/2015,2015,2,24, 6 ,5125,957,979,7061
2/24/2015,2015,2,24, 7 ,5108,917,914,6939
2/24/2015,2015,2,24, 8 ,5687,1008,990,7685
2/24/2015,2015,2,24, 9 ,6457,1187,1140,8784
2/24/2015,2015,2,24, 10 ,6910,1275,1233,9418
2/24/2015,2015,2,24, 11 ,7176,1325,1264,9765
2/24/2015,2015,2,24, 12 ,7009,1298,1231,9538
2/24/2015,2015,2,24, 13 ,7022,1305,1250,9577
2/24/2015,2015,2,24, 14 ,7351,1379,1278,10008
2/24/2015,2015,2,24, 15 ,7279,1353,1266,9898
2/24/2015,2015,2,24, 16 ,7149,1329,1228,9706
2/24/2015,2015,2,24, 17 ,6805,1263,1208,9276
2/24/2015,2015,2,24, 18 ,6748,1313,1283,9344
2/24/2015,2015,2,24, 19 ,7087,1434,1286,9807
2/24/2015,2015,2,24, 20 ,6861,1361,1256,9478
2/24/2015,2015,2,24, 21 ,6634,1297,1232,9163
2/24/2015,2015,2,24, 22 ,6314,1190,1123,8627
2/24/2015,2015,2,24, 23 ,5885,1080,1045,8010
2/24/2015,2015,2,24, 24 ,5454,1001,980,7435
2/25/2015,2015,2,25, 1 ,5208,946,937,7091
2/25/2015,2015,2,25, 2 ,5012,912,891,6815
2/25/2015,2015,2,25, 3 ,4917,885,869,6671
2/25/2015,2015,2,25, 4 ,4795,879,882,6556
2/25/2015,2015,2,25, 5 ,4928,897,903,6728
2/25/2015,2015,2,25, 6 ,5089,918,936,6943
2/25/2015,2015,2,25, 7 ,5296,922,937,7155
2/25/2015,2015,2,25, 8 ,5920,1076,1007,8003
2/25/2015,2015,2,25, 9 ,6582,1248,1128,8958
2/25/2015,2015,2,25, 10 ,7024,1313,1200,9537
2/25/2015,2015,2,25, 11 ,7325,1375,1247,9947
2/25/2015,2015,2,25, 12 ,7130,1324,1223,9677
2/25/2015,2015,2,25, 13 ,7114,1346,1218,9678
2/25/2015,2015,2,25, 14 ,7462,1416,1263,10141
2/25/2015,2015,2,25, 15 ,7397,1370,1238,10005
2/25/2015,2015,2,25, 16 ,7299,1344,1228,9871
2/25/2015,2015,2,25, 17 ,7003,1261,1175,9439
2/25/2015,2015,2,25, 18 ,6897,1300,1248,9445
2/25/2015,2015,2,25, 19 ,7240,1433,1273,9946
2/25/2015,2015,2,25, 20 ,7025,1366,1244,9635
2/25/2015,2015,2,25, 21 ,6733,1296,1206,9235
2/25/2015,2015,2,25, 22 ,6362,1181,1126,8669
2/25/2015,2015,2,25, 23 ,5990,1065,1035,8090
2/25/2015,2015,2,25, 24 ,5510,975,969,7454
2/26/2015,2015,2,26, 1 ,5257,960,919,7136
2/26/2015,2015,2,26, 2 ,5055,931,888,6874
2/26/2015,2015,2,26, 3 ,4956,904,905,6765
2/26/2015,2015,2,26, 4 ,4998,904,886,6788
2/26/2015,2015,2,26, 5 ,5175,941,917,7033
2/26/2015,2015,2,26, 6 ,5355,991,981,7327
2/26/2015,2015,2,26, 7 ,5393,948,925,7266
2/26/2015,2015,2,26, 8 ,6029,1071,1004,8104
2/26/2015,2015,2,26, 9 ,6678,1256,1147,9081
2/26/2015,2015,2,26, 10 ,7208,1353,1228,9789
2/26/2015,2015,2,26, 11 ,7493,1403,1247,10143
2/26/2015,2015,2,26, 12 ,7331,1304,1204,9839
2/26/2015,2015,2,26, 13 ,7370,1344,1254,9968
2/26/2015,2015,2,26, 14 ,7656,1404,1294,10354
2/26/2015,2015,2,26, 15 ,7555,1397,1237,10189
2/26/2015,2015,2,26, 16 ,7485,1371,1271,10127
2/26/2015,2015,2,26, 17 ,7112,1300,1209,9621
2/26/2015,2015,2,26, 18 ,7018,1333,1284,9635
2/26/2015,2015,2,26, 19 ,7370,1449,1302,10121
2/26/2015,2015,2,26, 20 ,7157,1382,1275,9814
2/26/2015,2015,2,26, 21 ,6866,1321,1259,9446
2/26/2015,2015,2,26, 22 ,6507,1200,1152,8859
2/26/2015,2015,2,26, 23 ,6178,1095,1065,8338
2/26/2015,2015,2,26, 24 ,5715,1017,983,7715
2/27/2015,2015,2,27, 1 ,5432,975,938,7345
2/27/2015,2015,2,27, 2 ,5198,942,906,7046
2/27/2015,2015,2,27, 3 ,5102,918,877,6897
2/27/2015,2015,2,27, 4 ,5037,905,869,6811
2/27/2015,2015,2,27, 5 ,5182,937,909,7028
2/27/2015,2015,2,27, 6 ,5359,978,963,7300
2/27/2015,2015,2,27, 7 ,5312,931,860,7103
2/27/2015,2015,2,27, 8 ,6059,1072,959,8090
2/27/2015,2015,2,27, 9 ,6786,1261,1146,9193
2/27/2015,2015,2,27, 10 ,7281,1359,1205,9845
2/27/2015,2015,2,27, 11 ,7553,1394,1270,10217
2/27/2015,2015,2,27, 12 ,7382,1368,1242,9992
2/27/2015,2015,2,27, 13 ,7374,1361,1278,10013
2/27/2015,2015,2,27, 14 ,7545,1430,1277,10252
2/27/2015,2015,2,27, 15 ,7491,1402,1271,10164
2/27/2015,2015,2,27, 16 ,7357,1374,1239,9970
2/27/2015,2015,2,27, 17 ,6910,1290,1198,9398
2/27/2015,2015,2,27, 18 ,6731,1317,1264,9312
2/27/2015,2015,2,27, 19 ,7088,1435,1303,9826
2/27/2015,2015,2,27, 20 ,6938,1377,1272,9587
2/27/2015,2015,2,27, 21 ,6750,1306,1212,9268
2/27/2015,2015,2,27, 22 ,6405,1200,1141,8746
2/27/2015,2015,2,27, 23 ,5990,1093,1051,8134
2/27/2015,2015,2,27, 24 ,5576,1014,980,7570
2/28/2015,2015,2,28, 1 ,5364,976,950,7290
2/28/2015,2015,2,28, 2 ,5191,941,936,7068
2/28/2015,2015,2,28, 3 ,5090,913,908,6911
2/28/2015,2015,2,28, 4 ,4965,898,901,6764
2/28/2015,2015,2,28, 5 ,4994,921,891,6806
2/28/2015,2015,2,28, 6 ,5076,932,915,6923
2/28/2015,2015,2,28, 7 ,5112,925,887,6924
2/28/2015,2015,2,28, 8 ,5610,1012,953,7575
2/28/2015,2015,2,28, 9 ,6178,1151,1076,8405
2/28/2015,2015,2,28, 10 ,6670,1223,1110,9003
2/28/2015,2015,2,28, 11 ,6954,1278,1158,9390
2/28/2015,2015,2,28, 12 ,6763,1200,1170,9133
2/28/2015,2015,2,28, 13 ,6740,1214,1163,9117
2/28/2015,2015,2,28, 14 ,6948,1245,1210,9403
2/28/2015,2015,2,28, 15 ,6839,1222,1133,9194
2/28/2015,2015,2,28, 16 ,6654,1199,1111,8964
2/28/2015,2015,2,28, 17 ,6305,1148,1078,8531
2/28/2015,2015,2,28, 18 ,6318,1214,1188,8720
2/28/2015,2015,2,28, 19 ,6857,1356,1214,9427
2/28/2015,2015,2,28, 20 ,6728,1315,1159,9202
2/28/2015,2015,2,28, 21 ,6581,1264,1162,9007
2/28/2015,2015,2,28, 22 ,6299,1179,1060,8538
2/28/2015,2015,2,28, 23 ,5942,1070,980,7992
2/28/2015,2015,2,28, 24 ,5464,992,981,7437
3/1/2015,2015,3,1, 1 ,5289,950,941,7180
3/1/2015,2015,3,1, 2 ,5116,916,914,6946
3/1/2015,2015,3,1, 3 ,4951,891,884,6726
3/1/2015,2015,3,1, 4 ,4843,853,866,6562
3/1/2015,2015,3,1, 5 ,4753,866,867,6486
3/1/2015,2015,3,1, 6 ,4770,846,842,6458
3/1/2015,2015,3,1, 7 ,4705,850,803,6358
3/1/2015,2015,3,1, 8 ,4892,896,834,6622
3/1/2015,2015,3,1, 9 ,5386,963,903,7252
3/1/2015,2015,3,1, 10 ,5723,1035,1004,7762
3/1/2015,2015,3,1, 11 ,5938,1094,1047,8079
3/1/2015,2015,3,1, 12 ,5928,1085,1060,8073
3/1/2015,2015,3,1, 13 ,5935,1103,1028,8066
3/1/2015,2015,3,1, 14 ,6049,1103,1072,8224
3/1/2015,2015,3,1, 15 ,5957,1088,1059,8104
3/1/2015,2015,3,1, 16 ,5808,1053,1028,7889
3/1/2015,2015,3,1, 17 ,5641,1047,1032,7720
3/1/2015,2015,3,1, 18 ,5807,1128,1153,8088
3/1/2015,2015,3,1, 19 ,6412,1297,1259,8968
3/1/2015,2015,3,1, 20 ,6412,1273,1225,8910
3/1/2015,2015,3,1, 21 ,6248,1212,1175,8635
3/1/2015,2015,3,1, 22 ,5889,1134,1121,8144
3/1/2015,2015,3,1, 23 ,5559,1036,1032,7627
3/1/2015,2015,3,1, 24 ,5226,955,935,7116
3/2/2015,2015,3,2, 1 ,4928,905,895,6728
3/2/2015,2015,3,2, 2 ,4747,869,860,6476
3/2/2015,2015,3,2, 3 ,4574,842,837,6253
3/2/2015,2015,3,2, 4 ,4532,845,828,6205
3/2/2015,2015,3,2, 5 ,4772,880,869,6521
3/2/2015,2015,3,2, 6 ,5051,933,945,6929
3/2/2015,2015,3,2, 7 ,5080,898,855,6833
3/2/2015,2015,3,2, 8 ,5752,1015,988,7755
3/2/2015,2015,3,2, 9 ,6536,1205,1163,8904
3/2/2015,2015,3,2, 10 ,7060,1282,1254,9596
3/2/2015,2015,3,2, 11 ,7273,1335,1308,9916
3/2/2015,2015,3,2, 12 ,7189,1310,1287,9786
3/2/2015,2015,3,2, 13 ,7188,1317,1328,9833
3/2/2015,2015,3,2, 14 ,7567,1338,1319,10224
3/2/2015,2015,3,2, 15 ,7516,1336,1297,10149
3/2/2015,2015,3,2, 16 ,7350,1318,1276,9944
3/2/2015,2015,3,2, 17 ,6845,1259,1269,9373
3/2/2015,2015,3,2, 18 ,6767,1295,1317,9379
3/2/2015,2015,3,2, 19 ,7162,1406,1365,9933
3/2/2015,2015,3,2, 20 ,6898,1347,1344,9589
3/2/2015,2015,3,2, 21 ,6673,1260,1283,9216
3/2/2015,2015,3,2, 22 ,6225,1144,1106,8475
3/2/2015,2015,3,2, 23 ,5829,1031,1015,7875
3/2/2015,2015,3,2, 24 ,5356,963,1031,7350
3/3/2015,2015,3,3, 1 ,5161,922,921,7004
3/3/2015,2015,3,3, 2 ,4964,894,896,6754
3/3/2015,2015,3,3, 3 ,4846,872,855,6573
3/3/2015,2015,3,3, 4 ,4807,863,846,6516
3/3/2015,2015,3,3, 5 ,5033,891,907,6831
3/3/2015,2015,3,3, 6 ,5258,953,956,7167
3/3/2015,2015,3,3, 7 ,5238,909,886,7033
3/3/2015,2015,3,3, 8 ,5915,1044,943,7902
3/3/2015,2015,3,3, 9 ,6699,1220,1183,9102
3/3/2015,2015,3,3, 10 ,7087,1316,1298,9701
3/3/2015,2015,3,3, 11 ,7394,1372,1374,10140
3/3/2015,2015,3,3, 12 ,7260,1329,1349,9938
3/3/2015,2015,3,3, 13 ,7238,1343,1402,9983
3/3/2015,2015,3,3, 14 ,7583,1397,1413,10393
3/3/2015,2015,3,3, 15 ,7459,1381,1343,10183
3/3/2015,2015,3,3, 16 ,7375,1345,1303,10023
3/3/2015,2015,3,3, 17 ,6999,1272,1260,9531
3/3/2015,2015,3,3, 18 ,6897,1317,1276,9490
3/3/2015,2015,3,3, 19 ,7265,1415,1344,10024
3/3/2015,2015,3,3, 20 ,7029,1360,1301,9690
3/3/2015,2015,3,3, 21 ,6765,1293,1222,9280
3/3/2015,2015,3,3, 22 ,6423,1175,1159,8757
3/3/2015,2015,3,3, 23 ,5937,1061,1085,8083
3/3/2015,2015,3,3, 24 ,5531,992,938,7461
3/4/2015,2015,3,4, 1 ,5264,951,958,7173
3/4/2015,2015,3,4, 2 ,5068,920,922,6910
3/4/2015,2015,3,4, 3 ,4936,900,902,6738
3/4/2015,2015,3,4, 4 ,4889,892,883,6664
3/4/2015,2015,3,4, 5 ,5048,931,937,6916
3/4/2015,2015,3,4, 6 ,5244,980,987,7211
3/4/2015,2015,3,4, 7 ,5256,935,912,7103
3/4/2015,2015,3,4, 8 ,5879,1063,1021,7963
3/4/2015,2015,3,4, 9 ,6598,1238,1195,9031
3/4/2015,2015,3,4, 10 ,7149,1345,1303,9797
3/4/2015,2015,3,4, 11 ,7434,1403,1340,10177
3/4/2015,2015,3,4, 12 ,7312,1349,1325,9986
3/4/2015,2015,3,4, 13 ,7309,1373,1348,10030
3/4/2015,2015,3,4, 14 ,7695,1427,1390,10512
3/4/2015,2015,3,4, 15 ,7674,1385,1371,10430
3/4/2015,2015,3,4, 16 ,7510,1370,1339,10219
3/4/2015,2015,3,4, 17 ,7136,1296,1287,9719
3/4/2015,2015,3,4, 18 ,6999,1349,1307,9655
3/4/2015,2015,3,4, 19 ,7453,1452,1359,10264
3/4/2015,2015,3,4, 20 ,7224,1398,1329,9951
3/4/2015,2015,3,4, 21 ,6997,1335,1275,9607
3/4/2015,2015,3,4, 22 ,6584,1231,1185,9000
3/4/2015,2015,3,4, 23 ,6137,1113,1068,8318
3/4/2015,2015,3,4, 24 ,5673,1021,984,7678
3/5/2015,2015,3,5, 1 ,5399,971,949,7319
3/5/2015,2015,3,5, 2 ,5237,942,924,7103
3/5/2015,2015,3,5, 3 ,5082,922,894,6898
3/5/2015,2015,3,5, 4 ,5043,912,884,6839
3/5/2015,2015,3,5, 5 ,5170,949,924,7043
3/5/2015,2015,3,5, 6 ,5363,992,981,7336
3/5/2015,2015,3,5, 7 ,5420,945,908,7273
3/5/2015,2015,3,5, 8 ,6059,1080,1023,8162
3/5/2015,2015,3,5, 9 ,6832,1255,1185,9272
3/5/2015,2015,3,5, 10 ,7307,1354,1286,9947
3/5/2015,2015,3,5, 11 ,7586,1416,1334,10336
3/5/2015,2015,3,5, 12 ,7339,1362,1284,9985
3/5/2015,2015,3,5, 13 ,7321,1378,1261,9960
3/5/2015,2015,3,5, 14 ,7602,1445,1329,10376
3/5/2015,2015,3,5, 15 ,7504,1413,1293,10210
3/5/2015,2015,3,5, 16 ,7369,1393,1274,10036
3/5/2015,2015,3,5, 17 ,7059,1304,1218,9581
3/5/2015,2015,3,5, 18 ,6913,1328,1295,9536
3/5/2015,2015,3,5, 19 ,7269,1446,1335,10050
3/5/2015,2015,3,5, 20 ,7079,1396,1311,9786
3/5/2015,2015,3,5, 21 ,6867,1323,1227,9417
3/5/2015,2015,3,5, 22 ,6394,1193,1134,8721
3/5/2015,2015,3,5, 23 ,5980,1084,1037,8101
3/5/2015,2015,3,5, 24 ,5589,990,984,7563
3/6/2015,2015,3,6, 1 ,5278,974,946,7198
3/6/2015,2015,3,6, 2 ,5107,939,907,6953
3/6/2015,2015,3,6, 3 ,5016,908,888,6812
3/6/2015,2015,3,6, 4 ,4952,895,879,6726
3/6/2015,2015,3,6, 5 ,5094,936,928,6958
3/6/2015,2015,3,6, 6 ,5369,972,986,7327
3/6/2015,2015,3,6, 7 ,5350,932,920,7202
3/6/2015,2015,3,6, 8 ,5961,1066,1024,8051
3/6/2015,2015,3,6, 9 ,6730,1253,1207,9190
3/6/2015,2015,3,6, 10 ,7096,1343,1294,9733
3/6/2015,2015,3,6, 11 ,7318,1393,1341,10052
3/6/2015,2015,3,6, 12 ,7147,1353,1307,9807
3/6/2015,2015,3,6, 13 ,7287,1355,1317,9959
3/6/2015,2015,3,6, 14 ,7499,1420,1351,10270
3/6/2015,2015,3,6, 15 ,7472,1394,1360,10226
3/6/2015,2015,3,6, 16 ,7487,1349,1340,10176
3/6/2015,2015,3,6, 17 ,7086,1286,1273,9645
3/6/2015,2015,3,6, 18 ,6970,1337,1331,9638
3/6/2015,2015,3,6, 19 ,7331,1423,1350,10104
3/6/2015,2015,3,6, 20 ,7113,1367,1285,9765
3/6/2015,2015,3,6, 21 ,6847,1284,1225,9356
3/6/2015,2015,3,6, 22 ,6470,1180,1119,8769
3/6/2015,2015,3,6, 23 ,6074,1070,1016,8160
3/6/2015,2015,3,6, 24 ,5695,1005,917,7617
3/7/2015,2015,3,7, 1 ,5356,972,939,7267
3/7/2015,2015,3,7, 2 ,5210,921,901,7032
3/7/2015,2015,3,7, 3 ,5064,896,886,6846
3/7/2015,2015,3,7, 4 ,4977,892,864,6733
3/7/2015,2015,3,7, 5 ,4952,909,886,6747
3/7/2015,2015,3,7, 6 ,5029,913,915,6857
3/7/2015,2015,3,7, 7 ,5059,905,883,6847
3/7/2015,2015,3,7, 8 ,5518,999,1003,7520
3/7/2015,2015,3,7, 9 ,6130,1109,1132,8371
3/7/2015,2015,3,7, 10 ,6642,1195,1200,9037
3/7/2015,2015,3,7, 11 ,6953,1255,1255,9463
3/7/2015,2015,3,7, 12 ,6798,1226,1244,9268
3/7/2015,2015,3,7, 13 ,6814,1232,1258,9304
3/7/2015,2015,3,7, 14 ,7018,1266,1281,9565
3/7/2015,2015,3,7, 15 ,6889,1239,1269,9397
3/7/2015,2015,3,7, 16 ,6720,1207,1229,9156
3/7/2015,2015,3,7, 17 ,6409,1146,1164,8719
3/7/2015,2015,3,7, 18 ,6403,1238,1264,8905
3/7/2015,2015,3,7, 19 ,6857,1365,1336,9558
3/7/2015,2015,3,7, 20 ,6705,1327,1286,9318
3/7/2015,2015,3,7, 21 ,6567,1256,1253,9076
3/7/2015,2015,3,7, 22 ,6267,1159,1151,8577
3/7/2015,2015,3,7, 23 ,5854,1073,1049,7976
3/7/2015,2015,3,7, 24 ,5519,1007,970,7496
3/8/2015,2015,3,8, 1 ,5315,961,917,7193
3/8/2015,2015,3,8, 2 ,5081,925,882,6888
3/8/2015,2015,3,8, 3 ,4988,903,856,6747
3/8/2015,2015,3,8, 4 ,4797,895,834,6526
3/8/2015,2015,3,8, 5 ,4793,897,855,6545
3/8/2015,2015,3,8, 6 ,4680,889,849,6418
3/8/2015,2015,3,8, 7 ,4655,888,825,6368
3/8/2015,2015,3,8, 8 ,4908,930,851,6689
3/8/2015,2015,3,8, 9 ,5249,993,919,7161
3/8/2015,2015,3,8, 10 ,5687,1059,985,7731
3/8/2015,2015,3,8, 11 ,5954,1096,1035,8085
3/8/2015,2015,3,8, 12 ,5860,1102,1040,8002
3/8/2015,2015,3,8, 13 ,5915,1109,1040,8064
3/8/2015,2015,3,8, 14 ,6002,1096,1074,8172
3/8/2015,2015,3,8, 15 ,5902,1065,1073,8040
3/8/2015,2015,3,8, 16 ,5757,1056,1052,7865
3/8/2015,2015,3,8, 17 ,5657,1075,1031,7763
3/8/2015,2015,3,8, 18 ,5806,1213,1151,8170
3/8/2015,2015,3,8, 19 ,6470,1292,1230,8992
3/8/2015,2015,3,8, 20 ,6422,1252,1200,8874
3/8/2015,2015,3,8, 21 ,6250,1190,1154,8594
3/8/2015,2015,3,8, 22 ,5829,1098,1050,7977
3/8/2015,2015,3,8, 23 ,5412,1002,952,7366
3/8/2015,2015,3,8, 24 ,5094,946,903,6943
3/9/2015,2015,3,9, 1 ,4816,902,836,6554
3/9/2015,2015,3,9, 2 ,4613,862,811,6286
3/9/2015,2015,3,9, 3 ,4503,830,795,6128
3/9/2015,2015,3,9, 4 ,4484,832,797,6113
3/9/2015,2015,3,9, 5 ,4685,874,864,6423
3/9/2015,2015,3,9, 6 ,4870,923,944,6737
3/9/2015,2015,3,9, 7 ,5010,904,867,6781
3/9/2015,2015,3,9, 8 ,5719,1037,1004,7760
3/9/2015,2015,3,9, 9 ,6528,1222,1174,8924
3/9/2015,2015,3,9, 10 ,7056,1309,1276,9641
3/9/2015,2015,3,9, 11 ,7374,1352,1313,10039
3/9/2015,2015,3,9, 12 ,7279,1318,1307,9904
3/9/2015,2015,3,9, 13 ,7299,1339,1330,9968
3/9/2015,2015,3,9, 14 ,7639,1395,1351,10385
3/9/2015,2015,3,9, 15 ,7599,1393,1359,10351
3/9/2015,2015,3,9, 16 ,7472,1358,1332,10162
3/9/2015,2015,3,9, 17 ,7116,1280,1273,9669
3/9/2015,2015,3,9, 18 ,6954,1297,1308,9559
3/9/2015,2015,3,9, 19 ,7265,1439,1256,9960
3/9/2015,2015,3,9, 20 ,7086,1368,1213,9667
3/9/2015,2015,3,9, 21 ,6802,1291,1246,9339
3/9/2015,2015,3,9, 22 ,6405,1159,1143,8707
3/9/2015,2015,3,9, 23 ,5937,1041,1041,8019
3/9/2015,2015,3,9, 24 ,5508,958,966,7432
3/10/2015,2015,3,10, 1 ,5239,916,919,7074
3/10/2015,2015,3,10, 2 ,5112,879,896,6887
3/10/2015,2015,3,10, 3 ,4954,862,885,6701
3/10/2015,2015,3,10, 4 ,4914,864,867,6645
3/10/2015,2015,3,10, 5 ,5105,911,917,6933
3/10/2015,2015,3,10, 6 ,5259,959,963,7181
3/10/2015,2015,3,10, 7 ,5285,925,892,7102
3/10/2015,2015,3,10, 8 ,6035,1056,993,8084
3/10/2015,2015,3,10, 9 ,6682,1226,1143,9051
3/10/2015,2015,3,10, 10 ,7189,1297,1205,9691
3/10/2015,2015,3,10, 11 ,7403,1356,1273,10032
3/10/2015,2015,3,10, 12 ,7232,1309,1260,9801
3/10/2015,2015,3,10, 13 ,7256,1316,1275,9847
3/10/2015,2015,3,10, 14 ,7563,1385,1368,10316
3/10/2015,2015,3,10, 15 ,7476,1375,1343,10194
3/10/2015,2015,3,10, 16 ,7303,1349,1345,9997
3/10/2015,2015,3,10, 17 ,6906,1266,1276,9448
3/10/2015,2015,3,10, 18 ,6802,1310,1318,9430
3/10/2015,2015,3,10, 19 ,7117,1420,1359,9896
3/10/2015,2015,3,10, 20 ,6871,1354,1332,9557
3/10/2015,2015,3,10, 21 ,6681,1285,1279,9245
3/10/2015,2015,3,10, 22 ,6307,1172,1184,8663
3/10/2015,2015,3,10, 23 ,5830,1045,1063,7938
3/10/2015,2015,3,10, 24 ,5430,974,1001,7405
3/11/2015,2015,3,11, 1 ,5181,927,921,7029
3/11/2015,2015,3,11, 2 ,5057,899,893,6849
3/11/2015,2015,3,11, 3 ,4901,870,867,6638
3/11/2015,2015,3,11, 4 ,4854,870,857,6581
3/11/2015,2015,3,11, 5 ,5033,917,901,6851
3/11/2015,2015,3,11, 6 ,5275,958,954,7187
3/11/2015,2015,3,11, 7 ,5269,923,894,7086
3/11/2015,2015,3,11, 8 ,5932,1060,1008,8000
3/11/2015,2015,3,11, 9 ,6595,1245,1170,9010
3/11/2015,2015,3,11, 10 ,7037,1343,1283,9663
3/11/2015,2015,3,11, 11 ,7237,1390,1339,9966
3/11/2015,2015,3,11, 12 ,7008,1346,1312,9666
3/11/2015,2015,3,11, 13 ,6886,1367,1338,9591
3/11/2015,2015,3,11, 14 ,7174,1449,1369,9992
3/11/2015,2015,3,11, 15 ,7039,1424,1349,9812
3/11/2015,2015,3,11, 16 ,6985,1395,1339,9719
3/11/2015,2015,3,11, 17 ,6722,1300,1275,9297
3/11/2015,2015,3,11, 18 ,6800,1325,1310,9435
3/11/2015,2015,3,11, 19 ,7033,1471,1362,9866
3/11/2015,2015,3,11, 20 ,6819,1396,1324,9539
3/11/2015,2015,3,11, 21 ,6566,1340,1277,9183
3/11/2015,2015,3,11, 22 ,6189,1236,1188,8613
3/11/2015,2015,3,11, 23 ,5715,1117,1071,7903
3/11/2015,2015,3,11, 24 ,5367,984,983,7334
3/12/2015,2015,3,12, 1 ,5117,966,928,7011
3/12/2015,2015,3,12, 2 ,4985,940,892,6817
3/12/2015,2015,3,12, 3 ,4912,906,872,6690
3/12/2015,2015,3,12, 4 ,4900,897,868,6665
3/12/2015,2015,3,12, 5 ,5119,939,881,6939
3/12/2015,2015,3,12, 6 ,5251,964,970,7185
3/12/2015,2015,3,12, 7 ,5327,935,913,7175
3/12/2015,2015,3,12, 8 ,6055,1066,1040,8161
3/12/2015,2015,3,12, 9 ,6685,1238,1203,9126
3/12/2015,2015,3,12, 10 ,7163,1299,1308,9770
3/12/2015,2015,3,12, 11 ,7350,1388,1362,10100
3/12/2015,2015,3,12, 12 ,7228,1323,1331,9882
3/12/2015,2015,3,12, 13 ,7219,1335,1353,9907
3/12/2015,2015,3,12, 14 ,7562,1366,1404,10332
3/12/2015,2015,3,12, 15 ,7494,1350,1375,10219
3/12/2015,2015,3,12, 16 ,7371,1340,1361,10072
3/12/2015,2015,3,12, 17 ,6937,1268,1277,9482
3/12/2015,2015,3,12, 18 ,6903,1324,1343,9570
3/12/2015,2015,3,12, 19 ,7317,1436,1371,10124
3/12/2015,2015,3,12, 20 ,7004,1374,1338,9716
3/12/2015,2015,3,12, 21 ,6820,1295,1110,9225
3/12/2015,2015,3,12, 22 ,6355,1203,1214,8772
3/12/2015,2015,3,12, 23 ,5895,1082,1097,8074
3/12/2015,2015,3,12, 24 ,5508,989,1067,7564
3/13/2015,2015,3,13, 1 ,5260,958,963,7181
3/13/2015,2015,3,13, 2 ,5145,932,931,7008
3/13/2015,2015,3,13, 3 ,4977,912,911,6800
3/13/2015,2015,3,13, 4 ,4940,891,901,6732
3/13/2015,2015,3,13, 5 ,5085,924,930,6939
3/13/2015,2015,3,13, 6 ,5294,958,674,6926
3/13/2015,2015,3,13, 7 ,5306,926,918,7150
3/13/2015,2015,3,13, 8 ,5947,1060,1037,8044
3/13/2015,2015,3,13, 9 ,6614,1256,1200,9070
3/13/2015,2015,3,13, 10 ,7150,1351,1306,9807
3/13/2015,2015,3,13, 11 ,7197,1390,1336,9923
3/13/2015,2015,3,13, 12 ,7050,1348,1304,9702
3/13/2015,2015,3,13, 13 ,7025,1357,1334,9716
3/13/2015,2015,3,13, 14 ,7259,1426,1379,10064
3/13/2015,2015,3,13, 15 ,7137,1411,1361,9909
3/13/2015,2015,3,13, 16 ,6965,1380,1333,9678
3/13/2015,2015,3,13, 17 ,6651,1292,1273,9216
3/13/2015,2015,3,13, 18 ,6591,1317,1355,9263
3/13/2015,2015,3,13, 19 ,6995,1454,1380,9829
3/13/2015,2015,3,13, 20 ,6808,1377,1353,9538
3/13/2015,2015,3,13, 21 ,6548,1315,1257,9120
3/13/2015,2015,3,13, 22 ,6199,1213,1174,8586
3/13/2015,2015,3,13, 23 ,5810,1105,1073,7988
3/13/2015,2015,3,13, 24 ,5462,1020,994,7476
3/14/2015,2015,3,14, 1 ,5217,980,945,7142
3/14/2015,2015,3,14, 2 ,5010,947,913,6870
3/14/2015,2015,3,14, 3 ,4915,917,889,6721
3/14/2015,2015,3,14, 4 ,4807,907,880,6594
3/14/2015,2015,3,14, 5 ,4856,935,892,6683
3/14/2015,2015,3,14, 6 ,4915,941,911,6767
3/14/2015,2015,3,14, 7 ,5029,937,895,6861
3/14/2015,2015,3,14, 8 ,5509,1034,970,7513
3/14/2015,2015,3,14, 9 ,6105,1175,1077,8357
3/14/2015,2015,3,14, 10 ,6567,1246,1183,8996
3/14/2015,2015,3,14, 11 ,6895,1300,1245,9440
3/14/2015,2015,3,14, 12 ,6752,1275,1253,9280
3/14/2015,2015,3,14, 13 ,6728,1268,1269,9265
3/14/2015,2015,3,14, 14 ,6959,1329,1293,9581
3/14/2015,2015,3,14, 15 ,6831,1314,1268,9413
3/14/2015,2015,3,14, 16 ,6720,1264,1245,9229
3/14/2015,2015,3,14, 17 ,6310,1210,1199,8719
3/14/2015,2015,3,14, 18 ,6338,1267,1278,8883
3/14/2015,2015,3,14, 19 ,6889,1415,1341,9645
3/14/2015,2015,3,14, 20 ,6707,1372,1326,9405
3/14/2015,2015,3,14, 21 ,6529,1304,1299,9132
3/14/2015,2015,3,14, 22 ,6249,1212,1199,8660
3/14/2015,2015,3,14, 23 ,5866,1104,1084,8054
3/14/2015,2015,3,14, 24 ,5494,1012,989,7495
3/15/2015,2015,3,15, 1 ,5195,971,942,7108
3/15/2015,2015,3,15, 2 ,5033,934,896,6863
3/15/2015,2015,3,15, 3 ,4902,907,865,6674
3/15/2015,2015,3,15, 4 ,4789,891,841,6521
3/15/2015,2015,3,15, 5 ,4707,892,865,6464
3/15/2015,2015,3,15, 6 ,4659,878,875,6412
3/15/2015,2015,3,15, 7 ,4634,883,840,6357
3/15/2015,2015,3,15, 8 ,4944,933,871,6748
3/15/2015,2015,3,15, 9 ,5327,1005,954,7286
3/15/2015,2015,3,15, 10 ,5780,1062,948,7790
3/15/2015,2015,3,15, 11 ,6012,1113,1040,8165
3/15/2015,2015,3,15, 12 ,5983,1122,1093,8198
3/15/2015,2015,3,15, 13 ,6085,1120,1097,8302
3/15/2015,2015,3,15, 14 ,6148,1131,1112,8391
3/15/2015,2015,3,15, 15 ,5962,1107,1100,8169
3/15/2015,2015,3,15, 16 ,5788,1089,1072,7949
3/15/2015,2015,3,15, 17 ,5771,1075,1042,7888
3/15/2015,2015,3,15, 18 ,5919,1160,1160,8239
3/15/2015,2015,3,15, 19 ,6526,1333,1286,9145
3/15/2015,2015,3,15, 20 ,6404,1298,1239,8941
3/15/2015,2015,3,15, 21 ,6350,1228,1188,8766
3/15/2015,2015,3,15, 22 ,5962,1124,1100,8186
3/15/2015,2015,3,15, 23 ,5691,1045,1024,7760
3/15/2015,2015,3,15, 24 ,5324,972,941,7237
3/16/2015,2015,3,16, 1 ,4990,915,883,6788
3/16/2015,2015,3,16, 2 ,4830,882,856,6568
3/16/2015,2015,3,16, 3 ,4632,861,850,6343
3/16/2015,2015,3,16, 4 ,4646,857,844,6347
3/16/2015,2015,3,16, 5 ,4796,894,868,6558
3/16/2015,2015,3,16, 6 ,5055,934,913,6902
3/16/2015,2015,3,16, 7 ,5243,909,861,7013
3/16/2015,2015,3,16, 8 ,5961,1046,966,7973
3/16/2015,2015,3,16, 9 ,6716,1232,1111,9059
3/16/2015,2015,3,16, 10 ,7181,1339,1253,9773
3/16/2015,2015,3,16, 11 ,7401,1396,1303,10100
3/16/2015,2015,3,16, 12 ,7269,1359,1264,9892
3/16/2015,2015,3,16, 13 ,7281,1364,1287,9932
3/16/2015,2015,3,16, 14 ,7514,1417,1315,10246
3/16/2015,2015,3,16, 15 ,7386,1397,1301,10084
3/16/2015,2015,3,16, 16 ,7317,1374,1276,9967
3/16/2015,2015,3,16, 17 ,6953,1293,1223,9469
3/16/2015,2015,3,16, 18 ,6787,1318,1282,9387
3/16/2015,2015,3,16, 19 ,7181,1427,1338,9946
3/16/2015,2015,3,16, 20 ,6959,1375,1296,9630
3/16/2015,2015,3,16, 21 ,6715,1301,1254,9270
3/16/2015,2015,3,16, 22 ,6348,1161,1158,8667
3/16/2015,2015,3,16, 23 ,5908,1064,1039,8011
3/16/2015,2015,3,16, 24 ,5460,987,995,7442
3/17/2015,2015,3,17, 1 ,5160,943,897,7000
3/17/2015,2015,3,17, 2 ,5031,910,864,6805
3/17/2015,2015,3,17, 3 ,4885,885,844,6614
3/17/2015,2015,3,17, 4 ,4860,874,846,6580
3/17/2015,2015,3,17, 5 ,4969,905,876,6750
3/17/2015,2015,3,17, 6 ,5227,947,930,7104
3/17/2015,2015,3,17, 7 ,5205,916,873,6994
3/17/2015,2015,3,17, 8 ,5856,1041,986,7883
3/17/2015,2015,3,17, 9 ,6618,1220,1143,8981
3/17/2015,2015,3,17, 10 ,7067,1329,1248,9644
3/17/2015,2015,3,17, 11 ,7387,1379,1305,10071
3/17/2015,2015,3,17, 12 ,7214,1345,1274,9833
3/17/2015,2015,3,17, 13 ,7220,1339,1301,9860
3/17/2015,2015,3,17, 14 ,7554,1407,1339,10300
3/17/2015,2015,3,17, 15 ,7456,1382,1323,10161
3/17/2015,2015,3,17, 16 ,7375,1363,1298,10036
3/17/2015,2015,3,17, 17 ,7008,1247,1234,9489
3/17/2015,2015,3,17, 18 ,6914,1300,1292,9506
3/17/2015,2015,3,17, 19 ,7297,1415,1350,10062
3/17/2015,2015,3,17, 20 ,7008,1351,1309,9668
3/17/2015,2015,3,17, 21 ,6769,1255,1253,9277
3/17/2015,2015,3,17, 22 ,6394,1146,1153,8693
3/17/2015,2015,3,17, 23 ,5959,1026,957,7942
3/17/2015,2015,3,17, 24 ,5561,952,920,7433
3/18/2015,2015,3,18, 1 ,5251,913,914,7078
3/18/2015,2015,3,18, 2 ,5078,890,878,6846
3/18/2015,2015,3,18, 3 ,4926,859,850,6635
3/18/2015,2015,3,18, 4 ,4919,849,838,6606
3/18/2015,2015,3,18, 5 ,5042,887,889,6818
3/18/2015,2015,3,18, 6 ,5201,919,945,7065
3/18/2015,2015,3,18, 7 ,5302,910,875,7087
3/18/2015,2015,3,18, 8 ,5876,1027,983,7886
3/18/2015,2015,3,18, 9 ,6639,1202,1128,8969
3/18/2015,2015,3,18, 10 ,7074,1328,1262,9664
3/18/2015,2015,3,18, 11 ,7407,1391,1319,10117
3/18/2015,2015,3,18, 12 ,7259,1351,1288,9898
3/18/2015,2015,3,18, 13 ,7279,1350,1314,9943
3/18/2015,2015,3,18, 14 ,7602,1406,1342,10350
3/18/2015,2015,3,18, 15 ,7545,1394,1218,10157
3/18/2015,2015,3,18, 16 ,7340,1357,1219,9916
3/18/2015,2015,3,18, 17 ,6988,1280,1174,9442
3/18/2015,2015,3,18, 18 ,6906,1316,1222,9444
3/18/2015,2015,3,18, 19 ,7309,1450,1305,10064
3/18/2015,2015,3,18, 20 ,7111,1386,1324,9821
3/18/2015,2015,3,18, 21 ,6833,1302,1249,9384
3/18/2015,2015,3,18, 22 ,6494,1165,1165,8824
3/18/2015,2015,3,18, 23 ,6072,1053,1040,8165
3/18/2015,2015,3,18, 24 ,5537,991,984,7512
3/19/2015,2015,3,19, 1 ,5381,933,911,7225
3/19/2015,2015,3,19, 2 ,5166,909,885,6960
3/19/2015,2015,3,19, 3 ,5016,885,860,6761
3/19/2015,2015,3,19, 4 ,4980,873,852,6705
3/19/2015,2015,3,19, 5 ,5129,911,889,6929
3/19/2015,2015,3,19, 6 ,5276,947,944,7167
3/19/2015,2015,3,19, 7 ,5279,921,887,7087
3/19/2015,2015,3,19, 8 ,6021,1069,1000,8090
3/19/2015,2015,3,19, 9 ,6731,1249,1150,9130
3/19/2015,2015,3,19, 10 ,7228,1342,1204,9774
3/19/2015,2015,3,19, 11 ,7506,1404,1279,10189
3/19/2015,2015,3,19, 12 ,7382,1369,1256,10007
3/19/2015,2015,3,19, 13 ,7411,1379,1328,10118
3/19/2015,2015,3,19, 14 ,7739,1444,1368,10551
3/19/2015,2015,3,19, 15 ,7681,1424,1359,10464
3/19/2015,2015,3,19, 16 ,7552,1401,1342,10295
3/19/2015,2015,3,19, 17 ,7134,1315,1267,9716
3/19/2015,2015,3,19, 18 ,7033,1337,1289,9659
3/19/2015,2015,3,19, 19 ,7439,1463,1352,10254
3/19/2015,2015,3,19, 20 ,7189,1403,1292,9884
3/19/2015,2015,3,19, 21 ,6959,1327,1272,9558
3/19/2015,2015,3,19, 22 ,6569,1208,1174,8951
3/19/2015,2015,3,19, 23 ,6204,1100,1066,8370
3/19/2015,2015,3,19, 24 ,5731,995,943,7669
3/20/2015,2015,3,20, 1 ,5391,954,931,7276
3/20/2015,2015,3,20, 2 ,5218,916,898,7032
3/20/2015,2015,3,20, 3 ,5106,897,867,6870
3/20/2015,2015,3,20, 4 ,5052,890,850,6792
3/20/2015,2015,3,20, 5 ,5167,918,877,6962
3/20/2015,2015,3,20, 6 ,5267,950,920,7137
3/20/2015,2015,3,20, 7 ,5325,932,877,7134
3/20/2015,2015,3,20, 8 ,6015,1078,956,8049
3/20/2015,2015,3,20, 9 ,6788,1261,1151,9200
3/20/2015,2015,3,20, 10 ,7316,1360,1250,9926
3/20/2015,2015,3,20, 11 ,7677,1404,1315,10396
3/20/2015,2015,3,20, 12 ,7474,1364,1290,10128
3/20/2015,2015,3,20, 13 ,7483,1371,1310,10164
3/20/2015,2015,3,20, 14 ,7821,1429,1338,10588
3/20/2015,2015,3,20, 15 ,7744,1417,1319,10480
3/20/2015,2015,3,20, 16 ,7594,1388,1298,10280
3/20/2015,2015,3,20, 17 ,7179,1302,1241,9722
3/20/2015,2015,3,20, 18 ,7079,1335,1276,9690
3/20/2015,2015,3,20, 19 ,7450,1474,1324,10248
3/20/2015,2015,3,20, 20 ,7265,1414,1302,9981
3/20/2015,2015,3,20, 21 ,7074,1345,1224,9643
3/20/2015,2015,3,20, 22 ,6776,1221,1146,9143
3/20/2015,2015,3,20, 23 ,6340,1108,1061,8509
3/20/2015,2015,3,20, 24 ,6009,1008,1022,8039
3/21/2015,2015,3,21, 1 ,5731,971,926,7628
3/21/2015,2015,3,21, 2 ,5541,946,886,7373
3/21/2015,2015,3,21, 3 ,5376,910,851,7137
3/21/2015,2015,3,21, 4 ,5307,895,851,7053
3/21/2015,2015,3,21, 5 ,5295,913,872,7080
3/21/2015,2015,3,21, 6 ,5244,915,881,7040
3/21/2015,2015,3,21, 7 ,5313,922,870,7105
3/21/2015,2015,3,21, 8 ,5878,1037,953,7868
3/21/2015,2015,3,21, 9 ,6389,1173,1066,8628
3/21/2015,2015,3,21, 10 ,6851,1270,1157,9278
3/21/2015,2015,3,21, 11 ,7169,1333,1217,9719
3/21/2015,2015,3,21, 12 ,7071,1301,1166,9538
3/21/2015,2015,3,21, 13 ,6997,1307,1207,9511
3/21/2015,2015,3,21, 14 ,7153,1350,1253,9756
3/21/2015,2015,3,21, 15 ,7121,1319,1228,9668
3/21/2015,2015,3,21, 16 ,6811,1272,1222,9305
3/21/2015,2015,3,21, 17 ,6550,1212,1166,8928
3/21/2015,2015,3,21, 18 ,6646,1287,1260,9193
3/21/2015,2015,3,21, 19 ,7114,1427,1286,9827
3/21/2015,2015,3,21, 20 ,6987,1381,1270,9638
3/21/2015,2015,3,21, 21 ,6943,1313,1224,9480
3/21/2015,2015,3,21, 22 ,6673,1216,1168,9057
3/21/2015,2015,3,21, 23 ,6237,1102,1079,8418
3/21/2015,2015,3,21, 24 ,5928,1021,1048,7997
3/22/2015,2015,3,22, 1 ,5641,988,924,7553
3/22/2015,2015,3,22, 2 ,5458,959,875,7292
3/22/2015,2015,3,22, 3 ,5323,932,857,7112
3/22/2015,2015,3,22, 4 ,5190,905,842,6937
3/22/2015,2015,3,22, 5 ,5137,898,849,6884
3/22/2015,2015,3,22, 6 ,5038,882,846,6766
3/22/2015,2015,3,22, 7 ,5033,889,833,6755
3/22/2015,2015,3,22, 8 ,5221,917,859,6997
3/22/2015,2015,3,22, 9 ,5520,983,939,7442
3/22/2015,2015,3,22, 10 ,5962,1058,990,8010
3/22/2015,2015,3,22, 11 ,6188,1115,1080,8383
3/22/2015,2015,3,22, 12 ,6181,1118,1096,8395
3/22/2015,2015,3,22, 13 ,6110,1119,1101,8330
3/22/2015,2015,3,22, 14 ,6095,1126,1118,8339
3/22/2015,2015,3,22, 15 ,6000,1130,1101,8231
3/22/2015,2015,3,22, 16 ,5919,1124,1097,8140
3/22/2015,2015,3,22, 17 ,5840,1112,1071,8023
3/22/2015,2015,3,22, 18 ,6086,1208,1156,8450
3/22/2015,2015,3,22, 19 ,6589,1366,1252,9207
3/22/2015,2015,3,22, 20 ,6587,1323,1265,9175
3/22/2015,2015,3,22, 21 ,6458,1264,1215,8937
3/22/2015,2015,3,22, 22 ,6073,1184,1122,8379
3/22/2015,2015,3,22, 23 ,5825,1085,1037,7947
3/22/2015,2015,3,22, 24 ,5430,1002,955,7387
3/23/2015,2015,3,23, 1 ,5149,963,903,7015
3/23/2015,2015,3,23, 2 ,5000,930,867,6797
3/23/2015,2015,3,23, 3 ,4842,908,843,6593
3/23/2015,2015,3,23, 4 ,4809,891,831,6531
3/23/2015,2015,3,23, 5 ,4962,921,864,6747
3/23/2015,2015,3,23, 6 ,5182,944,897,7023
3/23/2015,2015,3,23, 7 ,5351,947,863,7161
3/23/2015,2015,3,23, 8 ,6057,1098,997,8152
3/23/2015,2015,3,23, 9 ,6748,1293,1168,9209
3/23/2015,2015,3,23, 10 ,7028,1391,1268,9687
3/23/2015,2015,3,23, 11 ,7482,1448,1294,10224
3/23/2015,2015,3,23, 12 ,7289,1424,1291,10004
3/23/2015,2015,3,23, 13 ,7243,1428,1312,9983
3/23/2015,2015,3,23, 14 ,7532,1491,1338,10361
3/23/2015,2015,3,23, 15 ,7462,1472,1315,10249
3/23/2015,2015,3,23, 16 ,7299,1423,1307,10029
3/23/2015,2015,3,23, 17 ,6999,1350,1247,9596
3/23/2015,2015,3,23, 18 ,6965,1358,1306,9629
3/23/2015,2015,3,23, 19 ,7279,1497,1326,10102
3/23/2015,2015,3,23, 20 ,7046,1444,1258,9748
3/23/2015,2015,3,23, 21 ,6774,1394,1219,9387
3/23/2015,2015,3,23, 22 ,6344,1278,1156,8778
3/23/2015,2015,3,23, 23 ,5976,1169,1088,8233
3/23/2015,2015,3,23, 24 ,5542,1077,973,7592
3/24/2015,2015,3,24, 1 ,5328,1029,978,7335
3/24/2015,2015,3,24, 2 ,5160,994,941,7095
3/24/2015,2015,3,24, 3 ,5036,970,911,6917
3/24/2015,2015,3,24, 4 ,4987,960,903,6850
3/24/2015,2015,3,24, 5 ,5080,984,924,6988
3/24/2015,2015,3,24, 6 ,5235,991,975,7201
3/24/2015,2015,3,24, 7 ,5383,989,926,7298
3/24/2015,2015,3,24, 8 ,6154,1130,1017,8301
3/24/2015,2015,3,24, 9 ,6886,1329,1143,9358
3/24/2015,2015,3,24, 10 ,7364,1424,1254,10042
3/24/2015,2015,3,24, 11 ,7634,1494,1312,10440
3/24/2015,2015,3,24, 12 ,7420,1446,1296,10162
3/24/2015,2015,3,24, 13 ,7390,1449,1307,10146
3/24/2015,2015,3,24, 14 ,7634,1525,1333,10492
3/24/2015,2015,3,24, 15 ,7582,1518,1293,10393
3/24/2015,2015,3,24, 16 ,7440,1479,1274,10193
3/24/2015,2015,3,24, 17 ,7087,1392,1213,9692
3/24/2015,2015,3,24, 18 ,6954,1381,1299,9634
3/24/2015,2015,3,24, 19 ,7337,1505,1302,10144
3/24/2015,2015,3,24, 20 ,7102,1451,1234,9787
3/24/2015,2015,3,24, 21 ,6899,1389,1237,9525
3/24/2015,2015,3,24, 22 ,6508,1264,1131,8903
3/24/2015,2015,3,24, 23 ,6097,1165,1045,8307
3/24/2015,2015,3,24, 24 ,5736,1077,961,7774
3/25/2015,2015,3,25, 1 ,5398,1034,913,7345
3/25/2015,2015,3,25, 2 ,5209,1000,897,7106
3/25/2015,2015,3,25, 3 ,5090,972,878,6940
3/25/2015,2015,3,25, 4 ,5023,958,864,6845
3/25/2015,2015,3,25, 5 ,5122,983,893,6998
3/25/2015,2015,3,25, 6 ,5225,1005,939,7169
3/25/2015,2015,3,25, 7 ,5403,1001,910,7314
3/25/2015,2015,3,25, 8 ,6087,1151,1055,8293
3/25/2015,2015,3,25, 9 ,6791,1313,1208,9312
3/25/2015,2015,3,25, 10 ,7270,1403,1277,9950
3/25/2015,2015,3,25, 11 ,7544,1462,1316,10322
3/25/2015,2015,3,25, 12 ,7306,1417,1281,10004
3/25/2015,2015,3,25, 13 ,7241,1432,1313,9986
3/25/2015,2015,3,25, 14 ,7583,1497,1348,10428
3/25/2015,2015,3,25, 15 ,7546,1473,1312,10331
3/25/2015,2015,3,25, 16 ,7392,1450,1305,10147
3/25/2015,2015,3,25, 17 ,7155,1353,1221,9729
3/25/2015,2015,3,25, 18 ,6978,1361,1298,9637
3/25/2015,2015,3,25, 19 ,7323,1497,1323,10143
3/25/2015,2015,3,25, 20 ,7085,1444,1278,9807
3/25/2015,2015,3,25, 21 ,6894,1368,1235,9497
3/25/2015,2015,3,25, 22 ,6488,1255,1142,8885
3/25/2015,2015,3,25, 23 ,6166,1153,1065,8384
3/25/2015,2015,3,25, 24 ,5674,1070,972,7716
3/26/2015,2015,3,26, 1 ,5447,1025,894,7366
3/26/2015,2015,3,26, 2 ,5279,977,904,7160
3/26/2015,2015,3,26, 3 ,5128,956,879,6963
3/26/2015,2015,3,26, 4 ,5059,940,875,6874
3/26/2015,2015,3,26, 5 ,5166,961,905,7032
3/26/2015,2015,3,26, 6 ,5318,979,929,7226
3/26/2015,2015,3,26, 7 ,5490,968,920,7378
3/26/2015,2015,3,26, 8 ,6147,1093,1045,8285
3/26/2015,2015,3,26, 9 ,6859,1258,1158,9275
3/26/2015,2015,3,26, 10 ,7332,1353,1278,9963
3/26/2015,2015,3,26, 11 ,7606,1402,1340,10348
3/26/2015,2015,3,26, 12 ,7400,1372,1299,10071
3/26/2015,2015,3,26, 13 ,7423,1388,1296,10107
3/26/2015,2015,3,26, 14 ,7716,1441,1355,10512
3/26/2015,2015,3,26, 15 ,7675,1430,1346,10451
3/26/2015,2015,3,26, 16 ,7508,1391,1330,10229
3/26/2015,2015,3,26, 17 ,7160,1314,1264,9738
3/26/2015,2015,3,26, 18 ,6883,1337,1299,9519
3/26/2015,2015,3,26, 19 ,7317,1429,1343,10089
3/26/2015,2015,3,26, 20 ,7061,1383,1317,9761
3/26/2015,2015,3,26, 21 ,6853,1335,1274,9462
3/26/2015,2015,3,26, 22 ,6515,1234,1204,8953
3/26/2015,2015,3,26, 23 ,6153,1127,1124,8404
3/26/2015,2015,3,26, 24 ,5733,1042,1025,7800
3/27/2015,2015,3,27, 1 ,5489,991,980,7460
3/27/2015,2015,3,27, 2 ,5294,962,946,7202
3/27/2015,2015,3,27, 3 ,5175,904,919,6998
3/27/2015,2015,3,27, 4 ,5077,922,910,6909
3/27/2015,2015,3,27, 5 ,5135,942,900,6977
3/27/2015,2015,3,27, 6 ,5247,945,968,7160
3/27/2015,2015,3,27, 7 ,5482,906,954,7342
3/27/2015,2015,3,27, 8 ,6054,1074,1038,8166
3/27/2015,2015,3,27, 9 ,6774,1235,1231,9240
3/27/2015,2015,3,27, 10 ,7274,1335,1310,9919
3/27/2015,2015,3,27, 11 ,7614,1378,1343,10335
3/27/2015,2015,3,27, 12 ,7449,1328,1315,10092
3/27/2015,2015,3,27, 13 ,7450,1323,1327,10100
3/27/2015,2015,3,27, 14 ,7740,1381,1345,10466
3/27/2015,2015,3,27, 15 ,7664,1355,1344,10363
3/27/2015,2015,3,27, 16 ,7501,1346,1307,10154
3/27/2015,2015,3,27, 17 ,7037,1258,1272,9567
3/27/2015,2015,3,27, 18 ,6851,1290,1318,9459
3/27/2015,2015,3,27, 19 ,7254,1414,1345,10013
3/27/2015,2015,3,27, 20 ,7081,1368,1313,9762
3/27/2015,2015,3,27, 21 ,6870,1294,1268,9432
3/27/2015,2015,3,27, 22 ,6582,1198,1209,8989
3/27/2015,2015,3,27, 23 ,6231,1098,1122,8451
3/27/2015,2015,3,27, 24 ,5793,1021,1037,7851
3/28/2015,2015,3,28, 1 ,5510,991,978,7479
3/28/2015,2015,3,28, 2 ,5329,969,952,7250
3/28/2015,2015,3,28, 3 ,5179,938,930,7047
3/28/2015,2015,3,28, 4 ,5075,914,905,6894
3/28/2015,2015,3,28, 5 ,5053,934,915,6902
3/28/2015,2015,3,28, 6 ,5036,934,956,6926
3/28/2015,2015,3,28, 7 ,5163,930,940,7033
3/28/2015,2015,3,28, 8 ,5695,1029,1019,7743
3/28/2015,2015,3,28, 9 ,6318,1160,1133,8611
3/28/2015,2015,3,28, 10 ,6740,1241,1204,9185
3/28/2015,2015,3,28, 11 ,7076,1296,1253,9625
3/28/2015,2015,3,28, 12 ,6916,1274,1210,9400
3/28/2015,2015,3,28, 13 ,6906,1277,1220,9403
3/28/2015,2015,3,28, 14 ,7085,1333,1248,9666
3/28/2015,2015,3,28, 15 ,6975,1306,1222,9503
3/28/2015,2015,3,28, 16 ,6761,1281,1206,9248
3/28/2015,2015,3,28, 17 ,6336,1208,1165,8709
3/28/2015,2015,3,28, 18 ,6412,1271,1265,8948
3/28/2015,2015,3,28, 19 ,6935,1420,1323,9678
3/28/2015,2015,3,28, 20 ,6794,1364,1288,9446
3/28/2015,2015,3,28, 21 ,6589,1281,1220,9090
3/28/2015,2015,3,28, 22 ,6442,1232,1175,8849
3/28/2015,2015,3,28, 23 ,6045,1129,1088,8262
3/28/2015,2015,3,28, 24 ,5750,1055,973,7778
3/29/2015,2015,3,29, 1 ,5477,999,959,7435
3/29/2015,2015,3,29, 2 ,5266,969,931,7166
3/29/2015,2015,3,29, 3 ,5107,939,897,6943
3/29/2015,2015,3,29, 4 ,4995,926,888,6809
3/29/2015,2015,3,29, 5 ,4943,929,893,6765
3/29/2015,2015,3,29, 6 ,4781,906,891,6578
3/29/2015,2015,3,29, 7 ,4739,898,876,6513
3/29/2015,2015,3,29, 8 ,5070,940,917,6927
3/29/2015,2015,3,29, 9 ,5467,1022,974,7463
3/29/2015,2015,3,29, 10 ,5987,1099,1077,8163
3/29/2015,2015,3,29, 11 ,6216,1138,1136,8490
3/29/2015,2015,3,29, 12 ,6177,1134,1128,8439
3/29/2015,2015,3,29, 13 ,6182,1136,1133,8451
3/29/2015,2015,3,29, 14 ,6176,1143,1121,8440
3/29/2015,2015,3,29, 15 ,6137,1129,1098,8364
3/29/2015,2015,3,29, 16 ,5997,1098,1058,8153
3/29/2015,2015,3,29, 17 ,5835,1096,1081,8012
3/29/2015,2015,3,29, 18 ,5833,1162,1186,8181
3/29/2015,2015,3,29, 19 ,6614,1333,1285,9232
3/29/2015,2015,3,29, 20 ,6560,1310,1266,9136
3/29/2015,2015,3,29, 21 ,6442,1254,1215,8911
3/29/2015,2015,3,29, 22 ,6217,1169,1119,8505
3/29/2015,2015,3,29, 23 ,5938,1085,1039,8062
3/29/2015,2015,3,29, 24 ,5565,1015,946,7526
3/30/2015,2015,3,30, 1 ,5261,960,910,7131
3/30/2015,2015,3,30, 2 ,5028,929,877,6834
3/30/2015,2015,3,30, 3 ,4944,903,854,6701
3/30/2015,2015,3,30, 4 ,4856,891,847,6594
3/30/2015,2015,3,30, 5 ,4888,903,857,6648
3/30/2015,2015,3,30, 6 ,4933,912,905,6750
3/30/2015,2015,3,30, 7 ,5208,933,907,7048
3/30/2015,2015,3,30, 8 ,6070,1091,1044,8205
3/30/2015,2015,3,30, 9 ,6799,1282,1205,9286
3/30/2015,2015,3,30, 10 ,7331,1362,1278,9971
3/30/2015,2015,3,30, 11 ,7651,1433,1344,10428
3/30/2015,2015,3,30, 12 ,7554,1393,1329,10276
3/30/2015,2015,3,30, 13 ,7539,1408,1337,10284
3/30/2015,2015,3,30, 14 ,7864,1465,1374,10703
3/30/2015,2015,3,30, 15 ,7816,1455,1356,10627
3/30/2015,2015,3,30, 16 ,7638,1420,1347,10405
3/30/2015,2015,3,30, 17 ,7193,1335,1275,9803
3/30/2015,2015,3,30, 18 ,6933,1365,1335,9633
3/30/2015,2015,3,30, 19 ,7397,1476,1354,10227
3/30/2015,2015,3,30, 20 ,7143,1414,1325,9882
3/30/2015,2015,3,30, 21 ,6962,1361,1275,9598
3/30/2015,2015,3,30, 22 ,6629,1236,1204,9069
3/30/2015,2015,3,30, 23 ,6210,1132,1099,8441
3/30/2015,2015,3,30, 24 ,5858,1057,1025,7940
3/31/2015,2015,3,31, 1 ,5554,1009,960,7523
3/31/2015,2015,3,31, 2 ,5322,982,943,7247
3/31/2015,2015,3,31, 3 ,5223,951,909,7083
3/31/2015,2015,3,31, 4 ,5136,943,886,6965
3/31/2015,2015,3,31, 5 ,5123,947,894,6964
3/31/2015,2015,3,31, 6 ,5157,952,917,7026
3/31/2015,2015,3,31, 7 ,5341,945,914,7200
3/31/2015,2015,3,31, 8 ,6108,1091,1028,8227
3/31/2015,2015,3,31, 9 ,6876,1277,1212,9365
3/31/2015,2015,3,31, 10 ,7367,1379,1311,10057
3/31/2015,2015,3,31, 11 ,7657,1441,1360,10458
3/31/2015,2015,3,31, 12 ,7549,1403,1314,10266
3/31/2015,2015,3,31, 13 ,7574,1418,1341,10333
3/31/2015,2015,3,31, 14 ,7898,1485,1382,10765
3/31/2015,2015,3,31, 15 ,7856,1471,1352,10679
3/31/2015,2015,3,31, 16 ,7687,1433,1342,10462
3/31/2015,2015,3,31, 17 ,7253,1342,1255,9850
3/31/2015,2015,3,31, 18 ,7016,1347,1314,9677
3/31/2015,2015,3,31, 19 ,7416,1496,1362,10274
3/31/2015,2015,3,31, 20 ,7186,1447,1317,9950
3/31/2015,2015,3,31, 21 ,7032,1398,1279,9709
3/31/2015,2015,3,31, 22 ,6711,1275,1201,9187
3/31/2015,2015,3,31, 23 ,6381,1173,1097,8651
3/31/2015,2015,3,31, 24 ,5924,1095,1023,8042
4/1/2015,2015,4,1, 1 ,5707,1054,957,7718
4/1/2015,2015,4,1, 2 ,5457,1013,941,7411
4/1/2015,2015,4,1, 3 ,5297,961,907,7165
4/1/2015,2015,4,1, 4 ,5170,946,888,7004
4/1/2015,2015,4,1, 5 ,5166,956,899,7021
4/1/2015,2015,4,1, 6 ,5140,948,928,7016
4/1/2015,2015,4,1, 7 ,5290,956,911,7157
4/1/2015,2015,4,1, 8 ,6038,1094,1032,8164
4/1/2015,2015,4,1, 9 ,6742,1272,1204,9218
4/1/2015,2015,4,1, 10 ,7200,1364,1287,9851
4/1/2015,2015,4,1, 11 ,7491,1420,1338,10249
4/1/2015,2015,4,1, 12 ,7322,1377,1308,10007
4/1/2015,2015,4,1, 13 ,7284,1358,1328,9970
4/1/2015,2015,4,1, 14 ,7463,1419,1367,10249
4/1/2015,2015,4,1, 15 ,7361,1382,1351,10094
4/1/2015,2015,4,1, 16 ,7064,1333,1299,9696
4/1/2015,2015,4,1, 17 ,6582,1243,1240,9065
4/1/2015,2015,4,1, 18 ,6471,1284,1286,9041
4/1/2015,2015,4,1, 19 ,6996,1433,1341,9770
4/1/2015,2015,4,1, 20 ,6838,1385,1331,9554
4/1/2015,2015,4,1, 21 ,6702,1324,1307,9333
4/1/2015,2015,4,1, 22 ,6385,1218,1205,8808
4/1/2015,2015,4,1, 23 ,6074,1118,1100,8292
4/1/2015,2015,4,1, 24 ,5717,1040,1037,7794
4/2/2015,2015,4,2, 1 ,5430,994,959,7383
4/2/2015,2015,4,2, 2 ,5189,960,922,7071
4/2/2015,2015,4,2, 3 ,5068,934,889,6891
4/2/2015,2015,4,2, 4 ,4895,903,874,6672
4/2/2015,2015,4,2, 5 ,4797,891,871,6559
4/2/2015,2015,4,2, 6 ,4519,840,850,6209
4/2/2015,2015,4,2, 7 ,4332,828,841,6001
4/2/2015,2015,4,2, 8 ,4517,874,894,6285
4/2/2015,2015,4,2, 9 ,4775,945,965,6685
4/2/2015,2015,4,2, 10 ,4946,981,1030,6957
4/2/2015,2015,4,2, 11 ,5147,1012,1076,7235
4/2/2015,2015,4,2, 12 ,5160,1022,1094,7276
4/2/2015,2015,4,2, 13 ,5152,1036,1114,7302
4/2/2015,2015,4,2, 14 ,5276,1040,1125,7441
4/2/2015,2015,4,2, 15 ,5212,1034,1089,7335
4/2/2015,2015,4,2, 16 ,4965,980,1041,6986
4/2/2015,2015,4,2, 17 ,4759,957,1015,6731
4/2/2015,2015,4,2, 18 ,4904,1040,1119,7063
4/2/2015,2015,4,2, 19 ,5634,1221,1233,8088
4/2/2015,2015,4,2, 20 ,5630,1192,1192,8014
4/2/2015,2015,4,2, 21 ,5551,1168,1156,7875
4/2/2015,2015,4,2, 22 ,5444,1111,1102,7657
4/2/2015,2015,4,2, 23 ,5232,1031,1029,7292
4/2/2015,2015,4,2, 24 ,4917,962,998,6877
4/3/2015,2015,4,3, 1 ,4641,905,903,6449
4/3/2015,2015,4,3, 2 ,4489,885,859,6233
4/3/2015,2015,4,3, 3 ,4343,842,834,6019
4/3/2015,2015,4,3, 4 ,4167,837,819,5823
4/3/2015,2015,4,3, 5 ,4056,831,816,5703
4/3/2015,2015,4,3, 6 ,3851,793,763,5407
4/3/2015,2015,4,3, 7 ,3773,789,752,5314
4/3/2015,2015,4,3, 8 ,3867,807,769,5443
4/3/2015,2015,4,3, 9 ,4070,834,806,5710
4/3/2015,2015,4,3, 10 ,4207,878,839,5924
4/3/2015,2015,4,3, 11 ,4442,916,881,6239
4/3/2015,2015,4,3, 12 ,4410,914,895,6219
4/3/2015,2015,4,3, 13 ,4460,924,903,6287
4/3/2015,2015,4,3, 14 ,4586,950,918,6454
4/3/2015,2015,4,3, 15 ,4532,926,899,6357
4/3/2015,2015,4,3, 16 ,4415,891,864,6170
4/3/2015,2015,4,3, 17 ,4246,864,819,5929
4/3/2015,2015,4,3, 18 ,4382,945,963,6290
4/3/2015,2015,4,3, 19 ,5085,1122,1103,7310
4/3/2015,2015,4,3, 20 ,5176,1137,1107,7420
4/3/2015,2015,4,3, 21 ,5268,1127,1084,7479
4/3/2015,2015,4,3, 22 ,5208,1072,1022,7302
4/3/2015,2015,4,3, 23 ,4995,1001,954,6950
4/3/2015,2015,4,3, 24 ,4695,943,981,6619
4/4/2015,2015,4,4, 1 ,4509,887,859,6255
4/4/2015,2015,4,4, 2 ,4322,859,827,6008
4/4/2015,2015,4,4, 3 ,4164,831,808,5803
4/4/2015,2015,4,4, 4 ,4062,816,795,5673
4/4/2015,2015,4,4, 5 ,4061,818,812,5691
4/4/2015,2015,4,4, 6 ,3940,800,810,5550
4/4/2015,2015,4,4, 7 ,4071,818,826,5715
4/4/2015,2015,4,4, 8 ,4415,894,894,6203
4/4/2015,2015,4,4, 9 ,4847,1016,1016,6879
4/4/2015,2015,4,4, 10 ,5335,1077,1101,7513
4/4/2015,2015,4,4, 11 ,5587,1132,1167,7886
4/4/2015,2015,4,4, 12 ,5601,1124,1125,7850
4/4/2015,2015,4,4, 13 ,5548,1127,1148,7823
4/4/2015,2015,4,4, 14 ,5702,1152,1160,8014
4/4/2015,2015,4,4, 15 ,5682,1142,1167,7991
4/4/2015,2015,4,4, 16 ,5553,1120,1147,7820
4/4/2015,2015,4,4, 17 ,5437,1074,1111,7622
4/4/2015,2015,4,4, 18 ,5700,1183,1211,8094
4/4/2015,2015,4,4, 19 ,6257,1336,1268,8861
4/4/2015,2015,4,4, 20 ,6288,1305,1229,8822
4/4/2015,2015,4,4, 21 ,6233,1265,1194,8692
4/4/2015,2015,4,4, 22 ,6069,1182,1020,8271
4/4/2015,2015,4,4, 23 ,5850,1123,852,7825
4/4/2015,2015,4,4, 24 ,5509,1030,846,7385
4/5/2015,2015,4,5, 1 ,5273,978,859,7110
4/5/2015,2015,4,5, 2 ,5087,948,134,6169
4/5/2015,2015,4,5, 3 ,4962,915,58,5935
4/5/2015,2015,4,5, 4 ,4838,903,86,5827
4/5/2015,2015,4,5, 5 ,4791,889,218,5898
4/5/2015,2015,4,5, 6 ,4610,861,314,5785
4/5/2015,2015,4,5, 7 ,4646,871,471,5988
4/5/2015,2015,4,5, 8 ,4871,919,627,6417
4/5/2015,2015,4,5, 9 ,5182,997,759,6938
4/5/2015,2015,4,5, 10 ,5677,1068,725,7470
4/5/2015,2015,4,5, 11 ,5798,1124,841,7763
4/5/2015,2015,4,5, 12 ,5732,1123,1014,7869
4/5/2015,2015,4,5, 13 ,5701,1125,1031,7857
4/5/2015,2015,4,5, 14 ,5691,1142,1079,7912
4/5/2015,2015,4,5, 15 ,5626,1104,1051,7781
4/5/2015,2015,4,5, 16 ,5487,1080,1045,7612
4/5/2015,2015,4,5, 17 ,5421,1088,1011,7520
4/5/2015,2015,4,5, 18 ,5788,1203,1130,8121
4/5/2015,2015,4,5, 19 ,6264,1364,1230,8858
4/5/2015,2015,4,5, 20 ,6308,1340,1159,8807
4/5/2015,2015,4,5, 21 ,6230,1285,1160,8675
4/5/2015,2015,4,5, 22 ,5990,1201,1077,8268
4/5/2015,2015,4,5, 23 ,5712,1102,1001,7815
4/5/2015,2015,4,5, 24 ,5414,1039,928,7381
4/6/2015,2015,4,6, 1 ,5163,994,738,6895
4/6/2015,2015,4,6, 2 ,5002,954,739,6695
4/6/2015,2015,4,6, 3 ,4880,926,713,6519
4/6/2015,2015,4,6, 4 ,4810,912,712,6434
4/6/2015,2015,4,6, 5 ,4804,930,744,6478
4/6/2015,2015,4,6, 6 ,4876,927,728,6531
4/6/2015,2015,4,6, 7 ,5261,956,737,6954
4/6/2015,2015,4,6, 8 ,6133,1102,871,8106
4/6/2015,2015,4,6, 9 ,6955,1293,1182,9430
4/6/2015,2015,4,6, 10 ,7512,1411,1304,10227
4/6/2015,2015,4,6, 11 ,7844,1459,1318,10621
4/6/2015,2015,4,6, 12 ,7809,1423,1288,10520
4/6/2015,2015,4,6, 13 ,7809,1410,1315,10534
4/6/2015,2015,4,6, 14 ,8102,1492,1353,10947
4/6/2015,2015,4,6, 15 ,8051,1497,1365,10913
4/6/2015,2015,4,6, 16 ,7852,1467,1327,10646
4/6/2015,2015,4,6, 17 ,7409,1375,1256,10040
4/6/2015,2015,4,6, 18 ,7133,1380,1311,9824
4/6/2015,2015,4,6, 19 ,7506,1504,1326,10336
4/6/2015,2015,4,6, 20 ,7345,1455,1296,10096
4/6/2015,2015,4,6, 21 ,7171,1398,1256,9825
4/6/2015,2015,4,6, 22 ,6831,1294,1218,9343
4/6/2015,2015,4,6, 23 ,6512,1190,1153,8855
4/6/2015,2015,4,6, 24 ,6109,1115,1062,8286
4/7/2015,2015,4,7, 1 ,5914,1066,972,7952
4/7/2015,2015,4,7, 2 ,5756,1036,940,7732
4/7/2015,2015,4,7, 3 ,5576,1004,899,7479
4/7/2015,2015,4,7, 4 ,5412,978,886,7276
4/7/2015,2015,4,7, 5 ,5382,989,893,7264
4/7/2015,2015,4,7, 6 ,5351,979,936,7266
4/7/2015,2015,4,7, 7 ,5582,987,938,7507
4/7/2015,2015,4,7, 8 ,6362,1137,1092,8591
4/7/2015,2015,4,7, 9 ,7214,1317,1212,9743
4/7/2015,2015,4,7, 10 ,7641,1409,1290,10340
4/7/2015,2015,4,7, 11 ,7920,1466,1363,10749
4/7/2015,2015,4,7, 12 ,7784,1405,1328,10517
4/7/2015,2015,4,7, 13 ,7729,1395,1356,10480
4/7/2015,2015,4,7, 14 ,8040,1462,1364,10866
4/7/2015,2015,4,7, 15 ,7976,1468,1353,10797
4/7/2015,2015,4,7, 16 ,7854,1429,1333,10616
4/7/2015,2015,4,7, 17 ,7343,1345,1245,9933
4/7/2015,2015,4,7, 18 ,7065,1357,1336,9758
4/7/2015,2015,4,7, 19 ,7472,1487,1390,10349
4/7/2015,2015,4,7, 20 ,7226,1437,1384,10047
4/7/2015,2015,4,7, 21 ,7106,1388,1305,9799
4/7/2015,2015,4,7, 22 ,6752,1278,1204,9234
4/7/2015,2015,4,7, 23 ,6387,1172,1111,8670
4/7/2015,2015,4,7, 24 ,5972,1099,1030,8101
4/8/2015,2015,4,8, 1 ,5685,1042,976,7703
4/8/2015,2015,4,8, 2 ,5455,1011,945,7411
4/8/2015,2015,4,8, 3 ,5329,987,917,7233
4/8/2015,2015,4,8, 4 ,5199,975,901,7075
4/8/2015,2015,4,8, 5 ,5163,974,919,7056
4/8/2015,2015,4,8, 6 ,5244,978,924,7146
4/8/2015,2015,4,8, 7 ,5469,996,919,7384
4/8/2015,2015,4,8, 8 ,6222,1132,1071,8425
4/8/2015,2015,4,8, 9 ,7044,1307,1223,9574
4/8/2015,2015,4,8, 10 ,7508,1371,1282,10161
4/8/2015,2015,4,8, 11 ,7803,1432,1349,10584
4/8/2015,2015,4,8, 12 ,7644,1351,1326,10321
4/8/2015,2015,4,8, 13 ,7614,1364,1331,10309
4/8/2015,2015,4,8, 14 ,7965,1432,1357,10754
4/8/2015,2015,4,8, 15 ,7911,1431,1344,10686
4/8/2015,2015,4,8, 16 ,7771,1412,1329,10512
4/8/2015,2015,4,8, 17 ,7301,1321,1270,9892
4/8/2015,2015,4,8, 18 ,6994,1358,1333,9685
4/8/2015,2015,4,8, 19 ,7375,1488,1354,10217
4/8/2015,2015,4,8, 20 ,7239,1431,1301,9971
4/8/2015,2015,4,8, 21 ,7091,1355,1278,9724
4/8/2015,2015,4,8, 22 ,6679,1248,1203,9130
4/8/2015,2015,4,8, 23 ,6406,1149,1113,8668
4/8/2015,2015,4,8, 24 ,6029,1062,1060,8151
4/9/2015,2015,4,9, 1 ,5811,1011,990,7812
4/9/2015,2015,4,9, 2 ,5552,974,955,7481
4/9/2015,2015,4,9, 3 ,5389,948,927,7264
4/9/2015,2015,4,9, 4 ,5298,933,913,7144
4/9/2015,2015,4,9, 5 ,5228,940,925,7093
4/9/2015,2015,4,9, 6 ,5110,940,923,6973
4/9/2015,2015,4,9, 7 ,5174,933,901,7008
4/9/2015,2015,4,9, 8 ,5589,1027,988,7604
4/9/2015,2015,4,9, 9 ,6097,1155,1134,8386
4/9/2015,2015,4,9, 10 ,6510,1239,1238,8987
4/9/2015,2015,4,9, 11 ,6827,1290,1241,9358
4/9/2015,2015,4,9, 12 ,6707,1257,1231,9195
4/9/2015,2015,4,9, 13 ,6775,1269,1246,9290
4/9/2015,2015,4,9, 14 ,6969,1335,1264,9568
4/9/2015,2015,4,9, 15 ,6819,1318,1272,9409
4/9/2015,2015,4,9, 16 ,6651,1284,1217,9152
4/9/2015,2015,4,9, 17 ,6320,1236,1183,8739
4/9/2015,2015,4,9, 18 ,6337,1296,1252,8885
4/9/2015,2015,4,9, 19 ,6944,1463,1348,9755
4/9/2015,2015,4,9, 20 ,6956,1427,1319,9702
4/9/2015,2015,4,9, 21 ,6815,1367,1287,9469
4/9/2015,2015,4,9, 22 ,6503,1270,1186,8959
4/9/2015,2015,4,9, 23 ,6150,1174,1076,8400
4/9/2015,2015,4,9, 24 ,5773,1095,1021,7889
4/10/2015,2015,4,10, 1 ,5509,1054,974,7537
4/10/2015,2015,4,10, 2 ,5358,1015,931,7304
4/10/2015,2015,4,10, 3 ,5184,991,906,7081
4/10/2015,2015,4,10, 4 ,5096,969,904,6969
4/10/2015,2015,4,10, 5 ,5075,966,917,6958
4/10/2015,2015,4,10, 6 ,5117,959,925,7001
4/10/2015,2015,4,10, 7 ,5353,977,920,7250
4/10/2015,2015,4,10, 8 ,6226,1126,1044,8396
4/10/2015,2015,4,10, 9 ,7054,1311,1248,9613
4/10/2015,2015,4,10, 10 ,7520,1431,1299,10250
4/10/2015,2015,4,10, 11 ,7784,1482,1353,10619
4/10/2015,2015,4,10, 12 ,7632,1447,1336,10415
4/10/2015,2015,4,10, 13 ,7607,1431,1369,10407
4/10/2015,2015,4,10, 14 ,7906,1497,1395,10798
4/10/2015,2015,4,10, 15 ,7839,1501,1366,10706
4/10/2015,2015,4,10, 16 ,7663,1456,1362,10481
4/10/2015,2015,4,10, 17 ,7223,1361,1297,9881
4/10/2015,2015,4,10, 18 ,6937,1369,1333,9639
4/10/2015,2015,4,10, 19 ,7390,1503,1375,10268
4/10/2015,2015,4,10, 20 ,7201,1457,1347,10005
4/10/2015,2015,4,10, 21 ,7004,1390,1300,9694
4/10/2015,2015,4,10, 22 ,6722,1279,1209,9210
4/10/2015,2015,4,10, 23 ,6412,1173,1131,8716
4/10/2015,2015,4,10, 24 ,5996,1107,1010,8113
4/11/2015,2015,4,11, 1 ,5687,1063,1001,7751
4/11/2015,2015,4,11, 2 ,5535,1032,947,7514
4/11/2015,2015,4,11, 3 ,5350,1002,923,7275
4/11/2015,2015,4,11, 4 ,5219,981,921,7121
4/11/2015,2015,4,11, 5 ,5190,1003,928,7121
4/11/2015,2015,4,11, 6 ,5013,972,926,6911
4/11/2015,2015,4,11, 7 ,5136,969,924,7029
4/11/2015,2015,4,11, 8 ,5683,1054,1014,7751
4/11/2015,2015,4,11, 9 ,6385,1195,1079,8659
4/11/2015,2015,4,11, 10 ,6858,1271,1174,9303
4/11/2015,2015,4,11, 11 ,7175,1330,1206,9711
4/11/2015,2015,4,11, 12 ,7015,1282,1186,9483
4/11/2015,2015,4,11, 13 ,7019,1297,1208,9524
4/11/2015,2015,4,11, 14 ,7258,1364,1257,9879
4/11/2015,2015,4,11, 15 ,7115,1345,1249,9709
4/11/2015,2015,4,11, 16 ,6939,1309,1222,9470
4/11/2015,2015,4,11, 17 ,6527,1242,1183,8952
4/11/2015,2015,4,11, 18 ,6473,1292,1296,9061
4/11/2015,2015,4,11, 19 ,7069,1445,1339,9853
4/11/2015,2015,4,11, 20 ,6951,1403,1311,9665
4/11/2015,2015,4,11, 21 ,6827,1361,1292,9480
4/11/2015,2015,4,11, 22 ,6598,1278,1181,9057
4/11/2015,2015,4,11, 23 ,6234,1164,1091,8489
4/11/2015,2015,4,11, 24 ,5687,1092,1064,7843
4/12/2015,2015,4,12, 1 ,5542,1043,977,7562
4/12/2015,2015,4,12, 2 ,5365,1012,945,7322
4/12/2015,2015,4,12, 3 ,5199,972,915,7086
4/12/2015,2015,4,12, 4 ,5043,950,901,6894
4/12/2015,2015,4,12, 5 ,4988,950,909,6847
4/12/2015,2015,4,12, 6 ,4748,916,887,6551
4/12/2015,2015,4,12, 7 ,4762,922,871,6555
4/12/2015,2015,4,12, 8 ,5020,971,928,6919
4/12/2015,2015,4,12, 9 ,5518,1047,1013,7578
4/12/2015,2015,4,12, 10 ,5921,1119,1075,8115
4/12/2015,2015,4,12, 11 ,6175,1162,1102,8439
4/12/2015,2015,4,12, 12 ,6175,1161,1113,8449
4/12/2015,2015,4,12, 13 ,6229,1174,1122,8525
4/12/2015,2015,4,12, 14 ,6359,1198,1121,8678
4/12/2015,2015,4,12, 15 ,6193,1165,1085,8443
4/12/2015,2015,4,12, 16 ,6130,1159,1088,8377
4/12/2015,2015,4,12, 17 ,5971,1126,1073,8170
4/12/2015,2015,4,12, 18 ,6029,1226,1179,8434
4/12/2015,2015,4,12, 19 ,6715,1403,1259,9377
4/12/2015,2015,4,12, 20 ,6752,1375,1207,9334
4/12/2015,2015,4,12, 21 ,6662,1334,1199,9195
4/12/2015,2015,4,12, 22 ,6399,1241,1160,8800
4/12/2015,2015,4,12, 23 ,6166,1140,1070,8376
4/12/2015,2015,4,12, 24 ,5800,1065,995,7860
4/13/2015,2015,4,13, 1 ,5530,1019,964,7513
4/13/2015,2015,4,13, 2 ,5286,989,940,7215
4/13/2015,2015,4,13, 3 ,5136,961,912,7009
4/13/2015,2015,4,13, 4 ,5032,936,903,6871
4/13/2015,2015,4,13, 5 ,5022,960,924,6906
4/13/2015,2015,4,13, 6 ,5060,962,930,6952
4/13/2015,2015,4,13, 7 ,5351,996,929,7276
4/13/2015,2015,4,13, 8 ,6239,1150,1073,8462
4/13/2015,2015,4,13, 9 ,7096,1346,1198,9640
4/13/2015,2015,4,13, 10 ,7614,1447,1235,10296
4/13/2015,2015,4,13, 11 ,7968,1494,1288,10750
4/13/2015,2015,4,13, 12 ,7864,1444,1242,10550
4/13/2015,2015,4,13, 13 ,7863,1472,1260,10595
4/13/2015,2015,4,13, 14 ,8214,1527,1292,11033
4/13/2015,2015,4,13, 15 ,8140,1506,1274,10920
4/13/2015,2015,4,13, 16 ,7941,1462,1269,10672
4/13/2015,2015,4,13, 17 ,7474,1377,1235,10086
4/13/2015,2015,4,13, 18 ,7235,1394,1296,9925
4/13/2015,2015,4,13, 19 ,7633,1518,1316,10467
4/13/2015,2015,4,13, 20 ,7488,1468,1291,10247
4/13/2015,2015,4,13, 21 ,7321,1415,1268,10004
4/13/2015,2015,4,13, 22 ,7062,1301,1171,9534
4/13/2015,2015,4,13, 23 ,6702,1189,1091,8982
4/13/2015,2015,4,13, 24 ,6250,1114,1020,8384
4/14/2015,2015,4,14, 1 ,5937,1063,991,7991
4/14/2015,2015,4,14, 2 ,5754,1031,961,7746
4/14/2015,2015,4,14, 3 ,5595,1002,944,7541
4/14/2015,2015,4,14, 4 ,5510,995,932,7437
4/14/2015,2015,4,14, 5 ,5462,1000,956,7418
4/14/2015,2015,4,14, 6 ,5475,988,968,7431
4/14/2015,2015,4,14, 7 ,5577,1001,948,7526
4/14/2015,2015,4,14, 8 ,6442,1158,1058,8658
4/14/2015,2015,4,14, 9 ,7230,1335,1221,9786
4/14/2015,2015,4,14, 10 ,7724,1457,1305,10486
4/14/2015,2015,4,14, 11 ,8001,1508,1354,10863
4/14/2015,2015,4,14, 12 ,7873,1490,1313,10676
4/14/2015,2015,4,14, 13 ,7875,1482,1335,10692
4/14/2015,2015,4,14, 14 ,8203,1556,1365,11124
4/14/2015,2015,4,14, 15 ,8123,1536,1342,11001
4/14/2015,2015,4,14, 16 ,7988,1498,1286,10772
4/14/2015,2015,4,14, 17 ,7481,1409,1253,10143
4/14/2015,2015,4,14, 18 ,7214,1422,1342,9978
4/14/2015,2015,4,14, 19 ,7570,1532,1297,10399
4/14/2015,2015,4,14, 20 ,7379,1488,1312,10179
4/14/2015,2015,4,14, 21 ,7177,1432,1292,9901
4/14/2015,2015,4,14, 22 ,6849,1326,1186,9361
4/14/2015,2015,4,14, 23 ,6494,1241,1141,8876
4/14/2015,2015,4,14, 24 ,6102,1163,1053,8318
4/15/2015,2015,4,15, 1 ,5852,1109,1076,8037
4/15/2015,2015,4,15, 2 ,5634,1074,985,7693
4/15/2015,2015,4,15, 3 ,5452,1049,953,7454
4/15/2015,2015,4,15, 4 ,5328,1030,938,7296
4/15/2015,2015,4,15, 5 ,5326,1038,958,7322
4/15/2015,2015,4,15, 6 ,5366,1026,969,7361
4/15/2015,2015,4,15, 7 ,5605,1038,968,7611
4/15/2015,2015,4,15, 8 ,6401,1208,1178,8787
4/15/2015,2015,4,15, 9 ,7164,1385,1242,9791
4/15/2015,2015,4,15, 10 ,7655,1475,1312,10442
4/15/2015,2015,4,15, 11 ,7953,1497,1322,10772
4/15/2015,2015,4,15, 12 ,7785,1467,1302,10554
4/15/2015,2015,4,15, 13 ,7782,1472,1339,10593
4/15/2015,2015,4,15, 14 ,8076,1558,1347,10981
4/15/2015,2015,4,15, 15 ,7994,1548,1348,10890
4/15/2015,2015,4,15, 16 ,7777,1510,1326,10613
4/15/2015,2015,4,15, 17 ,7313,1411,1254,9978
4/15/2015,2015,4,15, 18 ,7087,1424,1300,9811
4/15/2015,2015,4,15, 19 ,7498,1566,1328,10392
4/15/2015,2015,4,15, 20 ,7359,1514,1312,10185
4/15/2015,2015,4,15, 21 ,7215,1470,1321,10006
4/15/2015,2015,4,15, 22 ,6889,1361,1230,9480
4/15/2015,2015,4,15, 23 ,6579,1253,1145,8977
4/15/2015,2015,4,15, 24 ,6219,1175,1065,8459
4/16/2015,2015,4,16, 1 ,5920,1120,1034,8074
4/16/2015,2015,4,16, 2 ,5700,1079,999,7778
4/16/2015,2015,4,16, 3 ,5525,1048,967,7540
4/16/2015,2015,4,16, 4 ,5393,1030,950,7373
4/16/2015,2015,4,16, 5 ,5435,1044,953,7432
4/16/2015,2015,4,16, 6 ,5406,1028,968,7402
4/16/2015,2015,4,16, 7 ,5633,1046,995,7674
4/16/2015,2015,4,16, 8 ,6401,1200,1140,8741
4/16/2015,2015,4,16, 9 ,7247,1394,1242,9883
4/16/2015,2015,4,16, 10 ,7762,1488,1283,10533
4/16/2015,2015,4,16, 11 ,8054,1539,1372,10965
4/16/2015,2015,4,16, 12 ,7801,1472,1328,10601
4/16/2015,2015,4,16, 13 ,8008,1502,1350,10860
4/16/2015,2015,4,16, 14 ,8325,1560,1368,11253
4/16/2015,2015,4,16, 15 ,8283,1542,1367,11192
4/16/2015,2015,4,16, 16 ,8138,1517,1361,11016
4/16/2015,2015,4,16, 17 ,7547,1426,1287,10260
4/16/2015,2015,4,16, 18 ,7247,1435,1324,10006
4/16/2015,2015,4,16, 19 ,7703,1573,1346,10622
4/16/2015,2015,4,16, 20 ,7496,1522,1332,10350
4/16/2015,2015,4,16, 21 ,7389,1465,1192,10046
4/16/2015,2015,4,16, 22 ,7121,1372,1119,9612
4/16/2015,2015,4,16, 23 ,6783,1258,1060,9101
4/16/2015,2015,4,16, 24 ,6410,1177,1079,8666
4/17/2015,2015,4,17, 1 ,6109,1139,1021,8269
4/17/2015,2015,4,17, 2 ,5952,1103,988,8043
4/17/2015,2015,4,17, 3 ,5722,1064,967,7753
4/17/2015,2015,4,17, 4 ,5611,1035,964,7610
4/17/2015,2015,4,17, 5 ,5601,1045,970,7616
4/17/2015,2015,4,17, 6 ,5541,1018,987,7546
4/17/2015,2015,4,17, 7 ,5769,1034,968,7771
4/17/2015,2015,4,17, 8 ,6549,1184,1043,8776
4/17/2015,2015,4,17, 9 ,7354,1378,1197,9929
4/17/2015,2015,4,17, 10 ,7911,1469,1252,10632
4/17/2015,2015,4,17, 11 ,8152,1524,1264,10940
4/17/2015,2015,4,17, 12 ,8002,1482,1207,10691
4/17/2015,2015,4,17, 13 ,8038,1502,1219,10759
4/17/2015,2015,4,17, 14 ,8344,1534,1227,11105
4/17/2015,2015,4,17, 15 ,8256,1502,1230,10988
4/17/2015,2015,4,17, 16 ,8096,1486,1230,10812
4/17/2015,2015,4,17, 17 ,7563,1379,1213,10155
4/17/2015,2015,4,17, 18 ,7293,1424,1281,9998
4/17/2015,2015,4,17, 19 ,7650,1513,1298,10461
4/17/2015,2015,4,17, 20 ,7460,1488,1225,10173
4/17/2015,2015,4,17, 21 ,7333,1447,1183,9963
4/17/2015,2015,4,17, 22 ,7078,1350,1115,9543
4/17/2015,2015,4,17, 23 ,6771,1242,1022,9035
4/17/2015,2015,4,17, 24 ,6332,1165,967,8464
4/18/2015,2015,4,18, 1 ,6045,1117,913,8075
4/18/2015,2015,4,18, 2 ,5864,1087,890,7841
4/18/2015,2015,4,18, 3 ,5675,1049,874,7598
4/18/2015,2015,4,18, 4 ,5517,1024,862,7403
4/18/2015,2015,4,18, 5 ,5490,1026,882,7398
4/18/2015,2015,4,18, 6 ,5315,990,898,7203
4/18/2015,2015,4,18, 7 ,5409,998,910,7317
4/18/2015,2015,4,18, 8 ,6045,1105,974,8124
4/18/2015,2015,4,18, 9 ,6622,1256,1053,8931
4/18/2015,2015,4,18, 10 ,7160,1347,1155,9662
4/18/2015,2015,4,18, 11 ,7447,1411,1258,10116
4/18/2015,2015,4,18, 12 ,7365,1375,1224,9964
4/18/2015,2015,4,18, 13 ,7378,1383,1236,9997
4/18/2015,2015,4,18, 14 ,7589,1437,1296,10322
4/18/2015,2015,4,18, 15 ,7514,1386,1279,10179
4/18/2015,2015,4,18, 16 ,7270,1357,1231,9858
4/18/2015,2015,4,18, 17 ,6885,1300,1190,9375
4/18/2015,2015,4,18, 18 ,6761,1373,1275,9409
4/18/2015,2015,4,18, 19 ,7344,1485,1316,10145
4/18/2015,2015,4,18, 20 ,7276,1459,1303,10038
4/18/2015,2015,4,18, 21 ,7230,1411,1259,9900
4/18/2015,2015,4,18, 22 ,7050,1343,1193,9586
4/18/2015,2015,4,18, 23 ,6757,1234,1096,9087
4/18/2015,2015,4,18, 24 ,6386,1170,1025,8581
4/19/2015,2015,4,19, 1 ,6108,1113,995,8216
4/19/2015,2015,4,19, 2 ,5867,1076,952,7895
4/19/2015,2015,4,19, 3 ,5691,1036,937,7664
4/19/2015,2015,4,19, 4 ,5547,1010,897,7454
4/19/2015,2015,4,19, 5 ,5421,1006,892,7319
4/19/2015,2015,4,19, 6 ,5140,967,889,6996
4/19/2015,2015,4,19, 7 ,5123,971,881,6975
4/19/2015,2015,4,19, 8 ,5454,1019,927,7400
4/19/2015,2015,4,19, 9 ,5893,1098,998,7989
4/19/2015,2015,4,19, 10 ,6322,1167,1067,8556
4/19/2015,2015,4,19, 11 ,6562,1214,1139,8915
4/19/2015,2015,4,19, 12 ,6546,1214,1151,8911
4/19/2015,2015,4,19, 13 ,6572,1226,1164,8962
4/19/2015,2015,4,19, 14 ,6658,1240,1164,9062
4/19/2015,2015,4,19, 15 ,6590,1218,1149,8957
4/19/2015,2015,4,19, 16 ,6453,1122,1123,8698
4/19/2015,2015,4,19, 17 ,6259,1141,1108,8508
4/19/2015,2015,4,19, 18 ,6280,1243,1212,8735
4/19/2015,2015,4,19, 19 ,7032,1439,1279,9750
4/19/2015,2015,4,19, 20 ,7144,1419,1278,9841
4/19/2015,2015,4,19, 21 ,7068,1378,1230,9676
4/19/2015,2015,4,19, 22 ,6883,1290,1149,9322
4/19/2015,2015,4,19, 23 ,6567,1232,1082,8881
4/19/2015,2015,4,19, 24 ,6225,1159,1033,8417
4/20/2015,2015,4,20, 1 ,5853,1089,955,7897
4/20/2015,2015,4,20, 2 ,5645,1062,927,7634
4/20/2015,2015,4,20, 3 ,5483,1020,893,7396
4/20/2015,2015,4,20, 4 ,5382,1006,886,7274
4/20/2015,2015,4,20, 5 ,5366,1008,902,7276
4/20/2015,2015,4,20, 6 ,5384,994,909,7287
4/20/2015,2015,4,20, 7 ,5711,1042,916,7669
4/20/2015,2015,4,20, 8 ,6658,1229,1044,8931
4/20/2015,2015,4,20, 9 ,7590,1423,1167,10180
4/20/2015,2015,4,20, 10 ,8101,1524,1328,10953
4/20/2015,2015,4,20, 11 ,8465,1571,1363,11399
4/20/2015,2015,4,20, 12 ,8348,1544,1338,11230
4/20/2015,2015,4,20, 13 ,8316,1559,1355,11230
4/20/2015,2015,4,20, 14 ,8669,1608,1387,11664
4/20/2015,2015,4,20, 15 ,8595,1574,1386,11555
4/20/2015,2015,4,20, 16 ,8413,1546,1377,11336
4/20/2015,2015,4,20, 17 ,7876,1447,1287,10610
4/20/2015,2015,4,20, 18 ,7551,1452,1361,10364
4/20/2015,2015,4,20, 19 ,7971,1554,1360,10885
4/20/2015,2015,4,20, 20 ,7838,1380,1339,10557
4/20/2015,2015,4,20, 21 ,7778,1422,1309,10509
4/20/2015,2015,4,20, 22 ,7496,1321,1235,10052
4/20/2015,2015,4,20, 23 ,7180,1231,1135,9546
4/20/2015,2015,4,20, 24 ,6817,1152,1073,9042
4/21/2015,2015,4,21, 1 ,6497,1120,1031,8648
4/21/2015,2015,4,21, 2 ,6301,1081,999,8381
4/21/2015,2015,4,21, 3 ,6086,1051,969,8106
4/21/2015,2015,4,21, 4 ,5995,1025,954,7974
4/21/2015,2015,4,21, 5 ,5881,1035,960,7876
4/21/2015,2015,4,21, 6 ,5795,1021,977,7793
4/21/2015,2015,4,21, 7 ,5999,1055,979,8033
4/21/2015,2015,4,21, 8 ,6823,1209,1135,9167
4/21/2015,2015,4,21, 9 ,7635,1396,1259,10290
4/21/2015,2015,4,21, 10 ,8172,1485,1325,10982
4/21/2015,2015,4,21, 11 ,8483,1549,1364,11396
4/21/2015,2015,4,21, 12 ,8342,1503,1301,11146
4/21/2015,2015,4,21, 13 ,8415,1512,1338,11265
4/21/2015,2015,4,21, 14 ,8545,1580,1402,11527
4/21/2015,2015,4,21, 15 ,7749,1571,1386,10706
4/21/2015,2015,4,21, 16 ,7703,1518,1346,10567
4/21/2015,2015,4,21, 17 ,7395,1412,1261,10068
4/21/2015,2015,4,21, 18 ,7216,1417,1364,9997
4/21/2015,2015,4,21, 19 ,7558,1544,1377,10479
4/21/2015,2015,4,21, 20 ,7429,1501,1362,10292
4/21/2015,2015,4,21, 21 ,7294,1463,1348,10105
4/21/2015,2015,4,21, 22 ,7056,1367,1260,9683
4/21/2015,2015,4,21, 23 ,6736,1260,1171,9167
4/21/2015,2015,4,21, 24 ,6303,1171,1076,8550
4/22/2015,2015,4,22, 1 ,6061,1122,1027,8210
4/22/2015,2015,4,22, 2 ,5841,1085,999,7925
4/22/2015,2015,4,22, 3 ,5669,1054,968,7691
4/22/2015,2015,4,22, 4 ,5585,1034,955,7574
4/22/2015,2015,4,22, 5 ,5551,1035,974,7560
4/22/2015,2015,4,22, 6 ,5503,1017,976,7496
4/22/2015,2015,4,22, 7 ,5769,1039,967,7775
4/22/2015,2015,4,22, 8 ,6575,1205,1123,8903
4/22/2015,2015,4,22, 9 ,7429,1399,1248,10076
4/22/2015,2015,4,22, 10 ,7946,1485,1311,10742
4/22/2015,2015,4,22, 11 ,8230,1532,1348,11110
4/22/2015,2015,4,22, 12 ,8061,1497,1313,10871
4/22/2015,2015,4,22, 13 ,8018,1492,1335,10845
4/22/2015,2015,4,22, 14 ,8334,1559,1379,11272
4/22/2015,2015,4,22, 15 ,8270,1557,1309,11136
4/22/2015,2015,4,22, 16 ,8106,1510,1285,10901
4/22/2015,2015,4,22, 17 ,7585,1399,1236,10220
4/22/2015,2015,4,22, 18 ,7307,1388,1276,9971
4/22/2015,2015,4,22, 19 ,7661,1535,1293,10489
4/22/2015,2015,4,22, 20 ,7579,1489,1317,10385
4/22/2015,2015,4,22, 21 ,7405,1433,1301,10139
4/22/2015,2015,4,22, 22 ,7149,1322,1187,9658
4/22/2015,2015,4,22, 23 ,6785,1233,1162,9180
4/22/2015,2015,4,22, 24 ,6425,1159,586,8170
4/23/2015,2015,4,23, 1 ,6124,1110,1024,8258
4/23/2015,2015,4,23, 2 ,5908,1069,995,7972
4/23/2015,2015,4,23, 3 ,5752,1043,968,7763
4/23/2015,2015,4,23, 4 ,5656,1011,958,7625
4/23/2015,2015,4,23, 5 ,5588,1020,969,7577
4/23/2015,2015,4,23, 6 ,5509,994,960,7463
4/23/2015,2015,4,23, 7 ,5762,1014,971,7747
4/23/2015,2015,4,23, 8 ,6561,1171,1138,8870
4/23/2015,2015,4,23, 9 ,7341,1356,1259,9956
4/23/2015,2015,4,23, 10 ,7855,1454,1329,10638
4/23/2015,2015,4,23, 11 ,8182,1517,1381,11080
4/23/2015,2015,4,23, 12 ,8055,1454,1312,10821
4/23/2015,2015,4,23, 13 ,8067,1451,1343,10861
4/23/2015,2015,4,23, 14 ,8340,1553,1400,11293
4/23/2015,2015,4,23, 15 ,8198,1542,1396,11136
4/23/2015,2015,4,23, 16 ,8090,1505,1373,10968
4/23/2015,2015,4,23, 17 ,7529,1412,1296,10237
4/23/2015,2015,4,23, 18 ,7202,1392,1369,9963
4/23/2015,2015,4,23, 19 ,7616,1526,1342,10484
4/23/2015,2015,4,23, 20 ,7464,1496,1356,10316
4/23/2015,2015,4,23, 21 ,7271,1444,1330,10045
4/23/2015,2015,4,23, 22 ,7027,1335,1233,9595
4/23/2015,2015,4,23, 23 ,6623,1250,1153,9026
4/23/2015,2015,4,23, 24 ,6265,1171,1075,8511
4/24/2015,2015,4,24, 1 ,5992,1108,1050,8150
4/24/2015,2015,4,24, 2 ,5786,1076,1011,7873
4/24/2015,2015,4,24, 3 ,5592,1055,983,7630
4/24/2015,2015,4,24, 4 ,5512,1034,961,7507
4/24/2015,2015,4,24, 5 ,5506,1031,962,7499
4/24/2015,2015,4,24, 6 ,5452,1009,959,7420
4/24/2015,2015,4,24, 7 ,5715,1032,975,7722
4/24/2015,2015,4,24, 8 ,6619,1196,1120,8935
4/24/2015,2015,4,24, 9 ,7317,1390,1261,9968
4/24/2015,2015,4,24, 10 ,7791,1476,1327,10594
4/24/2015,2015,4,24, 11 ,8090,1534,1361,10985
4/24/2015,2015,4,24, 12 ,7929,1488,1330,10747
4/24/2015,2015,4,24, 13 ,7931,1492,1340,10763
4/24/2015,2015,4,24, 14 ,8313,1543,1395,11251
4/24/2015,2015,4,24, 15 ,8218,1534,1354,11106
4/24/2015,2015,4,24, 16 ,7972,1492,1361,10825
4/24/2015,2015,4,24, 17 ,7442,1405,1270,10117
4/24/2015,2015,4,24, 18 ,7117,1397,1324,9838
4/24/2015,2015,4,24, 19 ,7573,1527,1371,10471
4/24/2015,2015,4,24, 20 ,7486,1487,1365,10338
4/24/2015,2015,4,24, 21 ,7317,1437,1321,10075
4/24/2015,2015,4,24, 22 ,7119,1340,1215,9674
4/24/2015,2015,4,24, 23 ,6746,1244,1162,9152
4/24/2015,2015,4,24, 24 ,6362,1169,1105,8636
4/25/2015,2015,4,25, 1 ,6083,1119,1033,8235
4/25/2015,2015,4,25, 2 ,5832,1080,1000,7912
4/25/2015,2015,4,25, 3 ,5685,1047,967,7699
4/25/2015,2015,4,25, 4 ,5537,1020,952,7509
4/25/2015,2015,4,25, 5 ,5493,1011,956,7460
4/25/2015,2015,4,25, 6 ,5282,967,985,7234
4/25/2015,2015,4,25, 7 ,5403,991,987,7381
4/25/2015,2015,4,25, 8 ,5962,1100,1085,8147
4/25/2015,2015,4,25, 9 ,6555,1232,1206,8993
4/25/2015,2015,4,25, 10 ,7073,1313,1250,9636
4/25/2015,2015,4,25, 11 ,7401,1378,1320,10099
4/25/2015,2015,4,25, 12 ,7245,1362,1293,9900
4/25/2015,2015,4,25, 13 ,7269,1357,1306,9932
4/25/2015,2015,4,25, 14 ,7548,1376,1327,10251
4/25/2015,2015,4,25, 15 ,7385,1346,1277,10008
4/25/2015,2015,4,25, 16 ,7133,1287,1253,9673
4/25/2015,2015,4,25, 17 ,6732,1232,1184,9148
4/25/2015,2015,4,25, 18 ,6565,1311,1300,9176
4/25/2015,2015,4,25, 19 ,7195,1434,1341,9970
4/25/2015,2015,4,25, 20 ,7151,1405,1342,9898
4/25/2015,2015,4,25, 21 ,7117,1372,1293,9782
4/25/2015,2015,4,25, 22 ,6917,1280,1219,9416
4/25/2015,2015,4,25, 23 ,6531,1187,1135,8853
4/25/2015,2015,4,25, 24 ,6215,1121,1051,8387
4/26/2015,2015,4,26, 1 ,5929,1084,1032,8045
4/26/2015,2015,4,26, 2 ,5736,1048,998,7782
4/26/2015,2015,4,26, 3 ,5560,1014,956,7530
4/26/2015,2015,4,26, 4 ,5394,997,935,7326
4/26/2015,2015,4,26, 5 ,5309,995,949,7253
4/26/2015,2015,4,26, 6 ,5040,942,920,6902
4/26/2015,2015,4,26, 7 ,5073,951,917,6941
4/26/2015,2015,4,26, 8 ,5376,1003,999,7378
4/26/2015,2015,4,26, 9 ,5724,1092,1082,7898
4/26/2015,2015,4,26, 10 ,6168,1168,1132,8468
4/26/2015,2015,4,26, 11 ,6425,1204,1176,8805
4/26/2015,2015,4,26, 12 ,6331,1209,1180,8720
4/26/2015,2015,4,26, 13 ,6377,1224,1196,8797
4/26/2015,2015,4,26, 14 ,6462,1219,1212,8893
4/26/2015,2015,4,26, 15 ,6353,1203,1185,8741
4/26/2015,2015,4,26, 16 ,6170,1170,1120,8460
4/26/2015,2015,4,26, 17 ,6007,1146,1136,8289
4/26/2015,2015,4,26, 18 ,6104,1247,1253,8604
4/26/2015,2015,4,26, 19 ,6778,1417,1318,9513
4/26/2015,2015,4,26, 20 ,6797,1404,1281,9482
4/26/2015,2015,4,26, 21 ,6714,1345,1195,9254
4/26/2015,2015,4,26, 22 ,6498,1256,1157,8911
4/26/2015,2015,4,26, 23 ,6223,1166,1095,8484
4/26/2015,2015,4,26, 24 ,5949,1086,1062,8097
4/27/2015,2015,4,27, 1 ,5646,1029,972,7647
4/27/2015,2015,4,27, 2 ,5445,1001,946,7392
4/27/2015,2015,4,27, 3 ,5272,974,913,7159
4/27/2015,2015,4,27, 4 ,5173,943,895,7011
4/27/2015,2015,4,27, 5 ,5183,965,908,7056
4/27/2015,2015,4,27, 6 ,5141,949,919,7009
4/27/2015,2015,4,27, 7 ,5529,988,936,7453
4/27/2015,2015,4,27, 8 ,6404,1154,1102,8660
4/27/2015,2015,4,27, 9 ,7289,1346,1204,9839
4/27/2015,2015,4,27, 10 ,7863,1458,1331,10652
4/27/2015,2015,4,27, 11 ,8222,1528,1357,11107
4/27/2015,2015,4,27, 12 ,8098,1497,1330,10925
4/27/2015,2015,4,27, 13 ,8091,1489,1355,10935
4/27/2015,2015,4,27, 14 ,8477,1549,1393,11419
4/27/2015,2015,4,27, 15 ,8375,1521,1366,11262
4/27/2015,2015,4,27, 16 ,8236,1484,1351,11071
4/27/2015,2015,4,27, 17 ,7729,1365,1283,10377
4/27/2015,2015,4,27, 18 ,7340,1378,1324,10042
4/27/2015,2015,4,27, 19 ,7756,1497,1379,10632
4/27/2015,2015,4,27, 20 ,7601,1433,1343,10377
4/27/2015,2015,4,27, 21 ,7468,1383,1301,10152
4/27/2015,2015,4,27, 22 ,7253,1270,1222,9745
4/27/2015,2015,4,27, 23 ,6919,1190,1137,9246
4/27/2015,2015,4,27, 24 ,6513,1110,1076,8699
4/28/2015,2015,4,28, 1 ,6236,1051,1038,8325
4/28/2015,2015,4,28, 2 ,6000,1010,994,8004
4/28/2015,2015,4,28, 3 ,5836,986,954,7776
4/28/2015,2015,4,28, 4 ,5669,978,940,7587
4/28/2015,2015,4,28, 5 ,5628,988,945,7561
4/28/2015,2015,4,28, 6 ,5540,972,942,7454
4/28/2015,2015,4,28, 7 ,5810,984,962,7756
4/28/2015,2015,4,28, 8 ,6653,1143,1130,8926
4/28/2015,2015,4,28, 9 ,7413,1364,1278,10055
4/28/2015,2015,4,28, 10 ,7967,1474,1341,10782
4/28/2015,2015,4,28, 11 ,8304,1530,1411,11245
4/28/2015,2015,4,28, 12 ,8164,1497,1367,11028
4/28/2015,2015,4,28, 13 ,8172,1492,1386,11050
4/28/2015,2015,4,28, 14 ,8518,1561,1410,11489
4/28/2015,2015,4,28, 15 ,8434,1540,1409,11383
4/28/2015,2015,4,28, 16 ,8264,1500,1373,11137
4/28/2015,2015,4,28, 17 ,7690,1407,1295,10392
4/28/2015,2015,4,28, 18 ,7397,1437,1321,10155
4/28/2015,2015,4,28, 19 ,7896,1555,1392,10843
4/28/2015,2015,4,28, 20 ,7788,1527,1367,10682
4/28/2015,2015,4,28, 21 ,7666,1484,1336,10486
4/28/2015,2015,4,28, 22 ,7434,1371,1286,10091
4/28/2015,2015,4,28, 23 ,7141,1266,1176,9583
4/28/2015,2015,4,28, 24 ,6712,1149,1085,8946
4/29/2015,2015,4,29, 1 ,6440,1100,1020,8560
4/29/2015,2015,4,29, 2 ,6231,1054,986,8271
4/29/2015,2015,4,29, 3 ,5994,1024,970,7988
4/29/2015,2015,4,29, 4 ,5865,1004,958,7827
4/29/2015,2015,4,29, 5 ,5822,1009,970,7801
4/29/2015,2015,4,29, 6 ,5687,973,965,7625
4/29/2015,2015,4,29, 7 ,5974,1013,986,7973
4/29/2015,2015,4,29, 8 ,6831,1186,1129,9146
4/29/2015,2015,4,29, 9 ,7485,1387,1279,10151
4/29/2015,2015,4,29, 10 ,8008,1486,1327,10821
4/29/2015,2015,4,29, 11 ,8316,1539,1356,11211
4/29/2015,2015,4,29, 12 ,8176,1484,1368,11028
4/29/2015,2015,4,29, 13 ,8218,1495,1366,11079
4/29/2015,2015,4,29, 14 ,8606,1572,1411,11589
4/29/2015,2015,4,29, 15 ,8546,1536,1399,11481
4/29/2015,2015,4,29, 16 ,8338,1490,1368,11196
4/29/2015,2015,4,29, 17 ,7821,1385,1283,10489
4/29/2015,2015,4,29, 18 ,7530,1378,1341,10249
4/29/2015,2015,4,29, 19 ,8003,1547,1372,10922
4/29/2015,2015,4,29, 20 ,7930,1506,1353,10789
4/29/2015,2015,4,29, 21 ,7752,1457,1278,10487
4/29/2015,2015,4,29, 22 ,7544,1368,1233,10145
4/29/2015,2015,4,29, 23 ,7216,1253,1142,9611
4/29/2015,2015,4,29, 24 ,6851,1165,1057,9073
4/30/2015,2015,4,30, 1 ,6519,1105,1014,8638
4/30/2015,2015,4,30, 2 ,6272,1062,974,8308
4/30/2015,2015,4,30, 3 ,6106,1027,948,8081
4/30/2015,2015,4,30, 4 ,5926,1002,933,7861
4/30/2015,2015,4,30, 5 ,5871,998,960,7829
4/30/2015,2015,4,30, 6 ,5720,972,952,7644
4/30/2015,2015,4,30, 7 ,5920,999,981,7900
4/30/2015,2015,4,30, 8 ,6718,1175,1138,9031
4/30/2015,2015,4,30, 9 ,7541,1368,1293,10202
4/30/2015,2015,4,30, 10 ,8060,1391,1343,10794
4/30/2015,2015,4,30, 11 ,8325,1433,1382,11140
4/30/2015,2015,4,30, 12 ,8177,1477,1360,11014
4/30/2015,2015,4,30, 13 ,8260,1490,1370,11120
4/30/2015,2015,4,30, 14 ,8575,1553,1394,11522
4/30/2015,2015,4,30, 15 ,8506,1529,1373,11408
4/30/2015,2015,4,30, 16 ,8274,1468,1341,11083
4/30/2015,2015,4,30, 17 ,7710,1381,1271,10362
4/30/2015,2015,4,30, 18 ,7360,1383,1324,10067
4/30/2015,2015,4,30, 19 ,7830,1512,1361,10703
4/30/2015,2015,4,30, 20 ,7699,1463,1344,10506
4/30/2015,2015,4,30, 21 ,7598,1412,1290,10300
4/30/2015,2015,4,30, 22 ,7384,1302,1199,9885
4/30/2015,2015,4,30, 23 ,7020,1198,1129,9347
4/30/2015,2015,4,30, 24 ,6649,1121,1049,8819
5/1/2015,2015,5,1, 1 ,6347,1069,1015,8431
5/1/2015,2015,5,1, 2 ,6203,1035,973,8211
5/1/2015,2015,5,1, 3 ,5967,987,932,7886
5/1/2015,2015,5,1, 4 ,5779,967,924,7670
5/1/2015,2015,5,1, 5 ,5618,960,923,7501
5/1/2015,2015,5,1, 6 ,5233,922,894,7049
5/1/2015,2015,5,1, 7 ,5261,937,882,7080
5/1/2015,2015,5,1, 8 ,5587,1028,960,7575
5/1/2015,2015,5,1, 9 ,6036,1142,1091,8269
5/1/2015,2015,5,1, 10 ,6510,1232,1189,8931
5/1/2015,2015,5,1, 11 ,6793,1283,1251,9327
5/1/2015,2015,5,1, 12 ,6772,1254,1230,9256
5/1/2015,2015,5,1, 13 ,6831,1239,1247,9317
5/1/2015,2015,5,1, 14 ,6993,1266,1276,9535
5/1/2015,2015,5,1, 15 ,6965,1260,1263,9488
5/1/2015,2015,5,1, 16 ,6828,1219,1236,9283
5/1/2015,2015,5,1, 17 ,6433,1194,1186,8813
5/1/2015,2015,5,1, 18 ,6352,1289,1241,8882
5/1/2015,2015,5,1, 19 ,7140,1410,1293,9843
5/1/2015,2015,5,1, 20 ,7121,1378,1245,9744
5/1/2015,2015,5,1, 21 ,7033,1333,1236,9602
5/1/2015,2015,5,1, 22 ,6918,1238,1147,9303
5/1/2015,2015,5,1, 23 ,6572,1149,1079,8800
5/1/2015,2015,5,1, 24 ,6276,1073,1024,8373
5/2/2015,2015,5,2, 1 ,5943,1030,963,7936
5/2/2015,2015,5,2, 2 ,5781,1001,933,7715
5/2/2015,2015,5,2, 3 ,5564,970,902,7436
5/2/2015,2015,5,2, 4 ,5414,952,887,7253
5/2/2015,2015,5,2, 5 ,5376,950,909,7235
5/2/2015,2015,5,2, 6 ,5109,915,891,6915
5/2/2015,2015,5,2, 7 ,5243,934,904,7081
5/2/2015,2015,5,2, 8 ,5832,1035,987,7854
5/2/2015,2015,5,2, 9 ,6429,1182,1112,8723
5/2/2015,2015,5,2, 10 ,6933,1270,1220,9423
5/2/2015,2015,5,2, 11 ,7246,1313,1254,9813
5/2/2015,2015,5,2, 12 ,7135,1291,1262,9688
5/2/2015,2015,5,2, 13 ,7148,1273,1267,9688
5/2/2015,2015,5,2, 14 ,7399,1300,1302,10001
5/2/2015,2015,5,2, 15 ,7267,1266,1287,9820
5/2/2015,2015,5,2, 16 ,7006,1208,1262,9476
5/2/2015,2015,5,2, 17 ,6614,1213,1228,9055
5/2/2015,2015,5,2, 18 ,6485,1304,1330,9119
5/2/2015,2015,5,2, 19 ,7146,1389,1316,9851
5/2/2015,2015,5,2, 20 ,7206,1368,1298,9872
5/2/2015,2015,5,2, 21 ,7177,1313,1270,9760
5/2/2015,2015,5,2, 22 ,7072,1234,1174,9480
5/2/2015,2015,5,2, 23 ,6670,1137,1079,8886
5/2/2015,2015,5,2, 24 ,6360,1067,1030,8457
5/3/2015,2015,5,3, 1 ,6140,1015,910,8065
5/3/2015,2015,5,3, 2 ,5902,969,879,7750
5/3/2015,2015,5,3, 3 ,5702,948,853,7503
5/3/2015,2015,5,3, 4 ,5489,941,831,7261
5/3/2015,2015,5,3, 5 ,5377,915,847,7139
5/3/2015,2015,5,3, 6 ,5084,899,878,6861
5/3/2015,2015,5,3, 7 ,5171,901,883,6955
5/3/2015,2015,5,3, 8 ,5408,975,943,7326
5/3/2015,2015,5,3, 9 ,5785,1071,1029,7885
5/3/2015,2015,5,3, 10 ,6267,1157,1123,8547
5/3/2015,2015,5,3, 11 ,6525,1211,1177,8913
5/3/2015,2015,5,3, 12 ,6429,1195,1168,8792
5/3/2015,2015,5,3, 13 ,6368,1203,1160,8731
5/3/2015,2015,5,3, 14 ,6510,1229,1158,8897
5/3/2015,2015,5,3, 15 ,6433,1169,1124,8726
5/3/2015,2015,5,3, 16 ,6205,1122,1063,8390
5/3/2015,2015,5,3, 17 ,6084,1126,1056,8266
5/3/2015,2015,5,3, 18 ,6156,1246,1198,8600
5/3/2015,2015,5,3, 19 ,6799,1336,1250,9385
5/3/2015,2015,5,3, 20 ,6868,1306,1231,9405
5/3/2015,2015,5,3, 21 ,6898,1265,1167,9330
5/3/2015,2015,5,3, 22 ,6672,1180,1085,8937
5/3/2015,2015,5,3, 23 ,6364,1101,1010,8475
5/3/2015,2015,5,3, 24 ,6098,1015,943,8056
5/4/2015,2015,5,4, 1 ,5807,979,905,7691
5/4/2015,2015,5,4, 2 ,5573,946,885,7404
5/4/2015,2015,5,4, 3 ,5384,923,852,7159
5/4/2015,2015,5,4, 4 ,5255,905,844,7004
5/4/2015,2015,5,4, 5 ,5259,909,871,7039
5/4/2015,2015,5,4, 6 ,5235,914,885,7034
5/4/2015,2015,5,4, 7 ,5681,954,905,7540
5/4/2015,2015,5,4, 8 ,6649,1113,1054,8816
5/4/2015,2015,5,4, 9 ,7474,1312,1223,10009
5/4/2015,2015,5,4, 10 ,8055,1392,1317,10764
5/4/2015,2015,5,4, 11 ,8388,1450,1360,11198
5/4/2015,2015,5,4, 12 ,8307,1400,1311,11018
5/4/2015,2015,5,4, 13 ,8278,1424,1324,11026
5/4/2015,2015,5,4, 14 ,8541,1468,1362,11371
5/4/2015,2015,5,4, 15 ,8360,1462,1337,11159
5/4/2015,2015,5,4, 16 ,8069,1441,1322,10832
5/4/2015,2015,5,4, 17 ,7573,1375,1273,10221
5/4/2015,2015,5,4, 18 ,7426,1400,1312,10138
5/4/2015,2015,5,4, 19 ,7538,1501,1350,10389
5/4/2015,2015,5,4, 20 ,7417,1468,1332,10217
5/4/2015,2015,5,4, 21 ,7269,1398,1250,9917
5/4/2015,2015,5,4, 22 ,7075,1280,1160,9515
5/4/2015,2015,5,4, 23 ,6793,1183,1075,9051
5/4/2015,2015,5,4, 24 ,6345,1097,1010,8452
5/5/2015,2015,5,5, 1 ,6142,1049,964,8155
5/5/2015,2015,5,5, 2 ,5902,1009,940,7851
5/5/2015,2015,5,5, 3 ,5754,982,916,7652
5/5/2015,2015,5,5, 4 ,5598,964,897,7459
5/5/2015,2015,5,5, 5 ,5600,972,926,7498
5/5/2015,2015,5,5, 6 ,5474,965,930,7369
5/5/2015,2015,5,5, 7 ,5872,995,941,7808
5/5/2015,2015,5,5, 8 ,6695,1172,1094,8961
5/5/2015,2015,5,5, 9 ,7539,1383,1251,10173
5/5/2015,2015,5,5, 10 ,7999,1455,1345,10799
5/5/2015,2015,5,5, 11 ,8356,1516,1387,11259
5/5/2015,2015,5,5, 12 ,8238,1497,1348,11083
5/5/2015,2015,5,5, 13 ,8293,1489,1361,11143
5/5/2015,2015,5,5, 14 ,8589,1556,1404,11549
5/5/2015,2015,5,5, 15 ,8549,1532,1378,11459
5/5/2015,2015,5,5, 16 ,8377,1507,1356,11240
5/5/2015,2015,5,5, 17 ,7895,1409,1287,10591
5/5/2015,2015,5,5, 18 ,7614,1390,1346,10350
5/5/2015,2015,5,5, 19 ,7936,1519,1358,10813
5/5/2015,2015,5,5, 20 ,7821,1468,1324,10613
5/5/2015,2015,5,5, 21 ,7691,1405,1287,10383
5/5/2015,2015,5,5, 22 ,7510,1299,1208,10017
5/5/2015,2015,5,5, 23 ,7156,1193,1127,9476
5/5/2015,2015,5,5, 24 ,6759,1119,994,8872
5/6/2015,2015,5,6, 1 ,6479,1054,987,8520
5/6/2015,2015,5,6, 2 ,6274,1011,957,8242
5/6/2015,2015,5,6, 3 ,6078,983,924,7985
5/6/2015,2015,5,6, 4 ,5901,969,913,7783
5/6/2015,2015,5,6, 5 ,5829,973,923,7725
5/6/2015,2015,5,6, 6 ,5698,958,930,7586
5/6/2015,2015,5,6, 7 ,5916,1000,929,7845
5/6/2015,2015,5,6, 8 ,6807,1170,1101,9078
5/6/2015,2015,5,6, 9 ,7659,1374,1216,10249
5/6/2015,2015,5,6, 10 ,8198,1478,1285,10961
5/6/2015,2015,5,6, 11 ,8550,1531,1341,11422
5/6/2015,2015,5,6, 12 ,8366,1489,1315,11170
5/6/2015,2015,5,6, 13 ,8431,1500,1327,11258
5/6/2015,2015,5,6, 14 ,8725,1565,1375,11665
5/6/2015,2015,5,6, 15 ,8620,1550,1351,11521
5/6/2015,2015,5,6, 16 ,8379,1500,1315,11194
5/6/2015,2015,5,6, 17 ,7787,1409,1252,10448
5/6/2015,2015,5,6, 18 ,7476,1413,1288,10177
5/6/2015,2015,5,6, 19 ,7807,1534,1339,10680
5/6/2015,2015,5,6, 20 ,7657,1493,1293,10443
5/6/2015,2015,5,6, 21 ,7523,1430,1264,10217
5/6/2015,2015,5,6, 22 ,7204,1299,1187,9690
5/6/2015,2015,5,6, 23 ,6988,1199,1110,9297
5/6/2015,2015,5,6, 24 ,6596,1119,942,8657
5/7/2015,2015,5,7, 1 ,6363,1071,908,8342
5/7/2015,2015,5,7, 2 ,6136,1032,895,8063
5/7/2015,2015,5,7, 3 ,5952,1002,873,7827
5/7/2015,2015,5,7, 4 ,5783,988,865,7636
5/7/2015,2015,5,7, 5 ,5739,991,883,7613
5/7/2015,2015,5,7, 6 ,5633,979,892,7504
5/7/2015,2015,5,7, 7 ,5892,1008,889,7789
5/7/2015,2015,5,7, 8 ,6752,1197,1097,9046
5/7/2015,2015,5,7, 9 ,7614,1390,1232,10236
5/7/2015,2015,5,7, 10 ,8145,1496,1300,10941
5/7/2015,2015,5,7, 11 ,8422,1531,1335,11288
5/7/2015,2015,5,7, 12 ,8282,1503,1291,11076
5/7/2015,2015,5,7, 13 ,8318,1505,1309,11132
5/7/2015,2015,5,7, 14 ,8645,1582,1332,11559
5/7/2015,2015,5,7, 15 ,8487,1554,1330,11371
5/7/2015,2015,5,7, 16 ,8295,1514,1330,11139
5/7/2015,2015,5,7, 17 ,7832,1430,1288,10550
5/7/2015,2015,5,7, 18 ,7588,1429,1349,10366
5/7/2015,2015,5,7, 19 ,7834,1553,1339,10726
5/7/2015,2015,5,7, 20 ,7704,1507,1348,10559
5/7/2015,2015,5,7, 21 ,7558,1451,1336,10345
5/7/2015,2015,5,7, 22 ,7349,1343,1237,9929
5/7/2015,2015,5,7, 23 ,6961,1231,1169,9361
5/7/2015,2015,5,7, 24 ,6568,1146,1162,8876
5/8/2015,2015,5,8, 1 ,6317,1090,1047,8454
5/8/2015,2015,5,8, 2 ,6128,1054,1024,8206
5/8/2015,2015,5,8, 3 ,5897,1015,982,7894
5/8/2015,2015,5,8, 4 ,5732,997,968,7697
5/8/2015,2015,5,8, 5 ,5682,1002,997,7681
5/8/2015,2015,5,8, 6 ,5593,984,991,7568
5/8/2015,2015,5,8, 7 ,5866,1018,1004,7888
5/8/2015,2015,5,8, 8 ,6723,1197,1152,9072
5/8/2015,2015,5,8, 9 ,7559,1396,1248,10203
5/8/2015,2015,5,8, 10 ,8058,1500,1322,10880
5/8/2015,2015,5,8, 11 ,8382,1549,1360,11291
5/8/2015,2015,5,8, 12 ,8208,1501,1346,11055
5/8/2015,2015,5,8, 13 ,8247,1509,1354,11110
5/8/2015,2015,5,8, 14 ,8557,1574,1379,11510
5/8/2015,2015,5,8, 15 ,8487,1565,1372,11424
5/8/2015,2015,5,8, 16 ,8333,1524,1365,11222
5/8/2015,2015,5,8, 17 ,7787,1409,1282,10478
5/8/2015,2015,5,8, 18 ,7522,1404,1354,10280
5/8/2015,2015,5,8, 19 ,7874,1538,1347,10759
5/8/2015,2015,5,8, 20 ,7773,1494,1329,10596
5/8/2015,2015,5,8, 21 ,7723,1417,1282,10422
5/8/2015,2015,5,8, 22 ,7397,1313,1203,9913
5/8/2015,2015,5,8, 23 ,7068,1206,1136,9410
5/8/2015,2015,5,8, 24 ,6691,1133,1064,8888
5/9/2015,2015,5,9, 1 ,6387,1083,1025,8495
5/9/2015,2015,5,9, 2 ,6155,1047,982,8184
5/9/2015,2015,5,9, 3 ,5946,1006,958,7910
5/9/2015,2015,5,9, 4 ,5805,988,941,7734
5/9/2015,2015,5,9, 5 ,5693,986,958,7637
5/9/2015,2015,5,9, 6 ,5492,954,915,7361
5/9/2015,2015,5,9, 7 ,5611,968,928,7507
5/9/2015,2015,5,9, 8 ,6099,1097,1018,8214
5/9/2015,2015,5,9, 9 ,6769,1272,1148,9189
5/9/2015,2015,5,9, 10 ,7306,1333,1224,9863
5/9/2015,2015,5,9, 11 ,7545,1403,1283,10231
5/9/2015,2015,5,9, 12 ,7517,1365,1260,10142
5/9/2015,2015,5,9, 13 ,7481,1369,1256,10106
5/9/2015,2015,5,9, 14 ,7749,1424,1243,10416
5/9/2015,2015,5,9, 15 ,7635,1398,1231,10264
5/9/2015,2015,5,9, 16 ,7379,1348,1254,9981
5/9/2015,2015,5,9, 17 ,6981,1275,1218,9474
5/9/2015,2015,5,9, 18 ,6850,1359,1332,9541
5/9/2015,2015,5,9, 19 ,7431,1486,1353,10270
5/9/2015,2015,5,9, 20 ,7177,1442,1321,9940
5/9/2015,2015,5,9, 21 ,7235,1419,1198,9852
5/9/2015,2015,5,9, 22 ,7076,1330,1115,9521
5/9/2015,2015,5,9, 23 ,6720,1226,1016,8962
5/9/2015,2015,5,9, 24 ,6423,1152,957,8532
5/10/2015,2015,5,10, 1 ,6172,1090,998,8260
5/10/2015,2015,5,10, 2 ,5986,1047,975,8008
5/10/2015,2015,5,10, 3 ,5793,1014,945,7752
5/10/2015,2015,5,10, 4 ,5640,976,919,7535
5/10/2015,2015,5,10, 5 ,5534,974,932,7440
5/10/2015,2015,5,10, 6 ,5261,928,904,7093
5/10/2015,2015,5,10, 7 ,5187,938,894,7019
5/10/2015,2015,5,10, 8 ,5448,1007,952,7407
5/10/2015,2015,5,10, 9 ,5755,1084,1021,7860
5/10/2015,2015,5,10, 10 ,6172,1150,1115,8437
5/10/2015,2015,5,10, 11 ,6336,1197,1166,8699
5/10/2015,2015,5,10, 12 ,6283,1200,1155,8638
5/10/2015,2015,5,10, 13 ,6347,1223,1164,8734
5/10/2015,2015,5,10, 14 ,6445,1235,1165,8845
5/10/2015,2015,5,10, 15 ,6335,1217,1147,8699
5/10/2015,2015,5,10, 16 ,6299,1209,1135,8643
5/10/2015,2015,5,10, 17 ,6111,1162,1118,8391
5/10/2015,2015,5,10, 18 ,6241,1244,1240,8725
5/10/2015,2015,5,10, 19 ,6856,1419,1264,9539
5/10/2015,2015,5,10, 20 ,6895,1390,1240,9525
5/10/2015,2015,5,10, 21 ,6873,1343,1223,9439
5/10/2015,2015,5,10, 22 ,6741,1297,1022,9060
5/10/2015,2015,5,10, 23 ,6500,1207,960,8667
5/10/2015,2015,5,10, 24 ,6203,1133,888,8224
5/11/2015,2015,5,11, 1 ,5935,1075,963,7973
5/11/2015,2015,5,11, 2 ,5690,1026,930,7646
5/11/2015,2015,5,11, 3 ,5510,986,914,7410
5/11/2015,2015,5,11, 4 ,5432,966,891,7289
5/11/2015,2015,5,11, 5 ,5392,969,908,7269
5/11/2015,2015,5,11, 6 ,5385,961,922,7268
5/11/2015,2015,5,11, 7 ,5790,1006,927,7723
5/11/2015,2015,5,11, 8 ,6727,1183,1090,9000
5/11/2015,2015,5,11, 9 ,7538,1389,1178,10105
5/11/2015,2015,5,11, 10 ,8052,1488,1291,10831
5/11/2015,2015,5,11, 11 ,8335,1541,1327,11203
5/11/2015,2015,5,11, 12 ,8222,1495,1297,11014
5/11/2015,2015,5,11, 13 ,8259,1514,1300,11073
5/11/2015,2015,5,11, 14 ,8549,1571,1342,11462
5/11/2015,2015,5,11, 15 ,8423,1535,1332,11290
5/11/2015,2015,5,11, 16 ,8224,1498,1310,11032
5/11/2015,2015,5,11, 17 ,7819,1412,1281,10512
5/11/2015,2015,5,11, 18 ,7486,1450,1314,10250
5/11/2015,2015,5,11, 19 ,7955,1550,1336,10841
5/11/2015,2015,5,11, 20 ,7806,1515,1319,10640
5/11/2015,2015,5,11, 21 ,7756,1463,1286,10505
5/11/2015,2015,5,11, 22 ,7454,1345,1188,9987
5/11/2015,2015,5,11, 23 ,7149,1258,1142,9549
5/11/2015,2015,5,11, 24 ,6724,1173,1082,8979
5/12/2015,2015,5,12, 1 ,6517,1125,1035,8677
5/12/2015,2015,5,12, 2 ,6253,1096,999,8348
5/12/2015,2015,5,12, 3 ,6069,1067,974,8110
5/12/2015,2015,5,12, 4 ,5881,1041,963,7885
5/12/2015,2015,5,12, 5 ,5878,1041,972,7891
5/12/2015,2015,5,12, 6 ,5717,1020,963,7700
5/12/2015,2015,5,12, 7 ,6049,1056,967,8072
5/12/2015,2015,5,12, 8 ,6912,1230,1085,9227
5/12/2015,2015,5,12, 9 ,7679,1433,1156,10268
5/12/2015,2015,5,12, 10 ,8146,1514,1272,10932
5/12/2015,2015,5,12, 11 ,8456,1558,1327,11341
5/12/2015,2015,5,12, 12 ,8355,1516,1307,11178
5/12/2015,2015,5,12, 13 ,8390,1519,1330,11239
5/12/2015,2015,5,12, 14 ,8743,1599,1336,11678
5/12/2015,2015,5,12, 15 ,8485,1568,1351,11404
5/12/2015,2015,5,12, 16 ,8300,1565,1326,11191
5/12/2015,2015,5,12, 17 ,7880,1448,1267,10595
5/12/2015,2015,5,12, 18 ,7633,1432,1321,10386
5/12/2015,2015,5,12, 19 ,8052,1568,1358,10978
5/12/2015,2015,5,12, 20 ,7921,1519,1317,10757
5/12/2015,2015,5,12, 21 ,7800,1488,1285,10573
5/12/2015,2015,5,12, 22 ,7539,1366,1214,10119
5/12/2015,2015,5,12, 23 ,7170,1273,1137,9580
5/12/2015,2015,5,12, 24 ,6788,1197,1116,9101
5/13/2015,2015,5,13, 1 ,6476,1144,1039,8659
5/13/2015,2015,5,13, 2 ,6285,1099,1008,8392
5/13/2015,2015,5,13, 3 ,6077,1071,977,8125
5/13/2015,2015,5,13, 4 ,5965,1048,960,7973
5/13/2015,2015,5,13, 5 ,5922,1042,978,7942
5/13/2015,2015,5,13, 6 ,5745,1007,977,7729
5/13/2015,2015,5,13, 7 ,6084,1047,985,8116
5/13/2015,2015,5,13, 8 ,6993,1213,1132,9338
5/13/2015,2015,5,13, 9 ,7758,1407,1241,10406
5/13/2015,2015,5,13, 10 ,8168,1497,1310,10975
5/13/2015,2015,5,13, 11 ,8423,1545,1359,11327
5/13/2015,2015,5,13, 12 ,8287,1506,1309,11102
5/13/2015,2015,5,13, 13 ,8333,1506,1359,11198
5/13/2015,2015,5,13, 14 ,8651,1551,1384,11586
5/13/2015,2015,5,13, 15 ,8542,1523,1381,11446
5/13/2015,2015,5,13, 16 ,8364,1519,1336,11219
5/13/2015,2015,5,13, 17 ,7802,1423,1271,10496
5/13/2015,2015,5,13, 18 ,7464,1386,1329,10179
5/13/2015,2015,5,13, 19 ,7928,1534,1378,10840
5/13/2015,2015,5,13, 20 ,7813,1489,1349,10651
5/13/2015,2015,5,13, 21 ,7648,1442,1327,10417
5/13/2015,2015,5,13, 22 ,7459,1337,1199,9995
5/13/2015,2015,5,13, 23 ,7157,1248,1172,9577
5/13/2015,2015,5,13, 24 ,6809,1170,1114,9093
5/14/2015,2015,5,14, 1 ,6455,1125,1047,8627
5/14/2015,2015,5,14, 2 ,6208,1068,1018,8294
5/14/2015,2015,5,14, 3 ,6023,1052,976,8051
5/14/2015,2015,5,14, 4 ,5875,1022,973,7870
5/14/2015,2015,5,14, 5 ,5830,1030,987,7847
5/14/2015,2015,5,14, 6 ,5671,991,962,7624
5/14/2015,2015,5,14, 7 ,6043,1021,991,8055
5/14/2015,2015,5,14, 8 ,6896,1188,1128,9212
5/14/2015,2015,5,14, 9 ,7632,1399,1256,10287
5/14/2015,2015,5,14, 10 ,8075,1493,1299,10867
5/14/2015,2015,5,14, 11 ,8416,1546,1371,11333
5/14/2015,2015,5,14, 12 ,8220,1500,1358,11078
5/14/2015,2015,5,14, 13 ,8302,1511,1363,11176
5/14/2015,2015,5,14, 14 ,8651,1584,1414,11649
5/14/2015,2015,5,14, 15 ,8604,1558,1401,11563
5/14/2015,2015,5,14, 16 ,8407,1511,1351,11269
5/14/2015,2015,5,14, 17 ,7895,1391,1284,10570
5/14/2015,2015,5,14, 18 ,7499,1384,1341,10224
5/14/2015,2015,5,14, 19 ,7884,1539,1349,10772
5/14/2015,2015,5,14, 20 ,7840,1484,1354,10678
5/14/2015,2015,5,14, 21 ,7675,1443,1332,10450
5/14/2015,2015,5,14, 22 ,7444,1347,1246,10037
5/14/2015,2015,5,14, 23 ,7159,1249,1183,9591
5/14/2015,2015,5,14, 24 ,6823,1188,1120,9131
5/15/2015,2015,5,15, 1 ,6499,1138,1060,8697
5/15/2015,2015,5,15, 2 ,6276,1097,1025,8398
5/15/2015,2015,5,15, 3 ,6050,1061,995,8106
5/15/2015,2015,5,15, 4 ,5878,1028,977,7883
5/15/2015,2015,5,15, 5 ,5810,1040,987,7837
5/15/2015,2015,5,15, 6 ,5681,1008,968,7657
5/15/2015,2015,5,15, 7 ,5960,1050,986,7996
5/15/2015,2015,5,15, 8 ,6806,1216,1116,9138
5/15/2015,2015,5,15, 9 ,7553,1415,1221,10189
5/15/2015,2015,5,15, 10 ,7953,1482,1308,10743
5/15/2015,2015,5,15, 11 ,8202,1533,1343,11078
5/15/2015,2015,5,15, 12 ,8031,1476,1306,10813
5/15/2015,2015,5,15, 13 ,8090,1489,1318,10897
5/15/2015,2015,5,15, 14 ,8523,1552,1349,11424
5/15/2015,2015,5,15, 15 ,8360,1543,1331,11234
5/15/2015,2015,5,15, 16 ,8271,1488,1321,11080
5/15/2015,2015,5,15, 17 ,7779,1384,1232,10395
5/15/2015,2015,5,15, 18 ,7335,1353,1312,10000
5/15/2015,2015,5,15, 19 ,7762,1502,1334,10598
5/15/2015,2015,5,15, 20 ,7685,1467,1323,10475
5/15/2015,2015,5,15, 21 ,7564,1416,1298,10278
5/15/2015,2015,5,15, 22 ,7373,1333,1228,9934
5/15/2015,2015,5,15, 23 ,7051,1189,1161,9401
5/15/2015,2015,5,15, 24 ,6716,1161,1075,8952
5/16/2015,2015,5,16, 1 ,6439,1119,1016,8574
5/16/2015,2015,5,16, 2 ,6244,1080,978,8302
5/16/2015,2015,5,16, 3 ,6009,1047,953,8009
5/16/2015,2015,5,16, 4 ,5815,1021,937,7773
5/16/2015,2015,5,16, 5 ,5715,1022,943,7680
5/16/2015,2015,5,16, 6 ,5521,972,928,7421
5/16/2015,2015,5,16, 7 ,5627,1003,905,7535
5/16/2015,2015,5,16, 8 ,6247,1122,1012,8381
5/16/2015,2015,5,16, 9 ,6919,1273,1121,9313
5/16/2015,2015,5,16, 10 ,7340,1341,1200,9881
5/16/2015,2015,5,16, 11 ,7652,1404,1276,10332
5/16/2015,2015,5,16, 12 ,7553,1383,1249,10185
5/16/2015,2015,5,16, 13 ,7549,1372,1270,10191
5/16/2015,2015,5,16, 14 ,7760,1414,1299,10473
5/16/2015,2015,5,16, 15 ,7655,1385,1280,10320
5/16/2015,2015,5,16, 16 ,7420,1343,1249,10012
5/16/2015,2015,5,16, 17 ,7026,1267,1247,9540
5/16/2015,2015,5,16, 18 ,6799,1318,1276,9393
5/16/2015,2015,5,16, 19 ,7454,1484,1319,10257
5/16/2015,2015,5,16, 20 ,7444,1440,1316,10200
5/16/2015,2015,5,16, 21 ,7505,1387,1294,10186
5/16/2015,2015,5,16, 22 ,7362,1345,1225,9932
5/16/2015,2015,5,16, 23 ,7085,1226,1164,9475
5/16/2015,2015,5,16, 24 ,6753,1145,1074,8972
5/17/2015,2015,5,17, 1 ,6439,1086,1017,8542
5/17/2015,2015,5,17, 2 ,6226,1047,985,8258
5/17/2015,2015,5,17, 3 ,5995,1011,954,7960
5/17/2015,2015,5,17, 4 ,5786,991,935,7712
5/17/2015,2015,5,17, 5 ,5641,974,943,7558
5/17/2015,2015,5,17, 6 ,5313,924,921,7158
5/17/2015,2015,5,17, 7 ,5306,934,895,7135
5/17/2015,2015,5,17, 8 ,5615,994,922,7531
5/17/2015,2015,5,17, 9 ,6042,1083,983,8108
5/17/2015,2015,5,17, 10 ,6411,1151,1064,8626
5/17/2015,2015,5,17, 11 ,6556,1205,1126,8887
5/17/2015,2015,5,17, 12 ,6543,1198,1136,8877
5/17/2015,2015,5,17, 13 ,6606,1202,1119,8927
5/17/2015,2015,5,17, 14 ,6715,1201,1127,9043
5/17/2015,2015,5,17, 15 ,6591,1186,1115,8892
5/17/2015,2015,5,17, 16 ,6475,1164,1099,8738
5/17/2015,2015,5,17, 17 ,6283,1135,1098,8516
5/17/2015,2015,5,17, 18 ,6312,1210,1222,8744
5/17/2015,2015,5,17, 19 ,6943,1384,1282,9609
5/17/2015,2015,5,17, 20 ,7035,1369,1278,9682
5/17/2015,2015,5,17, 21 ,7003,1321,1259,9583
5/17/2015,2015,5,17, 22 ,6810,1256,1176,9242
5/17/2015,2015,5,17, 23 ,6624,1169,1119,8912
5/17/2015,2015,5,17, 24 ,6295,1097,1017,8409
5/18/2015,2015,5,18, 1 ,5942,1049,963,7954
5/18/2015,2015,5,18, 2 ,5669,1008,930,7607
5/18/2015,2015,5,18, 3 ,5520,973,908,7401
5/18/2015,2015,5,18, 4 ,5382,960,894,7236
5/18/2015,2015,5,18, 5 ,5325,961,917,7203
5/18/2015,2015,5,18, 6 ,5265,949,925,7139
5/18/2015,2015,5,18, 7 ,5713,984,934,7631
5/18/2015,2015,5,18, 8 ,6645,1152,1080,8877
5/18/2015,2015,5,18, 9 ,7477,1366,1233,10076
5/18/2015,2015,5,18, 10 ,7944,1471,1303,10718
5/18/2015,2015,5,18, 11 ,8311,1509,1344,11164
5/18/2015,2015,5,18, 12 ,8190,1450,1318,10958
5/18/2015,2015,5,18, 13 ,8237,1482,1353,11072
5/18/2015,2015,5,18, 14 ,8570,1521,1372,11463
5/18/2015,2015,5,18, 15 ,8486,1513,1358,11357
5/18/2015,2015,5,18, 16 ,8299,1481,1352,11132
5/18/2015,2015,5,18, 17 ,7824,1388,1284,10496
5/18/2015,2015,5,18, 18 ,7466,1387,1295,10148
5/18/2015,2015,5,18, 19 ,7896,1526,1331,10753
5/18/2015,2015,5,18, 20 ,7874,1478,1304,10656
5/18/2015,2015,5,18, 21 ,7748,1428,1297,10473
5/18/2015,2015,5,18, 22 ,7576,1339,1198,10113
5/18/2015,2015,5,18, 23 ,7291,1225,1148,9664
5/18/2015,2015,5,18, 24 ,6882,1154,1071,9107
5/19/2015,2015,5,19, 1 ,6602,1099,1045,8746
5/19/2015,2015,5,19, 2 ,6350,1063,1016,8429
5/19/2015,2015,5,19, 3 ,6152,1033,964,8149
5/19/2015,2015,5,19, 4 ,5973,999,961,7933
5/19/2015,2015,5,19, 5 ,5917,1012,963,7892
5/19/2015,2015,5,19, 6 ,5817,983,953,7753
5/19/2015,2015,5,19, 7 ,6136,1006,970,8112
5/19/2015,2015,5,19, 8 ,6963,1198,1127,9288
5/19/2015,2015,5,19, 9 ,7720,1409,1244,10373
5/19/2015,2015,5,19, 10 ,8153,1491,1303,10947
5/19/2015,2015,5,19, 11 ,8425,1548,1368,11341
5/19/2015,2015,5,19, 12 ,8308,1507,1326,11141
5/19/2015,2015,5,19, 13 ,8342,1491,1362,11195
5/19/2015,2015,5,19, 14 ,8707,1537,1373,11617
5/19/2015,2015,5,19, 15 ,8585,1513,1377,11475
5/19/2015,2015,5,19, 16 ,8403,1502,1347,11252
5/19/2015,2015,5,19, 17 ,7900,1388,1302,10590
5/19/2015,2015,5,19, 18 ,7497,1389,1348,10234
5/19/2015,2015,5,19, 19 ,7997,1523,1349,10869
5/19/2015,2015,5,19, 20 ,7935,1497,1303,10735
5/19/2015,2015,5,19, 21 ,7861,1459,1288,10608
5/19/2015,2015,5,19, 22 ,7653,1351,1192,10196
5/19/2015,2015,5,19, 23 ,7342,1257,1123,9722
5/19/2015,2015,5,19, 24 ,6871,1207,1084,9162
5/20/2015,2015,5,20, 1 ,6649,1133,1016,8798
5/20/2015,2015,5,20, 2 ,6398,1096,995,8489
5/20/2015,2015,5,20, 3 ,6211,1063,971,8245
5/20/2015,2015,5,20, 4 ,6091,1044,965,8100
5/20/2015,2015,5,20, 5 ,5957,1045,978,7980
5/20/2015,2015,5,20, 6 ,5791,1010,977,7778
5/20/2015,2015,5,20, 7 ,6142,1039,985,8166
5/20/2015,2015,5,20, 8 ,7110,1212,1125,9447
5/20/2015,2015,5,20, 9 ,7768,1405,1267,10440
5/20/2015,2015,5,20, 10 ,8216,1497,1346,11059
5/20/2015,2015,5,20, 11 ,8496,1523,1393,11412
5/20/2015,2015,5,20, 12 ,8398,1510,1362,11270
5/20/2015,2015,5,20, 13 ,8416,1523,1380,11319
5/20/2015,2015,5,20, 14 ,8750,1580,1430,11760
5/20/2015,2015,5,20, 15 ,8675,1520,1402,11597
5/20/2015,2015,5,20, 16 ,8478,1510,1403,11391
5/20/2015,2015,5,20, 17 ,7983,1394,1279,10656
5/20/2015,2015,5,20, 18 ,7655,1399,1362,10416
5/20/2015,2015,5,20, 19 ,8101,1531,1383,11015
5/20/2015,2015,5,20, 20 ,8048,1502,1375,10925
5/20/2015,2015,5,20, 21 ,7973,1470,1347,10790
5/20/2015,2015,5,20, 22 ,7809,1385,1264,10458
5/20/2015,2015,5,20, 23 ,7458,1268,1187,9913
5/20/2015,2015,5,20, 24 ,7146,1197,1166,9509
5/21/2015,2015,5,21, 1 ,6803,1142,1073,9018
5/21/2015,2015,5,21, 2 ,6542,1104,1043,8689
5/21/2015,2015,5,21, 3 ,6348,1067,1008,8423
5/21/2015,2015,5,21, 4 ,6165,1046,992,8203
5/21/2015,2015,5,21, 5 ,6076,1050,997,8123
5/21/2015,2015,5,21, 6 ,5916,1019,990,7925
5/21/2015,2015,5,21, 7 ,6204,1045,989,8238
5/21/2015,2015,5,21, 8 ,7172,1225,1144,9541
5/21/2015,2015,5,21, 9 ,7863,1433,1290,10586
5/21/2015,2015,5,21, 10 ,8461,1522,1359,11342
5/21/2015,2015,5,21, 11 ,8621,1580,1402,11603
5/21/2015,2015,5,21, 12 ,8543,1526,1346,11415
5/21/2015,2015,5,21, 13 ,8576,1544,1388,11508
5/21/2015,2015,5,21, 14 ,8838,1616,1409,11863
5/21/2015,2015,5,21, 15 ,8732,1599,1384,11715
5/21/2015,2015,5,21, 16 ,8569,1548,1361,11478
5/21/2015,2015,5,21, 17 ,8049,1445,1276,10770
5/21/2015,2015,5,21, 18 ,7757,1450,1322,10529
5/21/2015,2015,5,21, 19 ,8107,1551,1352,11010
5/21/2015,2015,5,21, 20 ,8027,1505,1299,10831
5/21/2015,2015,5,21, 21 ,8040,1475,1332,10847
5/21/2015,2015,5,21, 22 ,7806,1356,1239,10401
5/21/2015,2015,5,21, 23 ,7444,1266,1150,9860
5/21/2015,2015,5,21, 24 ,7141,1183,1093,9417
5/22/2015,2015,5,22, 1 ,6843,1137,1045,9025
5/22/2015,2015,5,22, 2 ,6579,1100,1013,8692
5/22/2015,2015,5,22, 3 ,6402,1067,981,8450
5/22/2015,2015,5,22, 4 ,6157,1045,966,8168
5/22/2015,2015,5,22, 5 ,6110,1041,985,8136
5/22/2015,2015,5,22, 6 ,5989,1019,971,7979
5/22/2015,2015,5,22, 7 ,6267,1052,970,8289
5/22/2015,2015,5,22, 8 ,7153,1225,1133,9511
5/22/2015,2015,5,22, 9 ,7833,1422,1294,10549
5/22/2015,2015,5,22, 10 ,8275,1507,1354,11136
5/22/2015,2015,5,22, 11 ,8580,1568,1429,11577
5/22/2015,2015,5,22, 12 ,8392,1512,1372,11276
5/22/2015,2015,5,22, 13 ,8442,1516,1417,11375
5/22/2015,2015,5,22, 14 ,8686,1587,1440,11713
5/22/2015,2015,5,22, 15 ,8528,1575,1429,11532
5/22/2015,2015,5,22, 16 ,8383,1551,1398,11332
5/22/2015,2015,5,22, 17 ,7875,1435,1310,10620
5/22/2015,2015,5,22, 18 ,7633,1440,1364,10437
5/22/2015,2015,5,22, 19 ,8035,1566,1392,10993
5/22/2015,2015,5,22, 20 ,7957,1535,1382,10874
5/22/2015,2015,5,22, 21 ,7898,1477,1359,10734
5/22/2015,2015,5,22, 22 ,7666,1390,1265,10321
5/22/2015,2015,5,22, 23 ,7419,1282,1173,9874
5/22/2015,2015,5,22, 24 ,7003,1204,1111,9318
5/23/2015,2015,5,23, 1 ,6614,1144,1064,8822
5/23/2015,2015,5,23, 2 ,6487,1111,1023,8621
5/23/2015,2015,5,23, 3 ,6278,1077,993,8348
5/23/2015,2015,5,23, 4 ,6109,1050,972,8131
5/23/2015,2015,5,23, 5 ,5994,1053,984,8031
5/23/2015,2015,5,23, 6 ,5749,1010,960,7719
5/23/2015,2015,5,23, 7 ,5857,1027,951,7835
5/23/2015,2015,5,23, 8 ,6437,1147,1056,8640
5/23/2015,2015,5,23, 9 ,7050,1297,1161,9508
5/23/2015,2015,5,23, 10 ,7557,1391,1247,10195
5/23/2015,2015,5,23, 11 ,7828,1433,1306,10567
5/23/2015,2015,5,23, 12 ,7705,1404,1312,10421
5/23/2015,2015,5,23, 13 ,7684,1412,1330,10426
5/23/2015,2015,5,23, 14 ,7858,1464,1355,10677
5/23/2015,2015,5,23, 15 ,7677,1424,1308,10409
5/23/2015,2015,5,23, 16 ,7406,1371,1261,10038
5/23/2015,2015,5,23, 17 ,7003,1313,1216,9532
5/23/2015,2015,5,23, 18 ,7009,1346,1316,9671
5/23/2015,2015,5,23, 19 ,7495,1491,1317,10303
5/23/2015,2015,5,23, 20 ,7527,1470,1299,10296
5/23/2015,2015,5,23, 21 ,7568,1426,1297,10291
5/23/2015,2015,5,23, 22 ,7421,1342,1217,9980
5/23/2015,2015,5,23, 23 ,7088,1249,1111,9448
5/23/2015,2015,5,23, 24 ,6767,1177,1112,9056
5/24/2015,2015,5,24, 1 ,6471,1132,1021,8624
5/24/2015,2015,5,24, 2 ,6269,1088,988,8345
5/24/2015,2015,5,24, 3 ,6063,1063,959,8085
5/24/2015,2015,5,24, 4 ,5880,1035,936,7851
5/24/2015,2015,5,24, 5 ,5764,1024,928,7716
5/24/2015,2015,5,24, 6 ,5370,968,904,7242
5/24/2015,2015,5,24, 7 ,5473,979,892,7344
5/24/2015,2015,5,24, 8 ,5770,1041,945,7756
5/24/2015,2015,5,24, 9 ,6204,1130,1040,8374
5/24/2015,2015,5,24, 10 ,6600,1210,1118,8928
5/24/2015,2015,5,24, 11 ,6881,1245,1180,9306
5/24/2015,2015,5,24, 12 ,6842,1259,1172,9273
5/24/2015,2015,5,24, 13 ,6941,1275,1145,9361
5/24/2015,2015,5,24, 14 ,6907,1275,1195,9377
5/24/2015,2015,5,24, 15 ,6728,1255,1168,9151
5/24/2015,2015,5,24, 16 ,6587,1215,1146,8948
5/24/2015,2015,5,24, 17 ,6340,1177,1137,8654
5/24/2015,2015,5,24, 18 ,6452,1250,1220,8922
5/24/2015,2015,5,24, 19 ,7081,1427,1303,9811
5/24/2015,2015,5,24, 20 ,7229,1422,1301,9952
5/24/2015,2015,5,24, 21 ,7158,1388,1281,9827
5/24/2015,2015,5,24, 22 ,7002,1318,1197,9517
5/24/2015,2015,5,24, 23 ,6776,1242,1122,9140
5/24/2015,2015,5,24, 24 ,6438,1164,1043,8645
5/25/2015,2015,5,25, 1 ,6119,1104,996,8219
5/25/2015,2015,5,25, 2 ,5906,1067,962,7935
5/25/2015,2015,5,25, 3 ,5764,1033,921,7718
5/25/2015,2015,5,25, 4 ,5591,1007,910,7508
5/25/2015,2015,5,25, 5 ,5530,1010,926,7466
5/25/2015,2015,5,25, 6 ,5457,985,917,7359
5/25/2015,2015,5,25, 7 ,5891,1025,941,7857
5/25/2015,2015,5,25, 8 ,6909,1208,1112,9229
5/25/2015,2015,5,25, 9 ,7682,1414,1222,10318
5/25/2015,2015,5,25, 10 ,8259,1447,1269,10975
5/25/2015,2015,5,25, 11 ,8606,1568,1359,11533
5/25/2015,2015,5,25, 12 ,8495,1523,1327,11345
5/25/2015,2015,5,25, 13 ,8516,1550,1322,11388
5/25/2015,2015,5,25, 14 ,8764,1612,1375,11751
5/25/2015,2015,5,25, 15 ,8614,1579,1352,11545
5/25/2015,2015,5,25, 16 ,8405,1551,1359,11315
5/25/2015,2015,5,25, 17 ,7861,1429,1297,10587
5/25/2015,2015,5,25, 18 ,7562,1443,1326,10331
5/25/2015,2015,5,25, 19 ,7908,1559,1342,10809
5/25/2015,2015,5,25, 20 ,7814,1526,1292,10632
5/25/2015,2015,5,25, 21 ,7730,1469,1283,10482
5/25/2015,2015,5,25, 22 ,7480,1363,1198,10041
5/25/2015,2015,5,25, 23 ,7184,1262,1114,9560
5/25/2015,2015,5,25, 24 ,6757,1188,1056,9001
5/26/2015,2015,5,26, 1 ,6533,1128,1037,8698
5/26/2015,2015,5,26, 2 ,6301,1086,1002,8389
5/26/2015,2015,5,26, 3 ,6129,1060,956,8145
5/26/2015,2015,5,26, 4 ,5988,1038,943,7969
5/26/2015,2015,5,26, 5 ,5938,1034,966,7938
5/26/2015,2015,5,26, 6 ,5795,1012,948,7755
5/26/2015,2015,5,26, 7 ,6110,1048,964,8122
5/26/2015,2015,5,26, 8 ,7042,1216,1132,9390
5/26/2015,2015,5,26, 9 ,7770,1430,1214,10414
5/26/2015,2015,5,26, 10 ,8254,1507,1310,11071
5/26/2015,2015,5,26, 11 ,8547,1575,1360,11482
5/26/2015,2015,5,26, 12 ,8415,1508,1307,11230
5/26/2015,2015,5,26, 13 ,8384,1535,1339,11258
5/26/2015,2015,5,26, 14 ,8659,1605,1386,11650
5/26/2015,2015,5,26, 15 ,8601,1573,1346,11520
5/26/2015,2015,5,26, 16 ,8421,1540,1362,11323
5/26/2015,2015,5,26, 17 ,7862,1430,1278,10570
5/26/2015,2015,5,26, 18 ,7601,1410,1340,10351
5/26/2015,2015,5,26, 19 ,8013,1550,1342,10905
5/26/2015,2015,5,26, 20 ,7954,1528,1353,10835
5/26/2015,2015,5,26, 21 ,7806,1480,1325,10611
5/26/2015,2015,5,26, 22 ,7519,1360,1232,10111
5/26/2015,2015,5,26, 23 ,7205,1266,1169,9640
5/26/2015,2015,5,26, 24 ,6851,1174,1076,9101
5/27/2015,2015,5,27, 1 ,6547,1125,1040,8712
5/27/2015,2015,5,27, 2 ,6547,1080,1011,8638
5/27/2015,2015,5,27, 3 ,6144,1046,976,8166
5/27/2015,2015,5,27, 4 ,5993,1020,968,7981
5/27/2015,2015,5,27, 5 ,5925,1018,982,7925
5/27/2015,2015,5,27, 6 ,5808,1000,973,7781
5/27/2015,2015,5,27, 7 ,6131,1033,982,8146
5/27/2015,2015,5,27, 8 ,7071,1224,1131,9426
5/27/2015,2015,5,27, 9 ,7833,1425,1268,10526
5/27/2015,2015,5,27, 10 ,8246,1493,1324,11063
5/27/2015,2015,5,27, 11 ,8471,1576,1366,11413
5/27/2015,2015,5,27, 12 ,8319,1527,1325,11171
5/27/2015,2015,5,27, 13 ,8299,1543,1362,11204
5/27/2015,2015,5,27, 14 ,8569,1586,1387,11542
5/27/2015,2015,5,27, 15 ,8510,1556,1388,11454
5/27/2015,2015,5,27, 16 ,8321,1519,1362,11202
5/27/2015,2015,5,27, 17 ,7915,1419,1293,10627
5/27/2015,2015,5,27, 18 ,7617,1414,1353,10384
5/27/2015,2015,5,27, 19 ,7987,1536,1390,10913
5/27/2015,2015,5,27, 20 ,7863,1506,1327,10696
5/27/2015,2015,5,27, 21 ,7780,1462,1305,10547
5/27/2015,2015,5,27, 22 ,7498,1354,1246,10098
5/27/2015,2015,5,27, 23 ,7172,1274,1165,9611
5/27/2015,2015,5,27, 24 ,6783,1196,1088,9067
5/28/2015,2015,5,28, 1 ,6524,1125,1035,8684
5/28/2015,2015,5,28, 2 ,6304,1089,1003,8396
5/28/2015,2015,5,28, 3 ,6101,1056,978,8135
5/28/2015,2015,5,28, 4 ,5958,1025,957,7940
5/28/2015,2015,5,28, 5 ,5902,1031,971,7904
5/28/2015,2015,5,28, 6 ,5722,997,967,7686
5/28/2015,2015,5,28, 7 ,6026,1032,966,8024
5/28/2015,2015,5,28, 8 ,6954,1219,1125,9298
5/28/2015,2015,5,28, 9 ,7706,1410,1253,10369
5/28/2015,2015,5,28, 10 ,8211,1508,1327,11046
5/28/2015,2015,5,28, 11 ,8584,1568,1360,11512
5/28/2015,2015,5,28, 12 ,8431,1536,1327,11294
5/28/2015,2015,5,28, 13 ,8405,1547,1379,11331
5/28/2015,2015,5,28, 14 ,8600,1600,1381,11581
5/28/2015,2015,5,28, 15 ,8477,1575,1389,11441
5/28/2015,2015,5,28, 16 ,8285,1525,1383,11193
5/28/2015,2015,5,28, 17 ,7837,1427,1296,10560
5/28/2015,2015,5,28, 18 ,7569,1419,1359,10347
5/28/2015,2015,5,28, 19 ,7915,1551,1388,10854
5/28/2015,2015,5,28, 20 ,7877,1513,1370,10760
5/28/2015,2015,5,28, 21 ,7792,1481,1329,10602
5/28/2015,2015,5,28, 22 ,7586,1373,1276,10235
5/28/2015,2015,5,28, 23 ,7227,1291,1166,9684
5/28/2015,2015,5,28, 24 ,6820,1213,1091,9124
5/29/2015,2015,5,29, 1 ,6517,1142,1056,8715
5/29/2015,2015,5,29, 2 ,6338,1105,1002,8445
5/29/2015,2015,5,29, 3 ,6148,1064,981,8193
5/29/2015,2015,5,29, 4 ,5986,1032,972,7990
5/29/2015,2015,5,29, 5 ,5926,1032,984,7942
5/29/2015,2015,5,29, 6 ,5802,995,978,7775
5/29/2015,2015,5,29, 7 ,6086,1026,969,8081
5/29/2015,2015,5,29, 8 ,7039,1202,1123,9364
5/29/2015,2015,5,29, 9 ,7806,1413,1285,10504
5/29/2015,2015,5,29, 10 ,8225,1497,1323,11045
5/29/2015,2015,5,29, 11 ,8543,1549,1384,11476
5/29/2015,2015,5,29, 12 ,8366,1504,1363,11233
5/29/2015,2015,5,29, 13 ,8397,1518,1385,11300
5/29/2015,2015,5,29, 14 ,8595,1575,1421,11591
5/29/2015,2015,5,29, 15 ,8482,1549,1368,11399
5/29/2015,2015,5,29, 16 ,8271,1507,1341,11119
5/29/2015,2015,5,29, 17 ,7847,1388,1253,10488
5/29/2015,2015,5,29, 18 ,7559,1400,1331,10290
5/29/2015,2015,5,29, 19 ,7824,1527,1348,10699
5/29/2015,2015,5,29, 20 ,7778,1506,1320,10604
5/29/2015,2015,5,29, 21 ,7670,1458,1278,10406
5/29/2015,2015,5,29, 22 ,7388,1366,1207,9961
5/29/2015,2015,5,29, 23 ,7063,1255,1119,9437
5/29/2015,2015,5,29, 24 ,6709,1181,1090,8980
5/30/2015,2015,5,30, 1 ,6392,1140,1017,8549
5/30/2015,2015,5,30, 2 ,6180,1104,989,8273
5/30/2015,2015,5,30, 3 ,5969,1071,959,7999
5/30/2015,2015,5,30, 4 ,5847,1043,942,7832
5/30/2015,2015,5,30, 5 ,5757,1027,953,7737
5/30/2015,2015,5,30, 6 ,5493,981,937,7411
5/30/2015,2015,5,30, 7 ,5708,987,944,7639
5/30/2015,2015,5,30, 8 ,6303,1100,1041,8444
5/30/2015,2015,5,30, 9 ,6904,1275,1159,9338
5/30/2015,2015,5,30, 10 ,7427,1370,1220,10017
5/30/2015,2015,5,30, 11 ,7693,1426,1277,10396
5/30/2015,2015,5,30, 12 ,7585,1396,1246,10227
5/30/2015,2015,5,30, 13 ,7617,1407,1271,10295
5/30/2015,2015,5,30, 14 ,7631,1439,1311,10381
5/30/2015,2015,5,30, 15 ,7414,1409,1290,10113
5/30/2015,2015,5,30, 16 ,7230,1366,1222,9818
5/30/2015,2015,5,30, 17 ,6964,1301,1204,9469
5/30/2015,2015,5,30, 18 ,7036,1323,1276,9635
5/30/2015,2015,5,30, 19 ,7398,1502,1317,10217
5/30/2015,2015,5,30, 20 ,7434,1481,1295,10210
5/30/2015,2015,5,30, 21 ,7292,1435,1282,10009
5/30/2015,2015,5,30, 22 ,7021,1358,1215,9594
5/30/2015,2015,5,30, 23 ,6679,1246,1143,9068
5/30/2015,2015,5,30, 24 ,6344,1157,1126,8627
5/31/2015,2015,5,31, 1 ,6063,1115,1018,8196
5/31/2015,2015,5,31, 2 ,5881,1075,982,7938
5/31/2015,2015,5,31, 3 ,5703,1038,956,7697
5/31/2015,2015,5,31, 4 ,5533,1010,937,7480
5/31/2015,2015,5,31, 5 ,5417,987,939,7343
5/31/2015,2015,5,31, 6 ,5111,934,911,6956
5/31/2015,2015,5,31, 7 ,5154,920,906,6980
5/31/2015,2015,5,31, 8 ,5525,951,926,7402
5/31/2015,2015,5,31, 9 ,5894,1055,1030,7979
5/31/2015,2015,5,31, 10 ,6410,1132,1121,8663
5/31/2015,2015,5,31, 11 ,6631,1202,1167,9000
5/31/2015,2015,5,31, 12 ,6700,1199,1165,9064
5/31/2015,2015,5,31, 13 ,6769,1191,1193,9153
5/31/2015,2015,5,31, 14 ,6840,1196,1177,9213
5/31/2015,2015,5,31, 15 ,6758,1170,1130,9058
5/31/2015,2015,5,31, 16 ,6610,1157,1106,8873
5/31/2015,2015,5,31, 17 ,6367,1123,1112,8602
5/31/2015,2015,5,31, 18 ,6462,1209,1225,8896
5/31/2015,2015,5,31, 19 ,6959,1388,1273,9620
5/31/2015,2015,5,31, 20 ,7128,1389,1268,9785
5/31/2015,2015,5,31, 21 ,7121,1353,1259,9733
5/31/2015,2015,5,31, 22 ,6908,1255,1207,9370
5/31/2015,2015,5,31, 23 ,6597,1165,1107,8869
5/31/2015,2015,5,31, 24 ,6290,1084,1031,8405
6/1/2015,2015,6,1, 1 ,6006,1040,982,8028
6/1/2015,2015,6,1, 2 ,5799,1000,948,7747
6/1/2015,2015,6,1, 3 ,5538,953,916,7407
6/1/2015,2015,6,1, 4 ,5524,942,908,7374
6/1/2015,2015,6,1, 5 ,5552,972,964,7488
6/1/2015,2015,6,1, 6 ,5434,943,912,7289
6/1/2015,2015,6,1, 7 ,5726,957,929,7612
6/1/2015,2015,6,1, 8 ,6695,1136,1067,8898
6/1/2015,2015,6,1, 9 ,7530,1332,1263,10125
6/1/2015,2015,6,1, 10 ,8046,1441,1342,10829
6/1/2015,2015,6,1, 11 ,8398,1499,1381,11278
6/1/2015,2015,6,1, 12 ,8284,1467,1354,11105
6/1/2015,2015,6,1, 13 ,8352,1472,1349,11173
6/1/2015,2015,6,1, 14 ,8658,1485,1361,11504
6/1/2015,2015,6,1, 15 ,8538,1445,1331,11314
6/1/2015,2015,6,1, 16 ,8346,1422,1291,11059
6/1/2015,2015,6,1, 17 ,7871,1351,1273,10495
6/1/2015,2015,6,1, 18 ,7505,1361,1319,10185
6/1/2015,2015,6,1, 19 ,7907,1506,1339,10752
6/1/2015,2015,6,1, 20 ,7935,1454,1314,10703
6/1/2015,2015,6,1, 21 ,7810,1394,1273,10477
6/1/2015,2015,6,1, 22 ,7586,1272,1168,10026
6/1/2015,2015,6,1, 23 ,7263,1196,1094,9553
6/1/2015,2015,6,1, 24 ,6811,1124,1025,8960
6/2/2015,2015,6,2, 1 ,6529,1069,986,8584
6/2/2015,2015,6,2, 2 ,6290,1038,962,8290
6/2/2015,2015,6,2, 3 ,6143,1006,930,8079
6/2/2015,2015,6,2, 4 ,5936,992,932,7860
6/2/2015,2015,6,2, 5 ,5970,1020,986,7976
6/2/2015,2015,6,2, 6 ,5756,984,962,7702
6/2/2015,2015,6,2, 7 ,5997,981,897,7875
6/2/2015,2015,6,2, 8 ,6903,1173,1043,9119
6/2/2015,2015,6,2, 9 ,7579,1358,1204,10141
6/2/2015,2015,6,2, 10 ,8092,1471,1332,10895
6/2/2015,2015,6,2, 11 ,8447,1508,1352,11307
6/2/2015,2015,6,2, 12 ,8332,1465,1319,11116
6/2/2015,2015,6,2, 13 ,8405,1468,1356,11229
6/2/2015,2015,6,2, 14 ,8735,1533,1395,11663
6/2/2015,2015,6,2, 15 ,8679,1524,1384,11587
6/2/2015,2015,6,2, 16 ,8429,1506,1347,11282
6/2/2015,2015,6,2, 17 ,8086,1402,1314,10802
6/2/2015,2015,6,2, 18 ,7661,1393,1327,10381
6/2/2015,2015,6,2, 19 ,8018,1530,1337,10885
6/2/2015,2015,6,2, 20 ,8016,1506,1325,10847
6/2/2015,2015,6,2, 21 ,7929,1388,1253,10570
6/2/2015,2015,6,2, 22 ,7756,1339,1174,10269
6/2/2015,2015,6,2, 23 ,7355,1249,1121,9725
6/2/2015,2015,6,2, 24 ,6992,1163,1054,9209
6/3/2015,2015,6,3, 1 ,6668,1119,1005,8792
6/3/2015,2015,6,3, 2 ,6462,1077,976,8515
6/3/2015,2015,6,3, 3 ,6236,1059,941,8236
6/3/2015,2015,6,3, 4 ,6106,1027,941,8074
6/3/2015,2015,6,3, 5 ,6111,1046,988,8145
6/3/2015,2015,6,3, 6 ,5858,1018,967,7843
6/3/2015,2015,6,3, 7 ,6136,1003,928,8067
6/3/2015,2015,6,3, 8 ,7131,1174,1102,9407
6/3/2015,2015,6,3, 9 ,7792,1391,1247,10430
6/3/2015,2015,6,3, 10 ,8311,1476,1323,11110
6/3/2015,2015,6,3, 11 ,8604,1530,1374,11508
6/3/2015,2015,6,3, 12 ,8413,1426,1349,11188
6/3/2015,2015,6,3, 13 ,8570,1472,1372,11414
6/3/2015,2015,6,3, 14 ,8846,1523,1399,11768
6/3/2015,2015,6,3, 15 ,8841,1504,1379,11724
6/3/2015,2015,6,3, 16 ,8552,1468,1349,11369
6/3/2015,2015,6,3, 17 ,7931,1398,1285,10614
6/3/2015,2015,6,3, 18 ,7606,1398,1267,10271
6/3/2015,2015,6,3, 19 ,7919,1521,1281,10721
6/3/2015,2015,6,3, 20 ,7951,1483,1258,10692
6/3/2015,2015,6,3, 21 ,7717,1421,1209,10347
6/3/2015,2015,6,3, 22 ,7415,1303,1152,9870
6/3/2015,2015,6,3, 23 ,7100,1196,1060,9356
6/3/2015,2015,6,3, 24 ,6757,1126,1072,8955
6/4/2015,2015,6,4, 1 ,6401,1075,976,8452
6/4/2015,2015,6,4, 2 ,6238,1047,941,8226
6/4/2015,2015,6,4, 3 ,6077,1014,914,8005
6/4/2015,2015,6,4, 4 ,5989,997,915,7901
6/4/2015,2015,6,4, 5 ,6029,1020,968,8017
6/4/2015,2015,6,4, 6 ,6029,996,967,7992
6/4/2015,2015,6,4, 7 ,6047,987,921,7955
6/4/2015,2015,6,4, 8 ,7015,1180,1065,9260
6/4/2015,2015,6,4, 9 ,7758,1382,1222,10362
6/4/2015,2015,6,4, 10 ,8273,1482,1340,11095
6/4/2015,2015,6,4, 11 ,8492,1519,1324,11335
6/4/2015,2015,6,4, 12 ,8336,1488,1359,11183
6/4/2015,2015,6,4, 13 ,8403,1498,1387,11288
6/4/2015,2015,6,4, 14 ,8721,1567,1420,11708
6/4/2015,2015,6,4, 15 ,8608,1517,1346,11471
6/4/2015,2015,6,4, 16 ,8435,1496,1320,11251
6/4/2015,2015,6,4, 17 ,7942,1405,1221,10568
6/4/2015,2015,6,4, 18 ,7569,1408,1319,10296
6/4/2015,2015,6,4, 19 ,7985,1536,1372,10893
6/4/2015,2015,6,4, 20 ,8034,1508,1352,10894
6/4/2015,2015,6,4, 21 ,7876,1440,1316,10632
6/4/2015,2015,6,4, 22 ,7684,1315,1236,10235
6/4/2015,2015,6,4, 23 ,7286,1199,1136,9621
6/4/2015,2015,6,4, 24 ,6901,1134,1066,9101
6/5/2015,2015,6,5, 1 ,6625,1101,1013,8739
6/5/2015,2015,6,5, 2 ,6390,1067,967,8424
6/5/2015,2015,6,5, 3 ,6214,1024,949,8187
6/5/2015,2015,6,5, 4 ,6027,1015,946,7988
6/5/2015,2015,6,5, 5 ,6033,1026,993,8052
6/5/2015,2015,6,5, 6 ,5854,1010,979,7843
6/5/2015,2015,6,5, 7 ,6090,988,935,8013
6/5/2015,2015,6,5, 8 ,6973,1153,1076,9202
6/5/2015,2015,6,5, 9 ,7822,1369,1195,10386
6/5/2015,2015,6,5, 10 ,8291,1462,1290,11043
6/5/2015,2015,6,5, 11 ,8531,1519,1396,11446
6/5/2015,2015,6,5, 12 ,8360,1460,1329,11149
6/5/2015,2015,6,5, 13 ,8392,1460,1339,11191
6/5/2015,2015,6,5, 14 ,8634,1534,1394,11562
6/5/2015,2015,6,5, 15 ,8542,1511,1361,11414
6/5/2015,2015,6,5, 16 ,8363,1474,1352,11189
6/5/2015,2015,6,5, 17 ,7879,1387,1298,10564
6/5/2015,2015,6,5, 18 ,7567,1395,1359,10321
6/5/2015,2015,6,5, 19 ,7948,1525,1371,10844
6/5/2015,2015,6,5, 20 ,7967,1487,1336,10790
6/5/2015,2015,6,5, 21 ,7835,1426,1310,10571
6/5/2015,2015,6,5, 22 ,7601,1335,1240,10176
6/5/2015,2015,6,5, 23 ,7256,1233,1153,9642
6/5/2015,2015,6,5, 24 ,6926,1173,956,9055
6/6/2015,2015,6,6, 1 ,6588,1112,1029,8729
6/6/2015,2015,6,6, 2 ,6372,1058,1000,8430
6/6/2015,2015,6,6, 3 ,6147,1028,965,8140
6/6/2015,2015,6,6, 4 ,5971,994,955,7920
6/6/2015,2015,6,6, 5 ,5896,978,956,7830
6/6/2015,2015,6,6, 6 ,5651,956,945,7552
6/6/2015,2015,6,6, 7 ,5715,973,950,7638
6/6/2015,2015,6,6, 8 ,6408,1072,999,8479
6/6/2015,2015,6,6, 9 ,7035,1239,1175,9449
6/6/2015,2015,6,6, 10 ,7531,1319,1283,10133
6/6/2015,2015,6,6, 11 ,7799,1391,1314,10504
6/6/2015,2015,6,6, 12 ,7735,1364,1262,10361
6/6/2015,2015,6,6, 13 ,7807,1370,1305,10482
6/6/2015,2015,6,6, 14 ,8050,1406,1323,10779
6/6/2015,2015,6,6, 15 ,7893,1376,1305,10574
6/6/2015,2015,6,6, 16 ,7661,1333,1273,10267
6/6/2015,2015,6,6, 17 ,7228,1287,1223,9738
6/6/2015,2015,6,6, 18 ,7074,1345,1305,9724
6/6/2015,2015,6,6, 19 ,7612,1500,1329,10441
6/6/2015,2015,6,6, 20 ,7694,1469,1307,10470
6/6/2015,2015,6,6, 21 ,7677,1422,1080,10179
6/6/2015,2015,6,6, 22 ,7494,1324,1191,10009
6/6/2015,2015,6,6, 23 ,7198,1229,1104,9531
6/6/2015,2015,6,6, 24 ,6842,1147,1036,9025
6/7/2015,2015,6,7, 1 ,6529,1096,993,8618
6/7/2015,2015,6,7, 2 ,6278,1063,970,8311
6/7/2015,2015,6,7, 3 ,6049,1033,937,8019
6/7/2015,2015,6,7, 4 ,5864,1005,914,7783
6/7/2015,2015,6,7, 5 ,5753,988,936,7677
6/7/2015,2015,6,7, 6 ,5382,937,890,7209
6/7/2015,2015,6,7, 7 ,5376,954,888,7218
6/7/2015,2015,6,7, 8 ,5620,1013,942,7575
6/7/2015,2015,6,7, 9 ,5937,1093,1035,8065
6/7/2015,2015,6,7, 10 ,6422,1171,1101,8694
6/7/2015,2015,6,7, 11 ,6688,1222,1132,9042
6/7/2015,2015,6,7, 12 ,6696,1202,1166,9064
6/7/2015,2015,6,7, 13 ,6788,1226,1169,9183
6/7/2015,2015,6,7, 14 ,6909,1232,1202,9343
6/7/2015,2015,6,7, 15 ,6782,1183,1176,9141
6/7/2015,2015,6,7, 16 ,6728,1169,1164,9061
6/7/2015,2015,6,7, 17 ,6499,1149,1139,8787
6/7/2015,2015,6,7, 18 ,6546,1224,1254,9024
6/7/2015,2015,6,7, 19 ,7278,1417,1321,10016
6/7/2015,2015,6,7, 20 ,7358,1397,1305,10060
6/7/2015,2015,6,7, 21 ,7402,1343,1288,10033
6/7/2015,2015,6,7, 22 ,7228,1272,1216,9716
6/7/2015,2015,6,7, 23 ,6910,1172,1114,9196
6/7/2015,2015,6,7, 24 ,6568,1068,1041,8677
6/8/2015,2015,6,8, 1 ,6224,1028,992,8244
6/8/2015,2015,6,8, 2 ,5975,990,954,7919
6/8/2015,2015,6,8, 3 ,5804,971,929,7704
6/8/2015,2015,6,8, 4 ,5671,952,918,7541
6/8/2015,2015,6,8, 5 ,5755,990,988,7733
6/8/2015,2015,6,8, 6 ,5592,969,937,7498
6/8/2015,2015,6,8, 7 ,5891,958,908,7757
6/8/2015,2015,6,8, 8 ,6926,1165,1056,9147
6/8/2015,2015,6,8, 9 ,7815,1386,1251,10452
6/8/2015,2015,6,8, 10 ,8312,1499,1289,11100
6/8/2015,2015,6,8, 11 ,8597,1566,1346,11509
6/8/2015,2015,6,8, 12 ,8435,1527,1332,11294
6/8/2015,2015,6,8, 13 ,8498,1532,1364,11394
6/8/2015,2015,6,8, 14 ,8840,1595,1435,11870
6/8/2015,2015,6,8, 15 ,8708,1572,1393,11673
6/8/2015,2015,6,8, 16 ,8180,1531,1390,11101
6/8/2015,2015,6,8, 17 ,7882,1446,1293,10621
6/8/2015,2015,6,8, 18 ,7606,1440,1318,10364
6/8/2015,2015,6,8, 19 ,7997,1577,1347,10921
6/8/2015,2015,6,8, 20 ,8006,1532,1339,10877
6/8/2015,2015,6,8, 21 ,7895,1474,1307,10676
6/8/2015,2015,6,8, 22 ,7632,1351,1221,10204
6/8/2015,2015,6,8, 23 ,7222,1240,1131,9593
6/8/2015,2015,6,8, 24 ,6846,1143,1090,9079
6/9/2015,2015,6,9, 1 ,6550,1089,1027,8666
6/9/2015,2015,6,9, 2 ,6317,1049,985,8351
6/9/2015,2015,6,9, 3 ,6143,1025,961,8129
6/9/2015,2015,6,9, 4 ,6040,1007,943,7990
6/9/2015,2015,6,9, 5 ,6071,1042,988,8101
6/9/2015,2015,6,9, 6 ,5906,1014,973,7893
6/9/2015,2015,6,9, 7 ,6121,1000,925,8046
6/9/2015,2015,6,9, 8 ,7078,1180,1070,9328
6/9/2015,2015,6,9, 9 ,7844,1396,1228,10468
6/9/2015,2015,6,9, 10 ,8329,1508,1312,11149
6/9/2015,2015,6,9, 11 ,8590,1550,1355,11495
6/9/2015,2015,6,9, 12 ,8437,1514,1335,11286
6/9/2015,2015,6,9, 13 ,8369,1517,1341,11227
6/9/2015,2015,6,9, 14 ,8530,1587,1384,11501
6/9/2015,2015,6,9, 15 ,8393,1550,1339,11282
6/9/2015,2015,6,9, 16 ,8135,1502,1328,10965
6/9/2015,2015,6,9, 17 ,7786,1421,1290,10497
6/9/2015,2015,6,9, 18 ,7557,1432,1357,10346
6/9/2015,2015,6,9, 19 ,7874,1557,1356,10787
6/9/2015,2015,6,9, 20 ,7844,1518,1305,10667
6/9/2015,2015,6,9, 21 ,7679,1467,1249,10395
6/9/2015,2015,6,9, 22 ,7350,1329,1158,9837
6/9/2015,2015,6,9, 23 ,7006,1229,1076,9311
6/9/2015,2015,6,9, 24 ,6570,1151,1010,8731
6/10/2015,2015,6,10, 1 ,6308,1093,998,8399
6/10/2015,2015,6,10, 2 ,6069,1060,968,8097
6/10/2015,2015,6,10, 3 ,5950,1034,945,7929
6/10/2015,2015,6,10, 4 ,5866,1008,938,7812
6/10/2015,2015,6,10, 5 ,5929,1041,1005,7975
6/10/2015,2015,6,10, 6 ,5737,1021,982,7740
6/10/2015,2015,6,10, 7 ,5995,1004,944,7943
6/10/2015,2015,6,10, 8 ,7022,1202,1111,9335
6/10/2015,2015,6,10, 9 ,7754,1424,1239,10417
6/10/2015,2015,6,10, 10 ,8313,1533,1307,11153
6/10/2015,2015,6,10, 11 ,8548,1589,1341,11478
6/10/2015,2015,6,10, 12 ,8383,1535,1327,11245
6/10/2015,2015,6,10, 13 ,8424,1514,1326,11264
6/10/2015,2015,6,10, 14 ,8769,1575,1336,11680
6/10/2015,2015,6,10, 15 ,8582,1530,1275,11387
6/10/2015,2015,6,10, 16 ,8249,1465,1285,10999
6/10/2015,2015,6,10, 17 ,7898,1396,1257,10551
6/10/2015,2015,6,10, 18 ,7640,1455,1320,10415
6/10/2015,2015,6,10, 19 ,7974,1552,1302,10828
6/10/2015,2015,6,10, 20 ,7868,1505,1295,10668
6/10/2015,2015,6,10, 21 ,7782,1434,1258,10474
6/10/2015,2015,6,10, 22 ,7582,1317,1128,10027
6/10/2015,2015,6,10, 23 ,7174,1213,1087,9474
6/10/2015,2015,6,10, 24 ,6761,1130,1028,8919
6/11/2015,2015,6,11, 1 ,6442,1083,983,8508
6/11/2015,2015,6,11, 2 ,6227,1053,957,8237
6/11/2015,2015,6,11, 3 ,6083,1022,919,8024
6/11/2015,2015,6,11, 4 ,5951,1000,910,7861
6/11/2015,2015,6,11, 5 ,5998,1037,983,8018
6/11/2015,2015,6,11, 6 ,5792,1018,965,7775
6/11/2015,2015,6,11, 7 ,5967,1010,928,7905
6/11/2015,2015,6,11, 8 ,6918,1198,1081,9197
6/11/2015,2015,6,11, 9 ,7705,1392,1158,10255
6/11/2015,2015,6,11, 10 ,8192,1484,1220,10896
6/11/2015,2015,6,11, 11 ,8406,1537,1258,11201
6/11/2015,2015,6,11, 12 ,8294,1503,1268,11065
6/11/2015,2015,6,11, 13 ,8323,1520,1309,11152
6/11/2015,2015,6,11, 14 ,8527,1576,1352,11455
6/11/2015,2015,6,11, 15 ,8369,1541,1318,11228
6/11/2015,2015,6,11, 16 ,8218,1501,1323,11042
6/11/2015,2015,6,11, 17 ,7812,1411,1257,10480
6/11/2015,2015,6,11, 18 ,7536,1403,1308,10247
6/11/2015,2015,6,11, 19 ,7985,1539,1339,10863
6/11/2015,2015,6,11, 20 ,7889,1500,1289,10678
6/11/2015,2015,6,11, 21 ,7749,1439,1250,10438
6/11/2015,2015,6,11, 22 ,7530,1331,1227,10088
6/11/2015,2015,6,11, 23 ,7181,1229,1115,9525
6/11/2015,2015,6,11, 24 ,6864,1151,1063,9078
6/12/2015,2015,6,12, 1 ,6605,1108,1009,8722
6/12/2015,2015,6,12, 2 ,6345,1076,979,8400
6/12/2015,2015,6,12, 3 ,6163,1038,936,8137
6/12/2015,2015,6,12, 4 ,6013,1003,938,7954
6/12/2015,2015,6,12, 5 ,5916,997,956,7869
6/12/2015,2015,6,12, 6 ,5514,966,937,7417
6/12/2015,2015,6,12, 7 ,5573,993,940,7506
6/12/2015,2015,6,12, 8 ,6016,1106,1026,8148
6/12/2015,2015,6,12, 9 ,6521,1251,1139,8911
6/12/2015,2015,6,12, 10 ,7007,1339,1214,9560
6/12/2015,2015,6,12, 11 ,7408,1397,1240,10045
6/12/2015,2015,6,12, 12 ,7323,1365,1219,9907
6/12/2015,2015,6,12, 13 ,7309,1371,1232,9912
6/12/2015,2015,6,12, 14 ,7473,1417,1274,10164
6/12/2015,2015,6,12, 15 ,7380,1399,1247,10026
6/12/2015,2015,6,12, 16 ,7217,1347,1222,9786
6/12/2015,2015,6,12, 17 ,6920,1285,1178,9383
6/12/2015,2015,6,12, 18 ,6866,1335,1250,9451
6/12/2015,2015,6,12, 19 ,7426,1521,1306,10253
6/12/2015,2015,6,12, 20 ,7506,1468,1289,10263
6/12/2015,2015,6,12, 21 ,7480,1390,1244,10114
6/12/2015,2015,6,12, 22 ,7329,1328,1192,9849
6/12/2015,2015,6,12, 23 ,7000,1224,1117,9341
6/12/2015,2015,6,12, 24 ,6652,1152,1057,8861
6/13/2015,2015,6,13, 1 ,6390,1098,1054,8542
6/13/2015,2015,6,13, 2 ,6175,1065,1020,8260
6/13/2015,2015,6,13, 3 ,5934,1037,996,7967
6/13/2015,2015,6,13, 4 ,5753,1017,983,7753
6/13/2015,2015,6,13, 5 ,5649,1007,998,7654
6/13/2015,2015,6,13, 6 ,5366,969,939,7274
6/13/2015,2015,6,13, 7 ,5638,992,942,7572
6/13/2015,2015,6,13, 8 ,6182,1110,1035,8327
6/13/2015,2015,6,13, 9 ,6761,1249,1134,9144
6/13/2015,2015,6,13, 10 ,7257,1320,1184,9761
6/13/2015,2015,6,13, 11 ,7544,1397,1252,10193
6/13/2015,2015,6,13, 12 ,7466,1349,1239,10054
6/13/2015,2015,6,13, 13 ,7463,1347,1270,10080
6/13/2015,2015,6,13, 14 ,7602,1374,1284,10260
6/13/2015,2015,6,13, 15 ,7454,1349,1243,10046
6/13/2015,2015,6,13, 16 ,7099,1276,1239,9614
6/13/2015,2015,6,13, 17 ,6779,1254,1191,9224
6/13/2015,2015,6,13, 18 ,6648,1332,1250,9230
6/13/2015,2015,6,13, 19 ,7177,1447,1286,9910
6/13/2015,2015,6,13, 20 ,7244,1408,1246,9898
6/13/2015,2015,6,13, 21 ,7235,1336,1192,9763
6/13/2015,2015,6,13, 22 ,7095,1266,1129,9490
6/13/2015,2015,6,13, 23 ,6851,1186,1072,9109
6/13/2015,2015,6,13, 24 ,6480,1088,992,8560
6/14/2015,2015,6,14, 1 ,6183,1045,963,8191
6/14/2015,2015,6,14, 2 ,6184,1017,920,8121
6/14/2015,2015,6,14, 3 ,5792,990,905,7687
6/14/2015,2015,6,14, 4 ,5633,969,872,7474
6/14/2015,2015,6,14, 5 ,5491,970,877,7338
6/14/2015,2015,6,14, 6 ,5198,919,859,6976
6/14/2015,2015,6,14, 7 ,5259,909,872,7040
6/14/2015,2015,6,14, 8 ,5576,987,902,7465
6/14/2015,2015,6,14, 9 ,5948,1071,963,7982
6/14/2015,2015,6,14, 10 ,6498,1146,1057,8701
6/14/2015,2015,6,14, 11 ,6732,1192,1099,9023
6/14/2015,2015,6,14, 12 ,6767,1200,1086,9053
6/14/2015,2015,6,14, 13 ,6730,1205,1107,9042
6/14/2015,2015,6,14, 14 ,6866,1187,1109,9162
6/14/2015,2015,6,14, 15 ,6767,1158,1084,9009
6/14/2015,2015,6,14, 16 ,6614,1147,1076,8837
6/14/2015,2015,6,14, 17 ,6480,1142,1086,8708
6/14/2015,2015,6,14, 18 ,6435,1220,1197,8852
6/14/2015,2015,6,14, 19 ,7106,1397,1241,9744
6/14/2015,2015,6,14, 20 ,7226,1367,1218,9811
6/14/2015,2015,6,14, 21 ,7217,1304,1219,9740
6/14/2015,2015,6,14, 22 ,7075,1205,1101,9381
6/14/2015,2015,6,14, 23 ,6791,1117,1051,8959
6/14/2015,2015,6,14, 24 ,6420,1025,977,8422
6/15/2015,2015,6,15, 1 ,6140,991,922,8053
6/15/2015,2015,6,15, 2 ,5918,955,894,7767
6/15/2015,2015,6,15, 3 ,5726,926,876,7528
6/15/2015,2015,6,15, 4 ,5615,915,873,7403
6/15/2015,2015,6,15, 5 ,5744,962,934,7640
6/15/2015,2015,6,15, 6 ,5546,951,904,7401
6/15/2015,2015,6,15, 7 ,5868,941,878,7687
6/15/2015,2015,6,15, 8 ,6849,1130,1030,9009
6/15/2015,2015,6,15, 9 ,7640,1331,1203,10174
6/15/2015,2015,6,15, 10 ,8170,1408,1280,10858
6/15/2015,2015,6,15, 11 ,8466,1480,1312,11258
6/15/2015,2015,6,15, 12 ,8351,1439,1305,11095
6/15/2015,2015,6,15, 13 ,8395,1439,1329,11163
6/15/2015,2015,6,15, 14 ,8661,1513,1364,11538
6/15/2015,2015,6,15, 15 ,8601,1483,1346,11430
6/15/2015,2015,6,15, 16 ,8445,1452,1333,11230
6/15/2015,2015,6,15, 17 ,8048,1372,1270,10690
6/15/2015,2015,6,15, 18 ,7686,1389,1361,10436
6/15/2015,2015,6,15, 19 ,8029,1529,1376,10934
6/15/2015,2015,6,15, 20 ,8017,1483,1350,10850
6/15/2015,2015,6,15, 21 ,7948,1421,1312,10681
6/15/2015,2015,6,15, 22 ,7732,1311,1217,10260
6/15/2015,2015,6,15, 23 ,7345,1184,1118,9647
6/15/2015,2015,6,15, 24 ,7000,1109,1039,9148
6/16/2015,2015,6,16, 1 ,6661,1067,990,8718
6/16/2015,2015,6,16, 2 ,6448,1040,953,8441
6/16/2015,2015,6,16, 3 ,6274,1005,929,8208
6/16/2015,2015,6,16, 4 ,6082,993,917,7992
6/16/2015,2015,6,16, 5 ,6155,1030,982,8167
6/16/2015,2015,6,16, 6 ,5928,1016,985,7929
6/16/2015,2015,6,16, 7 ,6092,988,910,7990
6/16/2015,2015,6,16, 8 ,7102,1182,1079,9363
6/16/2015,2015,6,16, 9 ,7848,1369,1162,10379
6/16/2015,2015,6,16, 10 ,8276,1427,1280,10983
6/16/2015,2015,6,16, 11 ,8501,1488,1345,11334
6/16/2015,2015,6,16, 12 ,8259,1445,1299,11003
6/16/2015,2015,6,16, 13 ,8298,1471,1317,11086
6/16/2015,2015,6,16, 14 ,8680,1515,1355,11550
6/16/2015,2015,6,16, 15 ,8573,1476,1343,11392
6/16/2015,2015,6,16, 16 ,8465,1428,1330,11223
6/16/2015,2015,6,16, 17 ,8015,1378,1291,10684
6/16/2015,2015,6,16, 18 ,7670,1408,1315,10393
6/16/2015,2015,6,16, 19 ,8006,1539,1342,10887
6/16/2015,2015,6,16, 20 ,8019,1494,1305,10818
6/16/2015,2015,6,16, 21 ,7853,1422,1269,10544
6/16/2015,2015,6,16, 22 ,7610,1309,1133,10052
6/16/2015,2015,6,16, 23 ,7274,1205,1081,9560
6/16/2015,2015,6,16, 24 ,6856,1128,1092,9076
6/17/2015,2015,6,17, 1 ,6523,1081,967,8571
6/17/2015,2015,6,17, 2 ,6293,1044,944,8281
6/17/2015,2015,6,17, 3 ,6142,1013,921,8076
6/17/2015,2015,6,17, 4 ,5979,1000,920,7899
6/17/2015,2015,6,17, 5 ,6050,1040,990,8080
6/17/2015,2015,6,17, 6 ,5815,1021,973,7809
6/17/2015,2015,6,17, 7 ,6033,993,915,7941
6/17/2015,2015,6,17, 8 ,7006,1163,1053,9222
6/17/2015,2015,6,17, 9 ,7723,1342,1137,10202
6/17/2015,2015,6,17, 10 ,8309,1462,1309,11080
6/17/2015,2015,6,17, 11 ,8487,1514,1337,11338
6/17/2015,2015,6,17, 12 ,8337,1467,1308,11112
6/17/2015,2015,6,17, 13 ,8381,1447,1298,11126
6/17/2015,2015,6,17, 14 ,8734,1498,1365,11597
6/17/2015,2015,6,17, 15 ,8586,1458,1335,11379
6/17/2015,2015,6,17, 16 ,8233,1420,1305,10958
6/17/2015,2015,6,17, 17 ,7720,1350,1284,10354
6/17/2015,2015,6,17, 18 ,7518,1379,1326,10223
6/17/2015,2015,6,17, 19 ,7796,1492,1336,10624
6/17/2015,2015,6,17, 20 ,7756,1457,1304,10517
6/17/2015,2015,6,17, 21 ,7593,1386,1268,10247
6/17/2015,2015,6,17, 22 ,7335,1277,1169,9781
6/17/2015,2015,6,17, 23 ,6976,1176,1097,9249
6/17/2015,2015,6,17, 24 ,6616,1103,1024,8743
6/18/2015,2015,6,18, 1 ,6341,1056,992,8389
6/18/2015,2015,6,18, 2 ,6191,1026,974,8191
6/18/2015,2015,6,18, 3 ,5986,999,956,7941
6/18/2015,2015,6,18, 4 ,5871,988,944,7803
6/18/2015,2015,6,18, 5 ,5963,1022,987,7972
6/18/2015,2015,6,18, 6 ,5762,1009,989,7760
6/18/2015,2015,6,18, 7 ,5974,975,933,7882
6/18/2015,2015,6,18, 8 ,6886,1151,1076,9113
6/18/2015,2015,6,18, 9 ,7503,1328,1211,10042
6/18/2015,2015,6,18, 10 ,7915,1402,1248,10565
6/18/2015,2015,6,18, 11 ,8210,1445,1292,10947
6/18/2015,2015,6,18, 12 ,8048,1391,1251,10690
6/18/2015,2015,6,18, 13 ,8106,1378,1238,10722
6/18/2015,2015,6,18, 14 ,8489,1404,1290,11183
6/18/2015,2015,6,18, 15 ,8430,1386,1294,11110
6/18/2015,2015,6,18, 16 ,8177,1357,1286,10820
6/18/2015,2015,6,18, 17 ,7765,1312,1233,10310
6/18/2015,2015,6,18, 18 ,7460,1337,1308,10105
6/18/2015,2015,6,18, 19 ,7506,1437,1325,10268
6/18/2015,2015,6,18, 20 ,7550,1384,1292,10226
6/18/2015,2015,6,18, 21 ,7445,1311,1249,10005
6/18/2015,2015,6,18, 22 ,7148,1186,1111,9445
6/18/2015,2015,6,18, 23 ,6733,1093,1048,8874
6/18/2015,2015,6,18, 24 ,6351,1029,989,8369
6/19/2015,2015,6,19, 1 ,6131,991,954,8076
6/19/2015,2015,6,19, 2 ,5904,960,940,7804
6/19/2015,2015,6,19, 3 ,5722,943,924,7589
6/19/2015,2015,6,19, 4 ,5664,939,914,7517
6/19/2015,2015,6,19, 5 ,5700,980,952,7632
6/19/2015,2015,6,19, 6 ,5639,980,972,7591
6/19/2015,2015,6,19, 7 ,5812,953,898,7663
6/19/2015,2015,6,19, 8 ,6689,1120,1034,8843
6/19/2015,2015,6,19, 9 ,7526,1300,1200,10026
6/19/2015,2015,6,19, 10 ,8058,1372,1184,10614
6/19/2015,2015,6,19, 11 ,8294,1401,1283,10978
6/19/2015,2015,6,19, 12 ,8137,1335,1258,10730
6/19/2015,2015,6,19, 13 ,8196,1328,1274,10798
6/19/2015,2015,6,19, 14 ,8455,1383,1328,11166
6/19/2015,2015,6,19, 15 ,8278,1357,1318,10953
6/19/2015,2015,6,19, 16 ,8029,1342,1298,10669
6/19/2015,2015,6,19, 17 ,7655,1310,1248,10213
6/19/2015,2015,6,19, 18 ,7408,1341,1325,10074
6/19/2015,2015,6,19, 19 ,7711,1439,1357,10507
6/19/2015,2015,6,19, 20 ,7667,1376,1316,10359
6/19/2015,2015,6,19, 21 ,7584,1292,1280,10156
6/19/2015,2015,6,19, 22 ,7323,1175,1186,9684
6/19/2015,2015,6,19, 23 ,6913,1086,1104,9103
6/19/2015,2015,6,19, 24 ,6573,1023,1025,8621
6/20/2015,2015,6,20, 1 ,6264,985,989,8238
6/20/2015,2015,6,20, 2 ,6017,947,966,7930
6/20/2015,2015,6,20, 3 ,5863,931,954,7748
6/20/2015,2015,6,20, 4 ,5710,897,923,7530
6/20/2015,2015,6,20, 5 ,5698,917,938,7553
6/20/2015,2015,6,20, 6 ,5530,910,932,7372
6/20/2015,2015,6,20, 7 ,5685,925,924,7534
6/20/2015,2015,6,20, 8 ,6267,1042,1005,8314
6/20/2015,2015,6,20, 9 ,6867,1158,1136,9161
6/20/2015,2015,6,20, 10 ,7378,1247,1195,9820
6/20/2015,2015,6,20, 11 ,7696,1295,1264,10255
6/20/2015,2015,6,20, 12 ,7544,1252,1244,10040
6/20/2015,2015,6,20, 13 ,7478,1255,1264,9997
6/20/2015,2015,6,20, 14 ,7621,1302,1311,10234
6/20/2015,2015,6,20, 15 ,7489,1279,1285,10053
6/20/2015,2015,6,20, 16 ,7209,1219,1267,9695
6/20/2015,2015,6,20, 17 ,6896,1202,1222,9320
6/20/2015,2015,6,20, 18 ,6869,1277,1314,9460
6/20/2015,2015,6,20, 19 ,7144,1388,1330,9862
6/20/2015,2015,6,20, 20 ,7187,1334,1304,9825
6/20/2015,2015,6,20, 21 ,6991,1278,1268,9537
6/20/2015,2015,6,20, 22 ,6822,1149,1181,9152
6/20/2015,2015,6,20, 23 ,6466,1069,1114,8649
6/20/2015,2015,6,20, 24 ,6106,967,1038,8111
6/21/2015,2015,6,21, 1 ,5873,921,973,7767
6/21/2015,2015,6,21, 2 ,5699,888,951,7538
6/21/2015,2015,6,21, 3 ,5550,856,937,7343
6/21/2015,2015,6,21, 4 ,5372,837,908,7117
6/21/2015,2015,6,21, 5 ,5292,835,904,7031
6/21/2015,2015,6,21, 6 ,5082,808,886,6776
6/21/2015,2015,6,21, 7 ,5127,832,878,6837
6/21/2015,2015,6,21, 8 ,5384,878,895,7157
6/21/2015,2015,6,21, 9 ,5765,956,989,7710
6/21/2015,2015,6,21, 10 ,6259,1040,1064,8363
6/21/2015,2015,6,21, 11 ,6470,1082,1120,8672
6/21/2015,2015,6,21, 12 ,6415,1092,1132,8639
6/21/2015,2015,6,21, 13 ,6349,1085,1137,8571
6/21/2015,2015,6,21, 14 ,6381,1094,1153,8628
6/21/2015,2015,6,21, 15 ,6265,1087,1129,8481
6/21/2015,2015,6,21, 16 ,6094,1074,1110,8278
6/21/2015,2015,6,21, 17 ,6033,1077,1104,8214
6/21/2015,2015,6,21, 18 ,6168,1165,1198,8531
6/21/2015,2015,6,21, 19 ,6598,1308,1292,9198
6/21/2015,2015,6,21, 20 ,6786,1276,1265,9327
6/21/2015,2015,6,21, 21 ,6728,1208,1217,9153
6/21/2015,2015,6,21, 22 ,6374,1097,1116,8587
6/21/2015,2015,6,21, 23 ,6112,1017,1028,8157
6/21/2015,2015,6,21, 24 ,5724,945,1011,7680
6/22/2015,2015,6,22, 1 ,5475,903,907,7285
6/22/2015,2015,6,22, 2 ,5273,874,900,7047
6/22/2015,2015,6,22, 3 ,5162,846,894,6902
6/22/2015,2015,6,22, 4 ,5087,846,882,6815
6/22/2015,2015,6,22, 5 ,5333,895,932,7160
6/22/2015,2015,6,22, 6 ,5303,891,948,7142
6/22/2015,2015,6,22, 7 ,5575,876,884,7335
6/22/2015,2015,6,22, 8 ,6465,1055,1024,8544
6/22/2015,2015,6,22, 9 ,7319,1263,1200,9782
6/22/2015,2015,6,22, 10 ,7915,1353,1283,10551
6/22/2015,2015,6,22, 11 ,8185,1394,1310,10889
6/22/2015,2015,6,22, 12 ,8081,1354,1276,10711
6/22/2015,2015,6,22, 13 ,8104,1357,1271,10732
6/22/2015,2015,6,22, 14 ,8350,1426,1280,11056
6/22/2015,2015,6,22, 15 ,8249,1407,1287,10943
6/22/2015,2015,6,22, 16 ,8102,1386,1293,10781
6/22/2015,2015,6,22, 17 ,7715,1306,1271,10292
6/22/2015,2015,6,22, 18 ,7314,1334,1318,9966
6/22/2015,2015,6,22, 19 ,7713,1477,1349,10539
6/22/2015,2015,6,22, 20 ,7662,1426,1301,10389
6/22/2015,2015,6,22, 21 ,7526,1357,1258,10141
6/22/2015,2015,6,22, 22 ,7243,1240,1175,9658
6/22/2015,2015,6,22, 23 ,6833,1134,1090,9057
6/22/2015,2015,6,22, 24 ,6469,1053,1018,8540
6/23/2015,2015,6,23, 1 ,6139,1005,985,8129
6/23/2015,2015,6,23, 2 ,5962,973,955,7890
6/23/2015,2015,6,23, 3 ,5792,947,949,7688
6/23/2015,2015,6,23, 4 ,5671,939,932,7542
6/23/2015,2015,6,23, 5 ,5786,978,975,7739
6/23/2015,2015,6,23, 6 ,5654,977,1004,7635
6/23/2015,2015,6,23, 7 ,5744,938,926,7608
6/23/2015,2015,6,23, 8 ,6585,1117,1038,8740
6/23/2015,2015,6,23, 9 ,7389,1310,1178,9877
6/23/2015,2015,6,23, 10 ,7953,1421,1264,10638
6/23/2015,2015,6,23, 11 ,8268,1456,1314,11038
6/23/2015,2015,6,23, 12 ,8107,1400,1269,10776
6/23/2015,2015,6,23, 13 ,8152,1349,1300,10801
6/23/2015,2015,6,23, 14 ,8429,1424,1346,11199
6/23/2015,2015,6,23, 15 ,8280,1397,1306,10983
6/23/2015,2015,6,23, 16 ,8115,1371,1310,10796
6/23/2015,2015,6,23, 17 ,7707,1320,1282,10309
6/23/2015,2015,6,23, 18 ,7460,1362,1320,10142
6/23/2015,2015,6,23, 19 ,7863,1459,1348,10670
6/23/2015,2015,6,23, 20 ,7870,1397,1298,10565
6/23/2015,2015,6,23, 21 ,7691,1322,1245,10258
6/23/2015,2015,6,23, 22 ,7387,1191,1154,9732
6/23/2015,2015,6,23, 23 ,7025,1092,1090,9207
6/23/2015,2015,6,23, 24 ,6601,1013,1001,8615
6/24/2015,2015,6,24, 1 ,6333,976,998,8307
6/24/2015,2015,6,24, 2 ,6088,949,938,7975
6/24/2015,2015,6,24, 3 ,5908,924,930,7762
6/24/2015,2015,6,24, 4 ,5776,919,918,7613
6/24/2015,2015,6,24, 5 ,5865,953,967,7785
6/24/2015,2015,6,24, 6 ,5724,945,988,7657
6/24/2015,2015,6,24, 7 ,5947,924,929,7800
6/24/2015,2015,6,24, 8 ,6790,1098,1026,8914
6/24/2015,2015,6,24, 9 ,7547,1312,1177,10036
6/24/2015,2015,6,24, 10 ,7913,1410,1221,10544
6/24/2015,2015,6,24, 11 ,8222,1447,1256,10925
6/24/2015,2015,6,24, 12 ,8089,1378,1186,10653
6/24/2015,2015,6,24, 13 ,8120,1382,1189,10691
6/24/2015,2015,6,24, 14 ,8464,1434,1216,11114
6/24/2015,2015,6,24, 15 ,8356,1407,1190,10953
6/24/2015,2015,6,24, 16 ,8193,1338,1233,10764
6/24/2015,2015,6,24, 17 ,7822,1305,1231,10358
6/24/2015,2015,6,24, 18 ,7489,1332,1269,10090
6/24/2015,2015,6,24, 19 ,7879,1421,1293,10593
6/24/2015,2015,6,24, 20 ,7938,1346,1252,10536
6/24/2015,2015,6,24, 21 ,7827,1252,1211,10290
6/24/2015,2015,6,24, 22 ,7546,1144,1088,9778
6/24/2015,2015,6,24, 23 ,7204,1038,1011,9253
6/24/2015,2015,6,24, 24 ,6733,978,973,8684
6/25/2015,2015,6,25, 1 ,6454,934,904,8292
6/25/2015,2015,6,25, 2 ,6219,915,883,8017
6/25/2015,2015,6,25, 3 ,6055,893,874,7822
6/25/2015,2015,6,25, 4 ,5926,884,860,7670
6/25/2015,2015,6,25, 5 ,5984,931,929,7844
6/25/2015,2015,6,25, 6 ,5807,947,982,7736
6/25/2015,2015,6,25, 7 ,6045,917,907,7869
6/25/2015,2015,6,25, 8 ,6963,1085,1012,9060
6/25/2015,2015,6,25, 9 ,7712,1287,1164,10163
6/25/2015,2015,6,25, 10 ,8176,1376,1220,10772
6/25/2015,2015,6,25, 11 ,8436,1427,1217,11080
6/25/2015,2015,6,25, 12 ,8279,1380,1181,10840
6/25/2015,2015,6,25, 13 ,8329,1386,1187,10902
6/25/2015,2015,6,25, 14 ,8632,1463,1227,11322
6/25/2015,2015,6,25, 15 ,8555,1450,1218,11223
6/25/2015,2015,6,25, 16 ,8395,1413,1235,11043
6/25/2015,2015,6,25, 17 ,8022,1360,1219,10601
6/25/2015,2015,6,25, 18 ,7574,1373,1282,10229
6/25/2015,2015,6,25, 19 ,7918,1514,1302,10734
6/25/2015,2015,6,25, 20 ,7949,1455,1283,10687
6/25/2015,2015,6,25, 21 ,7889,1402,1204,10495
6/25/2015,2015,6,25, 22 ,7628,1271,1054,9953
6/25/2015,2015,6,25, 23 ,7277,1108,1002,9387
6/25/2015,2015,6,25, 24 ,6838,1050,929,8817
6/26/2015,2015,6,26, 1 ,6563,1011,892,8466
6/26/2015,2015,6,26, 2 ,6330,981,873,8184
6/26/2015,2015,6,26, 3 ,6133,956,868,7957
6/26/2015,2015,6,26, 4 ,6038,949,849,7836
6/26/2015,2015,6,26, 5 ,6093,979,916,7988
6/26/2015,2015,6,26, 6 ,5886,997,950,7833
6/26/2015,2015,6,26, 7 ,6064,962,897,7923
6/26/2015,2015,6,26, 8 ,7009,1097,997,9103
6/26/2015,2015,6,26, 9 ,7691,1266,1119,10076
6/26/2015,2015,6,26, 10 ,8232,1333,1203,10768
6/26/2015,2015,6,26, 11 ,8456,1373,1243,11072
6/26/2015,2015,6,26, 12 ,8303,1322,1184,10809
6/26/2015,2015,6,26, 13 ,8362,1337,1197,10896
6/26/2015,2015,6,26, 14 ,8608,1374,1248,11230
6/26/2015,2015,6,26, 15 ,8469,1377,1240,11086
6/26/2015,2015,6,26, 16 ,8210,1354,1239,10803
6/26/2015,2015,6,26, 17 ,7744,1299,1237,10280
6/26/2015,2015,6,26, 18 ,7456,1331,1276,10063
6/26/2015,2015,6,26, 19 ,7736,1434,1300,10470
6/26/2015,2015,6,26, 20 ,7728,1398,1256,10382
6/26/2015,2015,6,26, 21 ,7617,1328,1185,10130
6/26/2015,2015,6,26, 22 ,7353,1238,1076,9667
6/26/2015,2015,6,26, 23 ,7099,1115,999,9213
6/26/2015,2015,6,26, 24 ,6593,1045,943,8581
6/27/2015,2015,6,27, 1 ,6392,1004,888,8284
6/27/2015,2015,6,27, 2 ,6119,973,869,7961
6/27/2015,2015,6,27, 3 ,5894,942,859,7695
6/27/2015,2015,6,27, 4 ,5778,935,841,7554
6/27/2015,2015,6,27, 5 ,5725,941,862,7528
6/27/2015,2015,6,27, 6 ,5505,926,873,7304
6/27/2015,2015,6,27, 7 ,5720,956,873,7549
6/27/2015,2015,6,27, 8 ,6352,1061,955,8368
6/27/2015,2015,6,27, 9 ,6926,1211,1047,9184
6/27/2015,2015,6,27, 10 ,7429,1286,1141,9856
6/27/2015,2015,6,27, 11 ,7779,1338,1205,10322
6/27/2015,2015,6,27, 12 ,7646,1302,1176,10124
6/27/2015,2015,6,27, 13 ,7703,1297,1182,10182
6/27/2015,2015,6,27, 14 ,7892,1337,1226,10455
6/27/2015,2015,6,27, 15 ,7772,1303,1203,10278
6/27/2015,2015,6,27, 16 ,7538,1279,1189,10006
6/27/2015,2015,6,27, 17 ,7172,1223,1192,9587
6/27/2015,2015,6,27, 18 ,7013,1269,1229,9511
6/27/2015,2015,6,27, 19 ,7351,1414,1331,10096
6/27/2015,2015,6,27, 20 ,7395,1367,1273,10035
6/27/2015,2015,6,27, 21 ,7353,1307,1202,9862
6/27/2015,2015,6,27, 22 ,7238,1220,1136,9594
6/27/2015,2015,6,27, 23 ,6860,1135,1039,9034
6/27/2015,2015,6,27, 24 ,6503,1056,958,8517
6/28/2015,2015,6,28, 1 ,6218,1000,904,8122
6/28/2015,2015,6,28, 2 ,6007,970,884,7861
6/28/2015,2015,6,28, 3 ,5781,943,867,7591
6/28/2015,2015,6,28, 4 ,5592,924,836,7352
6/28/2015,2015,6,28, 5 ,5529,928,846,7303
6/28/2015,2015,6,28, 6 ,5246,896,844,6986
6/28/2015,2015,6,28, 7 ,5311,917,825,7053
6/28/2015,2015,6,28, 8 ,5662,959,880,7501
6/28/2015,2015,6,28, 9 ,6032,1046,929,8007
6/28/2015,2015,6,28, 10 ,6493,1130,1008,8631
6/28/2015,2015,6,28, 11 ,6780,1170,1065,9015
6/28/2015,2015,6,28, 12 ,6776,1172,1080,9028
6/28/2015,2015,6,28, 13 ,6815,1183,1093,9091
6/28/2015,2015,6,28, 14 ,6897,1184,1100,9181
6/28/2015,2015,6,28, 15 ,6739,1136,1083,8958
6/28/2015,2015,6,28, 16 ,6641,1112,1080,8833
6/28/2015,2015,6,28, 17 ,6462,1125,1081,8668
6/28/2015,2015,6,28, 18 ,6520,1230,1151,8901
6/28/2015,2015,6,28, 19 ,7065,1315,1269,9649
6/28/2015,2015,6,28, 20 ,7240,1264,1247,9751
6/28/2015,2015,6,28, 21 ,7205,1185,1186,9576
6/28/2015,2015,6,28, 22 ,6892,1088,1083,9063
6/28/2015,2015,6,28, 23 ,6542,998,988,8528
6/28/2015,2015,6,28, 24 ,6190,937,917,8044
6/29/2015,2015,6,29, 1 ,5907,900,887,7694
6/29/2015,2015,6,29, 2 ,5726,872,869,7467
6/29/2015,2015,6,29, 3 ,5519,859,836,7214
6/29/2015,2015,6,29, 4 ,5514,859,839,7212
6/29/2015,2015,6,29, 5 ,5616,910,894,7420
6/29/2015,2015,6,29, 6 ,5519,941,917,7377
6/29/2015,2015,6,29, 7 ,5871,918,860,7649
6/29/2015,2015,6,29, 8 ,6807,1055,966,8828
6/29/2015,2015,6,29, 9 ,7566,1249,1140,9955
6/29/2015,2015,6,29, 10 ,8036,1339,1225,10600
6/29/2015,2015,6,29, 11 ,8390,1395,1254,11039
6/29/2015,2015,6,29, 12 ,8292,1355,1197,10844
6/29/2015,2015,6,29, 13 ,8358,1358,1210,10926
6/29/2015,2015,6,29, 14 ,8664,1398,1274,11336
6/29/2015,2015,6,29, 15 ,8560,1383,1253,11196
6/29/2015,2015,6,29, 16 ,8411,1372,1231,11014
6/29/2015,2015,6,29, 17 ,7958,1312,1235,10505
6/29/2015,2015,6,29, 18 ,7681,1338,1304,10323
6/29/2015,2015,6,29, 19 ,7994,1449,1342,10785
6/29/2015,2015,6,29, 20 ,7982,1400,1255,10637
6/29/2015,2015,6,29, 21 ,7840,1314,1189,10343
6/29/2015,2015,6,29, 22 ,7546,1191,1058,9795
6/29/2015,2015,6,29, 23 ,7097,1087,973,9157
6/29/2015,2015,6,29, 24 ,6629,1026,993,8648
6/30/2015,2015,6,30, 1 ,6354,991,901,8246
6/30/2015,2015,6,30, 2 ,6185,966,880,8031
6/30/2015,2015,6,30, 3 ,5950,944,859,7753
6/30/2015,2015,6,30, 4 ,5817,941,858,7616
6/30/2015,2015,6,30, 5 ,5937,981,917,7835
6/30/2015,2015,6,30, 6 ,5822,981,966,7769
6/30/2015,2015,6,30, 7 ,5954,951,867,7772
6/30/2015,2015,6,30, 8 ,6844,1100,1000,8944
6/30/2015,2015,6,30, 9 ,7588,1285,1154,10027
6/30/2015,2015,6,30, 10 ,8099,1354,1221,10674
6/30/2015,2015,6,30, 11 ,8442,1403,1269,11114
6/30/2015,2015,6,30, 12 ,8283,1351,1193,10827
6/30/2015,2015,6,30, 13 ,8393,1354,1216,10963
6/30/2015,2015,6,30, 14 ,8704,1390,1258,11352
6/30/2015,2015,6,30, 15 ,8442,1360,1232,11034
6/30/2015,2015,6,30, 16 ,8130,1345,1218,10693
6/30/2015,2015,6,30, 17 ,7814,1302,1206,10322
6/30/2015,2015,6,30, 18 ,7542,1351,1271,10164
6/30/2015,2015,6,30, 19 ,7854,1439,1331,10624
6/30/2015,2015,6,30, 20 ,7881,1390,1276,10547
6/30/2015,2015,6,30, 21 ,7754,1300,1210,10264
6/30/2015,2015,6,30, 22 ,7525,1190,1112,9827
6/30/2015,2015,6,30, 23 ,7069,1094,1016,9179
6/30/2015,2015,6,30, 24 ,6695,1022,925,8642
7/1/2015,2015,7,1, 1 ,6361,978,920,8259
7/1/2015,2015,7,1, 2 ,6270,949,902,8121
7/1/2015,2015,7,1, 3 ,6096,930,886,7912
7/1/2015,2015,7,1, 4 ,5971,924,881,7776
7/1/2015,2015,7,1, 5 ,6029,964,917,7910
7/1/2015,2015,7,1, 6 ,5838,968,931,7737
7/1/2015,2015,7,1, 7 ,5982,945,883,7810
7/1/2015,2015,7,1, 8 ,6848,1109,998,8955
7/1/2015,2015,7,1, 9 ,7622,1303,1152,10077
7/1/2015,2015,7,1, 10 ,8123,1385,1283,10791
7/1/2015,2015,7,1, 11 ,8400,1426,1311,11137
7/1/2015,2015,7,1, 12 ,8290,1350,1256,10896
7/1/2015,2015,7,1, 13 ,8337,1346,1253,10936
7/1/2015,2015,7,1, 14 ,8673,1390,1267,11330
7/1/2015,2015,7,1, 15 ,8558,1353,1234,11145
7/1/2015,2015,7,1, 16 ,8362,1333,1246,10941
7/1/2015,2015,7,1, 17 ,7933,1294,1261,10488
7/1/2015,2015,7,1, 18 ,7562,1298,1296,10156
7/1/2015,2015,7,1, 19 ,7963,1419,1329,10711
7/1/2015,2015,7,1, 20 ,7944,1376,1270,10590
7/1/2015,2015,7,1, 21 ,7813,1295,1225,10333
7/1/2015,2015,7,1, 22 ,7677,1160,1075,9912
7/1/2015,2015,7,1, 23 ,7217,1064,1003,9284
7/1/2015,2015,7,1, 24 ,6812,997,937,8746
7/2/2015,2015,7,2, 1 ,6507,959,898,8364
7/2/2015,2015,7,2, 2 ,6315,933,880,8128
7/2/2015,2015,7,2, 3 ,6049,907,871,7827
7/2/2015,2015,7,2, 4 ,5908,906,860,7674
7/2/2015,2015,7,2, 5 ,6034,957,923,7914
7/2/2015,2015,7,2, 6 ,5859,974,950,7783
7/2/2015,2015,7,2, 7 ,5966,934,894,7794
7/2/2015,2015,7,2, 8 ,6914,1083,981,8978
7/2/2015,2015,7,2, 9 ,7615,1262,1116,9993
7/2/2015,2015,7,2, 10 ,8112,1347,1211,10670
7/2/2015,2015,7,2, 11 ,8357,1375,1273,11005
7/2/2015,2015,7,2, 12 ,8269,1291,1220,10780
7/2/2015,2015,7,2, 13 ,8307,1285,1225,10817
7/2/2015,2015,7,2, 14 ,8532,1286,1240,11058
7/2/2015,2015,7,2, 15 ,8423,1222,1190,10835
7/2/2015,2015,7,2, 16 ,8211,1258,1201,10670
7/2/2015,2015,7,2, 17 ,7804,1256,1165,10225
7/2/2015,2015,7,2, 18 ,7574,1271,1251,10096
7/2/2015,2015,7,2, 19 ,7926,1380,1293,10599
7/2/2015,2015,7,2, 20 ,7941,1331,1224,10496
7/2/2015,2015,7,2, 21 ,7896,1261,1171,10328
7/2/2015,2015,7,2, 22 ,7565,1181,1049,9795
7/2/2015,2015,7,2, 23 ,7177,1053,950,9180
7/2/2015,2015,7,2, 24 ,6759,977,910,8646
7/3/2015,2015,7,3, 1 ,6515,911,848,8274
7/3/2015,2015,7,3, 2 ,6296,911,820,8027
7/3/2015,2015,7,3, 3 ,6119,892,823,7834
7/3/2015,2015,7,3, 4 ,5957,910,816,7683
7/3/2015,2015,7,3, 5 ,6085,942,864,7891
7/3/2015,2015,7,3, 6 ,5912,975,919,7806
7/3/2015,2015,7,3, 7 ,6099,961,865,7925
7/3/2015,2015,7,3, 8 ,7034,1066,979,9079
7/3/2015,2015,7,3, 9 ,7608,1232,1075,9915
7/3/2015,2015,7,3, 10 ,8135,1320,1221,10676
7/3/2015,2015,7,3, 11 ,8322,1341,1259,10922
7/3/2015,2015,7,3, 12 ,8186,1268,1221,10675
7/3/2015,2015,7,3, 13 ,8227,1253,1247,10727
7/3/2015,2015,7,3, 14 ,8525,1298,1303,11126
7/3/2015,2015,7,3, 15 ,8385,1284,1264,10933
7/3/2015,2015,7,3, 16 ,8186,1277,1274,10737
7/3/2015,2015,7,3, 17 ,7748,1214,1237,10199
7/3/2015,2015,7,3, 18 ,7470,1263,1259,9992
7/3/2015,2015,7,3, 19 ,7779,1385,1350,10514
7/3/2015,2015,7,3, 20 ,7792,1255,1301,10348
7/3/2015,2015,7,3, 21 ,7732,1200,1227,10159
7/3/2015,2015,7,3, 22 ,7481,1096,1118,9695
7/3/2015,2015,7,3, 23 ,7101,1029,1037,9167
7/3/2015,2015,7,3, 24 ,6708,968,909,8585
7/4/2015,2015,7,4, 1 ,6488,931,954,8373
7/4/2015,2015,7,4, 2 ,6219,910,907,8036
7/4/2015,2015,7,4, 3 ,6062,889,890,7841
7/4/2015,2015,7,4, 4 ,5914,881,872,7667
7/4/2015,2015,7,4, 5 ,5793,895,884,7572
7/4/2015,2015,7,4, 6 ,5685,903,886,7474
7/4/2015,2015,7,4, 7 ,5803,907,876,7586
7/4/2015,2015,7,4, 8 ,6374,1012,919,8305
7/4/2015,2015,7,4, 9 ,6929,1142,1028,9099
7/4/2015,2015,7,4, 10 ,7266,1209,1119,9594
7/4/2015,2015,7,4, 11 ,7554,1246,1163,9963
7/4/2015,2015,7,4, 12 ,7398,1184,1133,9715
7/4/2015,2015,7,4, 13 ,7389,1175,1166,9730
7/4/2015,2015,7,4, 14 ,7632,1203,1199,10034
7/4/2015,2015,7,4, 15 ,7475,1183,1186,9844
7/4/2015,2015,7,4, 16 ,7258,1175,1140,9573
7/4/2015,2015,7,4, 17 ,6987,1153,1106,9246
7/4/2015,2015,7,4, 18 ,6954,1221,1199,9374
7/4/2015,2015,7,4, 19 ,7317,1332,1263,9912
7/4/2015,2015,7,4, 20 ,7315,1263,1224,9802
7/4/2015,2015,7,4, 21 ,7216,1227,1209,9652
7/4/2015,2015,7,4, 22 ,7019,1155,1156,9330
7/4/2015,2015,7,4, 23 ,6650,1064,1041,8755
7/4/2015,2015,7,4, 24 ,6325,984,969,8278
7/5/2015,2015,7,5, 1 ,6029,919,908,7856
7/5/2015,2015,7,5, 2 ,5750,924,893,7567
7/5/2015,2015,7,5, 3 ,5611,877,879,7367
7/5/2015,2015,7,5, 4 ,5432,860,853,7145
7/5/2015,2015,7,5, 5 ,5330,867,857,7054
7/5/2015,2015,7,5, 6 ,5078,845,856,6779
7/5/2015,2015,7,5, 7 ,5051,855,823,6729
7/5/2015,2015,7,5, 8 ,5306,897,870,7073
7/5/2015,2015,7,5, 9 ,5545,967,916,7428
7/5/2015,2015,7,5, 10 ,5904,1016,1003,7923
7/5/2015,2015,7,5, 11 ,5976,1061,1038,8075
7/5/2015,2015,7,5, 12 ,5915,1062,1024,8001
7/5/2015,2015,7,5, 13 ,5816,1050,1060,7926
7/5/2015,2015,7,5, 14 ,5717,1052,1051,7820
7/5/2015,2015,7,5, 15 ,5645,1026,1050,7721
7/5/2015,2015,7,5, 16 ,5546,1034,1041,7621
7/5/2015,2015,7,5, 17 ,5639,1043,1041,7723
7/5/2015,2015,7,5, 18 ,5820,1168,1136,8124
7/5/2015,2015,7,5, 19 ,6147,1292,1281,8720
7/5/2015,2015,7,5, 20 ,6146,1239,1246,8631
7/5/2015,2015,7,5, 21 ,5961,1168,1203,8332
7/5/2015,2015,7,5, 22 ,5509,1052,1102,7663
7/5/2015,2015,7,5, 23 ,5176,976,1028,7180
7/5/2015,2015,7,5, 24 ,4871,917,996,6784
7/6/2015,2015,7,6, 1 ,4661,885,920,6466
7/6/2015,2015,7,6, 2 ,4489,870,891,6250
7/6/2015,2015,7,6, 3 ,4425,848,873,6146
7/6/2015,2015,7,6, 4 ,4396,847,867,6110
7/6/2015,2015,7,6, 5 ,4659,901,920,6480
7/6/2015,2015,7,6, 6 ,4859,938,929,6726
7/6/2015,2015,7,6, 7 ,5095,899,877,6871
7/6/2015,2015,7,6, 8 ,5883,1045,1002,7930
7/6/2015,2015,7,6, 9 ,6807,1241,1192,9240
7/6/2015,2015,7,6, 10 ,6956,1348,1271,9575
7/6/2015,2015,7,6, 11 ,7215,1383,1321,9919
7/6/2015,2015,7,6, 12 ,6952,1327,1284,9563
7/6/2015,2015,7,6, 13 ,6865,1318,1301,9484
7/6/2015,2015,7,6, 14 ,7060,1408,1343,9811
7/6/2015,2015,7,6, 15 ,6903,1378,1336,9617
7/6/2015,2015,7,6, 16 ,6769,1355,1324,9448
7/6/2015,2015,7,6, 17 ,6492,1307,1284,9083
7/6/2015,2015,7,6, 18 ,6327,1313,1325,8965
7/6/2015,2015,7,6, 19 ,6756,1441,1368,9565
7/6/2015,2015,7,6, 20 ,6575,1394,1346,9315
7/6/2015,2015,7,6, 21 ,6360,1317,1279,8956
7/6/2015,2015,7,6, 22 ,5865,1195,1226,8286
7/6/2015,2015,7,6, 23 ,6461,1080,1113,8654
7/6/2015,2015,7,6, 24 ,5187,1007,1018,7212
7/7/2015,2015,7,7, 1 ,5017,977,1000,6994
7/7/2015,2015,7,7, 2 ,4890,944,962,6796
7/7/2015,2015,7,7, 3 ,4743,924,947,6614
7/7/2015,2015,7,7, 4 ,4762,918,935,6615
7/7/2015,2015,7,7, 5 ,5228,963,980,7171
7/7/2015,2015,7,7, 6 ,5179,973,982,7134
7/7/2015,2015,7,7, 7 ,5361,938,948,7247
7/7/2015,2015,7,7, 8 ,6152,1123,1066,8341
7/7/2015,2015,7,7, 9 ,7024,1296,1232,9552
7/7/2015,2015,7,7, 10 ,7505,1396,1305,10206
7/7/2015,2015,7,7, 11 ,7819,1432,1336,10587
7/7/2015,2015,7,7, 12 ,7697,1385,1297,10379
7/7/2015,2015,7,7, 13 ,7678,1403,1327,10408
7/7/2015,2015,7,7, 14 ,7961,1483,1354,10798
7/7/2015,2015,7,7, 15 ,7856,1455,1345,10656
7/7/2015,2015,7,7, 16 ,7716,1427,1324,10467
7/7/2015,2015,7,7, 17 ,7456,1359,1295,10110
7/7/2015,2015,7,7, 18 ,7322,1354,1321,9997
7/7/2015,2015,7,7, 19 ,7290,1502,1385,10177
7/7/2015,2015,7,7, 20 ,7248,1475,1353,10076
7/7/2015,2015,7,7, 21 ,7001,1383,1316,9700
7/7/2015,2015,7,7, 22 ,6550,1264,1211,9025
7/7/2015,2015,7,7, 23 ,6069,1149,1118,8336
7/7/2015,2015,7,7, 24 ,5720,1064,1068,7852
7/8/2015,2015,7,8, 1 ,5535,1024,990,7549
7/8/2015,2015,7,8, 2 ,5326,1005,961,7292
7/8/2015,2015,7,8, 3 ,5244,976,942,7162
7/8/2015,2015,7,8, 4 ,5281,959,939,7179
7/8/2015,2015,7,8, 5 ,5443,1001,982,7426
7/8/2015,2015,7,8, 6 ,5504,1004,988,7496
7/8/2015,2015,7,8, 7 ,5702,978,922,7602
7/8/2015,2015,7,8, 8 ,6423,1137,1042,8602
7/8/2015,2015,7,8, 9 ,7034,1325,1257,9616
7/8/2015,2015,7,8, 10 ,7469,1444,1314,10227
7/8/2015,2015,7,8, 11 ,7712,1460,1361,10533
7/8/2015,2015,7,8, 12 ,7382,1434,1308,10124
7/8/2015,2015,7,8, 13 ,7243,1439,1327,10009
7/8/2015,2015,7,8, 14 ,7403,1470,1385,10258
7/8/2015,2015,7,8, 15 ,7196,1452,1344,9992
7/8/2015,2015,7,8, 16 ,7185,1412,1323,9920
7/8/2015,2015,7,8, 17 ,6964,1378,1277,9619
7/8/2015,2015,7,8, 18 ,6907,1407,1327,9641
7/8/2015,2015,7,8, 19 ,7173,1512,1393,10078
7/8/2015,2015,7,8, 20 ,7054,1462,1341,9857
7/8/2015,2015,7,8, 21 ,6779,1367,1323,9469
7/8/2015,2015,7,8, 22 ,6315,1251,1220,8786
7/8/2015,2015,7,8, 23 ,5933,1134,1136,8203
7/8/2015,2015,7,8, 24 ,5566,1060,1058,7684
7/9/2015,2015,7,9, 1 ,5270,1026,1014,7310
7/9/2015,2015,7,9, 2 ,5190,994,984,7168
7/9/2015,2015,7,9, 3 ,5074,953,975,7002
7/9/2015,2015,7,9, 4 ,5034,948,952,6934
7/9/2015,2015,7,9, 5 ,5168,984,991,7143
7/9/2015,2015,7,9, 6 ,5275,1015,993,7283
7/9/2015,2015,7,9, 7 ,5525,977,936,7438
7/9/2015,2015,7,9, 8 ,6362,1121,1061,8544
7/9/2015,2015,7,9, 9 ,6938,1300,1243,9481
7/9/2015,2015,7,9, 10 ,7255,1386,1298,9939
7/9/2015,2015,7,9, 11 ,7517,1425,1356,10298
7/9/2015,2015,7,9, 12 ,7293,1374,1297,9964
7/9/2015,2015,7,9, 13 ,7078,1378,1311,9767
7/9/2015,2015,7,9, 14 ,7262,1447,1371,10080
7/9/2015,2015,7,9, 15 ,7106,1423,1343,9872
7/9/2015,2015,7,9, 16 ,7026,1403,1331,9760
7/9/2015,2015,7,9, 17 ,6807,1348,1256,9411
7/9/2015,2015,7,9, 18 ,6746,1382,1274,9402
7/9/2015,2015,7,9, 19 ,7050,1439,1391,9880
7/9/2015,2015,7,9, 20 ,6851,1364,1348,9563
7/9/2015,2015,7,9, 21 ,6655,1279,1337,9271
7/9/2015,2015,7,9, 22 ,6279,1161,1207,8647
7/9/2015,2015,7,9, 23 ,5841,1058,1122,8021
7/9/2015,2015,7,9, 24 ,5507,992,1050,7549
7/10/2015,2015,7,10, 1 ,5187,962,1010,7159
7/10/2015,2015,7,10, 2 ,5088,935,980,7003
7/10/2015,2015,7,10, 3 ,5021,925,958,6904
7/10/2015,2015,7,10, 4 ,4945,917,951,6813
7/10/2015,2015,7,10, 5 ,5045,949,987,6981
7/10/2015,2015,7,10, 6 ,5134,983,1010,7127
7/10/2015,2015,7,10, 7 ,5406,953,950,7309
7/10/2015,2015,7,10, 8 ,6101,1087,1075,8263
7/10/2015,2015,7,10, 9 ,6651,1255,1255,9161
7/10/2015,2015,7,10, 10 ,7156,1347,1301,9804
7/10/2015,2015,7,10, 11 ,7452,1376,1357,10185
7/10/2015,2015,7,10, 12 ,7253,1306,1291,9850
7/10/2015,2015,7,10, 13 ,7052,1293,1282,9627
7/10/2015,2015,7,10, 14 ,7273,1336,1368,9977
7/10/2015,2015,7,10, 15 ,7109,1337,1332,9778
7/10/2015,2015,7,10, 16 ,7101,1333,1315,9749
7/10/2015,2015,7,10, 17 ,6903,1270,1264,9437
7/10/2015,2015,7,10, 18 ,6767,1319,1324,9410
7/10/2015,2015,7,10, 19 ,7018,1377,1379,9774
7/10/2015,2015,7,10, 20 ,6881,1331,1333,9545
7/10/2015,2015,7,10, 21 ,6688,1258,1278,9224
7/10/2015,2015,7,10, 22 ,6365,1141,1164,8670
7/10/2015,2015,7,10, 23 ,5847,1042,1089,7978
7/10/2015,2015,7,10, 24 ,5511,978,1054,7543
7/11/2015,2015,7,11, 1 ,5245,936,1007,7188
7/11/2015,2015,7,11, 2 ,5061,919,975,6955
7/11/2015,2015,7,11, 3 ,4947,907,960,6814
7/11/2015,2015,7,11, 4 ,4929,894,929,6752
7/11/2015,2015,7,11, 5 ,4964,908,942,6814
7/11/2015,2015,7,11, 6 ,4953,919,939,6811
7/11/2015,2015,7,11, 7 ,5107,952,937,6996
7/11/2015,2015,7,11, 8 ,5735,1052,1017,7804
7/11/2015,2015,7,11, 9 ,6252,1183,1170,8605
7/11/2015,2015,7,11, 10 ,6756,1266,1232,9254
7/11/2015,2015,7,11, 11 ,6965,1326,1265,9556
7/11/2015,2015,7,11, 12 ,6855,1289,1134,9278
7/11/2015,2015,7,11, 13 ,6844,1280,1227,9351
7/11/2015,2015,7,11, 14 ,6988,1318,1227,9533
7/11/2015,2015,7,11, 15 ,6829,1288,1231,9348
7/11/2015,2015,7,11, 16 ,6674,1264,1225,9163
7/11/2015,2015,7,11, 17 ,6379,1217,1202,8798
7/11/2015,2015,7,11, 18 ,6417,1262,1272,8951
7/11/2015,2015,7,11, 19 ,6771,1410,1372,9553
7/11/2015,2015,7,11, 20 ,6757,1392,1290,9439
7/11/2015,2015,7,11, 21 ,6738,1349,1248,9335
7/11/2015,2015,7,11, 22 ,6414,1270,1158,8842
7/11/2015,2015,7,11, 23 ,6022,1146,1068,8236
7/11/2015,2015,7,11, 24 ,5722,1059,958,7739
7/12/2015,2015,7,12, 1 ,5421,976,952,7349
7/12/2015,2015,7,12, 2 ,5238,947,933,7118
7/12/2015,2015,7,12, 3 ,5137,925,924,6986
7/12/2015,2015,7,12, 4 ,5014,913,899,6826
7/12/2015,2015,7,12, 5 ,5017,931,906,6854
7/12/2015,2015,7,12, 6 ,4792,907,888,6587
7/12/2015,2015,7,12, 7 ,4889,907,874,6670
7/12/2015,2015,7,12, 8 ,5226,955,923,7104
7/12/2015,2015,7,12, 9 ,5578,1041,994,7613
7/12/2015,2015,7,12, 10 ,5928,1128,1084,8140
7/12/2015,2015,7,12, 11 ,6225,1179,1147,8551
7/12/2015,2015,7,12, 12 ,6184,1181,1149,8514
7/12/2015,2015,7,12, 13 ,6109,1177,1163,8449
7/12/2015,2015,7,12, 14 ,6159,1185,1170,8514
7/12/2015,2015,7,12, 15 ,6059,1179,1162,8400
7/12/2015,2015,7,12, 16 ,5986,1158,1139,8283
7/12/2015,2015,7,12, 17 ,5898,1140,1111,8149
7/12/2015,2015,7,12, 18 ,6008,1199,1187,8394
7/12/2015,2015,7,12, 19 ,6657,1410,1309,9376
7/12/2015,2015,7,12, 20 ,6670,1384,1289,9343
7/12/2015,2015,7,12, 21 ,6552,1328,1233,9113
7/12/2015,2015,7,12, 22 ,6246,1238,1182,8666
7/12/2015,2015,7,12, 23 ,5884,1149,1108,8141
7/12/2015,2015,7,12, 24 ,5544,1060,1039,7643
7/13/2015,2015,7,13, 1 ,5249,996,960,7205
7/13/2015,2015,7,13, 2 ,5097,962,935,6994
7/13/2015,2015,7,13, 3 ,4934,936,918,6788
7/13/2015,2015,7,13, 4 ,4910,922,901,6733
7/13/2015,2015,7,13, 5 ,5088,976,951,7015
7/13/2015,2015,7,13, 6 ,5168,982,965,7115
7/13/2015,2015,7,13, 7 ,5435,964,879,7278
7/13/2015,2015,7,13, 8 ,6334,1138,1048,8520
7/13/2015,2015,7,13, 9 ,7147,1344,1210,9701
7/13/2015,2015,7,13, 10 ,7706,1432,1286,10424
7/13/2015,2015,7,13, 11 ,7933,1486,1290,10709
7/13/2015,2015,7,13, 12 ,7793,1453,1271,10517
7/13/2015,2015,7,13, 13 ,7818,1434,1305,10557
7/13/2015,2015,7,13, 14 ,8100,1521,1333,10954
7/13/2015,2015,7,13, 15 ,7990,1505,1313,10808
7/13/2015,2015,7,13, 16 ,7814,1464,1327,10605
7/13/2015,2015,7,13, 17 ,7469,1382,1264,10115
7/13/2015,2015,7,13, 18 ,7165,1383,1280,9828
7/13/2015,2015,7,13, 19 ,7603,1554,1367,10524
7/13/2015,2015,7,13, 20 ,7503,1527,1345,10375
7/13/2015,2015,7,13, 21 ,7339,1448,1308,10095
7/13/2015,2015,7,13, 22 ,6966,1319,1196,9481
7/13/2015,2015,7,13, 23 ,6542,1202,1138,8882
7/13/2015,2015,7,13, 24 ,6138,1112,1079,8329
7/14/2015,2015,7,14, 1 ,5887,1056,1022,7965
7/14/2015,2015,7,14, 2 ,5650,1020,988,7658
7/14/2015,2015,7,14, 3 ,5573,997,968,7538
7/14/2015,2015,7,14, 4 ,5523,983,956,7462
7/14/2015,2015,7,14, 5 ,5637,1017,997,7651
7/14/2015,2015,7,14, 6 ,5670,1018,999,7687
7/14/2015,2015,7,14, 7 ,5804,1003,932,7739
7/14/2015,2015,7,14, 8 ,6606,1185,1103,8894
7/14/2015,2015,7,14, 9 ,7336,1357,1239,9932
7/14/2015,2015,7,14, 10 ,7798,1475,1324,10597
7/14/2015,2015,7,14, 11 ,8035,1515,1358,10908
7/14/2015,2015,7,14, 12 ,7801,1473,1324,10598
7/14/2015,2015,7,14, 13 ,7729,1488,1322,10539
7/14/2015,2015,7,14, 14 ,8014,1554,1361,10929
7/14/2015,2015,7,14, 15 ,7860,1537,1399,10796
7/14/2015,2015,7,14, 16 ,7748,1505,1355,10608
7/14/2015,2015,7,14, 17 ,7409,1410,1303,10122
7/14/2015,2015,7,14, 18 ,7169,1389,1304,9862
7/14/2015,2015,7,14, 19 ,7491,1560,1378,10429
7/14/2015,2015,7,14, 20 ,7465,1514,1343,10322
7/14/2015,2015,7,14, 21 ,7305,1459,1254,10018
7/14/2015,2015,7,14, 22 ,6965,1324,1186,9475
7/14/2015,2015,7,14, 23 ,6555,1221,1143,8919
7/14/2015,2015,7,14, 24 ,6156,1133,1096,8385
7/15/2015,2015,7,15, 1 ,5883,1071,1023,7977
7/15/2015,2015,7,15, 2 ,5740,1041,987,7768
7/15/2015,2015,7,15, 3 ,5631,1000,970,7601
7/15/2015,2015,7,15, 4 ,5563,998,954,7515
7/15/2015,2015,7,15, 5 ,5652,1033,997,7682
7/15/2015,2015,7,15, 6 ,5670,1027,983,7680
7/15/2015,2015,7,15, 7 ,5826,991,920,7737
7/15/2015,2015,7,15, 8 ,6643,1172,1103,8918
7/15/2015,2015,7,15, 9 ,7397,1376,1248,10021
7/15/2015,2015,7,15, 10 ,7687,1468,1316,10471
7/15/2015,2015,7,15, 11 ,8004,1517,1352,10873
7/15/2015,2015,7,15, 12 ,7813,1487,1332,10632
7/15/2015,2015,7,15, 13 ,7915,1499,1359,10773
7/15/2015,2015,7,15, 14 ,8137,1535,1388,11060
7/15/2015,2015,7,15, 15 ,8088,1517,1222,10827
7/15/2015,2015,7,15, 16 ,7836,1481,1309,10626
7/15/2015,2015,7,15, 17 ,7551,1375,1278,10204
7/15/2015,2015,7,15, 18 ,7270,1369,1300,9939
7/15/2015,2015,7,15, 19 ,7715,1529,1335,10579
7/15/2015,2015,7,15, 20 ,7583,1493,1337,10413
7/15/2015,2015,7,15, 21 ,7451,1447,1309,10207
7/15/2015,2015,7,15, 22 ,7160,1319,1196,9675
7/15/2015,2015,7,15, 23 ,6668,1219,1137,9024
7/15/2015,2015,7,15, 24 ,6325,1118,1033,8476
7/16/2015,2015,7,16, 1 ,6011,1078,989,8078
7/16/2015,2015,7,16, 2 ,5831,1020,967,7818
7/16/2015,2015,7,16, 3 ,5706,992,928,7626
7/16/2015,2015,7,16, 4 ,5666,976,952,7594
7/16/2015,2015,7,16, 5 ,5796,1002,994,7792
7/16/2015,2015,7,16, 6 ,5767,1007,987,7761
7/16/2015,2015,7,16, 7 ,5869,974,927,7770
7/16/2015,2015,7,16, 8 ,6697,1135,1100,8932
7/16/2015,2015,7,16, 9 ,7372,1333,1199,9904
7/16/2015,2015,7,16, 10 ,7871,1451,1278,10600
7/16/2015,2015,7,16, 11 ,7968,1535,1318,10821
7/16/2015,2015,7,16, 12 ,7777,1489,1304,10570
7/16/2015,2015,7,16, 13 ,7703,1505,1331,10539
7/16/2015,2015,7,16, 14 ,7910,1560,1360,10830
7/16/2015,2015,7,16, 15 ,7786,1540,1311,10637
7/16/2015,2015,7,16, 16 ,7577,1498,1237,10312
7/16/2015,2015,7,16, 17 ,7373,1416,1153,9942
7/16/2015,2015,7,16, 18 ,7235,1397,1260,9892
7/16/2015,2015,7,16, 19 ,7502,1555,1349,10406
7/16/2015,2015,7,16, 20 ,7325,1501,1313,10139
7/16/2015,2015,7,16, 21 ,7121,1443,1297,9861
7/16/2015,2015,7,16, 22 ,6775,1325,1189,9289
7/16/2015,2015,7,16, 23 ,6432,1214,1103,8749
7/16/2015,2015,7,16, 24 ,6020,1139,1050,8209
7/17/2015,2015,7,17, 1 ,5841,1092,947,7880
7/17/2015,2015,7,17, 2 ,5630,1046,920,7596
7/17/2015,2015,7,17, 3 ,5532,1016,898,7446
7/17/2015,2015,7,17, 4 ,5436,990,900,7326
7/17/2015,2015,7,17, 5 ,5463,985,939,7387
7/17/2015,2015,7,17, 6 ,5338,964,906,7208
7/17/2015,2015,7,17, 7 ,5429,974,896,7299
7/17/2015,2015,7,17, 8 ,5768,1092,989,7849
7/17/2015,2015,7,17, 9 ,6209,1219,1122,8550
7/17/2015,2015,7,17, 10 ,6565,1302,1182,9049
7/17/2015,2015,7,17, 11 ,6853,1372,1222,9447
7/17/2015,2015,7,17, 12 ,6660,1328,1189,9177
7/17/2015,2015,7,17, 13 ,6497,1347,1230,9074
7/17/2015,2015,7,17, 14 ,6607,1387,1242,9236
7/17/2015,2015,7,17, 15 ,6518,1368,1220,9106
7/17/2015,2015,7,17, 16 ,6430,1336,1209,8975
7/17/2015,2015,7,17, 17 ,6338,1267,1137,8742
7/17/2015,2015,7,17, 18 ,6514,1310,1217,9041
7/17/2015,2015,7,17, 19 ,6877,1490,1331,9698
7/17/2015,2015,7,17, 20 ,6906,1455,1282,9643
7/17/2015,2015,7,17, 21 ,6791,1399,1256,9446
7/17/2015,2015,7,17, 22 ,6464,1293,1162,8919
7/17/2015,2015,7,17, 23 ,6139,1199,1114,8452
7/17/2015,2015,7,17, 24 ,5804,1108,1095,8007
7/18/2015,2015,7,18, 1 ,5582,1057,984,7623
7/18/2015,2015,7,18, 2 ,5439,1024,963,7426
7/18/2015,2015,7,18, 3 ,5238,994,937,7169
7/18/2015,2015,7,18, 4 ,5179,980,917,7076
7/18/2015,2015,7,18, 5 ,5150,985,927,7062
7/18/2015,2015,7,18, 6 ,5161,955,912,7028
7/18/2015,2015,7,18, 7 ,5294,972,894,7160
7/18/2015,2015,7,18, 8 ,5770,1096,1016,7882
7/18/2015,2015,7,18, 9 ,6295,1240,1088,8623
7/18/2015,2015,7,18, 10 ,6709,1332,1136,9177
7/18/2015,2015,7,18, 11 ,6973,1410,1170,9553
7/18/2015,2015,7,18, 12 ,6823,1373,1161,9357
7/18/2015,2015,7,18, 13 ,6744,1385,1178,9307
7/18/2015,2015,7,18, 14 ,6831,1432,1222,9485
7/18/2015,2015,7,18, 15 ,6708,1392,1206,9306
7/18/2015,2015,7,18, 16 ,6618,1346,1182,9146
7/18/2015,2015,7,18, 17 ,6401,1289,1111,8801
7/18/2015,2015,7,18, 18 ,6463,1330,1197,8990
7/18/2015,2015,7,18, 19 ,6974,1501,1242,9717
7/18/2015,2015,7,18, 20 ,6862,1481,1255,9598
7/18/2015,2015,7,18, 21 ,6777,1434,1193,9404
7/18/2015,2015,7,18, 22 ,6522,1348,1122,8992
7/18/2015,2015,7,18, 23 ,6158,1231,1046,8435
7/18/2015,2015,7,18, 24 ,5810,1145,990,7945
7/19/2015,2015,7,19, 1 ,5621,1078,993,7692
7/19/2015,2015,7,19, 2 ,5452,1038,976,7466
7/19/2015,2015,7,19, 3 ,5275,1007,925,7207
7/19/2015,2015,7,19, 4 ,5137,982,913,7032
7/19/2015,2015,7,19, 5 ,5079,967,928,6974
7/19/2015,2015,7,19, 6 ,4907,924,889,6720
7/19/2015,2015,7,19, 7 ,4879,931,890,6700
7/19/2015,2015,7,19, 8 ,5260,991,946,7197
7/19/2015,2015,7,19, 9 ,5665,1087,1035,7787
7/19/2015,2015,7,19, 10 ,6139,1185,1085,8409
7/19/2015,2015,7,19, 11 ,6390,1240,1099,8729
7/19/2015,2015,7,19, 12 ,6421,1230,1108,8759
7/19/2015,2015,7,19, 13 ,6396,1251,1106,8753
7/19/2015,2015,7,19, 14 ,6507,1259,1111,8877
7/19/2015,2015,7,19, 15 ,6457,1247,1084,8788
7/19/2015,2015,7,19, 16 ,6298,1220,1096,8614
7/19/2015,2015,7,19, 17 ,6073,1174,1094,8341
7/19/2015,2015,7,19, 18 ,6231,1233,1171,8635
7/19/2015,2015,7,19, 19 ,6889,1438,1232,9559
7/19/2015,2015,7,19, 20 ,7015,1430,1230,9675
7/19/2015,2015,7,19, 21 ,6889,1368,1230,9487
7/19/2015,2015,7,19, 22 ,6689,1274,1145,9108
7/19/2015,2015,7,19, 23 ,6367,1171,1078,8616
7/19/2015,2015,7,19, 24 ,6019,1103,1016,8138
7/20/2015,2015,7,20, 1 ,5635,1027,979,7641
7/20/2015,2015,7,20, 2 ,5441,985,949,7375
7/20/2015,2015,7,20, 3 ,5294,956,888,7138
7/20/2015,2015,7,20, 4 ,5264,944,898,7106
7/20/2015,2015,7,20, 5 ,5378,981,954,7313
7/20/2015,2015,7,20, 6 ,5434,976,985,7395
7/20/2015,2015,7,20, 7 ,5608,936,913,7457
7/20/2015,2015,7,20, 8 ,6568,1126,1076,8770
7/20/2015,2015,7,20, 9 ,7415,1386,1189,9990
7/20/2015,2015,7,20, 10 ,7926,1485,1282,10693
7/20/2015,2015,7,20, 11 ,8195,1540,1308,11043
7/20/2015,2015,7,20, 12 ,8023,1496,1310,10829
7/20/2015,2015,7,20, 13 ,8082,1503,1321,10906
7/20/2015,2015,7,20, 14 ,8374,1567,1325,11266
7/20/2015,2015,7,20, 15 ,8331,1546,1311,11188
7/20/2015,2015,7,20, 16 ,8182,1518,1274,10974
7/20/2015,2015,7,20, 17 ,7668,1413,1248,10329
7/20/2015,2015,7,20, 18 ,7303,1398,1255,9956
7/20/2015,2015,7,20, 19 ,7614,1577,1314,10505
7/20/2015,2015,7,20, 20 ,7550,1518,1271,10339
7/20/2015,2015,7,20, 21 ,7529,1456,1252,10237
7/20/2015,2015,7,20, 22 ,7190,1355,1212,9757
7/20/2015,2015,7,20, 23 ,6842,1243,1142,9227
7/20/2015,2015,7,20, 24 ,6409,1151,1079,8639
7/21/2015,2015,7,21, 1 ,6100,1096,1012,8208
7/21/2015,2015,7,21, 2 ,5918,1061,995,7974
7/21/2015,2015,7,21, 3 ,5700,1029,949,7678
7/21/2015,2015,7,21, 4 ,5627,1006,945,7578
7/21/2015,2015,7,21, 5 ,5723,1041,989,7753
7/21/2015,2015,7,21, 6 ,5666,1040,1004,7710
7/21/2015,2015,7,21, 7 ,5769,1003,930,7702
7/21/2015,2015,7,21, 8 ,6746,1200,1051,8997
7/21/2015,2015,7,21, 9 ,7527,1417,1149,10093
7/21/2015,2015,7,21, 10 ,7965,1507,1174,10646
7/21/2015,2015,7,21, 11 ,8242,1549,1170,10961
7/21/2015,2015,7,21, 12 ,8089,1496,1191,10776
7/21/2015,2015,7,21, 13 ,8117,1527,1185,10829
7/21/2015,2015,7,21, 14 ,8370,1572,1210,11152
7/21/2015,2015,7,21, 15 ,8262,1543,1234,11039
7/21/2015,2015,7,21, 16 ,8151,1507,1119,10777
7/21/2015,2015,7,21, 17 ,7811,1440,1131,10382
7/21/2015,2015,7,21, 18 ,7480,1452,1173,10105
7/21/2015,2015,7,21, 19 ,7851,1539,1211,10601
7/21/2015,2015,7,21, 20 ,7764,1512,1216,10492
7/21/2015,2015,7,21, 21 ,7690,1434,1146,10270
7/21/2015,2015,7,21, 22 ,7361,1337,1078,9776
7/21/2015,2015,7,21, 23 ,6912,1204,999,9115
7/21/2015,2015,7,21, 24 ,6493,1129,886,8508
7/22/2015,2015,7,22, 1 ,6185,1082,976,8243
7/22/2015,2015,7,22, 2 ,6005,1048,943,7996
7/22/2015,2015,7,22, 3 ,5807,1023,919,7749
7/22/2015,2015,7,22, 4 ,5716,1004,916,7636
7/22/2015,2015,7,22, 5 ,5764,1038,952,7754
7/22/2015,2015,7,22, 6 ,5759,1053,985,7797
7/22/2015,2015,7,22, 7 ,5858,1011,903,7772
7/22/2015,2015,7,22, 8 ,6777,1138,1039,8954
7/22/2015,2015,7,22, 9 ,7479,1334,1151,9964
7/22/2015,2015,7,22, 10 ,7864,1411,1225,10500
7/22/2015,2015,7,22, 11 ,8196,1465,1171,10832
7/22/2015,2015,7,22, 12 ,8061,1426,1161,10648
7/22/2015,2015,7,22, 13 ,8152,1424,1196,10772
7/22/2015,2015,7,22, 14 ,8376,1495,1194,11065
7/22/2015,2015,7,22, 15 ,8206,1483,1202,10891
7/22/2015,2015,7,22, 16 ,8065,1459,1194,10718
7/22/2015,2015,7,22, 17 ,7340,1379,1170,9889
7/22/2015,2015,7,22, 18 ,7219,1405,1186,9810
7/22/2015,2015,7,22, 19 ,7475,1524,1228,10227
7/22/2015,2015,7,22, 20 ,7323,1474,1183,9980
7/22/2015,2015,7,22, 21 ,7111,1399,1146,9656
7/22/2015,2015,7,22, 22 ,6703,1256,1080,9039
7/22/2015,2015,7,22, 23 ,6239,1142,994,8375
7/22/2015,2015,7,22, 24 ,5899,1066,950,7915
7/23/2015,2015,7,23, 1 ,5653,1027,912,7592
7/23/2015,2015,7,23, 2 ,5504,1005,896,7405
7/23/2015,2015,7,23, 3 ,5386,983,836,7205
7/23/2015,2015,7,23, 4 ,5296,976,874,7146
7/23/2015,2015,7,23, 5 ,5482,1011,918,7411
7/23/2015,2015,7,23, 6 ,5533,1026,951,7510
7/23/2015,2015,7,23, 7 ,5669,989,880,7538
7/23/2015,2015,7,23, 8 ,6434,1129,1024,8587
7/23/2015,2015,7,23, 9 ,7149,1348,1155,9652
7/23/2015,2015,7,23, 10 ,7690,1444,1229,10363
7/23/2015,2015,7,23, 11 ,8062,1500,1214,10776
7/23/2015,2015,7,23, 12 ,7943,1456,1196,10595
7/23/2015,2015,7,23, 13 ,7950,1478,1280,10708
7/23/2015,2015,7,23, 14 ,8301,1543,1343,11187
7/23/2015,2015,7,23, 15 ,8198,1500,1330,11028
7/23/2015,2015,7,23, 16 ,8056,1468,1316,10840
7/23/2015,2015,7,23, 17 ,7662,1394,1280,10336
7/23/2015,2015,7,23, 18 ,7337,1406,1287,10030
7/23/2015,2015,7,23, 19 ,7729,1537,1372,10638
7/23/2015,2015,7,23, 20 ,7724,1495,1331,10550
7/23/2015,2015,7,23, 21 ,7583,1435,1292,10310
7/23/2015,2015,7,23, 22 ,7279,1310,1189,9778
7/23/2015,2015,7,23, 23 ,6803,1194,1089,9086
7/23/2015,2015,7,23, 24 ,6441,1114,862,8417
7/24/2015,2015,7,24, 1 ,6142,1063,982,8187
7/24/2015,2015,7,24, 2 ,5925,1026,944,7895
7/24/2015,2015,7,24, 3 ,5775,992,917,7684
7/24/2015,2015,7,24, 4 ,5679,974,918,7571
7/24/2015,2015,7,24, 5 ,5733,1006,965,7704
7/24/2015,2015,7,24, 6 ,5765,1013,980,7758
7/24/2015,2015,7,24, 7 ,5871,979,915,7765
7/24/2015,2015,7,24, 8 ,6681,1145,1056,8882
7/24/2015,2015,7,24, 9 ,7425,1358,1233,10016
7/24/2015,2015,7,24, 10 ,7873,1446,1314,10633
7/24/2015,2015,7,24, 11 ,8135,1519,1323,10977
7/24/2015,2015,7,24, 12 ,7954,1447,1298,10699
7/24/2015,2015,7,24, 13 ,7941,1464,1341,10746
7/24/2015,2015,7,24, 14 ,8236,1535,1380,11151
7/24/2015,2015,7,24, 15 ,8069,1522,1332,10923
7/24/2015,2015,7,24, 16 ,7848,1485,1291,10624
7/24/2015,2015,7,24, 17 ,7453,1380,1236,10069
7/24/2015,2015,7,24, 18 ,7188,1366,1275,9829
7/24/2015,2015,7,24, 19 ,7489,1512,1281,10282
7/24/2015,2015,7,24, 20 ,7494,1464,1261,10219
7/24/2015,2015,7,24, 21 ,7304,1404,1224,9932
7/24/2015,2015,7,24, 22 ,7001,1298,1109,9408
7/24/2015,2015,7,24, 23 ,6574,1196,1042,8812
7/24/2015,2015,7,24, 24 ,6172,1119,979,8270
7/25/2015,2015,7,25, 1 ,5973,1059,947,7979
7/25/2015,2015,7,25, 2 ,5733,1022,911,7666
7/25/2015,2015,7,25, 3 ,5566,994,891,7451
7/25/2015,2015,7,25, 4 ,5463,974,867,7304
7/25/2015,2015,7,25, 5 ,5431,957,892,7280
7/25/2015,2015,7,25, 6 ,5294,948,900,7142
7/25/2015,2015,7,25, 7 ,5461,973,902,7336
7/25/2015,2015,7,25, 8 ,6111,1091,999,8201
7/25/2015,2015,7,25, 9 ,6726,1255,1105,9086
7/25/2015,2015,7,25, 10 ,7220,1357,1205,9782
7/25/2015,2015,7,25, 11 ,7553,1415,1285,10253
7/25/2015,2015,7,25, 12 ,7454,1391,1244,10089
7/25/2015,2015,7,25, 13 ,7472,1393,1264,10129
7/25/2015,2015,7,25, 14 ,7663,1437,1286,10386
7/25/2015,2015,7,25, 15 ,7462,1413,1258,10133
7/25/2015,2015,7,25, 16 ,7132,1351,1235,9718
7/25/2015,2015,7,25, 17 ,6817,1290,1204,9311
7/25/2015,2015,7,25, 18 ,6683,1314,1236,9233
7/25/2015,2015,7,25, 19 ,6978,1501,1293,9772
7/25/2015,2015,7,25, 20 ,6873,1468,1254,9595
7/25/2015,2015,7,25, 21 ,6748,1408,1250,9406
7/25/2015,2015,7,25, 22 ,6459,1306,1178,8943
7/25/2015,2015,7,25, 23 ,6183,1200,1072,8455
7/25/2015,2015,7,25, 24 ,5870,1117,915,7902
7/26/2015,2015,7,26, 1 ,5528,1062,957,7547
7/26/2015,2015,7,26, 2 ,5399,1020,923,7342
7/26/2015,2015,7,26, 3 ,5251,993,896,7140
7/26/2015,2015,7,26, 4 ,5109,964,873,6946
7/26/2015,2015,7,26, 5 ,5036,962,884,6882
7/26/2015,2015,7,26, 6 ,4882,924,871,6677
7/26/2015,2015,7,26, 7 ,4891,934,833,6658
7/26/2015,2015,7,26, 8 ,5165,999,880,7044
7/26/2015,2015,7,26, 9 ,5514,1088,971,7573
7/26/2015,2015,7,26, 10 ,6084,1157,994,8235
7/26/2015,2015,7,26, 11 ,6357,1209,1061,8627
7/26/2015,2015,7,26, 12 ,6409,1149,1085,8643
7/26/2015,2015,7,26, 13 ,6358,1174,1124,8656
7/26/2015,2015,7,26, 14 ,6454,1184,1060,8698
7/26/2015,2015,7,26, 15 ,6400,1174,1047,8621
7/26/2015,2015,7,26, 16 ,6181,1155,1054,8390
7/26/2015,2015,7,26, 17 ,6070,1161,1072,8303
7/26/2015,2015,7,26, 18 ,6140,1228,1118,8486
7/26/2015,2015,7,26, 19 ,6629,1405,1225,9259
7/26/2015,2015,7,26, 20 ,6679,1379,1205,9263
7/26/2015,2015,7,26, 21 ,6584,1325,1140,9049
7/26/2015,2015,7,26, 22 ,6217,1208,1050,8475
7/26/2015,2015,7,26, 23 ,5875,1113,970,7958
7/26/2015,2015,7,26, 24 ,5513,1035,903,7451
7/27/2015,2015,7,27, 1 ,5228,983,870,7081
7/27/2015,2015,7,27, 2 ,5051,949,841,6841
7/27/2015,2015,7,27, 3 ,4974,928,813,6715
7/27/2015,2015,7,27, 4 ,4943,925,802,6670
7/27/2015,2015,7,27, 5 ,5104,960,862,6926
7/27/2015,2015,7,27, 6 ,5234,974,918,7126
7/27/2015,2015,7,27, 7 ,5448,962,858,7268
7/27/2015,2015,7,27, 8 ,6265,1133,962,8360
7/27/2015,2015,7,27, 9 ,7158,1358,1132,9648
7/27/2015,2015,7,27, 10 ,7684,1455,1137,10276
7/27/2015,2015,7,27, 11 ,8024,1515,1223,10762
7/27/2015,2015,7,27, 12 ,7779,1470,1211,10460
7/27/2015,2015,7,27, 13 ,7692,1442,1252,10386
7/27/2015,2015,7,27, 14 ,7819,1471,1206,10496
7/27/2015,2015,7,27, 15 ,7603,1363,1281,10247
7/27/2015,2015,7,27, 16 ,7417,1344,1275,10036
7/27/2015,2015,7,27, 17 ,7204,1315,1275,9794
7/27/2015,2015,7,27, 18 ,7025,1359,1304,9688
7/27/2015,2015,7,27, 19 ,7320,1458,1310,10088
7/27/2015,2015,7,27, 20 ,7179,1389,1265,9833
7/27/2015,2015,7,27, 21 ,6927,1297,1224,9448
7/27/2015,2015,7,27, 22 ,6533,1179,972,8684
7/27/2015,2015,7,27, 23 ,6136,1075,936,8147
7/27/2015,2015,7,27, 24 ,5756,1013,789,7558
7/28/2015,2015,7,28, 1 ,5495,967,917,7379
7/28/2015,2015,7,28, 2 ,5376,940,890,7206
7/28/2015,2015,7,28, 3 ,5260,916,866,7042
7/28/2015,2015,7,28, 4 ,5208,908,867,6983
7/28/2015,2015,7,28, 5 ,5366,954,926,7246
7/28/2015,2015,7,28, 6 ,5385,988,963,7336
7/28/2015,2015,7,28, 7 ,5553,956,895,7404
7/28/2015,2015,7,28, 8 ,6415,1102,1017,8534
7/28/2015,2015,7,28, 9 ,7194,1305,1196,9695
7/28/2015,2015,7,28, 10 ,7707,1401,1256,10364
7/28/2015,2015,7,28, 11 ,7995,1455,1309,10759
7/28/2015,2015,7,28, 12 ,7901,1427,1281,10609
7/28/2015,2015,7,28, 13 ,7912,1420,1299,10631
7/28/2015,2015,7,28, 14 ,8233,1501,1323,11057
7/28/2015,2015,7,28, 15 ,7965,1495,1299,10759
7/28/2015,2015,7,28, 16 ,7714,1446,1292,10452
7/28/2015,2015,7,28, 17 ,7336,1382,1262,9980
7/28/2015,2015,7,28, 18 ,7183,1376,1292,9851
7/28/2015,2015,7,28, 19 ,7562,1542,1325,10429
7/28/2015,2015,7,28, 20 ,7440,1483,1257,10180
7/28/2015,2015,7,28, 21 ,7272,1399,1213,9884
7/28/2015,2015,7,28, 22 ,6905,1278,1128,9311
7/28/2015,2015,7,28, 23 ,6461,1149,1035,8645
7/28/2015,2015,7,28, 24 ,6071,1079,890,8040
7/29/2015,2015,7,29, 1 ,5783,1020,929,7732
7/29/2015,2015,7,29, 2 ,5613,988,901,7502
7/29/2015,2015,7,29, 3 ,5459,959,874,7292
7/29/2015,2015,7,29, 4 ,5389,954,873,7216
7/29/2015,2015,7,29, 5 ,5555,993,926,7474
7/29/2015,2015,7,29, 6 ,5551,1021,959,7531
7/29/2015,2015,7,29, 7 ,5652,989,899,7540
7/29/2015,2015,7,29, 8 ,6540,1162,1043,8745
7/29/2015,2015,7,29, 9 ,7336,1373,1153,9862
7/29/2015,2015,7,29, 10 ,7800,1440,1270,10510
7/29/2015,2015,7,29, 11 ,8080,1496,1267,10843
7/29/2015,2015,7,29, 12 ,7940,1398,1259,10597
7/29/2015,2015,7,29, 13 ,7997,1443,1274,10714
7/29/2015,2015,7,29, 14 ,8338,1504,1294,11136
7/29/2015,2015,7,29, 15 ,8010,1480,1266,10756
7/29/2015,2015,7,29, 16 ,7748,1443,1274,10465
7/29/2015,2015,7,29, 17 ,7406,1341,1267,10014
7/29/2015,2015,7,29, 18 ,7119,1372,1262,9753
7/29/2015,2015,7,29, 19 ,7547,1493,1295,10335
7/29/2015,2015,7,29, 20 ,7500,1454,1269,10223
7/29/2015,2015,7,29, 21 ,7303,1381,1226,9910
7/29/2015,2015,7,29, 22 ,6952,1250,1118,9320
7/29/2015,2015,7,29, 23 ,6502,1144,1067,8713
7/29/2015,2015,7,29, 24 ,6097,1064,961,8122
7/30/2015,2015,7,30, 1 ,5853,1019,967,7839
7/30/2015,2015,7,30, 2 ,5648,998,936,7582
7/30/2015,2015,7,30, 3 ,5505,969,902,7376
7/30/2015,2015,7,30, 4 ,5391,952,902,7245
7/30/2015,2015,7,30, 5 ,5525,994,950,7469
7/30/2015,2015,7,30, 6 ,5562,1013,987,7562
7/30/2015,2015,7,30, 7 ,5673,990,918,7581
7/30/2015,2015,7,30, 8 ,6556,1168,1047,8771
7/30/2015,2015,7,30, 9 ,7274,1370,1208,9852
7/30/2015,2015,7,30, 10 ,7820,1473,1259,10552
7/30/2015,2015,7,30, 11 ,8014,1528,1291,10833
7/30/2015,2015,7,30, 12 ,7988,1472,1239,10699
7/30/2015,2015,7,30, 13 ,7985,1498,1190,10673
7/30/2015,2015,7,30, 14 ,8250,1540,1205,10995
7/30/2015,2015,7,30, 15 ,8064,1514,1192,10770
7/30/2015,2015,7,30, 16 ,7850,1478,1209,10537
7/30/2015,2015,7,30, 17 ,7549,1380,1162,10091
7/30/2015,2015,7,30, 18 ,7194,1381,1172,9747
7/30/2015,2015,7,30, 19 ,7632,1528,1215,10375
7/30/2015,2015,7,30, 20 ,7547,1479,1201,10227
7/30/2015,2015,7,30, 21 ,7429,1408,1221,10058
7/30/2015,2015,7,30, 22 ,7086,1270,1108,9464
7/30/2015,2015,7,30, 23 ,6639,1174,1058,8871
7/30/2015,2015,7,30, 24 ,6322,1051,1044,8417
7/31/2015,2015,7,31, 1 ,5972,1030,953,7955
7/31/2015,2015,7,31, 2 ,5827,992,945,7764
7/31/2015,2015,7,31, 3 ,5363,966,941,7270
7/31/2015,2015,7,31, 4 ,5546,959,927,7432
7/31/2015,2015,7,31, 5 ,5607,990,951,7548
7/31/2015,2015,7,31, 6 ,5598,1016,975,7589
7/31/2015,2015,7,31, 7 ,5710,985,917,7612
7/31/2015,2015,7,31, 8 ,6546,1111,1047,8704
7/31/2015,2015,7,31, 9 ,7293,1304,1125,9722
7/31/2015,2015,7,31, 10 ,7780,1391,1186,10357
7/31/2015,2015,7,31, 11 ,8035,1457,1197,10689
7/31/2015,2015,7,31, 12 ,7943,1423,1183,10549
7/31/2015,2015,7,31, 13 ,7976,1412,1219,10607
7/31/2015,2015,7,31, 14 ,8330,1455,1226,11011
7/31/2015,2015,7,31, 15 ,8195,1432,1214,10841
7/31/2015,2015,7,31, 16 ,8118,1373,1208,10699
7/31/2015,2015,7,31, 17 ,7584,1338,1175,10097
7/31/2015,2015,7,31, 18 ,7154,1360,1216,9730
7/31/2015,2015,7,31, 19 ,7562,1445,1255,10262
7/31/2015,2015,7,31, 20 ,7485,1400,1218,10103
7/31/2015,2015,7,31, 21 ,7405,1326,1162,9893
7/31/2015,2015,7,31, 22 ,7131,1199,1036,9366
7/31/2015,2015,7,31, 23 ,6662,1095,975,8732
7/31/2015,2015,7,31, 24 ,6300,1032,984,8316
8/1/2015,2015,8,1, 1 ,6065,986,874,7925
8/1/2015,2015,8,1, 2 ,5859,951,849,7659
8/1/2015,2015,8,1, 3 ,5682,938,830,7450
8/1/2015,2015,8,1, 4 ,5531,925,822,7278
8/1/2015,2015,8,1, 5 ,5493,935,860,7288
8/1/2015,2015,8,1, 6 ,5294,943,875,7112
8/1/2015,2015,8,1, 7 ,5508,961,887,7356
8/1/2015,2015,8,1, 8 ,6063,1060,974,8097
8/1/2015,2015,8,1, 9 ,6611,1215,1069,8895
8/1/2015,2015,8,1, 10 ,7126,1330,1134,9590
8/1/2015,2015,8,1, 11 ,7510,1385,1145,10040
8/1/2015,2015,8,1, 12 ,7416,1353,1135,9904
8/1/2015,2015,8,1, 13 ,7440,1345,1144,9929
8/1/2015,2015,8,1, 14 ,7627,1365,1133,10125
8/1/2015,2015,8,1, 15 ,7316,1348,1088,9752
8/1/2015,2015,8,1, 16 ,7043,1310,1133,9486
8/1/2015,2015,8,1, 17 ,6656,1253,1129,9038
8/1/2015,2015,8,1, 18 ,6602,1306,1194,9102
8/1/2015,2015,8,1, 19 ,7166,1433,1246,9845
8/1/2015,2015,8,1, 20 ,7218,1402,1230,9850
8/1/2015,2015,8,1, 21 ,7188,1329,1169,9686
8/1/2015,2015,8,1, 22 ,7031,1239,1086,9356
8/1/2015,2015,8,1, 23 ,6637,1111,990,8738
8/1/2015,2015,8,1, 24 ,6297,1034,909,8240
8/2/2015,2015,8,2, 1 ,6036,980,935,7951
8/2/2015,2015,8,2, 2 ,5798,949,845,7592
8/2/2015,2015,8,2, 3 ,5596,922,822,7340
8/2/2015,2015,8,2, 4 ,5490,899,808,7197
8/2/2015,2015,8,2, 5 ,5360,887,827,7074
8/2/2015,2015,8,2, 6 ,5149,867,832,6848
8/2/2015,2015,8,2, 7 ,5096,879,829,6804
8/2/2015,2015,8,2, 8 ,5380,940,858,7178
8/2/2015,2015,8,2, 9 ,5739,1030,931,7700
8/2/2015,2015,8,2, 10 ,6144,1098,1009,8251
8/2/2015,2015,8,2, 11 ,6373,1162,1064,8599
8/2/2015,2015,8,2, 12 ,6364,1153,1060,8577
8/2/2015,2015,8,2, 13 ,6380,1159,1065,8604
8/2/2015,2015,8,2, 14 ,6417,1182,1069,8668
8/2/2015,2015,8,2, 15 ,6293,1143,1046,8482
8/2/2015,2015,8,2, 16 ,6212,1098,1044,8354
8/2/2015,2015,8,2, 17 ,6117,1098,1057,8272
8/2/2015,2015,8,2, 18 ,6122,1216,1156,8494
8/2/2015,2015,8,2, 19 ,6861,1362,1236,9459
8/2/2015,2015,8,2, 20 ,6973,1307,1195,9475
8/2/2015,2015,8,2, 21 ,6915,1236,1127,9278
8/2/2015,2015,8,2, 22 ,6584,1130,1012,8726
8/2/2015,2015,8,2, 23 ,6250,1043,955,8248
8/2/2015,2015,8,2, 24 ,5951,961,873,7785
8/3/2015,2015,8,3, 1 ,5610,936,843,7389
8/3/2015,2015,8,3, 2 ,5411,907,809,7127
8/3/2015,2015,8,3, 3 ,5240,895,794,6929
8/3/2015,2015,8,3, 4 ,5197,889,793,6879
8/3/2015,2015,8,3, 5 ,5391,933,866,7190
8/3/2015,2015,8,3, 6 ,5398,969,913,7280
8/3/2015,2015,8,3, 7 ,5671,939,848,7458
8/3/2015,2015,8,3, 8 ,6611,1085,949,8645
8/3/2015,2015,8,3, 9 ,7422,1304,1138,9864
8/3/2015,2015,8,3, 10 ,7994,1394,1239,10627
8/3/2015,2015,8,3, 11 ,8273,1447,1306,11026
8/3/2015,2015,8,3, 12 ,8131,1415,1277,10823
8/3/2015,2015,8,3, 13 ,8202,1432,1279,10913
8/3/2015,2015,8,3, 14 ,8462,1479,1332,11273
8/3/2015,2015,8,3, 15 ,8243,1455,1315,11013
8/3/2015,2015,8,3, 16 ,8022,1420,1286,10728
8/3/2015,2015,8,3, 17 ,7666,1373,1256,10295
8/3/2015,2015,8,3, 18 ,7338,1389,1312,10039
8/3/2015,2015,8,3, 19 ,7821,1522,1327,10670
8/3/2015,2015,8,3, 20 ,7740,1468,1264,10472
8/3/2015,2015,8,3, 21 ,7661,1382,1194,10237
8/3/2015,2015,8,3, 22 ,7288,1256,1077,9621
8/3/2015,2015,8,3, 23 ,6820,1153,999,8972
8/3/2015,2015,8,3, 24 ,6434,1076,894,8404
8/4/2015,2015,8,4, 1 ,6114,1027,901,8042
8/4/2015,2015,8,4, 2 ,5945,999,879,7823
8/4/2015,2015,8,4, 3 ,5782,971,861,7614
8/4/2015,2015,8,4, 4 ,5691,966,860,7517
8/4/2015,2015,8,4, 5 ,5825,1000,914,7739
8/4/2015,2015,8,4, 6 ,5743,1020,959,7722
8/4/2015,2015,8,4, 7 ,5903,983,890,7776
8/4/2015,2015,8,4, 8 ,6763,1138,1009,8910
8/4/2015,2015,8,4, 9 ,7564,1335,1163,10062
8/4/2015,2015,8,4, 10 ,7976,1429,1246,10651
8/4/2015,2015,8,4, 11 ,8310,1477,1291,11078
8/4/2015,2015,8,4, 12 ,8275,1445,1265,10985
8/4/2015,2015,8,4, 13 ,8314,1467,1254,11035
8/4/2015,2015,8,4, 14 ,8606,1530,1288,11424
8/4/2015,2015,8,4, 15 ,8481,1495,1263,11239
8/4/2015,2015,8,4, 16 ,8275,1446,1262,10983
8/4/2015,2015,8,4, 17 ,7834,1385,1249,10468
8/4/2015,2015,8,4, 18 ,7534,1415,1296,10245
8/4/2015,2015,8,4, 19 ,7881,1535,1330,10746
8/4/2015,2015,8,4, 20 ,7822,1482,1247,10551
8/4/2015,2015,8,4, 21 ,7656,1407,1171,10234
8/4/2015,2015,8,4, 22 ,7239,1275,1067,9581
8/4/2015,2015,8,4, 23 ,6732,1167,973,8872
8/4/2015,2015,8,4, 24 ,6315,1084,830,8229
8/5/2015,2015,8,5, 1 ,6070,1032,879,7981
8/5/2015,2015,8,5, 2 ,5880,1004,864,7748
8/5/2015,2015,8,5, 3 ,5703,973,832,7508
8/5/2015,2015,8,5, 4 ,5605,960,832,7397
8/5/2015,2015,8,5, 5 ,5760,1002,898,7660
8/5/2015,2015,8,5, 6 ,5738,1024,945,7707
8/5/2015,2015,8,5, 7 ,5894,979,885,7758
8/5/2015,2015,8,5, 8 ,6682,1136,986,8804
8/5/2015,2015,8,5, 9 ,7502,1345,1169,10016
8/5/2015,2015,8,5, 10 ,7980,1455,1241,10676
8/5/2015,2015,8,5, 11 ,8286,1484,1288,11058
8/5/2015,2015,8,5, 12 ,8209,1438,1234,10881
8/5/2015,2015,8,5, 13 ,8266,1437,1178,10881
8/5/2015,2015,8,5, 14 ,8582,1472,1208,11262
8/5/2015,2015,8,5, 15 ,8443,1440,1196,11079
8/5/2015,2015,8,5, 16 ,8289,1401,1200,10890
8/5/2015,2015,8,5, 17 ,7666,1349,1182,10197
8/5/2015,2015,8,5, 18 ,7486,1400,1240,10126
8/5/2015,2015,8,5, 19 ,7884,1482,1256,10622
8/5/2015,2015,8,5, 20 ,7873,1420,1228,10521
8/5/2015,2015,8,5, 21 ,7710,1318,1168,10196
8/5/2015,2015,8,5, 22 ,7415,1199,1061,9675
8/5/2015,2015,8,5, 23 ,6978,1108,973,9059
8/5/2015,2015,8,5, 24 ,6532,1037,942,8511
8/6/2015,2015,8,6, 1 ,6209,993,881,8083
8/6/2015,2015,8,6, 2 ,6058,970,861,7889
8/6/2015,2015,8,6, 3 ,5880,953,839,7672
8/6/2015,2015,8,6, 4 ,5762,944,837,7543
8/6/2015,2015,8,6, 5 ,5848,974,863,7685
8/6/2015,2015,8,6, 6 ,5851,1008,944,7803
8/6/2015,2015,8,6, 7 ,5894,991,872,7757
8/6/2015,2015,8,6, 8 ,6724,1091,977,8792
8/6/2015,2015,8,6, 9 ,7436,1256,1108,9800
8/6/2015,2015,8,6, 10 ,7940,1327,1189,10456
8/6/2015,2015,8,6, 11 ,8272,1367,1227,10866
8/6/2015,2015,8,6, 12 ,8166,1283,1206,10655
8/6/2015,2015,8,6, 13 ,8214,1279,1217,10710
8/6/2015,2015,8,6, 14 ,8533,1318,1252,11103
8/6/2015,2015,8,6, 15 ,8377,1306,1230,10913
8/6/2015,2015,8,6, 16 ,8130,1291,1235,10656
8/6/2015,2015,8,6, 17 ,7673,1273,1205,10151
8/6/2015,2015,8,6, 18 ,7362,1364,1297,10023
8/6/2015,2015,8,6, 19 ,7826,1438,1322,10586
8/6/2015,2015,8,6, 20 ,7752,1371,1289,10412
8/6/2015,2015,8,6, 21 ,7607,1292,1199,10098
8/6/2015,2015,8,6, 22 ,7252,1184,1106,9542
8/6/2015,2015,8,6, 23 ,6883,1084,993,8960
8/6/2015,2015,8,6, 24 ,6482,1013,939,8434
8/7/2015,2015,8,7, 1 ,6173,972,903,8048
8/7/2015,2015,8,7, 2 ,5951,951,872,7774
8/7/2015,2015,8,7, 3 ,5951,929,853,7733
8/7/2015,2015,8,7, 4 ,5678,925,855,7458
8/7/2015,2015,8,7, 5 ,5767,959,906,7632
8/7/2015,2015,8,7, 6 ,5720,1005,942,7667
8/7/2015,2015,8,7, 7 ,5906,980,886,7772
8/7/2015,2015,8,7, 8 ,6688,1114,1015,8817
8/7/2015,2015,8,7, 9 ,7487,1300,1151,9938
8/7/2015,2015,8,7, 10 ,8011,1385,1204,10600
8/7/2015,2015,8,7, 11 ,8296,1422,1233,10951
8/7/2015,2015,8,7, 12 ,8114,1380,1205,10699
8/7/2015,2015,8,7, 13 ,8171,1346,1151,10668
8/7/2015,2015,8,7, 14 ,8512,1391,1227,11130
8/7/2015,2015,8,7, 15 ,8376,1362,1219,10957
8/7/2015,2015,8,7, 16 ,8139,1360,1180,10679
8/7/2015,2015,8,7, 17 ,7681,1325,1189,10195
8/7/2015,2015,8,7, 18 ,7375,1372,1263,10010
8/7/2015,2015,8,7, 19 ,7795,1446,1334,10575
8/7/2015,2015,8,7, 20 ,7684,1387,1280,10351
8/7/2015,2015,8,7, 21 ,7570,1284,1206,10060
8/7/2015,2015,8,7, 22 ,7313,1185,1134,9632
8/7/2015,2015,8,7, 23 ,6953,1098,1059,9110
8/7/2015,2015,8,7, 24 ,6584,996,960,8540
8/8/2015,2015,8,8, 1 ,6204,958,921,8083
8/8/2015,2015,8,8, 2 ,6029,930,887,7846
8/8/2015,2015,8,8, 3 ,5850,915,864,7629
8/8/2015,2015,8,8, 4 ,5678,901,853,7432
8/8/2015,2015,8,8, 5 ,5655,912,870,7437
8/8/2015,2015,8,8, 6 ,5558,938,884,7380
8/8/2015,2015,8,8, 7 ,5633,954,877,7464
8/8/2015,2015,8,8, 8 ,6172,1047,965,8184
8/8/2015,2015,8,8, 9 ,6771,1186,1078,9035
8/8/2015,2015,8,8, 10 ,7192,1258,1149,9599
8/8/2015,2015,8,8, 11 ,7465,1311,1200,9976
8/8/2015,2015,8,8, 12 ,7347,1279,1194,9820
8/8/2015,2015,8,8, 13 ,7355,1273,1202,9830
8/8/2015,2015,8,8, 14 ,7569,1307,1252,10128
8/8/2015,2015,8,8, 15 ,7375,1289,1216,9880
8/8/2015,2015,8,8, 16 ,7144,1243,1179,9566
8/8/2015,2015,8,8, 17 ,6787,1208,1146,9141
8/8/2015,2015,8,8, 18 ,6762,1282,1249,9293
8/8/2015,2015,8,8, 19 ,7322,1383,1303,10008
8/8/2015,2015,8,8, 20 ,7316,1338,1279,9933
8/8/2015,2015,8,8, 21 ,7201,1256,1213,9670
8/8/2015,2015,8,8, 22 ,7056,1178,1145,9379
8/8/2015,2015,8,8, 23 ,6666,1085,1039,8790
8/8/2015,2015,8,8, 24 ,6315,1003,962,8280
8/9/2015,2015,8,9, 1 ,5986,960,907,7853
8/9/2015,2015,8,9, 2 ,5834,931,872,7637
8/9/2015,2015,8,9, 3 ,5731,915,827,7473
8/9/2015,2015,8,9, 4 ,5499,901,833,7233
8/9/2015,2015,8,9, 5 ,5438,914,840,7192
8/9/2015,2015,8,9, 6 ,5228,910,846,6984
8/9/2015,2015,8,9, 7 ,5243,923,844,7010
8/9/2015,2015,8,9, 8 ,5455,988,865,7308
8/9/2015,2015,8,9, 9 ,5819,1052,941,7812
8/9/2015,2015,8,9, 10 ,6189,1113,1022,8324
8/9/2015,2015,8,9, 11 ,6368,1137,1077,8582
8/9/2015,2015,8,9, 12 ,6296,1158,1088,8542
8/9/2015,2015,8,9, 13 ,6161,1136,1102,8399
8/9/2015,2015,8,9, 14 ,6163,1151,1119,8433
8/9/2015,2015,8,9, 15 ,6040,1155,1108,8303
8/9/2015,2015,8,9, 16 ,5933,1139,1080,8152
8/9/2015,2015,8,9, 17 ,5920,1121,1073,8114
8/9/2015,2015,8,9, 18 ,6127,1212,1159,8498
8/9/2015,2015,8,9, 19 ,6722,1392,1311,9425
8/9/2015,2015,8,9, 20 ,6827,1360,1271,9458
8/9/2015,2015,8,9, 21 ,6706,1296,1227,9229
8/9/2015,2015,8,9, 22 ,6371,1194,1135,8700
8/9/2015,2015,8,9, 23 ,6003,1099,1022,8124
8/9/2015,2015,8,9, 24 ,5694,1022,926,7642
8/10/2015,2015,8,10, 1 ,5425,980,918,7323
8/10/2015,2015,8,10, 2 ,5213,939,879,7031
8/10/2015,2015,8,10, 3 ,5062,918,849,6829
8/10/2015,2015,8,10, 4 ,5033,915,855,6803
8/10/2015,2015,8,10, 5 ,5215,956,897,7068
8/10/2015,2015,8,10, 6 ,5334,996,944,7274
8/10/2015,2015,8,10, 7 ,5635,964,877,7476
8/10/2015,2015,8,10, 8 ,6458,1127,994,8579
8/10/2015,2015,8,10, 9 ,7227,1345,1183,9755
8/10/2015,2015,8,10, 10 ,7379,1462,1290,10131
8/10/2015,2015,8,10, 11 ,7976,1525,1382,10883
8/10/2015,2015,8,10, 12 ,7825,1489,1338,10652
8/10/2015,2015,8,10, 13 ,7896,1496,1348,10740
8/10/2015,2015,8,10, 14 ,8198,1548,1374,11120
8/10/2015,2015,8,10, 15 ,8049,1312,1336,10697
8/10/2015,2015,8,10, 16 ,7879,1350,1304,10533
8/10/2015,2015,8,10, 17 ,7457,1368,1267,10092
8/10/2015,2015,8,10, 18 ,7280,1412,1329,10021
8/10/2015,2015,8,10, 19 ,7618,1512,1344,10474
8/10/2015,2015,8,10, 20 ,7507,1494,1338,10339
8/10/2015,2015,8,10, 21 ,7279,1446,1274,9999
8/10/2015,2015,8,10, 22 ,6952,1324,1183,9459
8/10/2015,2015,8,10, 23 ,6495,1219,1096,8810
8/10/2015,2015,8,10, 24 ,6113,1128,1023,8264
8/11/2015,2015,8,11, 1 ,5787,1073,991,7851
8/11/2015,2015,8,11, 2 ,5639,1041,957,7637
8/11/2015,2015,8,11, 3 ,5529,1036,908,7473
8/11/2015,2015,8,11, 4 ,5433,995,932,7360
8/11/2015,2015,8,11, 5 ,5548,1029,964,7541
8/11/2015,2015,8,11, 6 ,5677,1054,1000,7731
8/11/2015,2015,8,11, 7 ,5752,1008,926,7686
8/11/2015,2015,8,11, 8 ,6598,1165,1053,8816
8/11/2015,2015,8,11, 9 ,7406,1375,1238,10019
8/11/2015,2015,8,11, 10 ,7821,1488,1326,10635
8/11/2015,2015,8,11, 11 ,8171,1546,1365,11082
8/11/2015,2015,8,11, 12 ,8076,1496,1346,10918
8/11/2015,2015,8,11, 13 ,8061,1512,1347,10920
8/11/2015,2015,8,11, 14 ,8327,1576,1358,11261
8/11/2015,2015,8,11, 15 ,8236,1557,1331,11124
8/11/2015,2015,8,11, 16 ,8032,1532,1361,10925
8/11/2015,2015,8,11, 17 ,7684,1463,1299,10446
8/11/2015,2015,8,11, 18 ,7429,1475,1361,10265
8/11/2015,2015,8,11, 19 ,7814,1595,1445,10854
8/11/2015,2015,8,11, 20 ,7759,1543,1412,10714
8/11/2015,2015,8,11, 21 ,7552,1462,1362,10376
8/11/2015,2015,8,11, 22 ,7264,1336,1239,9839
8/11/2015,2015,8,11, 23 ,6825,1225,1135,9185
8/11/2015,2015,8,11, 24 ,6480,1147,1049,8676
8/12/2015,2015,8,12, 1 ,6137,1100,1014,8251
8/12/2015,2015,8,12, 2 ,5956,1057,978,7991
8/12/2015,2015,8,12, 3 ,5776,1032,959,7767
8/12/2015,2015,8,12, 4 ,5697,1009,950,7656
8/12/2015,2015,8,12, 5 ,5789,1047,999,7835
8/12/2015,2015,8,12, 6 ,5832,1054,1018,7904
8/12/2015,2015,8,12, 7 ,5925,1015,938,7878
8/12/2015,2015,8,12, 8 ,6787,1197,1089,9073
8/12/2015,2015,8,12, 9 ,7543,1407,1275,10225
8/12/2015,2015,8,12, 10 ,7907,1526,1380,10813
8/12/2015,2015,8,12, 11 ,7989,1581,1415,10985
8/12/2015,2015,8,12, 12 ,7789,1517,1371,10677
8/12/2015,2015,8,12, 13 ,7711,1522,1399,10632
8/12/2015,2015,8,12, 14 ,7884,1581,1431,10896
8/12/2015,2015,8,12, 15 ,7800,1555,1364,10719
8/12/2015,2015,8,12, 16 ,7734,1519,1378,10631
8/12/2015,2015,8,12, 17 ,7514,1441,1306,10261
8/12/2015,2015,8,12, 18 ,7318,1477,1375,10170
8/12/2015,2015,8,12, 19 ,7692,1584,1433,10709
8/12/2015,2015,8,12, 20 ,7573,1546,1351,10470
8/12/2015,2015,8,12, 21 ,7373,1458,1299,10130
8/12/2015,2015,8,12, 22 ,7082,1345,1240,9667
8/12/2015,2015,8,12, 23 ,6635,1233,1136,9004
8/12/2015,2015,8,12, 24 ,6257,1152,1058,8467
8/13/2015,2015,8,13, 1 ,5911,1098,1034,8043
8/13/2015,2015,8,13, 2 ,5772,1058,985,7815
8/13/2015,2015,8,13, 3 ,5654,1028,953,7635
8/13/2015,2015,8,13, 4 ,5541,1020,942,7503
8/13/2015,2015,8,13, 5 ,5676,1050,989,7715
8/13/2015,2015,8,13, 6 ,5696,1070,988,7754
8/13/2015,2015,8,13, 7 ,5785,1025,933,7743
8/13/2015,2015,8,13, 8 ,6699,1179,1061,8939
8/13/2015,2015,8,13, 9 ,7500,1377,1244,10121
8/13/2015,2015,8,13, 10 ,7977,1493,1331,10801
8/13/2015,2015,8,13, 11 ,8251,1525,1405,11181
8/13/2015,2015,8,13, 12 ,8124,1502,1371,10997
8/13/2015,2015,8,13, 13 ,8193,1530,1385,11108
8/13/2015,2015,8,13, 14 ,8472,1592,1416,11480
8/13/2015,2015,8,13, 15 ,8319,1579,1394,11292
8/13/2015,2015,8,13, 16 ,8059,1482,1361,10902
8/13/2015,2015,8,13, 17 ,7838,1425,1282,10545
8/13/2015,2015,8,13, 18 ,7545,1431,1305,10281
8/13/2015,2015,8,13, 19 ,7741,1574,1349,10664
8/13/2015,2015,8,13, 20 ,7736,1525,1299,10560
8/13/2015,2015,8,13, 21 ,7583,1442,1275,10300
8/13/2015,2015,8,13, 22 ,7256,1313,1141,9710
8/13/2015,2015,8,13, 23 ,6789,1205,1053,9047
8/13/2015,2015,8,13, 24 ,6297,1134,1057,8488
8/14/2015,2015,8,14, 1 ,6018,1077,975,8070
8/14/2015,2015,8,14, 2 ,5829,1034,911,7774
8/14/2015,2015,8,14, 3 ,5713,1006,886,7605
8/14/2015,2015,8,14, 4 ,5644,989,884,7517
8/14/2015,2015,8,14, 5 ,5723,1019,941,7683
8/14/2015,2015,8,14, 6 ,5684,1029,968,7681
8/14/2015,2015,8,14, 7 ,5835,1004,900,7739
8/14/2015,2015,8,14, 8 ,6658,1169,1030,8857
8/14/2015,2015,8,14, 9 ,7384,1371,1232,9987
8/14/2015,2015,8,14, 10 ,7812,1442,1329,10583
8/14/2015,2015,8,14, 11 ,8227,1477,1379,11083
8/14/2015,2015,8,14, 12 ,8144,1422,1345,10911
8/14/2015,2015,8,14, 13 ,8224,1452,1362,11038
8/14/2015,2015,8,14, 14 ,8467,1502,1391,11360
8/14/2015,2015,8,14, 15 ,8326,1489,1393,11208
8/14/2015,2015,8,14, 16 ,8112,1454,1365,10931
8/14/2015,2015,8,14, 17 ,7562,1373,1297,10232
8/14/2015,2015,8,14, 18 ,7422,1400,1342,10164
8/14/2015,2015,8,14, 19 ,7837,1539,1398,10774
8/14/2015,2015,8,14, 20 ,7741,1502,1346,10589
8/14/2015,2015,8,14, 21 ,7653,1438,1289,10380
8/14/2015,2015,8,14, 22 ,7349,1326,1203,9878
8/14/2015,2015,8,14, 23 ,6977,1211,1105,9293
8/14/2015,2015,8,14, 24 ,6583,1146,989,8718
8/15/2015,2015,8,15, 1 ,6273,1083,987,8343
8/15/2015,2015,8,15, 2 ,6103,1050,956,8109
8/15/2015,2015,8,15, 3 ,5893,1020,915,7828
8/15/2015,2015,8,15, 4 ,5778,1000,908,7686
8/15/2015,2015,8,15, 5 ,5710,1010,923,7643
8/15/2015,2015,8,15, 6 ,5542,998,933,7473
8/15/2015,2015,8,15, 7 ,5700,1004,909,7613
8/15/2015,2015,8,15, 8 ,6251,1109,999,8359
8/15/2015,2015,8,15, 9 ,6874,1259,1143,9276
8/15/2015,2015,8,15, 10 ,7448,1346,1247,10041
8/15/2015,2015,8,15, 11 ,7791,1400,1292,10483
8/15/2015,2015,8,15, 12 ,7719,1407,1302,10428
8/15/2015,2015,8,15, 13 ,7719,1331,1315,10365
8/15/2015,2015,8,15, 14 ,7996,1403,1355,10754
8/15/2015,2015,8,15, 15 ,7789,1350,1313,10452
8/15/2015,2015,8,15, 16 ,7497,1331,1275,10103
8/15/2015,2015,8,15, 17 ,7143,1264,1236,9643
8/15/2015,2015,8,15, 18 ,7011,1337,1303,9651
8/15/2015,2015,8,15, 19 ,7552,1469,1373,10394
8/15/2015,2015,8,15, 20 ,7573,1430,1330,10333
8/15/2015,2015,8,15, 21 ,7500,1361,1306,10167
8/15/2015,2015,8,15, 22 ,7282,1258,1199,9739
8/15/2015,2015,8,15, 23 ,6890,1157,973,9020
8/15/2015,2015,8,15, 24 ,6584,1091,835,8510
8/16/2015,2015,8,16, 1 ,6278,1041,979,8298
8/16/2015,2015,8,16, 2 ,6094,1000,951,8045
8/16/2015,2015,8,16, 3 ,5879,970,918,7767
8/16/2015,2015,8,16, 4 ,5693,952,907,7552
8/16/2015,2015,8,16, 5 ,5625,952,914,7491
8/16/2015,2015,8,16, 6 ,5347,920,909,7176
8/16/2015,2015,8,16, 7 ,5393,937,891,7221
8/16/2015,2015,8,16, 8 ,5695,987,921,7603
8/16/2015,2015,8,16, 9 ,6121,1084,956,8161
8/16/2015,2015,8,16, 10 ,6610,1164,1035,8809
8/16/2015,2015,8,16, 11 ,6774,1196,1083,9053
8/16/2015,2015,8,16, 12 ,6822,1193,1101,9116
8/16/2015,2015,8,16, 13 ,6921,1208,1087,9216
8/16/2015,2015,8,16, 14 ,6951,1205,1122,9278
8/16/2015,2015,8,16, 15 ,6937,1176,1011,9124
8/16/2015,2015,8,16, 16 ,6758,1132,1086,8976
8/16/2015,2015,8,16, 17 ,6548,1146,1111,8805
8/16/2015,2015,8,16, 18 ,6559,1247,1199,9005
8/16/2015,2015,8,16, 19 ,7233,1269,1265,9767
8/16/2015,2015,8,16, 20 ,7349,1294,1240,9883
8/16/2015,2015,8,16, 21 ,7282,1262,1184,9728
8/16/2015,2015,8,16, 22 ,6859,1219,1079,9157
8/16/2015,2015,8,16, 23 ,6571,1100,988,8659
8/16/2015,2015,8,16, 24 ,6210,1032,929,8171
8/17/2015,2015,8,17, 1 ,5939,982,884,7805
8/17/2015,2015,8,17, 2 ,5776,948,864,7588
8/17/2015,2015,8,17, 3 ,5597,927,843,7367
8/17/2015,2015,8,17, 4 ,5503,919,840,7262
8/17/2015,2015,8,17, 5 ,5571,959,893,7423
8/17/2015,2015,8,17, 6 ,5665,993,947,7605
8/17/2015,2015,8,17, 7 ,5840,957,877,7674
8/17/2015,2015,8,17, 8 ,6800,1133,1017,8950
8/17/2015,2015,8,17, 9 ,7677,1346,1195,10218
8/17/2015,2015,8,17, 10 ,8239,1444,1338,11021
8/17/2015,2015,8,17, 11 ,8520,1519,1346,11385
8/17/2015,2015,8,17, 12 ,8437,1477,1312,11226
8/17/2015,2015,8,17, 13 ,8528,1496,1342,11366
8/17/2015,2015,8,17, 14 ,8827,1440,1344,11611
8/17/2015,2015,8,17, 15 ,8678,1445,1359,11482
8/17/2015,2015,8,17, 16 ,8529,1436,1334,11299
8/17/2015,2015,8,17, 17 ,8105,1349,1298,10752
8/17/2015,2015,8,17, 18 ,7681,1396,1360,10437
8/17/2015,2015,8,17, 19 ,8205,1509,1368,11082
8/17/2015,2015,8,17, 20 ,8075,1466,1323,10864
8/17/2015,2015,8,17, 21 ,7909,1364,1259,10532
8/17/2015,2015,8,17, 22 ,7604,1254,1129,9987
8/17/2015,2015,8,17, 23 ,7236,1152,1051,9439
8/17/2015,2015,8,17, 24 ,6766,1079,962,8807
8/18/2015,2015,8,18, 1 ,6513,1034,960,8507
8/18/2015,2015,8,18, 2 ,6290,1003,922,8215
8/18/2015,2015,8,18, 3 ,6066,982,900,7948
8/18/2015,2015,8,18, 4 ,5995,972,885,7852
8/18/2015,2015,8,18, 5 ,6038,1005,933,7976
8/18/2015,2015,8,18, 6 ,5994,1021,991,8006
8/18/2015,2015,8,18, 7 ,6175,985,893,8053
8/18/2015,2015,8,18, 8 ,7021,1168,1009,9198
8/18/2015,2015,8,18, 9 ,7813,1365,1207,10385
8/18/2015,2015,8,18, 10 ,8322,1468,1322,11112
8/18/2015,2015,8,18, 11 ,8616,1536,1364,11516
8/18/2015,2015,8,18, 12 ,8500,1474,1341,11315
8/18/2015,2015,8,18, 13 ,8580,1502,1361,11443
8/18/2015,2015,8,18, 14 ,8886,1591,1407,11884
8/18/2015,2015,8,18, 15 ,8707,1534,1373,11614
8/18/2015,2015,8,18, 16 ,8090,1519,1342,10951
8/18/2015,2015,8,18, 17 ,7592,1417,1302,10311
8/18/2015,2015,8,18, 18 ,7461,1472,1366,10299
8/18/2015,2015,8,18, 19 ,7739,1580,1387,10706
8/18/2015,2015,8,18, 20 ,7701,1546,1353,10600
8/18/2015,2015,8,18, 21 ,7535,1459,1298,10292
8/18/2015,2015,8,18, 22 ,7278,1342,1186,9806
8/18/2015,2015,8,18, 23 ,6872,1231,1095,9198
8/18/2015,2015,8,18, 24 ,6455,1117,1042,8614
8/19/2015,2015,8,19, 1 ,6168,1077,972,8217
8/19/2015,2015,8,19, 2 ,5956,1053,950,7959
8/19/2015,2015,8,19, 3 ,5777,1034,920,7731
8/19/2015,2015,8,19, 4 ,5715,995,917,7627
8/19/2015,2015,8,19, 5 ,5789,1032,920,7741
8/19/2015,2015,8,19, 6 ,5764,1053,1007,7824
8/19/2015,2015,8,19, 7 ,5922,1014,925,7861
8/19/2015,2015,8,19, 8 ,6745,1184,1056,8985
8/19/2015,2015,8,19, 9 ,7503,1378,1227,10108
8/19/2015,2015,8,19, 10 ,8038,1465,1332,10835
8/19/2015,2015,8,19, 11 ,8336,1529,1374,11239
8/19/2015,2015,8,19, 12 ,8213,1485,1331,11029
8/19/2015,2015,8,19, 13 ,8249,1502,1334,11085
8/19/2015,2015,8,19, 14 ,8501,1558,1382,11441
8/19/2015,2015,8,19, 15 ,8278,1542,1347,11167
8/19/2015,2015,8,19, 16 ,7745,1500,1318,10563
8/19/2015,2015,8,19, 17 ,7416,1414,1251,10081
8/19/2015,2015,8,19, 18 ,7367,1449,1285,10101
8/19/2015,2015,8,19, 19 ,7770,1573,1339,10682
8/19/2015,2015,8,19, 20 ,7664,1529,1335,10528
8/19/2015,2015,8,19, 21 ,7546,1456,1260,10262
8/19/2015,2015,8,19, 22 ,7306,1342,1177,9825
8/19/2015,2015,8,19, 23 ,6895,1224,1102,9221
8/19/2015,2015,8,19, 24 ,6510,1145,981,8636
8/20/2015,2015,8,20, 1 ,6213,1100,972,8285
8/20/2015,2015,8,20, 2 ,6027,1053,942,8022
8/20/2015,2015,8,20, 3 ,5805,1028,867,7700
8/20/2015,2015,8,20, 4 ,5755,1019,903,7677
8/20/2015,2015,8,20, 5 ,5826,1040,956,7822
8/20/2015,2015,8,20, 6 ,5812,1067,1005,7884
8/20/2015,2015,8,20, 7 ,5946,1026,936,7908
8/20/2015,2015,8,20, 8 ,6694,1167,1056,8917
8/20/2015,2015,8,20, 9 ,7412,1357,1234,10003
8/20/2015,2015,8,20, 10 ,7777,1434,1322,10533
8/20/2015,2015,8,20, 11 ,8041,1463,1357,10861
8/20/2015,2015,8,20, 12 ,7793,1402,1310,10505
8/20/2015,2015,8,20, 13 ,7595,1403,1344,10342
8/20/2015,2015,8,20, 14 ,7805,1471,1368,10644
8/20/2015,2015,8,20, 15 ,7627,1420,1334,10381
8/20/2015,2015,8,20, 16 ,7524,1403,1323,10250
8/20/2015,2015,8,20, 17 ,7275,1356,1278,9909
8/20/2015,2015,8,20, 18 ,7219,1414,1334,9967
8/20/2015,2015,8,20, 19 ,7390,1476,1367,10233
8/20/2015,2015,8,20, 20 ,7172,1423,1317,9912
8/20/2015,2015,8,20, 21 ,6922,1339,1274,9535
8/20/2015,2015,8,20, 22 ,6694,1235,1177,9106
8/20/2015,2015,8,20, 23 ,6322,1132,1086,8540
8/20/2015,2015,8,20, 24 ,5948,1021,1075,8044
8/21/2015,2015,8,21, 1 ,5692,986,967,7645
8/21/2015,2015,8,21, 2 ,5458,977,937,7372
8/21/2015,2015,8,21, 3 ,5382,951,903,7236
8/21/2015,2015,8,21, 4 ,5192,935,888,7015
8/21/2015,2015,8,21, 5 ,5139,946,895,6980
8/21/2015,2015,8,21, 6 ,5103,965,904,6972
8/21/2015,2015,8,21, 7 ,5193,987,915,7095
8/21/2015,2015,8,21, 8 ,5519,1073,978,7570
8/21/2015,2015,8,21, 9 ,5968,1184,1085,8237
8/21/2015,2015,8,21, 10 ,6364,1252,1174,8790
8/21/2015,2015,8,21, 11 ,6701,1282,1253,9236
8/21/2015,2015,8,21, 12 ,6618,1244,1221,9083
8/21/2015,2015,8,21, 13 ,6535,1262,1219,9016
8/21/2015,2015,8,21, 14 ,6546,1288,1277,9111
8/21/2015,2015,8,21, 15 ,6352,1270,1247,8869
8/21/2015,2015,8,21, 16 ,6212,1236,1226,8674
8/21/2015,2015,8,21, 17 ,6118,1223,1207,8548
8/21/2015,2015,8,21, 18 ,6316,1352,1286,8954
8/21/2015,2015,8,21, 19 ,6700,1422,1333,9455
8/21/2015,2015,8,21, 20 ,6701,1370,1300,9371
8/21/2015,2015,8,21, 21 ,6613,1299,1259,9171
8/21/2015,2015,8,21, 22 ,6184,1192,1159,8535
8/21/2015,2015,8,21, 23 ,5836,1111,1067,8014
8/21/2015,2015,8,21, 24 ,5494,1028,995,7517
8/22/2015,2015,8,22, 1 ,5316,983,962,7261
8/22/2015,2015,8,22, 2 ,5217,954,919,7090
8/22/2015,2015,8,22, 3 ,5114,931,902,6947
8/22/2015,2015,8,22, 4 ,5025,917,890,6832
8/22/2015,2015,8,22, 5 ,4903,933,916,6752
8/22/2015,2015,8,22, 6 ,4835,937,919,6691
8/22/2015,2015,8,22, 7 ,4980,962,904,6846
8/22/2015,2015,8,22, 8 ,5408,1065,979,7452
8/22/2015,2015,8,22, 9 ,5964,1189,1104,8257
8/22/2015,2015,8,22, 10 ,6443,1261,1181,8885
8/22/2015,2015,8,22, 11 ,6677,1302,1254,9233
8/22/2015,2015,8,22, 12 ,6571,1274,1230,9075
8/22/2015,2015,8,22, 13 ,6473,1274,1251,8998
8/22/2015,2015,8,22, 14 ,6634,1319,1291,9244
8/22/2015,2015,8,22, 15 ,6434,1288,1263,8985
8/22/2015,2015,8,22, 16 ,6306,1263,1235,8804
8/22/2015,2015,8,22, 17 ,6197,1227,1182,8606
8/22/2015,2015,8,22, 18 ,6265,1328,1300,8893
8/22/2015,2015,8,22, 19 ,6642,1412,1372,9426
8/22/2015,2015,8,22, 20 ,6560,1379,1341,9280
8/22/2015,2015,8,22, 21 ,6410,1312,1295,9017
8/22/2015,2015,8,22, 22 ,6146,1221,1207,8574
8/22/2015,2015,8,22, 23 ,5780,1110,1107,7997
8/22/2015,2015,8,22, 24 ,5466,1036,1029,7531
8/23/2015,2015,8,23, 1 ,5194,1009,983,7186
8/23/2015,2015,8,23, 2 ,5076,975,947,6998
8/23/2015,2015,8,23, 3 ,4886,943,923,6752
8/23/2015,2015,8,23, 4 ,4814,933,909,6656
8/23/2015,2015,8,23, 5 ,4827,941,904,6672
8/23/2015,2015,8,23, 6 ,4696,925,900,6521
8/23/2015,2015,8,23, 7 ,4790,934,887,6611
8/23/2015,2015,8,23, 8 ,5034,984,919,6937
8/23/2015,2015,8,23, 9 ,5356,1039,967,7362
8/23/2015,2015,8,23, 10 ,5779,1113,1069,7961
8/23/2015,2015,8,23, 11 ,5977,1167,1113,8257
8/23/2015,2015,8,23, 12 ,5865,1179,1124,8168
8/23/2015,2015,8,23, 13 ,5796,1193,1140,8129
8/23/2015,2015,8,23, 14 ,5809,1212,1146,8167
8/23/2015,2015,8,23, 15 ,5745,1194,1139,8078
8/23/2015,2015,8,23, 16 ,5616,1176,1110,7902
8/23/2015,2015,8,23, 17 ,5582,1164,1085,7831
8/23/2015,2015,8,23, 18 ,5915,1303,1181,8399
8/23/2015,2015,8,23, 19 ,6333,1437,1309,9079
8/23/2015,2015,8,23, 20 ,6359,1413,1293,9065
8/23/2015,2015,8,23, 21 ,6183,1363,1243,8789
8/23/2015,2015,8,23, 22 ,5916,1258,1145,8319
8/23/2015,2015,8,23, 23 ,5525,1170,1035,7730
8/23/2015,2015,8,23, 24 ,5251,1097,970,7318
8/24/2015,2015,8,24, 1 ,5013,1041,924,6978
8/24/2015,2015,8,24, 2 ,4845,1007,891,6743
8/24/2015,2015,8,24, 3 ,4728,980,870,6578
8/24/2015,2015,8,24, 4 ,4699,967,859,6525
8/24/2015,2015,8,24, 5 ,4902,1004,906,6812
8/24/2015,2015,8,24, 6 ,5099,1026,896,7021
8/24/2015,2015,8,24, 7 ,5358,1001,845,7204
8/24/2015,2015,8,24, 8 ,6157,1167,1038,8362
8/24/2015,2015,8,24, 9 ,6884,1373,1200,9457
8/24/2015,2015,8,24, 10 ,7332,1496,1310,10138
8/24/2015,2015,8,24, 11 ,7526,1557,1383,10466
8/24/2015,2015,8,24, 12 ,7374,1522,1364,10260
8/24/2015,2015,8,24, 13 ,7336,1528,1379,10243
8/24/2015,2015,8,24, 14 ,7559,1593,1427,10579
8/24/2015,2015,8,24, 15 ,7419,1561,1405,10385
8/24/2015,2015,8,24, 16 ,7331,1518,1382,10231
8/24/2015,2015,8,24, 17 ,7162,1415,1307,9884
8/24/2015,2015,8,24, 18 ,7033,1455,1366,9854
8/24/2015,2015,8,24, 19 ,7281,1564,1438,10283
8/24/2015,2015,8,24, 20 ,7119,1519,1378,10016
8/24/2015,2015,8,24, 21 ,6885,1462,1329,9676
8/24/2015,2015,8,24, 22 ,6451,1339,1184,8974
8/24/2015,2015,8,24, 23 ,6016,1219,1110,8345
8/24/2015,2015,8,24, 24 ,5672,1136,909,7717
8/25/2015,2015,8,25, 1 ,5394,1076,960,7430
8/25/2015,2015,8,25, 2 ,5253,1047,970,7270
8/25/2015,2015,8,25, 3 ,5112,1024,937,7073
8/25/2015,2015,8,25, 4 ,5081,1018,934,7033
8/25/2015,2015,8,25, 5 ,5276,1046,975,7297
8/25/2015,2015,8,25, 6 ,5384,1046,1009,7439
8/25/2015,2015,8,25, 7 ,5550,996,927,7473
8/25/2015,2015,8,25, 8 ,6399,1174,1086,8659
8/25/2015,2015,8,25, 9 ,7133,1377,1269,9779
8/25/2015,2015,8,25, 10 ,7569,1469,1371,10409
8/25/2015,2015,8,25, 11 ,7861,1530,1379,10770
8/25/2015,2015,8,25, 12 ,7789,1485,1372,10646
8/25/2015,2015,8,25, 13 ,7854,1503,1410,10767
8/25/2015,2015,8,25, 14 ,8194,1564,1424,11182
8/25/2015,2015,8,25, 15 ,7959,1547,1399,10905
8/25/2015,2015,8,25, 16 ,7807,1516,1390,10713
8/25/2015,2015,8,25, 17 ,7410,1427,1305,10142
8/25/2015,2015,8,25, 18 ,7232,1474,1378,10084
8/25/2015,2015,8,25, 19 ,7556,1581,1395,10532
8/25/2015,2015,8,25, 20 ,7344,1541,1352,10237
8/25/2015,2015,8,25, 21 ,7110,1470,1333,9913
8/25/2015,2015,8,25, 22 ,6689,1347,1235,9271
8/25/2015,2015,8,25, 23 ,6257,1239,1143,8639
8/25/2015,2015,8,25, 24 ,5890,1151,1074,8115
8/26/2015,2015,8,26, 1 ,5633,1096,1014,7743
8/26/2015,2015,8,26, 2 ,5466,1056,997,7519
8/26/2015,2015,8,26, 3 ,5340,1023,971,7334
8/26/2015,2015,8,26, 4 ,5259,1011,945,7215
8/26/2015,2015,8,26, 5 ,5385,1037,983,7405
8/26/2015,2015,8,26, 6 ,5419,1047,1006,7472
8/26/2015,2015,8,26, 7 ,5609,1024,947,7580
8/26/2015,2015,8,26, 8 ,6460,1208,1114,8782
8/26/2015,2015,8,26, 9 ,7241,1414,1268,9923
8/26/2015,2015,8,26, 10 ,7789,1524,1349,10662
8/26/2015,2015,8,26, 11 ,8127,1571,1388,11086
8/26/2015,2015,8,26, 12 ,8011,1531,1372,10914
8/26/2015,2015,8,26, 13 ,8013,1534,1388,10935
8/26/2015,2015,8,26, 14 ,8315,1623,1430,11368
8/26/2015,2015,8,26, 15 ,8156,1589,1382,11127
8/26/2015,2015,8,26, 16 ,7980,1552,1374,10906
8/26/2015,2015,8,26, 17 ,7587,1455,1308,10350
8/26/2015,2015,8,26, 18 ,7289,1484,1361,10134
8/26/2015,2015,8,26, 19 ,7689,1613,1400,10702
8/26/2015,2015,8,26, 20 ,7544,1550,1344,10438
8/26/2015,2015,8,26, 21 ,7379,1473,1329,10181
8/26/2015,2015,8,26, 22 ,6971,1353,1198,9522
8/26/2015,2015,8,26, 23 ,6541,1258,1143,8942
8/26/2015,2015,8,26, 24 ,6110,1168,1092,8370
8/27/2015,2015,8,27, 1 ,5825,1120,1023,7968
8/27/2015,2015,8,27, 2 ,5671,1080,988,7739
8/27/2015,2015,8,27, 3 ,5492,1053,962,7507
8/27/2015,2015,8,27, 4 ,5420,1037,949,7406
8/27/2015,2015,8,27, 5 ,5501,1062,990,7553
8/27/2015,2015,8,27, 6 ,5550,1065,1001,7616
8/27/2015,2015,8,27, 7 ,5687,1028,955,7670
8/27/2015,2015,8,27, 8 ,6492,1204,1081,8777
8/27/2015,2015,8,27, 9 ,7286,1413,1269,9968
8/27/2015,2015,8,27, 10 ,7879,1492,1360,10731
8/27/2015,2015,8,27, 11 ,8179,1539,1364,11082
8/27/2015,2015,8,27, 12 ,8070,1480,1345,10895
8/27/2015,2015,8,27, 13 ,8148,1476,1357,10981
8/27/2015,2015,8,27, 14 ,8469,1534,1362,11365
8/27/2015,2015,8,27, 15 ,8177,1513,1405,11095
8/27/2015,2015,8,27, 16 ,7800,1485,1365,10650
8/27/2015,2015,8,27, 17 ,7482,1409,1287,10178
8/27/2015,2015,8,27, 18 ,7258,1463,1360,10081
8/27/2015,2015,8,27, 19 ,7719,1564,1371,10654
8/27/2015,2015,8,27, 20 ,7541,1517,1305,10363
8/27/2015,2015,8,27, 21 ,7338,1443,1299,10080
8/27/2015,2015,8,27, 22 ,6892,1325,1198,9415
8/27/2015,2015,8,27, 23 ,6443,1217,1109,8769
8/27/2015,2015,8,27, 24 ,6110,1131,1048,8289
8/28/2015,2015,8,28, 1 ,5829,1077,999,7905
8/28/2015,2015,8,28, 2 ,5612,1041,967,7620
8/28/2015,2015,8,28, 3 ,5488,1010,945,7443
8/28/2015,2015,8,28, 4 ,5353,997,936,7286
8/28/2015,2015,8,28, 5 ,5469,1026,965,7460
8/28/2015,2015,8,28, 6 ,5542,1044,994,7580
8/28/2015,2015,8,28, 7 ,5613,1009,951,7573
8/28/2015,2015,8,28, 8 ,6404,1168,1074,8646
8/28/2015,2015,8,28, 9 ,7163,1367,1261,9791
8/28/2015,2015,8,28, 10 ,7710,1478,1326,10514
8/28/2015,2015,8,28, 11 ,8035,1511,1353,10899
8/28/2015,2015,8,28, 12 ,7894,1436,1330,10660
8/28/2015,2015,8,28, 13 ,7868,1463,1321,10652
8/28/2015,2015,8,28, 14 ,8025,1535,1337,10897
8/28/2015,2015,8,28, 15 ,7897,1491,1325,10713
8/28/2015,2015,8,28, 16 ,7739,1446,1316,10501
8/28/2015,2015,8,28, 17 ,7378,1400,1253,10031
8/28/2015,2015,8,28, 18 ,7250,1458,1314,10022
8/28/2015,2015,8,28, 19 ,7591,1539,1348,10478
8/28/2015,2015,8,28, 20 ,7407,1487,1312,10206
8/28/2015,2015,8,28, 21 ,7249,1416,1273,9938
8/28/2015,2015,8,28, 22 ,6979,1299,1219,9497
8/28/2015,2015,8,28, 23 ,6490,1199,1117,8806
8/28/2015,2015,8,28, 24 ,6187,1121,411,7719
8/29/2015,2015,8,29, 1 ,5843,1079,1016,7938
8/29/2015,2015,8,29, 2 ,5652,1041,958,7651
8/29/2015,2015,8,29, 3 ,5457,1011,950,7418
8/29/2015,2015,8,29, 4 ,5384,1001,936,7321
8/29/2015,2015,8,29, 5 ,5398,1006,948,7352
8/29/2015,2015,8,29, 6 ,5246,999,999,7244
8/29/2015,2015,8,29, 7 ,5364,1006,938,7308
8/29/2015,2015,8,29, 8 ,5983,1098,1017,8098
8/29/2015,2015,8,29, 9 ,6540,1255,1107,8902
8/29/2015,2015,8,29, 10 ,7103,1344,1209,9656
8/29/2015,2015,8,29, 11 ,7425,1403,1228,10056
8/29/2015,2015,8,29, 12 ,7304,1382,1211,9897
8/29/2015,2015,8,29, 13 ,7284,1380,1264,9928
8/29/2015,2015,8,29, 14 ,7402,1433,1313,10148
8/29/2015,2015,8,29, 15 ,7051,1372,1270,9693
8/29/2015,2015,8,29, 16 ,6760,1342,1268,9370
8/29/2015,2015,8,29, 17 ,6571,1317,1219,9107
8/29/2015,2015,8,29, 18 ,6662,1409,1290,9361
8/29/2015,2015,8,29, 19 ,6960,1485,1306,9751
8/29/2015,2015,8,29, 20 ,6905,1454,1241,9600
8/29/2015,2015,8,29, 21 ,6747,1395,1267,9409
8/29/2015,2015,8,29, 22 ,6531,1324,1148,9003
8/29/2015,2015,8,29, 23 ,6102,1223,1120,8445
8/29/2015,2015,8,29, 24 ,5789,1128,1146,8063
8/30/2015,2015,8,30, 1 ,5495,1078,992,7565
8/30/2015,2015,8,30, 2 ,5349,1031,957,7337
8/30/2015,2015,8,30, 3 ,5190,1002,930,7122
8/30/2015,2015,8,30, 4 ,5120,982,907,7009
8/30/2015,2015,8,30, 5 ,5035,984,910,6929
8/30/2015,2015,8,30, 6 ,4873,957,898,6728
8/30/2015,2015,8,30, 7 ,4835,961,883,6679
8/30/2015,2015,8,30, 8 ,5097,1011,940,7048
8/30/2015,2015,8,30, 9 ,5492,1101,1003,7596
8/30/2015,2015,8,30, 10 ,5936,1180,1093,8209
8/30/2015,2015,8,30, 11 ,6276,1234,1145,8655
8/30/2015,2015,8,30, 12 ,6224,1227,1160,8611
8/30/2015,2015,8,30, 13 ,6251,1236,1186,8673
8/30/2015,2015,8,30, 14 ,6342,1237,1200,8779
8/30/2015,2015,8,30, 15 ,6316,1234,1188,8738
8/30/2015,2015,8,30, 16 ,6098,1202,1109,8409
8/30/2015,2015,8,30, 17 ,6008,1191,1128,8327
8/30/2015,2015,8,30, 18 ,6219,1300,1234,8753
8/30/2015,2015,8,30, 19 ,6657,1449,1301,9407
8/30/2015,2015,8,30, 20 ,6603,1420,1292,9315
8/30/2015,2015,8,30, 21 ,6374,1383,1257,9014
8/30/2015,2015,8,30, 22 ,6053,1275,1178,8506
8/30/2015,2015,8,30, 23 ,5674,1172,1087,7933
8/30/2015,2015,8,30, 24 ,5353,1102,975,7430
8/31/2015,2015,8,31, 1 ,5834,1036,961,7831
8/31/2015,2015,8,31, 2 ,5576,996,947,7519
8/31/2015,2015,8,31, 3 ,5448,964,908,7320
8/31/2015,2015,8,31, 4 ,5284,947,895,7126
8/31/2015,2015,8,31, 5 ,5214,945,901,7060
8/31/2015,2015,8,31, 6 ,5061,930,899,6890
8/31/2015,2015,8,31, 7 ,5082,931,895,6908
8/31/2015,2015,8,31, 8 ,5399,1016,944,7359
8/31/2015,2015,8,31, 9 ,5745,1145,1009,7899
8/31/2015,2015,8,31, 10 ,6226,1253,1150,8629
8/31/2015,2015,8,31, 11 ,6561,1308,1185,9054
8/31/2015,2015,8,31, 12 ,6542,1296,1200,9038
8/31/2015,2015,8,31, 13 ,6635,1294,1222,9151
8/31/2015,2015,8,31, 14 ,6689,1329,1232,9250
8/31/2015,2015,8,31, 15 ,6527,1295,1219,9041
8/31/2015,2015,8,31, 16 ,6427,1251,1182,8860
8/31/2015,2015,8,31, 17 ,6238,1215,1222,8675
8/31/2015,2015,8,31, 18 ,6384,1321,1306,9011
8/31/2015,2015,8,31, 19 ,7005,1430,1341,9776
8/31/2015,2015,8,31, 20 ,7048,1394,1309,9751
8/31/2015,2015,8,31, 21 ,6952,1338,1235,9525
8/31/2015,2015,8,31, 22 ,6611,1232,1136,8979
8/31/2015,2015,8,31, 23 ,6297,1125,1037,8459
8/31/2015,2015,8,31, 24 ,6002,1045,966,8013
9/1/2015,2015,9,1, 1 ,5505,1009,921,7435
9/1/2015,2015,9,1, 2 ,5331,974,894,7199
9/1/2015,2015,9,1, 3 ,5197,946,866,7009
9/1/2015,2015,9,1, 4 ,5134,936,863,6933
9/1/2015,2015,9,1, 5 ,5300,979,897,7176
9/1/2015,2015,9,1, 6 ,5334,978,935,7247
9/1/2015,2015,9,1, 7 ,5556,944,840,7340
9/1/2015,2015,9,1, 8 ,6428,1126,992,8546
9/1/2015,2015,9,1, 9 ,7208,1362,1188,9758
9/1/2015,2015,9,1, 10 ,7738,1480,1264,10482
9/1/2015,2015,9,1, 11 ,8112,1513,1348,10973
9/1/2015,2015,9,1, 12 ,8071,1472,1315,10858
9/1/2015,2015,9,1, 13 ,7956,1476,1331,10763
9/1/2015,2015,9,1, 14 ,8247,1551,1374,11172
9/1/2015,2015,9,1, 15 ,8056,1539,1359,10954
9/1/2015,2015,9,1, 16 ,7844,1500,1352,10696
9/1/2015,2015,9,1, 17 ,7505,1418,1292,10215
9/1/2015,2015,9,1, 18 ,7379,1475,1377,10231
9/1/2015,2015,9,1, 19 ,7762,1557,1405,10724
9/1/2015,2015,9,1, 20 ,7581,1509,1343,10433
9/1/2015,2015,9,1, 21 ,7316,1439,1301,10056
9/1/2015,2015,9,1, 22 ,6981,1306,1191,9478
9/1/2015,2015,9,1, 23 ,6518,1192,1091,8801
9/1/2015,2015,9,1, 24 ,6114,1117,1050,8281
9/2/2015,2015,9,2, 1 ,5898,1066,983,7947
9/2/2015,2015,9,2, 2 ,5739,1025,960,7724
9/2/2015,2015,9,2, 3 ,5582,997,931,7510
9/2/2015,2015,9,2, 4 ,5519,988,920,7427
9/2/2015,2015,9,2, 5 ,5617,1018,966,7601
9/2/2015,2015,9,2, 6 ,5592,1024,987,7603
9/2/2015,2015,9,2, 7 ,5761,992,927,7680
9/2/2015,2015,9,2, 8 ,6580,1178,1061,8819
9/2/2015,2015,9,2, 9 ,7338,1387,1241,9966
9/2/2015,2015,9,2, 10 ,7764,1434,1331,10529
9/2/2015,2015,9,2, 11 ,8062,1547,1378,10987
9/2/2015,2015,9,2, 12 ,7929,1535,1362,10826
9/2/2015,2015,9,2, 13 ,7917,1527,1392,10836
9/2/2015,2015,9,2, 14 ,8267,1577,1409,11253
9/2/2015,2015,9,2, 15 ,8076,1547,1386,11009
9/2/2015,2015,9,2, 16 ,7953,1508,1369,10830
9/2/2015,2015,9,2, 17 ,7616,1450,1322,10388
9/2/2015,2015,9,2, 18 ,7434,1509,1348,10291
9/2/2015,2015,9,2, 19 ,7737,1589,1378,10704
9/2/2015,2015,9,2, 20 ,7604,1547,1331,10482
9/2/2015,2015,9,2, 21 ,7404,1475,1315,10194
9/2/2015,2015,9,2, 22 ,7059,1344,1215,9618
9/2/2015,2015,9,2, 23 ,6614,1231,1115,8960
9/2/2015,2015,9,2, 24 ,6225,1164,1102,8491
9/3/2015,2015,9,3, 1 ,5921,1107,1001,8029
9/3/2015,2015,9,3, 2 ,5729,1072,970,7771
9/3/2015,2015,9,3, 3 ,5561,1044,944,7549
9/3/2015,2015,9,3, 4 ,5465,1023,929,7417
9/3/2015,2015,9,3, 5 ,5596,1051,968,7615
9/3/2015,2015,9,3, 6 ,5608,1061,980,7649
9/3/2015,2015,9,3, 7 ,5701,1029,899,7629
9/3/2015,2015,9,3, 8 ,6525,1198,1056,8779
9/3/2015,2015,9,3, 9 ,7388,1420,1237,10045
9/3/2015,2015,9,3, 10 ,7936,1536,1340,10812
9/3/2015,2015,9,3, 11 ,8243,1587,1362,11192
9/3/2015,2015,9,3, 12 ,8178,1516,1358,11052
9/3/2015,2015,9,3, 13 ,8157,1514,1389,11060
9/3/2015,2015,9,3, 14 ,8600,1569,1377,11546
9/3/2015,2015,9,3, 15 ,8436,1542,1333,11311
9/3/2015,2015,9,3, 16 ,8097,1526,1301,10924
9/3/2015,2015,9,3, 17 ,7736,1451,1310,10497
9/3/2015,2015,9,3, 18 ,7590,1516,1385,10491
9/3/2015,2015,9,3, 19 ,7916,1583,1391,10890
9/3/2015,2015,9,3, 20 ,7741,1537,1367,10645
9/3/2015,2015,9,3, 21 ,7505,1441,1299,10245
9/3/2015,2015,9,3, 22 ,7182,1309,1217,9708
9/3/2015,2015,9,3, 23 ,6739,1215,1149,9103
9/3/2015,2015,9,3, 24 ,6363,1141,1058,8562
9/4/2015,2015,9,4, 1 ,6051,1092,997,8140
9/4/2015,2015,9,4, 2 ,5861,1056,986,7903
9/4/2015,2015,9,4, 3 ,5701,1021,965,7687
9/4/2015,2015,9,4, 4 ,5648,1013,961,7622
9/4/2015,2015,9,4, 5 ,5739,1044,999,7782
9/4/2015,2015,9,4, 6 ,5706,1059,1013,7778
9/4/2015,2015,9,4, 7 ,5857,1026,960,7843
9/4/2015,2015,9,4, 8 ,6700,1202,1122,9024
9/4/2015,2015,9,4, 9 ,7533,1412,1240,10185
9/4/2015,2015,9,4, 10 ,8019,1479,1317,10815
9/4/2015,2015,9,4, 11 ,8330,1542,1365,11237
9/4/2015,2015,9,4, 12 ,8186,1483,1360,11029
9/4/2015,2015,9,4, 13 ,8074,1494,1377,10945
9/4/2015,2015,9,4, 14 ,8432,1568,1406,11406
9/4/2015,2015,9,4, 15 ,8282,1537,1374,11193
9/4/2015,2015,9,4, 16 ,8065,1464,1372,10901
9/4/2015,2015,9,4, 17 ,7670,1416,1285,10371
9/4/2015,2015,9,4, 18 ,7517,1476,1379,10372
9/4/2015,2015,9,4, 19 ,7952,1553,1389,10894
9/4/2015,2015,9,4, 20 ,7763,1506,1361,10630
9/4/2015,2015,9,4, 21 ,7532,1435,1315,10282
9/4/2015,2015,9,4, 22 ,7103,1336,1256,9695
9/4/2015,2015,9,4, 23 ,6655,1214,1144,9013
9/4/2015,2015,9,4, 24 ,6254,1140,1054,8448
9/5/2015,2015,9,5, 1 ,5969,1097,1003,8069
9/5/2015,2015,9,5, 2 ,5817,1059,976,7852
9/5/2015,2015,9,5, 3 ,5651,1023,931,7605
9/5/2015,2015,9,5, 4 ,5514,1005,918,7437
9/5/2015,2015,9,5, 5 ,5472,1004,927,7403
9/5/2015,2015,9,5, 6 ,5366,993,927,7286
9/5/2015,2015,9,5, 7 ,5428,998,914,7340
9/5/2015,2015,9,5, 8 ,6018,1096,975,8089
9/5/2015,2015,9,5, 9 ,6666,1239,1114,9019
9/5/2015,2015,9,5, 10 ,7225,1309,1196,9730
9/5/2015,2015,9,5, 11 ,7568,1369,1259,10196
9/5/2015,2015,9,5, 12 ,7551,1333,1232,10116
9/5/2015,2015,9,5, 13 ,7565,1345,1258,10168
9/5/2015,2015,9,5, 14 ,7762,1373,1280,10415
9/5/2015,2015,9,5, 15 ,7543,1342,1230,10115
9/5/2015,2015,9,5, 16 ,7287,1318,1199,9804
9/5/2015,2015,9,5, 17 ,7081,1271,1197,9549
9/5/2015,2015,9,5, 18 ,7130,1398,1309,9837
9/5/2015,2015,9,5, 19 ,7274,1468,1310,10052
9/5/2015,2015,9,5, 20 ,7131,1421,1262,9814
9/5/2015,2015,9,5, 21 ,7037,1361,1223,9621
9/5/2015,2015,9,5, 22 ,6832,1262,1135,9229
9/5/2015,2015,9,5, 23 ,6421,1159,1046,8626
9/5/2015,2015,9,5, 24 ,6018,1078,1073,8169
9/6/2015,2015,9,6, 1 ,5834,1041,941,7816
9/6/2015,2015,9,6, 2 ,5576,1003,914,7493
9/6/2015,2015,9,6, 3 ,5448,978,881,7307
9/6/2015,2015,9,6, 4 ,5284,955,866,7105
9/6/2015,2015,9,6, 5 ,5214,944,879,7037
9/6/2015,2015,9,6, 6 ,5061,921,886,6868
9/6/2015,2015,9,6, 7 ,5082,936,845,6863
9/6/2015,2015,9,6, 8 ,5399,1003,876,7278
9/6/2015,2015,9,6, 9 ,5745,1067,965,7777
9/6/2015,2015,9,6, 10 ,6226,1147,1041,8414
9/6/2015,2015,9,6, 11 ,6561,1137,1108,8806
9/6/2015,2015,9,6, 12 ,6542,1208,1126,8876
9/6/2015,2015,9,6, 13 ,6635,1208,1120,8963
9/6/2015,2015,9,6, 14 ,6689,1210,1109,9008
9/6/2015,2015,9,6, 15 ,6527,1183,1095,8805
9/6/2015,2015,9,6, 16 ,6427,1039,1087,8553
9/6/2015,2015,9,6, 17 ,6238,1042,1076,8356
9/6/2015,2015,9,6, 18 ,6384,1177,1230,8791
9/6/2015,2015,9,6, 19 ,7005,1250,1260,9515
9/6/2015,2015,9,6, 20 ,7048,1324,1255,9627
9/6/2015,2015,9,6, 21 ,6952,1263,1200,9415
9/6/2015,2015,9,6, 22 ,6611,1203,1092,8906
9/6/2015,2015,9,6, 23 ,6297,1133,999,8429
9/6/2015,2015,9,6, 24 ,6002,1057,946,8005
9/7/2015,2015,9,7, 1 ,5706,1017,898,7621
9/7/2015,2015,9,7, 2 ,5475,991,870,7336
9/7/2015,2015,9,7, 3 ,5339,968,849,7156
9/7/2015,2015,9,7, 4 ,5291,961,842,7094
9/7/2015,2015,9,7, 5 ,5389,992,887,7268
9/7/2015,2015,9,7, 6 ,5462,1021,932,7415
9/7/2015,2015,9,7, 7 ,5673,990,861,7524
9/7/2015,2015,9,7, 8 ,6599,1164,1008,8771
9/7/2015,2015,9,7, 9 ,7515,1365,1203,10083
9/7/2015,2015,9,7, 10 ,8055,1471,1308,10834
9/7/2015,2015,9,7, 11 ,8375,1551,1339,11265
9/7/2015,2015,9,7, 12 ,8321,1482,1296,11099
9/7/2015,2015,9,7, 13 ,8345,1489,1316,11150
9/7/2015,2015,9,7, 14 ,8626,1538,1364,11528
9/7/2015,2015,9,7, 15 ,8442,1518,1332,11292
9/7/2015,2015,9,7, 16 ,8258,1458,1320,11036
9/7/2015,2015,9,7, 17 ,7900,1406,1261,10567
9/7/2015,2015,9,7, 18 ,7743,1489,1351,10583
9/7/2015,2015,9,7, 19 ,7936,1558,1349,10843
9/7/2015,2015,9,7, 20 ,7753,1484,1319,10556
9/7/2015,2015,9,7, 21 ,7496,1414,1264,10174
9/7/2015,2015,9,7, 22 ,7118,1285,1174,9577
9/7/2015,2015,9,7, 23 ,6654,1174,1092,8920
9/7/2015,2015,9,7, 24 ,6256,1100,1014,8370
9/8/2015,2015,9,8, 1 ,5944,1059,950,7953
9/8/2015,2015,9,8, 2 ,5849,1020,929,7798
9/8/2015,2015,9,8, 3 ,5635,986,914,7535
9/8/2015,2015,9,8, 4 ,5602,975,904,7481
9/8/2015,2015,9,8, 5 ,5723,995,956,7674
9/8/2015,2015,9,8, 6 ,5729,1011,993,7733
9/8/2015,2015,9,8, 7 ,5860,986,916,7762
9/8/2015,2015,9,8, 8 ,6671,1158,1046,8875
9/8/2015,2015,9,8, 9 ,7516,1354,1218,10088
9/8/2015,2015,9,8, 10 ,8095,1458,1332,10885
9/8/2015,2015,9,8, 11 ,8472,1506,1250,11228
9/8/2015,2015,9,8, 12 ,8343,1456,1195,10994
9/8/2015,2015,9,8, 13 ,8382,1460,1196,11038
9/8/2015,2015,9,8, 14 ,8678,1508,1293,11479
9/8/2015,2015,9,8, 15 ,8476,1471,1256,11203
9/8/2015,2015,9,8, 16 ,8239,1446,1300,10985
9/8/2015,2015,9,8, 17 ,7828,1383,1281,10492
9/8/2015,2015,9,8, 18 ,7745,1478,1383,10606
9/8/2015,2015,9,8, 19 ,7940,1537,1394,10871
9/8/2015,2015,9,8, 20 ,7668,1468,1333,10469
9/8/2015,2015,9,8, 21 ,7399,1398,1260,10057
9/8/2015,2015,9,8, 22 ,7100,1282,1194,9576
9/8/2015,2015,9,8, 23 ,6725,1174,1064,8963
9/8/2015,2015,9,8, 24 ,6356,1099,1039,8494
9/9/2015,2015,9,9, 1 ,6109,1063,951,8123
9/9/2015,2015,9,9, 2 ,5896,1028,920,7844
9/9/2015,2015,9,9, 3 ,5764,994,895,7653
9/9/2015,2015,9,9, 4 ,5707,977,897,7581
9/9/2015,2015,9,9, 5 ,5825,1012,952,7789
9/9/2015,2015,9,9, 6 ,5820,1026,976,7822
9/9/2015,2015,9,9, 7 ,5889,996,898,7783
9/9/2015,2015,9,9, 8 ,6772,1147,1030,8949
9/9/2015,2015,9,9, 9 ,7600,1324,1224,10148
9/9/2015,2015,9,9, 10 ,8130,1422,1342,10894
9/9/2015,2015,9,9, 11 ,8428,1467,1373,11268
9/9/2015,2015,9,9, 12 ,8300,1417,1368,11085
9/9/2015,2015,9,9, 13 ,8339,1402,1384,11125
9/9/2015,2015,9,9, 14 ,8675,1444,1430,11549
9/9/2015,2015,9,9, 15 ,8423,1429,1405,11257
9/9/2015,2015,9,9, 16 ,8214,1374,1377,10965
9/9/2015,2015,9,9, 17 ,7797,1350,1327,10474
9/9/2015,2015,9,9, 18 ,7622,1465,1419,10506
9/9/2015,2015,9,9, 19 ,7970,1505,1427,10902
9/9/2015,2015,9,9, 20 ,7899,1453,1382,10734
9/9/2015,2015,9,9, 21 ,7701,1386,1327,10414
9/9/2015,2015,9,9, 22 ,7342,1276,1210,9828
9/9/2015,2015,9,9, 23 ,6825,1168,1143,9136
9/9/2015,2015,9,9, 24 ,6398,1095,1097,8590
9/10/2015,2015,9,10, 1 ,6087,1048,998,8133
9/10/2015,2015,9,10, 2 ,5910,1012,969,7891
9/10/2015,2015,9,10, 3 ,5789,993,941,7723
9/10/2015,2015,9,10, 4 ,5716,984,935,7635
9/10/2015,2015,9,10, 5 ,5823,1020,979,7822
9/10/2015,2015,9,10, 6 ,5842,1040,1011,7893
9/10/2015,2015,9,10, 7 ,5892,1006,937,7835
9/10/2015,2015,9,10, 8 ,6748,1171,1059,8978
9/10/2015,2015,9,10, 9 ,7564,1393,1215,10172
9/10/2015,2015,9,10, 10 ,8064,1481,1327,10872
9/10/2015,2015,9,10, 11 ,8459,1560,1364,11383
9/10/2015,2015,9,10, 12 ,8227,1491,1325,11043
9/10/2015,2015,9,10, 13 ,8189,1500,1315,11004
9/10/2015,2015,9,10, 14 ,8293,1523,1371,11187
9/10/2015,2015,9,10, 15 ,8038,1486,1327,10851
9/10/2015,2015,9,10, 16 ,7847,1461,1307,10615
9/10/2015,2015,9,10, 17 ,7473,1404,1290,10167
9/10/2015,2015,9,10, 18 ,7437,1513,1297,10247
9/10/2015,2015,9,10, 19 ,7570,1545,1284,10399
9/10/2015,2015,9,10, 20 ,7408,1472,1249,10129
9/10/2015,2015,9,10, 21 ,7185,1397,1224,9806
9/10/2015,2015,9,10, 22 ,6820,1285,1123,9228
9/10/2015,2015,9,10, 23 ,6386,1196,1039,8621
9/10/2015,2015,9,10, 24 ,5999,1098,979,8076
9/11/2015,2015,9,11, 1 ,5752,1067,941,7760
9/11/2015,2015,9,11, 2 ,5605,1039,917,7561
9/11/2015,2015,9,11, 3 ,5468,1012,889,7369
9/11/2015,2015,9,11, 4 ,5457,996,889,7342
9/11/2015,2015,9,11, 5 ,5564,1019,930,7513
9/11/2015,2015,9,11, 6 ,5611,1039,964,7614
9/11/2015,2015,9,11, 7 ,5696,1009,965,7670
9/11/2015,2015,9,11, 8 ,6557,1173,1038,8768
9/11/2015,2015,9,11, 9 ,7346,1381,1166,9893
9/11/2015,2015,9,11, 10 ,7821,1494,1279,10594
9/11/2015,2015,9,11, 11 ,8038,1543,1378,10959
9/11/2015,2015,9,11, 12 ,7812,1483,1341,10636
9/11/2015,2015,9,11, 13 ,7807,1475,1338,10620
9/11/2015,2015,9,11, 14 ,8142,1533,1357,11032
9/11/2015,2015,9,11, 15 ,7990,1487,1347,10824
9/11/2015,2015,9,11, 16 ,7754,1448,1325,10527
9/11/2015,2015,9,11, 17 ,7345,1385,1289,10019
9/11/2015,2015,9,11, 18 ,7328,1474,1390,10192
9/11/2015,2015,9,11, 19 ,7564,1491,1366,10421
9/11/2015,2015,9,11, 20 ,7402,1443,1321,10166
9/11/2015,2015,9,11, 21 ,7168,1361,1257,9786
9/11/2015,2015,9,11, 22 ,6876,1261,1171,9308
9/11/2015,2015,9,11, 23 ,6431,1156,1055,8642
9/11/2015,2015,9,11, 24 ,6077,1082,965,8124
9/12/2015,2015,9,12, 1 ,5796,1035,923,7754
9/12/2015,2015,9,12, 2 ,5648,1009,898,7555
9/12/2015,2015,9,12, 3 ,5489,981,881,7351
9/12/2015,2015,9,12, 4 ,5350,967,892,7209
9/12/2015,2015,9,12, 5 ,5333,975,898,7206
9/12/2015,2015,9,12, 6 ,5273,977,912,7162
9/12/2015,2015,9,12, 7 ,5384,988,897,7269
9/12/2015,2015,9,12, 8 ,5965,1082,978,8025
9/12/2015,2015,9,12, 9 ,6557,1247,1110,8914
9/12/2015,2015,9,12, 10 ,7158,1321,1201,9680
9/12/2015,2015,9,12, 11 ,7483,1383,1257,10123
9/12/2015,2015,9,12, 12 ,7405,1341,1262,10008
9/12/2015,2015,9,12, 13 ,7385,1363,1290,10038
9/12/2015,2015,9,12, 14 ,7564,1412,1332,10308
9/12/2015,2015,9,12, 15 ,7394,1368,1298,10060
9/12/2015,2015,9,12, 16 ,7082,1262,1268,9612
9/12/2015,2015,9,12, 17 ,6788,1270,1210,9268
9/12/2015,2015,9,12, 18 ,6856,1364,1364,9584
9/12/2015,2015,9,12, 19 ,7245,1463,1393,10101
9/12/2015,2015,9,12, 20 ,7182,1432,1340,9954
9/12/2015,2015,9,12, 21 ,7061,1377,1292,9730
9/12/2015,2015,9,12, 22 ,6803,1291,1202,9296
9/12/2015,2015,9,12, 23 ,6397,1174,1108,8679
9/12/2015,2015,9,12, 24 ,6012,1081,1026,8119
9/13/2015,2015,9,13, 1 ,5735,1027,943,7705
9/13/2015,2015,9,13, 2 ,5564,990,944,7498
9/13/2015,2015,9,13, 3 ,5448,955,913,7316
9/13/2015,2015,9,13, 4 ,5309,936,896,7141
9/13/2015,2015,9,13, 5 ,5179,936,892,7007
9/13/2015,2015,9,13, 6 ,5001,908,886,6795
9/13/2015,2015,9,13, 7 ,5018,912,846,6776
9/13/2015,2015,9,13, 8 ,5279,971,873,7123
9/13/2015,2015,9,13, 9 ,5687,1048,953,7688
9/13/2015,2015,9,13, 10 ,6220,1134,1030,8384
9/13/2015,2015,9,13, 11 ,6451,1194,1098,8743
9/13/2015,2015,9,13, 12 ,6462,1183,1084,8729
9/13/2015,2015,9,13, 13 ,6450,1199,1103,8752
9/13/2015,2015,9,13, 14 ,6382,1190,1105,8677
9/13/2015,2015,9,13, 15 ,6227,1167,1078,8472
9/13/2015,2015,9,13, 16 ,6010,1128,1095,8233
9/13/2015,2015,9,13, 17 ,6066,1138,1127,8331
9/13/2015,2015,9,13, 18 ,6368,1322,1251,8941
9/13/2015,2015,9,13, 19 ,6769,1366,1302,9437
9/13/2015,2015,9,13, 20 ,6819,1333,1255,9407
9/13/2015,2015,9,13, 21 ,6618,1257,1194,9069
9/13/2015,2015,9,13, 22 ,6265,1153,1100,8518
9/13/2015,2015,9,13, 23 ,5937,1058,1002,7997
9/13/2015,2015,9,13, 24 ,5624,990,967,7581
9/14/2015,2015,9,14, 1 ,5350,938,903,7191
9/14/2015,2015,9,14, 2 ,5149,916,873,6938
9/14/2015,2015,9,14, 3 ,4987,895,852,6734
9/14/2015,2015,9,14, 4 ,5002,891,851,6744
9/14/2015,2015,9,14, 5 ,5223,947,898,7068
9/14/2015,2015,9,14, 6 ,5281,998,945,7224
9/14/2015,2015,9,14, 7 ,5496,964,878,7338
9/14/2015,2015,9,14, 8 ,6393,1130,997,8520
9/14/2015,2015,9,14, 9 ,7250,1320,1212,9782
9/14/2015,2015,9,14, 10 ,7831,1464,1317,10612
9/14/2015,2015,9,14, 11 ,8156,1512,1353,11021
9/14/2015,2015,9,14, 12 ,7987,1468,1308,10763
9/14/2015,2015,9,14, 13 ,8016,1448,1304,10768
9/14/2015,2015,9,14, 14 ,8292,1501,1353,11146
9/14/2015,2015,9,14, 15 ,8053,1466,1322,10841
9/14/2015,2015,9,14, 16 ,7829,1444,1294,10567
9/14/2015,2015,9,14, 17 ,7475,1402,1303,10180
9/14/2015,2015,9,14, 18 ,7465,1461,1313,10239
9/14/2015,2015,9,14, 19 ,7585,1472,1309,10366
9/14/2015,2015,9,14, 20 ,7449,1425,1245,10119
9/14/2015,2015,9,14, 21 ,7209,1338,1171,9718
9/14/2015,2015,9,14, 22 ,6891,1217,1063,9171
9/14/2015,2015,9,14, 23 ,6392,1111,982,8485
9/14/2015,2015,9,14, 24 ,5994,1034,958,7986
9/15/2015,2015,9,15, 1 ,5767,996,866,7629
9/15/2015,2015,9,15, 2 ,5633,975,856,7464
9/15/2015,2015,9,15, 3 ,5489,948,834,7271
9/15/2015,2015,9,15, 4 ,5353,944,835,7132
9/15/2015,2015,9,15, 5 ,5535,989,891,7415
9/15/2015,2015,9,15, 6 ,5557,1014,946,7517
9/15/2015,2015,9,15, 7 ,5698,980,868,7546
9/15/2015,2015,9,15, 8 ,6541,1134,973,8648
9/15/2015,2015,9,15, 9 ,7429,1349,1118,9896
9/15/2015,2015,9,15, 10 ,7910,1455,1211,10576
9/15/2015,2015,9,15, 11 ,8202,1514,1290,11006
9/15/2015,2015,9,15, 12 ,8114,1460,1253,10827
9/15/2015,2015,9,15, 13 ,8180,1473,1280,10933
9/15/2015,2015,9,15, 14 ,8453,1551,1342,11346
9/15/2015,2015,9,15, 15 ,8078,1508,1305,10891
9/15/2015,2015,9,15, 16 ,7876,1446,1277,10599
9/15/2015,2015,9,15, 17 ,7537,1378,1257,10172
9/15/2015,2015,9,15, 18 ,7531,1480,1368,10379
9/15/2015,2015,9,15, 19 ,7770,1478,1335,10583
9/15/2015,2015,9,15, 20 ,7621,1398,1257,10276
9/15/2015,2015,9,15, 21 ,7405,1345,1185,9935
9/15/2015,2015,9,15, 22 ,7121,1226,1082,9429
9/15/2015,2015,9,15, 23 ,6647,1129,978,8754
9/15/2015,2015,9,15, 24 ,6234,1049,948,8231
9/16/2015,2015,9,16, 1 ,6016,1003,883,7902
9/16/2015,2015,9,16, 2 ,5773,974,860,7607
9/16/2015,2015,9,16, 3 ,5638,960,837,7435
9/16/2015,2015,9,16, 4 ,5535,966,835,7336
9/16/2015,2015,9,16, 5 ,5662,995,867,7524
9/16/2015,2015,9,16, 6 ,5650,1027,918,7595
9/16/2015,2015,9,16, 7 ,5740,983,853,7576
9/16/2015,2015,9,16, 8 ,6567,1130,950,8647
9/16/2015,2015,9,16, 9 ,7376,1339,1123,9838
9/16/2015,2015,9,16, 10 ,7947,1426,1255,10628
9/16/2015,2015,9,16, 11 ,8279,1467,1281,11027
9/16/2015,2015,9,16, 12 ,8195,1422,1276,10893
9/16/2015,2015,9,16, 13 ,8128,1431,1290,10849
9/16/2015,2015,9,16, 14 ,8323,1473,1336,11132
9/16/2015,2015,9,16, 15 ,8044,1443,1308,10795
9/16/2015,2015,9,16, 16 ,7845,1397,1279,10521
9/16/2015,2015,9,16, 17 ,7531,1369,1262,10162
9/16/2015,2015,9,16, 18 ,7451,1472,1357,10280
9/16/2015,2015,9,16, 19 ,7727,1477,1370,10574
9/16/2015,2015,9,16, 20 ,7573,1407,1282,10262
9/16/2015,2015,9,16, 21 ,7351,1318,1208,9877
9/16/2015,2015,9,16, 22 ,6988,1185,1117,9290
9/16/2015,2015,9,16, 23 ,6498,1082,1010,8590
9/16/2015,2015,9,16, 24 ,6075,1016,929,8020
9/17/2015,2015,9,17, 1 ,5828,979,900,7707
9/17/2015,2015,9,17, 2 ,5681,939,873,7493
9/17/2015,2015,9,17, 3 ,5509,926,846,7281
9/17/2015,2015,9,17, 4 ,5432,920,844,7196
9/17/2015,2015,9,17, 5 ,5571,962,894,7427
9/17/2015,2015,9,17, 6 ,5620,997,932,7549
9/17/2015,2015,9,17, 7 ,5733,958,868,7559
9/17/2015,2015,9,17, 8 ,6568,1116,1006,8690
9/17/2015,2015,9,17, 9 ,7364,1324,1167,9855
9/17/2015,2015,9,17, 10 ,7936,1417,1294,10647
9/17/2015,2015,9,17, 11 ,8190,1463,1368,11021
9/17/2015,2015,9,17, 12 ,8049,1412,1336,10797
9/17/2015,2015,9,17, 13 ,8168,1423,1360,10951
9/17/2015,2015,9,17, 14 ,8495,1484,1427,11406
9/17/2015,2015,9,17, 15 ,8197,1453,1391,11041
9/17/2015,2015,9,17, 16 ,7941,1427,1311,10679
9/17/2015,2015,9,17, 17 ,7563,1382,1290,10235
9/17/2015,2015,9,17, 18 ,7440,1461,1390,10291
9/17/2015,2015,9,17, 19 ,7704,1494,1394,10592
9/17/2015,2015,9,17, 20 ,7596,1444,1333,10373
9/17/2015,2015,9,17, 21 ,7400,1359,1313,10072
9/17/2015,2015,9,17, 22 ,7075,1224,1213,9512
9/17/2015,2015,9,17, 23 ,6623,1124,1089,8836
9/17/2015,2015,9,17, 24 ,6248,1029,990,8267
9/18/2015,2015,9,18, 1 ,5953,1008,979,7940
9/18/2015,2015,9,18, 2 ,5803,982,954,7739
9/18/2015,2015,9,18, 3 ,5595,960,924,7479
9/18/2015,2015,9,18, 4 ,5525,950,914,7389
9/18/2015,2015,9,18, 5 ,5649,983,950,7582
9/18/2015,2015,9,18, 6 ,5612,1008,974,7594
9/18/2015,2015,9,18, 7 ,5710,980,920,7610
9/18/2015,2015,9,18, 8 ,6590,1139,1039,8768
9/18/2015,2015,9,18, 9 ,7451,1352,1227,10030
9/18/2015,2015,9,18, 10 ,7967,1446,1353,10766
9/18/2015,2015,9,18, 11 ,8289,1496,1405,11190
9/18/2015,2015,9,18, 12 ,8138,1465,1381,10984
9/18/2015,2015,9,18, 13 ,8191,1489,1419,11099
9/18/2015,2015,9,18, 14 ,8466,1564,1452,11482
9/18/2015,2015,9,18, 15 ,8214,1514,1419,11147
9/18/2015,2015,9,18, 16 ,8049,1468,1388,10905
9/18/2015,2015,9,18, 17 ,7598,1408,1339,10345
9/18/2015,2015,9,18, 18 ,7548,1513,1439,10500
9/18/2015,2015,9,18, 19 ,7791,1526,1443,10760
9/18/2015,2015,9,18, 20 ,7703,1477,1380,10560
9/18/2015,2015,9,18, 21 ,7519,1364,1332,10215
9/18/2015,2015,9,18, 22 ,7297,1228,1240,9765
9/18/2015,2015,9,18, 23 ,6824,1131,1124,9079
9/18/2015,2015,9,18, 24 ,6397,1058,991,8446
9/19/2015,2015,9,19, 1 ,6136,1002,1004,8142
9/19/2015,2015,9,19, 2 ,5935,967,971,7873
9/19/2015,2015,9,19, 3 ,5737,950,948,7635
9/19/2015,2015,9,19, 4 ,5660,947,940,7547
9/19/2015,2015,9,19, 5 ,5551,973,948,7472
9/19/2015,2015,9,19, 6 ,5489,958,951,7398
9/19/2015,2015,9,19, 7 ,5606,964,941,7511
9/19/2015,2015,9,19, 8 ,6162,1073,1000,8235
9/19/2015,2015,9,19, 9 ,6776,1204,1119,9099
9/19/2015,2015,9,19, 10 ,7299,1272,1229,9800
9/19/2015,2015,9,19, 11 ,7611,1311,1282,10204
9/19/2015,2015,9,19, 12 ,7564,1299,1258,10121
9/19/2015,2015,9,19, 13 ,7581,1297,1257,10135
9/19/2015,2015,9,19, 14 ,7821,1341,1267,10429
9/19/2015,2015,9,19, 15 ,7547,1313,1173,10033
9/19/2015,2015,9,19, 16 ,7278,1261,1161,9700
9/19/2015,2015,9,19, 17 ,6875,1277,1197,9349
9/19/2015,2015,9,19, 18 ,7024,1446,1337,9807
9/19/2015,2015,9,19, 19 ,7446,1464,1300,10210
9/19/2015,2015,9,19, 20 ,7355,1413,1244,10012
9/19/2015,2015,9,19, 21 ,7332,1342,1198,9872
9/19/2015,2015,9,19, 22 ,7084,1240,1105,9429
9/19/2015,2015,9,19, 23 ,6698,1151,982,8831
9/19/2015,2015,9,19, 24 ,6311,1080,952,8343
9/20/2015,2015,9,20, 1 ,6020,1025,881,7926
9/20/2015,2015,9,20, 2 ,5789,995,859,7643
9/20/2015,2015,9,20, 3 ,5673,968,837,7478
9/20/2015,2015,9,20, 4 ,5456,941,826,7223
9/20/2015,2015,9,20, 5 ,5412,938,844,7194
9/20/2015,2015,9,20, 6 ,5190,914,848,6952
9/20/2015,2015,9,20, 7 ,5190,939,796,6925
9/20/2015,2015,9,20, 8 ,5541,993,820,7354
9/20/2015,2015,9,20, 9 ,5956,1088,909,7953
9/20/2015,2015,9,20, 10 ,6374,1169,985,8528
9/20/2015,2015,9,20, 11 ,6708,1204,1070,8982
9/20/2015,2015,9,20, 12 ,6654,1192,1066,8912
9/20/2015,2015,9,20, 13 ,6731,1197,1098,9026
9/20/2015,2015,9,20, 14 ,6743,1177,1109,9029
9/20/2015,2015,9,20, 15 ,6667,1164,1102,8933
9/20/2015,2015,9,20, 16 ,6465,1146,1040,8651
9/20/2015,2015,9,20, 17 ,6324,1165,1052,8541
9/20/2015,2015,9,20, 18 ,6674,1359,1205,9238
9/20/2015,2015,9,20, 19 ,7039,1386,1249,9674
9/20/2015,2015,9,20, 20 ,7119,1370,1220,9709
9/20/2015,2015,9,20, 21 ,6947,1305,1162,9414
9/20/2015,2015,9,20, 22 ,6511,1214,1081,8806
9/20/2015,2015,9,20, 23 ,6266,1108,988,8362
9/20/2015,2015,9,20, 24 ,5889,1034,924,7847
9/21/2015,2015,9,21, 1 ,5626,993,887,7506
9/21/2015,2015,9,21, 2 ,5375,957,862,7194
9/21/2015,2015,9,21, 3 ,5288,940,839,7067
9/21/2015,2015,9,21, 4 ,5191,927,845,6963
9/21/2015,2015,9,21, 5 ,5365,980,896,7241
9/21/2015,2015,9,21, 6 ,5442,1012,934,7388
9/21/2015,2015,9,21, 7 ,5586,992,870,7448
9/21/2015,2015,9,21, 8 ,6549,1155,1039,8743
9/21/2015,2015,9,21, 9 ,7461,1378,1224,10063
9/21/2015,2015,9,21, 10 ,7977,1478,1360,10815
9/21/2015,2015,9,21, 11 ,8284,1515,1424,11223
9/21/2015,2015,9,21, 12 ,8179,1486,1398,11063
9/21/2015,2015,9,21, 13 ,8243,1506,1404,11153
9/21/2015,2015,9,21, 14 ,8477,1547,1412,11436
9/21/2015,2015,9,21, 15 ,8241,1502,1387,11130
9/21/2015,2015,9,21, 16 ,7961,1464,1338,10763
9/21/2015,2015,9,21, 17 ,7616,1431,1322,10369
9/21/2015,2015,9,21, 18 ,7634,1570,1398,10602
9/21/2015,2015,9,21, 19 ,7705,1597,1395,10697
9/21/2015,2015,9,21, 20 ,7570,1548,1336,10454
9/21/2015,2015,9,21, 21 ,7388,1478,1283,10149
9/21/2015,2015,9,21, 22 ,6990,1349,1143,9482
9/21/2015,2015,9,21, 23 ,6656,1245,1086,8987
9/21/2015,2015,9,21, 24 ,6245,1157,937,8339
9/22/2015,2015,9,22, 1 ,5909,1106,944,7959
9/22/2015,2015,9,22, 2 ,5697,1068,919,7684
9/22/2015,2015,9,22, 3 ,5605,1053,885,7543
9/22/2015,2015,9,22, 4 ,5528,1049,839,7416
9/22/2015,2015,9,22, 5 ,5632,1084,935,7651
9/22/2015,2015,9,22, 6 ,5691,1111,994,7796
9/22/2015,2015,9,22, 7 ,5833,1061,930,7824
9/22/2015,2015,9,22, 8 ,6780,1210,1033,9023
9/22/2015,2015,9,22, 9 ,7528,1417,1193,10138
9/22/2015,2015,9,22, 10 ,8006,1507,1328,10841
9/22/2015,2015,9,22, 11 ,8283,1554,1367,11204
9/22/2015,2015,9,22, 12 ,8147,1490,1340,10977
9/22/2015,2015,9,22, 13 ,8242,1507,1333,11082
9/22/2015,2015,9,22, 14 ,8511,1565,1356,11432
9/22/2015,2015,9,22, 15 ,8239,1526,1326,11091
9/22/2015,2015,9,22, 16 ,8197,1504,1291,10992
9/22/2015,2015,9,22, 17 ,7729,1463,1291,10483
9/22/2015,2015,9,22, 18 ,7653,1566,1401,10620
9/22/2015,2015,9,22, 19 ,8049,1551,1368,10968
9/22/2015,2015,9,22, 20 ,7891,1494,1341,10726
9/22/2015,2015,9,22, 21 ,7529,1420,1246,10195
9/22/2015,2015,9,22, 22 ,7049,1298,1133,9480
9/22/2015,2015,9,22, 23 ,6551,1207,1018,8776
9/22/2015,2015,9,22, 24 ,6182,1124,970,8276
9/23/2015,2015,9,23, 1 ,5933,1088,928,7949
9/23/2015,2015,9,23, 2 ,5756,1055,903,7714
9/23/2015,2015,9,23, 3 ,5624,1015,885,7524
9/23/2015,2015,9,23, 4 ,5528,1008,877,7413
9/23/2015,2015,9,23, 5 ,5653,1059,932,7644
9/23/2015,2015,9,23, 6 ,5702,1097,978,7777
9/23/2015,2015,9,23, 7 ,5797,1047,902,7746
9/23/2015,2015,9,23, 8 ,6695,1181,1037,8913
9/23/2015,2015,9,23, 9 ,7450,1368,1201,10019
9/23/2015,2015,9,23, 10 ,7970,1462,1324,10756
9/23/2015,2015,9,23, 11 ,8272,1527,1399,11198
9/23/2015,2015,9,23, 12 ,8056,1486,1367,10909
9/23/2015,2015,9,23, 13 ,8176,1510,1393,11079
9/23/2015,2015,9,23, 14 ,8485,1580,1436,11501
9/23/2015,2015,9,23, 15 ,8358,1547,1336,11241
9/23/2015,2015,9,23, 16 ,8172,1520,1296,10988
9/23/2015,2015,9,23, 17 ,7838,1442,1257,10537
9/23/2015,2015,9,23, 18 ,7843,1564,1397,10804
9/23/2015,2015,9,23, 19 ,8031,1579,1401,11011
9/23/2015,2015,9,23, 20 ,7890,1521,1360,10771
9/23/2015,2015,9,23, 21 ,7663,1441,1281,10385
9/23/2015,2015,9,23, 22 ,7235,1320,1183,9738
9/23/2015,2015,9,23, 23 ,6846,1214,1059,9119
9/23/2015,2015,9,23, 24 ,6406,1144,957,8507
9/24/2015,2015,9,24, 1 ,6129,1045,948,8122
9/24/2015,2015,9,24, 2 ,5952,1017,924,7893
9/24/2015,2015,9,24, 3 ,5794,994,902,7690
9/24/2015,2015,9,24, 4 ,5710,981,897,7588
9/24/2015,2015,9,24, 5 ,5821,1011,947,7779
9/24/2015,2015,9,24, 6 ,5817,1032,967,7816
9/24/2015,2015,9,24, 7 ,5975,1005,903,7883
9/24/2015,2015,9,24, 8 ,6712,1170,1040,8922
9/24/2015,2015,9,24, 9 ,7467,1365,1217,10049
9/24/2015,2015,9,24, 10 ,7946,1462,1112,10520
9/24/2015,2015,9,24, 11 ,8275,1512,1170,10957
9/24/2015,2015,9,24, 12 ,8137,1469,1207,10813
9/24/2015,2015,9,24, 13 ,8221,1464,1235,10920
9/24/2015,2015,9,24, 14 ,8516,1498,1318,11332
9/24/2015,2015,9,24, 15 ,8326,1441,1344,11111
9/24/2015,2015,9,24, 16 ,8156,1413,1304,10873
9/24/2015,2015,9,24, 17 ,7793,1376,1281,10450
9/24/2015,2015,9,24, 18 ,7868,1495,1389,10752
9/24/2015,2015,9,24, 19 ,8033,1497,1365,10895
9/24/2015,2015,9,24, 20 ,7841,1451,1316,10608
9/24/2015,2015,9,24, 21 ,7711,1361,1241,10313
9/24/2015,2015,9,24, 22 ,7401,1256,1140,9797
9/24/2015,2015,9,24, 23 ,6994,1156,1057,9207
9/24/2015,2015,9,24, 24 ,6616,1094,978,8688
9/25/2015,2015,9,25, 1 ,6334,1049,945,8328
9/25/2015,2015,9,25, 2 ,6136,1008,913,8057
9/25/2015,2015,9,25, 3 ,5888,988,880,7756
9/25/2015,2015,9,25, 4 ,5818,979,841,7638
9/25/2015,2015,9,25, 5 ,5693,997,868,7558
9/25/2015,2015,9,25, 6 ,5559,975,892,7426
9/25/2015,2015,9,25, 7 ,5618,986,905,7509
9/25/2015,2015,9,25, 8 ,6044,1093,977,8114
9/25/2015,2015,9,25, 9 ,6583,1211,1049,8843
9/25/2015,2015,9,25, 10 ,7138,1276,1137,9551
9/25/2015,2015,9,25, 11 ,7460,1333,1194,9987
9/25/2015,2015,9,25, 12 ,7440,1284,1181,9905
9/25/2015,2015,9,25, 13 ,7446,1299,1183,9928
9/25/2015,2015,9,25, 14 ,7703,1336,1111,10150
9/25/2015,2015,9,25, 15 ,7452,1291,1152,9895
9/25/2015,2015,9,25, 16 ,7206,1259,1151,9616
9/25/2015,2015,9,25, 17 ,7012,1253,1192,9457
9/25/2015,2015,9,25, 18 ,7319,1427,1344,10090
9/25/2015,2015,9,25, 19 ,7648,1429,1301,10378
9/25/2015,2015,9,25, 20 ,7646,1388,1258,10292
9/25/2015,2015,9,25, 21 ,7594,1322,1172,10088
9/25/2015,2015,9,25, 22 ,7238,1223,1090,9551
9/25/2015,2015,9,25, 23 ,6858,1134,1002,8994
9/25/2015,2015,9,25, 24 ,6477,1064,906,8447
9/26/2015,2015,9,26, 1 ,6207,1081,884,8172
9/26/2015,2015,9,26, 2 ,5979,1050,866,7895
9/26/2015,2015,9,26, 3 ,5778,1027,831,7636
9/26/2015,2015,9,26, 4 ,5671,1011,825,7507
9/26/2015,2015,9,26, 5 ,5610,1025,866,7501
9/26/2015,2015,9,26, 6 ,5610,1023,896,7529
9/26/2015,2015,9,26, 7 ,5570,1044,884,7498
9/26/2015,2015,9,26, 8 ,6151,1149,954,8254
9/26/2015,2015,9,26, 9 ,6796,1277,1066,9139
9/26/2015,2015,9,26, 10 ,7279,1362,1161,9802
9/26/2015,2015,9,26, 11 ,7647,1426,1188,10261
9/26/2015,2015,9,26, 12 ,7581,1401,1193,10175
9/26/2015,2015,9,26, 13 ,7586,1403,1216,10205
9/26/2015,2015,9,26, 14 ,7758,1429,1252,10439
9/26/2015,2015,9,26, 15 ,7549,1394,1225,10168
9/26/2015,2015,9,26, 16 ,7246,1346,1195,9787
9/26/2015,2015,9,26, 17 ,6919,1305,1178,9402
9/26/2015,2015,9,26, 18 ,7187,1504,1361,10052
9/26/2015,2015,9,26, 19 ,7392,1505,1340,10237
9/26/2015,2015,9,26, 20 ,7357,1451,1276,10084
9/26/2015,2015,9,26, 21 ,7267,1402,1220,9889
9/26/2015,2015,9,26, 22 ,7062,1307,1123,9492
9/26/2015,2015,9,26, 23 ,6688,1210,1042,8940
9/26/2015,2015,9,26, 24 ,6293,1163,991,8447
9/27/2015,2015,9,27, 1 ,6052,1099,955,8106
9/27/2015,2015,9,27, 2 ,5830,1073,891,7794
9/27/2015,2015,9,27, 3 ,5643,1045,864,7552
9/27/2015,2015,9,27, 4 ,5485,1018,850,7353
9/27/2015,2015,9,27, 5 ,5464,1023,863,7350
9/27/2015,2015,9,27, 6 ,5259,1012,868,7139
9/27/2015,2015,9,27, 7 ,5273,1005,847,7125
9/27/2015,2015,9,27, 8 ,5569,1045,877,7491
9/27/2015,2015,9,27, 9 ,5931,1114,956,8001
9/27/2015,2015,9,27, 10 ,6344,1169,1005,8518
9/27/2015,2015,9,27, 11 ,6642,1218,1055,8915
9/27/2015,2015,9,27, 12 ,6585,1206,1078,8869
9/27/2015,2015,9,27, 13 ,6581,1200,1103,8884
9/27/2015,2015,9,27, 14 ,6589,1224,1117,8930
9/27/2015,2015,9,27, 15 ,6484,1213,1094,8791
9/27/2015,2015,9,27, 16 ,6305,1184,1074,8563
9/27/2015,2015,9,27, 17 ,6236,1207,1101,8544
9/27/2015,2015,9,27, 18 ,6671,1440,1295,9406
9/27/2015,2015,9,27, 19 ,6983,1458,1291,9732
9/27/2015,2015,9,27, 20 ,7025,1429,1261,9715
9/27/2015,2015,9,27, 21 ,6900,1353,1211,9464
9/27/2015,2015,9,27, 22 ,6563,1251,1095,8909
9/27/2015,2015,9,27, 23 ,6189,1157,1026,8372
9/27/2015,2015,9,27, 24 ,5864,1083,960,7907
9/28/2015,2015,9,28, 1 ,5594,1044,912,7550
9/28/2015,2015,9,28, 2 ,5386,1004,882,7272
9/28/2015,2015,9,28, 3 ,5258,986,857,7101
9/28/2015,2015,9,28, 4 ,5190,977,854,7021
9/28/2015,2015,9,28, 5 ,5330,1015,899,7244
9/28/2015,2015,9,28, 6 ,5429,1069,934,7432
9/28/2015,2015,9,28, 7 ,5659,1045,876,7580
9/28/2015,2015,9,28, 8 ,6507,1202,1021,8730
9/28/2015,2015,9,28, 9 ,7358,1399,1183,9940
9/28/2015,2015,9,28, 10 ,7873,1506,1307,10686
9/28/2015,2015,9,28, 11 ,8195,1554,1403,11152
9/28/2015,2015,9,28, 12 ,8041,1518,1388,10947
9/28/2015,2015,9,28, 13 ,8021,1522,1403,10946
9/28/2015,2015,9,28, 14 ,8308,1589,1438,11335
9/28/2015,2015,9,28, 15 ,8068,1550,1396,11014
9/28/2015,2015,9,28, 16 ,7868,1522,1380,10770
9/28/2015,2015,9,28, 17 ,7558,1463,1325,10346
9/28/2015,2015,9,28, 18 ,7716,1614,1450,10780
9/28/2015,2015,9,28, 19 ,7698,1609,1428,10735
9/28/2015,2015,9,28, 20 ,7557,1555,1394,10506
9/28/2015,2015,9,28, 21 ,7316,1482,1339,10137
9/28/2015,2015,9,28, 22 ,6912,1365,1220,9497
9/28/2015,2015,9,28, 23 ,6525,1245,1132,8902
9/28/2015,2015,9,28, 24 ,6076,1160,1052,8288
9/29/2015,2015,9,29, 1 ,5791,1107,997,7895
9/29/2015,2015,9,29, 2 ,5665,1076,961,7702
9/29/2015,2015,9,29, 3 ,5504,1041,936,7481
9/29/2015,2015,9,29, 4 ,5423,1045,928,7396
9/29/2015,2015,9,29, 5 ,5588,1084,958,7630
9/29/2015,2015,9,29, 6 ,5564,1099,978,7641
9/29/2015,2015,9,29, 7 ,5756,1069,914,7739
9/29/2015,2015,9,29, 8 ,6607,1243,1070,8920
9/29/2015,2015,9,29, 9 ,7381,1455,1240,10076
9/29/2015,2015,9,29, 10 ,7925,1563,1347,10835
9/29/2015,2015,9,29, 11 ,8250,1618,1419,11287
9/29/2015,2015,9,29, 12 ,8110,1581,1391,11082
9/29/2015,2015,9,29, 13 ,8097,1606,1403,11106
9/29/2015,2015,9,29, 14 ,8387,1654,1436,11477
9/29/2015,2015,9,29, 15 ,8223,1630,1436,11289
9/29/2015,2015,9,29, 16 ,8080,1583,1398,11061
9/29/2015,2015,9,29, 17 ,7672,1516,1320,10508
9/29/2015,2015,9,29, 18 ,7837,1678,1414,10929
9/29/2015,2015,9,29, 19 ,7946,1670,1405,11021
9/29/2015,2015,9,29, 20 ,7808,1612,1367,10787
9/29/2015,2015,9,29, 21 ,7654,1528,1274,10456
9/29/2015,2015,9,29, 22 ,7250,1410,1152,9812
9/29/2015,2015,9,29, 23 ,6800,1289,1079,9168
9/29/2015,2015,9,29, 24 ,6443,1205,1055,8703
9/30/2015,2015,9,30, 1 ,6142,1163,968,8273
9/30/2015,2015,9,30, 2 ,5943,1122,938,8003
9/30/2015,2015,9,30, 3 ,5770,1080,913,7763
9/30/2015,2015,9,30, 4 ,5666,1077,902,7645
9/30/2015,2015,9,30, 5 ,5802,1102,944,7848
9/30/2015,2015,9,30, 6 ,5782,1128,973,7883
9/30/2015,2015,9,30, 7 ,5919,1083,913,7915
9/30/2015,2015,9,30, 8 ,6776,1171,1009,8956
9/30/2015,2015,9,30, 9 ,7634,1374,1154,10162
9/30/2015,2015,9,30, 10 ,8119,1491,1279,10889
9/30/2015,2015,9,30, 11 ,8403,1579,1337,11319
9/30/2015,2015,9,30, 12 ,8282,1552,1311,11145
9/30/2015,2015,9,30, 13 ,8329,1528,1330,11187
9/30/2015,2015,9,30, 14 ,8624,1569,1363,11556
9/30/2015,2015,9,30, 15 ,8353,1521,1311,11185
9/30/2015,2015,9,30, 16 ,8038,1497,1299,10834
9/30/2015,2015,9,30, 17 ,7703,1472,1269,10444
9/30/2015,2015,9,30, 18 ,7810,1620,1412,10842
9/30/2015,2015,9,30, 19 ,7882,1602,1381,10865
9/30/2015,2015,9,30, 20 ,7766,1549,1299,10614
9/30/2015,2015,9,30, 21 ,7553,1455,1246,10254
9/30/2015,2015,9,30, 22 ,7244,1332,1121,9697
9/30/2015,2015,9,30, 23 ,6640,1236,1041,8917
9/30/2015,2015,9,30, 24 ,6437,1159,965,8561
10/1/2015,2015,10,1, 1 ,6120,1108,920,8148
10/1/2015,2015,10,1, 2 ,5904,1076,891,7871
10/1/2015,2015,10,1, 3 ,5762,1050,873,7685
10/1/2015,2015,10,1, 4 ,5681,1042,870,7593
10/1/2015,2015,10,1, 5 ,5748,1065,922,7735
10/1/2015,2015,10,1, 6 ,5754,1088,958,7800
10/1/2015,2015,10,1, 7 ,5810,1069,904,7783
10/1/2015,2015,10,1, 8 ,6584,1200,1043,8827
10/1/2015,2015,10,1, 9 ,7185,1398,1185,9768
10/1/2015,2015,10,1, 10 ,7692,1487,1337,10516
10/1/2015,2015,10,1, 11 ,7951,1531,1402,10884
10/1/2015,2015,10,1, 12 ,7865,1488,1370,10723
10/1/2015,2015,10,1, 13 ,7862,1469,1381,10712
10/1/2015,2015,10,1, 14 ,8125,1505,1420,11050
10/1/2015,2015,10,1, 15 ,7865,1485,1375,10725
10/1/2015,2015,10,1, 16 ,7661,1473,1348,10482
10/1/2015,2015,10,1, 17 ,7440,1454,1335,10229
10/1/2015,2015,10,1, 18 ,7538,1602,1442,10582
10/1/2015,2015,10,1, 19 ,7486,1581,1389,10456
10/1/2015,2015,10,1, 20 ,7258,1504,1333,10095
10/1/2015,2015,10,1, 21 ,7026,1416,1273,9715
10/1/2015,2015,10,1, 22 ,6644,1315,1160,9119
10/1/2015,2015,10,1, 23 ,6292,1225,1082,8599
10/1/2015,2015,10,1, 24 ,5844,1128,982,7954
10/2/2015,2015,10,2, 1 ,5586,1086,946,7618
10/2/2015,2015,10,2, 2 ,5437,1055,911,7403
10/2/2015,2015,10,2, 3 ,5247,1032,898,7177
10/2/2015,2015,10,2, 4 ,5105,1020,879,7004
10/2/2015,2015,10,2, 5 ,5196,1059,931,7186
10/2/2015,2015,10,2, 6 ,5313,1082,951,7346
10/2/2015,2015,10,2, 7 ,5395,1060,908,7363
10/2/2015,2015,10,2, 8 ,5806,1202,1039,8047
10/2/2015,2015,10,2, 9 ,6494,1415,1205,9114
10/2/2015,2015,10,2, 10 ,6985,1524,1329,9838
10/2/2015,2015,10,2, 11 ,7252,1577,1361,10190
10/2/2015,2015,10,2, 12 ,7092,1558,1340,9990
10/2/2015,2015,10,2, 13 ,7033,1561,1393,9987
10/2/2015,2015,10,2, 14 ,7249,1628,1417,10294
10/2/2015,2015,10,2, 15 ,7034,1582,1381,9997
10/2/2015,2015,10,2, 16 ,6944,1539,1367,9850
10/2/2015,2015,10,2, 17 ,6901,1471,1301,9673
10/2/2015,2015,10,2, 18 ,7053,1621,1443,10117
10/2/2015,2015,10,2, 19 ,7015,1593,1425,10033
10/2/2015,2015,10,2, 20 ,6827,1527,1344,9698
10/2/2015,2015,10,2, 21 ,6827,1473,1296,9596
10/2/2015,2015,10,2, 22 ,6342,1367,1200,8909
10/2/2015,2015,10,2, 23 ,6032,1278,1152,8462
10/2/2015,2015,10,2, 24 ,5566,1179,942,7687
10/3/2015,2015,10,3, 1 ,5360,1118,966,7444
10/3/2015,2015,10,3, 2 ,5220,1080,924,7224
10/3/2015,2015,10,3, 3 ,5106,1047,896,7049
10/3/2015,2015,10,3, 4 ,4953,1032,886,6871
10/3/2015,2015,10,3, 5 ,5031,1045,916,6992
10/3/2015,2015,10,3, 6 ,5003,1029,886,6918
10/3/2015,2015,10,3, 7 ,5173,1052,880,7105
10/3/2015,2015,10,3, 8 ,5858,1174,992,8024
10/3/2015,2015,10,3, 9 ,6443,1338,1121,8902
10/3/2015,2015,10,3, 10 ,6951,1429,1233,9613
10/3/2015,2015,10,3, 11 ,7375,1495,1298,10168
10/3/2015,2015,10,3, 12 ,7375,1476,1324,10175
10/3/2015,2015,10,3, 13 ,7376,1464,1308,10148
10/3/2015,2015,10,3, 14 ,7630,1530,1342,10502
10/3/2015,2015,10,3, 15 ,7413,1483,1301,10197
10/3/2015,2015,10,3, 16 ,7205,1432,1255,9892
10/3/2015,2015,10,3, 17 ,6871,1378,1245,9494
10/3/2015,2015,10,3, 18 ,7247,1587,1404,10238
10/3/2015,2015,10,3, 19 ,7371,1596,1378,10345
10/3/2015,2015,10,3, 20 ,7207,1558,1358,10123
10/3/2015,2015,10,3, 21 ,7104,1495,1294,9893
10/3/2015,2015,10,3, 22 ,6875,1388,1206,9469
10/3/2015,2015,10,3, 23 ,6505,1282,1087,8874
10/3/2015,2015,10,3, 24 ,6100,1170,1020,8290
10/4/2015,2015,10,4, 1 ,5815,1133,963,7911
10/4/2015,2015,10,4, 2 ,5623,1096,931,7650
10/4/2015,2015,10,4, 3 ,5451,1067,893,7411
10/4/2015,2015,10,4, 4 ,5323,1041,876,7240
10/4/2015,2015,10,4, 5 ,5226,1034,876,7136
10/4/2015,2015,10,4, 6 ,5066,1004,875,6945
10/4/2015,2015,10,4, 7 ,5101,1010,872,6983
10/4/2015,2015,10,4, 8 ,5373,1052,915,7340
10/4/2015,2015,10,4, 9 ,5775,1129,982,7886
10/4/2015,2015,10,4, 10 ,6180,1184,1051,8415
10/4/2015,2015,10,4, 11 ,6426,1216,1105,8747
10/4/2015,2015,10,4, 12 ,6286,1213,1082,8581
10/4/2015,2015,10,4, 13 ,6195,1207,1097,8499
10/4/2015,2015,10,4, 14 ,6108,1211,1085,8404
10/4/2015,2015,10,4, 15 ,5938,1204,1072,8214
10/4/2015,2015,10,4, 16 ,5856,1189,1058,8103
10/4/2015,2015,10,4, 17 ,5822,1214,1080,8116
10/4/2015,2015,10,4, 18 ,6364,1429,1268,9061
10/4/2015,2015,10,4, 19 ,6531,1425,1243,9199
10/4/2015,2015,10,4, 20 ,6570,1399,1179,9148
10/4/2015,2015,10,4, 21 ,6384,1324,1098,8806
10/4/2015,2015,10,4, 22 ,6014,1234,1021,8269
10/4/2015,2015,10,4, 23 ,5714,1122,940,7776
10/4/2015,2015,10,4, 24 ,5367,1056,884,7307
10/5/2015,2015,10,5, 1 ,5115,1016,849,6980
10/5/2015,2015,10,5, 2 ,4966,983,827,6776
10/5/2015,2015,10,5, 3 ,4848,971,813,6632
10/5/2015,2015,10,5, 4 ,4811,964,812,6587
10/5/2015,2015,10,5, 5 ,5030,1009,871,6910
10/5/2015,2015,10,5, 6 ,5167,1041,913,7121
10/5/2015,2015,10,5, 7 ,5423,1020,870,7313
10/5/2015,2015,10,5, 8 ,6295,1169,982,8446
10/5/2015,2015,10,5, 9 ,7194,1382,1191,9767
10/5/2015,2015,10,5, 10 ,7655,1495,1287,10437
10/5/2015,2015,10,5, 11 ,8009,1535,1384,10928
10/5/2015,2015,10,5, 12 ,7857,1518,1357,10732
10/5/2015,2015,10,5, 13 ,7896,1530,1381,10807
10/5/2015,2015,10,5, 14 ,8233,1599,1437,11269
10/5/2015,2015,10,5, 15 ,7998,1552,1407,10957
10/5/2015,2015,10,5, 16 ,7792,1539,1362,10693
10/5/2015,2015,10,5, 17 ,7506,1478,1302,10286
10/5/2015,2015,10,5, 18 ,7657,1641,1419,10717
10/5/2015,2015,10,5, 19 ,7800,1629,1400,10829
10/5/2015,2015,10,5, 20 ,7634,1580,1354,10568
10/5/2015,2015,10,5, 21 ,7413,1496,1293,10202
10/5/2015,2015,10,5, 22 ,7086,1349,1179,9614
10/5/2015,2015,10,5, 23 ,6510,1234,1075,8819
10/5/2015,2015,10,5, 24 ,6193,1150,890,8233
10/6/2015,2015,10,6, 1 ,5885,1106,958,7949
10/6/2015,2015,10,6, 2 ,5682,1074,933,7689
10/6/2015,2015,10,6, 3 ,5562,1052,912,7526
10/6/2015,2015,10,6, 4 ,5453,1038,903,7394
10/6/2015,2015,10,6, 5 ,5612,1075,960,7647
10/6/2015,2015,10,6, 6 ,5653,1096,966,7715
10/6/2015,2015,10,6, 7 ,5762,1076,911,7749
10/6/2015,2015,10,6, 8 ,6493,1253,1073,8819
10/6/2015,2015,10,6, 9 ,7220,1456,1278,9954
10/6/2015,2015,10,6, 10 ,7675,1541,1371,10587
10/6/2015,2015,10,6, 11 ,7990,1582,1430,11002
10/6/2015,2015,10,6, 12 ,7904,1528,1406,10838
10/6/2015,2015,10,6, 13 ,8002,1516,1425,10943
10/6/2015,2015,10,6, 14 ,8326,1575,1478,11379
10/6/2015,2015,10,6, 15 ,8202,1549,1436,11187
10/6/2015,2015,10,6, 16 ,8058,1524,1397,10979
10/6/2015,2015,10,6, 17 ,7647,1474,1308,10429
10/6/2015,2015,10,6, 18 ,7805,1618,1450,10873
10/6/2015,2015,10,6, 19 ,7895,1600,1396,10891
10/6/2015,2015,10,6, 20 ,7760,1560,1304,10624
10/6/2015,2015,10,6, 21 ,7533,1460,1255,10248
10/6/2015,2015,10,6, 22 ,7191,1338,1146,9675
10/6/2015,2015,10,6, 23 ,6765,1224,1052,9041
10/6/2015,2015,10,6, 24 ,6311,1150,989,8450
10/7/2015,2015,10,7, 1 ,6076,1104,956,8136
10/7/2015,2015,10,7, 2 ,5819,1068,931,7818
10/7/2015,2015,10,7, 3 ,5620,1040,901,7561
10/7/2015,2015,10,7, 4 ,5585,1036,909,7530
10/7/2015,2015,10,7, 5 ,5695,1069,944,7708
10/7/2015,2015,10,7, 6 ,5755,1098,959,7812
10/7/2015,2015,10,7, 7 ,5866,1068,915,7849
10/7/2015,2015,10,7, 8 ,6733,1241,1078,9052
10/7/2015,2015,10,7, 9 ,7509,1456,1271,10236
10/7/2015,2015,10,7, 10 ,8002,1553,1377,10932
10/7/2015,2015,10,7, 11 ,8240,1575,1444,11259
10/7/2015,2015,10,7, 12 ,8084,1507,1411,11002
10/7/2015,2015,10,7, 13 ,8143,1485,1423,11051
10/7/2015,2015,10,7, 14 ,8423,1527,1452,11402
10/7/2015,2015,10,7, 15 ,8309,1509,1407,11225
10/7/2015,2015,10,7, 16 ,8137,1498,1369,11004
10/7/2015,2015,10,7, 17 ,7780,1445,1320,10545
10/7/2015,2015,10,7, 18 ,7897,1611,1429,10937
10/7/2015,2015,10,7, 19 ,7976,1594,1372,10942
10/7/2015,2015,10,7, 20 ,7786,1536,1315,10637
10/7/2015,2015,10,7, 21 ,7623,1445,1248,10316
10/7/2015,2015,10,7, 22 ,7205,1318,1128,9651
10/7/2015,2015,10,7, 23 ,6813,1210,1056,9079
10/7/2015,2015,10,7, 24 ,6412,1135,965,8512
10/8/2015,2015,10,8, 1 ,6112,1090,940,8142
10/8/2015,2015,10,8, 2 ,5923,1057,912,7892
10/8/2015,2015,10,8, 3 ,5737,1036,880,7653
10/8/2015,2015,10,8, 4 ,5641,1028,876,7545
10/8/2015,2015,10,8, 5 ,5747,1062,923,7732
10/8/2015,2015,10,8, 6 ,5768,1089,955,7812
10/8/2015,2015,10,8, 7 ,6050,1059,898,8007
10/8/2015,2015,10,8, 8 ,6784,1227,1021,9032
10/8/2015,2015,10,8, 9 ,7546,1440,1220,10206
10/8/2015,2015,10,8, 10 ,8039,1547,1335,10921
10/8/2015,2015,10,8, 11 ,8309,1605,1392,11306
10/8/2015,2015,10,8, 12 ,8192,1560,1378,11130
10/8/2015,2015,10,8, 13 ,8213,1544,1379,11136
10/8/2015,2015,10,8, 14 ,8527,1623,1413,11563
10/8/2015,2015,10,8, 15 ,8311,1610,1377,11298
10/8/2015,2015,10,8, 16 ,8112,1576,1339,11027
10/8/2015,2015,10,8, 17 ,7799,1498,1322,10619
10/8/2015,2015,10,8, 18 ,7986,1662,1417,11065
10/8/2015,2015,10,8, 19 ,8031,1658,1381,11070
10/8/2015,2015,10,8, 20 ,7892,1605,1328,10825
10/8/2015,2015,10,8, 21 ,7719,1518,1273,10510
10/8/2015,2015,10,8, 22 ,7386,1385,1169,9940
10/8/2015,2015,10,8, 23 ,6851,1264,1073,9188
10/8/2015,2015,10,8, 24 ,6422,1182,986,8590
10/9/2015,2015,10,9, 1 ,6086,1119,955,8160
10/9/2015,2015,10,9, 2 ,5934,1083,922,7939
10/9/2015,2015,10,9, 3 ,5686,1051,906,7643
10/9/2015,2015,10,9, 4 ,5669,1041,900,7610
10/9/2015,2015,10,9, 5 ,5763,1070,946,7779
10/9/2015,2015,10,9, 6 ,5791,1090,972,7853
10/9/2015,2015,10,9, 7 ,5888,1073,902,7863
10/9/2015,2015,10,9, 8 ,6762,1254,1058,9074
10/9/2015,2015,10,9, 9 ,7640,1477,1247,10364
10/9/2015,2015,10,9, 10 ,8033,1564,1350,10947
10/9/2015,2015,10,9, 11 ,8306,1626,1419,11351
10/9/2015,2015,10,9, 12 ,8212,1578,1393,11183
10/9/2015,2015,10,9, 13 ,8234,1596,1406,11236
10/9/2015,2015,10,9, 14 ,8559,1661,1449,11669
10/9/2015,2015,10,9, 15 ,8371,1630,1395,11396
10/9/2015,2015,10,9, 16 ,8120,1591,1368,11079
10/9/2015,2015,10,9, 17 ,7796,1513,1324,10633
10/9/2015,2015,10,9, 18 ,7933,1661,1460,11054
10/9/2015,2015,10,9, 19 ,7984,1653,1404,11041
10/9/2015,2015,10,9, 20 ,7828,1583,1314,10725
10/9/2015,2015,10,9, 21 ,7679,1510,1255,10444
10/9/2015,2015,10,9, 22 ,7377,1396,1141,9914
10/9/2015,2015,10,9, 23 ,6977,1293,1078,9348
10/9/2015,2015,10,9, 24 ,6599,1211,962,8772
10/10/2015,2015,10,10, 1 ,6230,1146,940,8316
10/10/2015,2015,10,10, 2 ,6083,1113,912,8108
10/10/2015,2015,10,10, 3 ,5915,1081,907,7903
10/10/2015,2015,10,10, 4 ,5725,1064,891,7680
10/10/2015,2015,10,10, 5 ,5700,1071,922,7693
10/10/2015,2015,10,10, 6 ,5609,1061,927,7597
10/10/2015,2015,10,10, 7 ,5691,1076,912,7679
10/10/2015,2015,10,10, 8 ,6336,1218,1007,8561
10/10/2015,2015,10,10, 9 ,6921,1378,1084,9383
10/10/2015,2015,10,10, 10 ,7424,1467,1208,10099
10/10/2015,2015,10,10, 11 ,7698,1519,1263,10480
10/10/2015,2015,10,10, 12 ,7700,1483,1238,10421
10/10/2015,2015,10,10, 13 ,7647,1495,1239,10381
10/10/2015,2015,10,10, 14 ,7874,1540,1301,10715
10/10/2015,2015,10,10, 15 ,7703,1495,1270,10468
10/10/2015,2015,10,10, 16 ,7460,1435,1233,10128
10/10/2015,2015,10,10, 17 ,7130,1396,1227,9753
10/10/2015,2015,10,10, 18 ,7421,1574,1412,10407
10/10/2015,2015,10,10, 19 ,7579,1572,1377,10528
10/10/2015,2015,10,10, 20 ,7512,1519,1341,10372
10/10/2015,2015,10,10, 21 ,7468,1459,1280,10207
10/10/2015,2015,10,10, 22 ,7267,1357,1185,9809
10/10/2015,2015,10,10, 23 ,6837,1258,1086,9181
10/10/2015,2015,10,10, 24 ,6471,1151,1003,8625
10/11/2015,2015,10,11, 1 ,6167,1098,973,8238
10/11/2015,2015,10,11, 2 ,5990,1061,943,7994
10/11/2015,2015,10,11, 3 ,5757,1055,918,7730
10/11/2015,2015,10,11, 4 ,5610,1039,902,7551
10/11/2015,2015,10,11, 5 ,5512,1031,913,7456
10/11/2015,2015,10,11, 6 ,5291,1002,859,7152
10/11/2015,2015,10,11, 7 ,5227,1016,892,7135
10/11/2015,2015,10,11, 8 ,5458,1064,915,7437
10/11/2015,2015,10,11, 9 ,5885,1162,968,8015
10/11/2015,2015,10,11, 10 ,6349,1225,1011,8585
10/11/2015,2015,10,11, 11 ,6596,1272,1059,8927
10/11/2015,2015,10,11, 12 ,6628,1265,1079,8972
10/11/2015,2015,10,11, 13 ,6657,1271,1101,9029
10/11/2015,2015,10,11, 14 ,6617,1289,1119,9025
10/11/2015,2015,10,11, 15 ,6554,1258,1111,8923
10/11/2015,2015,10,11, 16 ,6314,1223,1083,8620
10/11/2015,2015,10,11, 17 ,6265,1235,1124,8624
10/11/2015,2015,10,11, 18 ,6830,1470,1318,9618
10/11/2015,2015,10,11, 19 ,6964,1512,1323,9799
10/11/2015,2015,10,11, 20 ,7094,1474,1301,9869
10/11/2015,2015,10,11, 21 ,6995,1390,1237,9622
10/11/2015,2015,10,11, 22 ,6764,1294,1123,9181
10/11/2015,2015,10,11, 23 ,6407,1189,1044,8640
10/11/2015,2015,10,11, 24 ,5999,1114,971,8084
10/12/2015,2015,10,12, 1 ,5788,1065,932,7785
10/12/2015,2015,10,12, 2 ,5519,1028,901,7448
10/12/2015,2015,10,12, 3 ,5377,1005,877,7259
10/12/2015,2015,10,12, 4 ,5287,995,875,7157
10/12/2015,2015,10,12, 5 ,5429,1037,927,7393
10/12/2015,2015,10,12, 6 ,5535,1053,947,7535
10/12/2015,2015,10,12, 7 ,5716,1036,894,7646
10/12/2015,2015,10,12, 8 ,6645,1219,1049,8913
10/12/2015,2015,10,12, 9 ,7465,1441,1211,10117
10/12/2015,2015,10,12, 10 ,7946,1553,1349,10848
10/12/2015,2015,10,12, 11 ,8299,1566,1413,11278
10/12/2015,2015,10,12, 12 ,8127,1527,1380,11034
10/12/2015,2015,10,12, 13 ,8145,1582,1382,11109
10/12/2015,2015,10,12, 14 ,8526,1613,1441,11580
10/12/2015,2015,10,12, 15 ,8234,1604,1403,11241
10/12/2015,2015,10,12, 16 ,8012,1579,1325,10916
10/12/2015,2015,10,12, 17 ,7687,1504,1296,10487
10/12/2015,2015,10,12, 18 ,7917,1654,1444,11015
10/12/2015,2015,10,12, 19 ,7906,1640,1406,10952
10/12/2015,2015,10,12, 20 ,7765,1584,1342,10691
10/12/2015,2015,10,12, 21 ,7609,1515,1293,10417
10/12/2015,2015,10,12, 22 ,7231,1389,1190,9810
10/12/2015,2015,10,12, 23 ,6781,1269,1108,9158
10/12/2015,2015,10,12, 24 ,6410,1174,980,8564
10/13/2015,2015,10,13, 1 ,6041,1121,994,8156
10/13/2015,2015,10,13, 2 ,5894,1082,958,7934
10/13/2015,2015,10,13, 3 ,5697,1055,920,7672
10/13/2015,2015,10,13, 4 ,5642,1042,919,7603
10/13/2015,2015,10,13, 5 ,5718,1076,980,7774
10/13/2015,2015,10,13, 6 ,5763,1100,998,7861
10/13/2015,2015,10,13, 7 ,5868,1073,928,7869
10/13/2015,2015,10,13, 8 ,6692,1260,1101,9053
10/13/2015,2015,10,13, 9 ,7486,1449,1282,10217
10/13/2015,2015,10,13, 10 ,7961,1563,1379,10903
10/13/2015,2015,10,13, 11 ,8251,1607,1436,11294
10/13/2015,2015,10,13, 12 ,8060,1548,1409,11017
10/13/2015,2015,10,13, 13 ,8090,1543,1431,11064
10/13/2015,2015,10,13, 14 ,8343,1614,1472,11429
10/13/2015,2015,10,13, 15 ,8140,1575,1444,11159
10/13/2015,2015,10,13, 16 ,7989,1540,1419,10948
10/13/2015,2015,10,13, 17 ,7673,1478,1381,10532
10/13/2015,2015,10,13, 18 ,7925,1632,1485,11042
10/13/2015,2015,10,13, 19 ,7862,1610,1437,10909
10/13/2015,2015,10,13, 20 ,7658,1564,1374,10596
10/13/2015,2015,10,13, 21 ,7495,1472,1319,10286
10/13/2015,2015,10,13, 22 ,7149,1343,1211,9703
10/13/2015,2015,10,13, 23 ,6713,1237,1103,9053
10/13/2015,2015,10,13, 24 ,6290,1155,1090,8535
10/14/2015,2015,10,14, 1 ,5981,1108,990,8079
10/14/2015,2015,10,14, 2 ,5815,1076,955,7846
10/14/2015,2015,10,14, 3 ,5675,1053,934,7662
10/14/2015,2015,10,14, 4 ,5599,1033,932,7564
10/14/2015,2015,10,14, 5 ,5759,1075,991,7825
10/14/2015,2015,10,14, 6 ,5779,1087,992,7858
10/14/2015,2015,10,14, 7 ,5877,1055,935,7867
10/14/2015,2015,10,14, 8 ,6729,1219,1083,9031
10/14/2015,2015,10,14, 9 ,7414,1446,1259,10119
10/14/2015,2015,10,14, 10 ,7912,1515,1359,10786
10/14/2015,2015,10,14, 11 ,8108,1586,1434,11128
10/14/2015,2015,10,14, 12 ,7858,1517,1392,10767
10/14/2015,2015,10,14, 13 ,7793,1537,1403,10733
10/14/2015,2015,10,14, 14 ,8079,1623,1442,11144
10/14/2015,2015,10,14, 15 ,7888,1603,1398,10889
10/14/2015,2015,10,14, 16 ,7750,1568,1377,10695
10/14/2015,2015,10,14, 17 ,7507,1522,1348,10377
10/14/2015,2015,10,14, 18 ,7767,1682,1503,10952
10/14/2015,2015,10,14, 19 ,7715,1650,1444,10809
10/14/2015,2015,10,14, 20 ,7527,1594,1405,10526
10/14/2015,2015,10,14, 21 ,7283,1503,1349,10135
10/14/2015,2015,10,14, 22 ,6918,1368,1236,9522
10/14/2015,2015,10,14, 23 ,6512,1255,1150,8917
10/14/2015,2015,10,14, 24 ,6077,1165,1060,8302
10/15/2015,2015,10,15, 1 ,5844,1124,1016,7984
10/15/2015,2015,10,15, 2 ,5672,1078,987,7737
10/15/2015,2015,10,15, 3 ,5516,1051,963,7530
10/15/2015,2015,10,15, 4 ,5503,1051,955,7509
10/15/2015,2015,10,15, 5 ,5586,1083,1004,7673
10/15/2015,2015,10,15, 6 ,5684,1103,1025,7812
10/15/2015,2015,10,15, 7 ,5782,1079,963,7824
10/15/2015,2015,10,15, 8 ,6553,1240,1113,8906
10/15/2015,2015,10,15, 9 ,7311,1441,1262,10014
10/15/2015,2015,10,15, 10 ,7801,1549,1361,10711
10/15/2015,2015,10,15, 11 ,8074,1583,1424,11081
10/15/2015,2015,10,15, 12 ,7937,1521,1380,10838
10/15/2015,2015,10,15, 13 ,7947,1521,1362,10830
10/15/2015,2015,10,15, 14 ,8200,1589,1416,11205
10/15/2015,2015,10,15, 15 ,8080,1542,1392,11014
10/15/2015,2015,10,15, 16 ,7910,1501,1366,10777
10/15/2015,2015,10,15, 17 ,7578,1480,1344,10402
10/15/2015,2015,10,15, 18 ,7841,1617,1503,10961
10/15/2015,2015,10,15, 19 ,7792,1588,1446,10826
10/15/2015,2015,10,15, 20 ,7597,1531,1407,10535
10/15/2015,2015,10,15, 21 ,7423,1456,1318,10197
10/15/2015,2015,10,15, 22 ,7073,1326,1187,9586
10/15/2015,2015,10,15, 23 ,6671,1222,1094,8987
10/15/2015,2015,10,15, 24 ,6305,1147,1078,8530
10/16/2015,2015,10,16, 1 ,6032,1110,980,8122
10/16/2015,2015,10,16, 2 ,5822,1083,968,7873
10/16/2015,2015,10,16, 3 ,5615,1045,943,7603
10/16/2015,2015,10,16, 4 ,5559,1043,938,7540
10/16/2015,2015,10,16, 5 ,5676,1076,978,7730
10/16/2015,2015,10,16, 6 ,5711,1104,1004,7819
10/16/2015,2015,10,16, 7 ,5790,1073,959,7822
10/16/2015,2015,10,16, 8 ,6533,1229,1105,8867
10/16/2015,2015,10,16, 9 ,7214,1404,1289,9907
10/16/2015,2015,10,16, 10 ,7641,1498,1384,10523
10/16/2015,2015,10,16, 11 ,7966,1561,1409,10936
10/16/2015,2015,10,16, 12 ,7846,1510,1370,10726
10/16/2015,2015,10,16, 13 ,7805,1521,1356,10682
10/16/2015,2015,10,16, 14 ,8106,1589,1378,11073
10/16/2015,2015,10,16, 15 ,7873,1562,1373,10808
10/16/2015,2015,10,16, 16 ,7686,1534,1344,10564
10/16/2015,2015,10,16, 17 ,7482,1494,1329,10305
10/16/2015,2015,10,16, 18 ,7724,1657,1474,10855
10/16/2015,2015,10,16, 19 ,7622,1623,1411,10656
10/16/2015,2015,10,16, 20 ,7419,1564,1363,10346
10/16/2015,2015,10,16, 21 ,7259,1491,1295,10045
10/16/2015,2015,10,16, 22 ,6952,1375,1186,9513
10/16/2015,2015,10,16, 23 ,6569,1269,1108,8946
10/16/2015,2015,10,16, 24 ,6278,1196,1071,8545
10/17/2015,2015,10,17, 1 ,6005,1148,986,8139
10/17/2015,2015,10,17, 2 ,5857,1113,951,7921
10/17/2015,2015,10,17, 3 ,5704,1081,930,7715
10/17/2015,2015,10,17, 4 ,5593,1074,904,7571
10/17/2015,2015,10,17, 5 ,5613,1079,925,7617
10/17/2015,2015,10,17, 6 ,5564,1080,935,7579
10/17/2015,2015,10,17, 7 ,5734,1075,942,7751
10/17/2015,2015,10,17, 8 ,6211,1189,999,8399
10/17/2015,2015,10,17, 9 ,6635,1328,1126,9089
10/17/2015,2015,10,17, 10 ,7070,1405,1207,9682
10/17/2015,2015,10,17, 11 ,7266,1457,1280,10003
10/17/2015,2015,10,17, 12 ,7138,1429,1275,9842
10/17/2015,2015,10,17, 13 ,6980,1414,1272,9666
10/17/2015,2015,10,17, 14 ,7119,1455,1307,9881
10/17/2015,2015,10,17, 15 ,6907,1416,1280,9603
10/17/2015,2015,10,17, 16 ,6777,1373,1235,9385
10/17/2015,2015,10,17, 17 ,6723,1352,1262,9337
10/17/2015,2015,10,17, 18 ,7101,1558,1387,10046
10/17/2015,2015,10,17, 19 ,6996,1539,1360,9895
10/17/2015,2015,10,17, 20 ,6844,1499,1358,9701
10/17/2015,2015,10,17, 21 ,6695,1438,1311,9444
10/17/2015,2015,10,17, 22 ,6387,1327,1233,8947
10/17/2015,2015,10,17, 23 ,5960,1254,1139,8353
10/17/2015,2015,10,17, 24 ,5608,1124,1068,7800
10/18/2015,2015,10,18, 1 ,5271,1128,1025,7424
10/18/2015,2015,10,18, 2 ,5040,1098,987,7125
10/18/2015,2015,10,18, 3 ,4880,1066,958,6904
10/18/2015,2015,10,18, 4 ,4760,1046,937,6743
10/18/2015,2015,10,18, 5 ,4556,1048,943,6547
10/18/2015,2015,10,18, 6 ,4514,1031,932,6477
10/18/2015,2015,10,18, 7 ,4427,1023,913,6363
10/18/2015,2015,10,18, 8 ,4670,1076,926,6672
10/18/2015,2015,10,18, 9 ,4834,1154,1003,6991
10/18/2015,2015,10,18, 10 ,5089,1216,1065,7370
10/18/2015,2015,10,18, 11 ,5235,1254,1131,7620
10/18/2015,2015,10,18, 12 ,5063,1262,1122,7447
10/18/2015,2015,10,18, 13 ,5062,1267,1131,7460
10/18/2015,2015,10,18, 14 ,4972,1240,1113,7325
10/18/2015,2015,10,18, 15 ,4987,1229,1100,7316
10/18/2015,2015,10,18, 16 ,4925,1207,1106,7238
10/18/2015,2015,10,18, 17 ,5104,1211,1156,7471
10/18/2015,2015,10,18, 18 ,5630,1451,1350,8431
10/18/2015,2015,10,18, 19 ,5774,1461,1313,8548
10/18/2015,2015,10,18, 20 ,5751,1430,1272,8453
10/18/2015,2015,10,18, 21 ,5585,1370,1225,8180
10/18/2015,2015,10,18, 22 ,5357,1289,1153,7799
10/18/2015,2015,10,18, 23 ,5062,1215,1023,7300
10/18/2015,2015,10,18, 24 ,4883,1158,990,7031
10/19/2015,2015,10,19, 1 ,4630,1110,947,6687
10/19/2015,2015,10,19, 2 ,4395,1084,914,6393
10/19/2015,2015,10,19, 3 ,4401,1055,889,6345
10/19/2015,2015,10,19, 4 ,4359,1047,897,6303
10/19/2015,2015,10,19, 5 ,4422,1092,936,6450
10/19/2015,2015,10,19, 6 ,4588,1121,966,6675
10/19/2015,2015,10,19, 7 ,5035,1092,913,7040
10/19/2015,2015,10,19, 8 ,5567,1254,1053,7874
10/19/2015,2015,10,19, 9 ,6322,1462,1225,9009
10/19/2015,2015,10,19, 10 ,6732,1551,1339,9622
10/19/2015,2015,10,19, 11 ,7094,1585,1391,10070
10/19/2015,2015,10,19, 12 ,6982,1546,1373,9901
10/19/2015,2015,10,19, 13 ,6937,1527,1374,9838
10/19/2015,2015,10,19, 14 ,7153,1613,1416,10182
10/19/2015,2015,10,19, 15 ,6953,1588,1380,9921
10/19/2015,2015,10,19, 16 ,6826,1544,1370,9740
10/19/2015,2015,10,19, 17 ,6707,1491,1365,9563
10/19/2015,2015,10,19, 18 ,6971,1657,1467,10095
10/19/2015,2015,10,19, 19 ,6829,1614,1435,9878
10/19/2015,2015,10,19, 20 ,6662,1561,1392,9615
10/19/2015,2015,10,19, 21 ,6350,1456,1326,9132
10/19/2015,2015,10,19, 22 ,6075,1342,1205,8622
10/19/2015,2015,10,19, 23 ,5690,1252,1112,8054
10/19/2015,2015,10,19, 24 ,5317,1180,1005,7502
10/20/2015,2015,10,20, 1 ,5125,1146,1004,7275
10/20/2015,2015,10,20, 2 ,4942,1112,974,7028
10/20/2015,2015,10,20, 3 ,4845,1083,947,6875
10/20/2015,2015,10,20, 4 ,4802,1070,937,6809
10/20/2015,2015,10,20, 5 ,4979,1095,984,7058
10/20/2015,2015,10,20, 6 ,5108,1123,1001,7232
10/20/2015,2015,10,20, 7 ,5304,1096,945,7345
10/20/2015,2015,10,20, 8 ,6069,1249,1083,8401
10/20/2015,2015,10,20, 9 ,6763,1472,1234,9469
10/20/2015,2015,10,20, 10 ,7313,1562,1355,10230
10/20/2015,2015,10,20, 11 ,7551,1581,1417,10549
10/20/2015,2015,10,20, 12 ,7421,1555,1388,10364
10/20/2015,2015,10,20, 13 ,7393,1524,1349,10266
10/20/2015,2015,10,20, 14 ,7671,1614,1450,10735
10/20/2015,2015,10,20, 15 ,7555,1597,1433,10585
10/20/2015,2015,10,20, 16 ,7396,1580,1397,10373
10/20/2015,2015,10,20, 17 ,7138,1514,1367,10019
10/20/2015,2015,10,20, 18 ,7308,1679,1465,10452
10/20/2015,2015,10,20, 19 ,7187,1663,1427,10277
10/20/2015,2015,10,20, 20 ,7003,1603,1393,9999
10/20/2015,2015,10,20, 21 ,6726,1529,1336,9591
10/20/2015,2015,10,20, 22 ,6498,1401,1244,9143
10/20/2015,2015,10,20, 23 ,6078,1297,1150,8525
10/20/2015,2015,10,20, 24 ,5701,1214,1050,7965
10/21/2015,2015,10,21, 1 ,5499,1171,1009,7679
10/21/2015,2015,10,21, 2 ,5323,1135,980,7438
10/21/2015,2015,10,21, 3 ,5135,1113,953,7201
10/21/2015,2015,10,21, 4 ,5105,1099,940,7144
10/21/2015,2015,10,21, 5 ,5299,1131,1009,7439
10/21/2015,2015,10,21, 6 ,5361,1138,1022,7521
10/21/2015,2015,10,21, 7 ,5493,1112,948,7553
10/21/2015,2015,10,21, 8 ,6241,1277,1089,8607
10/21/2015,2015,10,21, 9 ,6880,1495,1276,9651
10/21/2015,2015,10,21, 10 ,7389,1591,1373,10353
10/21/2015,2015,10,21, 11 ,7633,1652,1428,10713
10/21/2015,2015,10,21, 12 ,7502,1607,1338,10447
10/21/2015,2015,10,21, 13 ,7490,1598,1365,10453
10/21/2015,2015,10,21, 14 ,7790,1672,1457,10919
10/21/2015,2015,10,21, 15 ,7643,1640,1441,10724
10/21/2015,2015,10,21, 16 ,7477,1603,1413,10493
10/21/2015,2015,10,21, 17 ,7153,1530,1385,10068
10/21/2015,2015,10,21, 18 ,7380,1699,1502,10581
10/21/2015,2015,10,21, 19 ,7292,1670,1466,10428
10/21/2015,2015,10,21, 20 ,7137,1626,1439,10202
10/21/2015,2015,10,21, 21 ,6881,1541,1377,9799
10/21/2015,2015,10,21, 22 ,6669,1416,1240,9325
10/21/2015,2015,10,21, 23 ,6284,1302,1137,8723
10/21/2015,2015,10,21, 24 ,5794,1236,1069,8099
10/22/2015,2015,10,22, 1 ,5566,1182,1018,7766
10/22/2015,2015,10,22, 2 ,5399,1137,979,7515
10/22/2015,2015,10,22, 3 ,5293,1111,950,7354
10/22/2015,2015,10,22, 4 ,5190,1092,943,7225
10/22/2015,2015,10,22, 5 ,5377,1116,988,7481
10/22/2015,2015,10,22, 6 ,5444,1126,997,7567
10/22/2015,2015,10,22, 7 ,5579,1102,941,7622
10/22/2015,2015,10,22, 8 ,6341,1274,1086,8701
10/22/2015,2015,10,22, 9 ,7114,1468,1252,9834
10/22/2015,2015,10,22, 10 ,7410,1532,1326,10268
10/22/2015,2015,10,22, 11 ,7791,1544,1407,10742
10/22/2015,2015,10,22, 12 ,7652,1513,1369,10534
10/22/2015,2015,10,22, 13 ,7718,1518,1382,10618
10/22/2015,2015,10,22, 14 ,8006,1645,1420,11071
10/22/2015,2015,10,22, 15 ,7836,1647,1358,10841
10/22/2015,2015,10,22, 16 ,7666,1598,1334,10598
10/22/2015,2015,10,22, 17 ,7292,1523,1290,10105
10/22/2015,2015,10,22, 18 ,7578,1698,1482,10758
10/22/2015,2015,10,22, 19 ,7515,1655,1442,10612
10/22/2015,2015,10,22, 20 ,7292,1609,1380,10281
10/22/2015,2015,10,22, 21 ,7048,1531,1323,9902
10/22/2015,2015,10,22, 22 ,6745,1410,1214,9369
10/22/2015,2015,10,22, 23 ,6379,1261,1132,8772
10/22/2015,2015,10,22, 24 ,6029,1219,1126,8374
10/23/2015,2015,10,23, 1 ,5731,1163,1016,7910
10/23/2015,2015,10,23, 2 ,5571,1144,983,7698
10/23/2015,2015,10,23, 3 ,5428,1111,960,7499
10/23/2015,2015,10,23, 4 ,5352,1102,959,7413
10/23/2015,2015,10,23, 5 ,5445,1125,994,7564
10/23/2015,2015,10,23, 6 ,5474,1129,996,7599
10/23/2015,2015,10,23, 7 ,5650,1113,958,7721
10/23/2015,2015,10,23, 8 ,6390,1270,1070,8730
10/23/2015,2015,10,23, 9 ,7160,1455,1249,9864
10/23/2015,2015,10,23, 10 ,7622,1573,1306,10501
10/23/2015,2015,10,23, 11 ,7932,1627,1293,10852
10/23/2015,2015,10,23, 12 ,7800,1589,1239,10628
10/23/2015,2015,10,23, 13 ,7764,1618,1360,10742
10/23/2015,2015,10,23, 14 ,8125,1669,1407,11201
10/23/2015,2015,10,23, 15 ,7946,1633,1360,10939
10/23/2015,2015,10,23, 16 ,7792,1586,1357,10735
10/23/2015,2015,10,23, 17 ,7471,1526,1334,10331
10/23/2015,2015,10,23, 18 ,7708,1668,1467,10843
10/23/2015,2015,10,23, 19 ,7620,1639,1432,10691
10/23/2015,2015,10,23, 20 ,7381,1587,1419,10387
10/23/2015,2015,10,23, 21 ,7235,1510,1333,10078
10/23/2015,2015,10,23, 22 ,6949,1393,1232,9574
10/23/2015,2015,10,23, 23 ,6571,1294,1145,9010
10/23/2015,2015,10,23, 24 ,6155,1216,1080,8451
10/24/2015,2015,10,24, 1 ,5911,1166,1006,8083
10/24/2015,2015,10,24, 2 ,5688,1135,954,7777
10/24/2015,2015,10,24, 3 ,5520,1104,948,7572
10/24/2015,2015,10,24, 4 ,5367,1084,933,7384
10/24/2015,2015,10,24, 5 ,5397,1097,945,7439
10/24/2015,2015,10,24, 6 ,5288,1081,944,7313
10/24/2015,2015,10,24, 7 ,5475,1077,920,7472
10/24/2015,2015,10,24, 8 ,5991,1195,1012,8198
10/24/2015,2015,10,24, 9 ,6577,1376,1137,9090
10/24/2015,2015,10,24, 10 ,7105,1478,1242,9825
10/24/2015,2015,10,24, 11 ,7432,1547,1303,10282
10/24/2015,2015,10,24, 12 ,7398,1523,1286,10207
10/24/2015,2015,10,24, 13 ,7392,1470,1304,10166
10/24/2015,2015,10,24, 14 ,7535,1565,1349,10449
10/24/2015,2015,10,24, 15 ,7348,1516,1287,10151
10/24/2015,2015,10,24, 16 ,7090,1465,1262,9817
10/24/2015,2015,10,24, 17 ,6785,1418,1272,9475
10/24/2015,2015,10,24, 18 ,7277,1637,1409,10323
10/24/2015,2015,10,24, 19 ,7255,1611,1389,10255
10/24/2015,2015,10,24, 20 ,7194,1570,1339,10103
10/24/2015,2015,10,24, 21 ,7086,1503,1301,9890
10/24/2015,2015,10,24, 22 ,6810,1404,1199,9413
10/24/2015,2015,10,24, 23 ,6511,1308,1120,8939
10/24/2015,2015,10,24, 24 ,6117,1230,1053,8400
10/25/2015,2015,10,25, 1 ,5857,1171,1019,8047
10/25/2015,2015,10,25, 2 ,5638,1130,955,7723
10/25/2015,2015,10,25, 3 ,5475,1092,924,7491
10/25/2015,2015,10,25, 4 ,5328,1074,907,7309
10/25/2015,2015,10,25, 5 ,5233,1068,916,7217
10/25/2015,2015,10,25, 6 ,5019,1036,905,6960
10/25/2015,2015,10,25, 7 ,5041,1040,899,6980
10/25/2015,2015,10,25, 8 ,5417,1110,929,7456
10/25/2015,2015,10,25, 9 ,5809,1197,1007,8013
10/25/2015,2015,10,25, 10 ,6314,1276,1092,8682
10/25/2015,2015,10,25, 11 ,6536,1320,1154,9010
10/25/2015,2015,10,25, 12 ,6512,1333,1182,9027
10/25/2015,2015,10,25, 13 ,6539,1346,1191,9076
10/25/2015,2015,10,25, 14 ,6599,1355,1192,9146
10/25/2015,2015,10,25, 15 ,6495,1336,1174,9005
10/25/2015,2015,10,25, 16 ,6396,1309,1154,8859
10/25/2015,2015,10,25, 17 ,6303,1290,1155,8748
10/25/2015,2015,10,25, 18 ,6933,1537,1301,9771
10/25/2015,2015,10,25, 19 ,7039,1526,1355,9920
10/25/2015,2015,10,25, 20 ,7092,1481,1273,9846
10/25/2015,2015,10,25, 21 ,6993,1415,1226,9634
10/25/2015,2015,10,25, 22 ,6669,1326,1144,9139
10/25/2015,2015,10,25, 23 ,6282,1243,1053,8578
10/25/2015,2015,10,25, 24 ,5977,1165,996,8138
10/26/2015,2015,10,26, 1 ,5692,1114,944,7750
10/26/2015,2015,10,26, 2 ,5420,1066,906,7392
10/26/2015,2015,10,26, 3 ,5325,1040,875,7240
10/26/2015,2015,10,26, 4 ,5216,1019,863,7098
10/26/2015,2015,10,26, 5 ,5289,1038,883,7210
10/26/2015,2015,10,26, 6 ,5285,1044,909,7238
10/26/2015,2015,10,26, 7 ,5596,1069,917,7582
10/26/2015,2015,10,26, 8 ,6587,1260,1057,8904
10/26/2015,2015,10,26, 9 ,7362,1485,1253,10100
10/26/2015,2015,10,26, 10 ,7908,1597,1352,10857
10/26/2015,2015,10,26, 11 ,8237,1659,1369,11265
10/26/2015,2015,10,26, 12 ,8173,1608,1342,11123
10/26/2015,2015,10,26, 13 ,8171,1598,1373,11142
10/26/2015,2015,10,26, 14 ,8479,1665,1426,11570
10/26/2015,2015,10,26, 15 ,8259,1644,1397,11300
10/26/2015,2015,10,26, 16 ,8091,1611,1390,11092
10/26/2015,2015,10,26, 17 ,7825,1515,1332,10672
10/26/2015,2015,10,26, 18 ,8061,1683,1436,11180
10/26/2015,2015,10,26, 19 ,7848,1654,1415,10917
10/26/2015,2015,10,26, 20 ,7738,1598,1363,10699
10/26/2015,2015,10,26, 21 ,7458,1527,1307,10292
10/26/2015,2015,10,26, 22 ,7240,1388,1212,9840
10/26/2015,2015,10,26, 23 ,6810,1276,1118,9204
10/26/2015,2015,10,26, 24 ,6398,1199,1022,8619
10/27/2015,2015,10,27, 1 ,6072,1138,998,8208
10/27/2015,2015,10,27, 2 ,5952,1101,964,8017
10/27/2015,2015,10,27, 3 ,5784,1083,937,7804
10/27/2015,2015,10,27, 4 ,5604,1066,918,7588
10/27/2015,2015,10,27, 5 ,5652,1076,945,7673
10/27/2015,2015,10,27, 6 ,5683,1080,949,7712
10/27/2015,2015,10,27, 7 ,5939,1115,959,8013
10/27/2015,2015,10,27, 8 ,6710,1284,1066,9060
10/27/2015,2015,10,27, 9 ,7356,1471,1267,10094
10/27/2015,2015,10,27, 10 ,7913,1585,1372,10870
10/27/2015,2015,10,27, 11 ,8241,1666,1307,11214
10/27/2015,2015,10,27, 12 ,8159,1623,1346,11128
10/27/2015,2015,10,27, 13 ,8180,1629,1399,11208
10/27/2015,2015,10,27, 14 ,8407,1699,1447,11553
10/27/2015,2015,10,27, 15 ,8236,1668,1419,11323
10/27/2015,2015,10,27, 16 ,8084,1618,1385,11087
10/27/2015,2015,10,27, 17 ,7737,1545,1339,10621
10/27/2015,2015,10,27, 18 ,7918,1717,1462,11097
10/27/2015,2015,10,27, 19 ,7842,1679,1422,10943
10/27/2015,2015,10,27, 20 ,7598,1615,1394,10607
10/27/2015,2015,10,27, 21 ,7432,1527,1334,10293
10/27/2015,2015,10,27, 22 ,7123,1410,1247,9780
10/27/2015,2015,10,27, 23 ,6661,1307,1134,9102
10/27/2015,2015,10,27, 24 ,6248,1222,1067,8537
10/28/2015,2015,10,28, 1 ,6013,1181,1027,8221
10/28/2015,2015,10,28, 2 ,5813,1141,985,7939
10/28/2015,2015,10,28, 3 ,5623,1112,952,7687
10/28/2015,2015,10,28, 4 ,5535,1094,955,7584
10/28/2015,2015,10,28, 5 ,5552,1107,978,7637
10/28/2015,2015,10,28, 6 ,5532,1097,976,7605
10/28/2015,2015,10,28, 7 ,5781,1122,975,7878
10/28/2015,2015,10,28, 8 ,6587,1295,1065,8947
10/28/2015,2015,10,28, 9 ,7315,1487,1300,10102
10/28/2015,2015,10,28, 10 ,7817,1592,1381,10790
10/28/2015,2015,10,28, 11 ,8069,1658,1413,11140
10/28/2015,2015,10,28, 12 ,7923,1620,1339,10882
10/28/2015,2015,10,28, 13 ,7901,1605,1397,10903
10/28/2015,2015,10,28, 14 ,8178,1692,1397,11267
10/28/2015,2015,10,28, 15 ,7996,1658,1362,11016
10/28/2015,2015,10,28, 16 ,7806,1620,1351,10777
10/28/2015,2015,10,28, 17 ,7400,1543,1329,10272
10/28/2015,2015,10,28, 18 ,7718,1705,1457,10880
10/28/2015,2015,10,28, 19 ,7609,1660,1411,10680
10/28/2015,2015,10,28, 20 ,7410,1607,1371,10388
10/28/2015,2015,10,28, 21 ,7285,1518,1339,10142
10/28/2015,2015,10,28, 22 ,6965,1401,1232,9598
10/28/2015,2015,10,28, 23 ,6543,1296,1139,8978
10/28/2015,2015,10,28, 24 ,6156,1190,1041,8387
10/29/2015,2015,10,29, 1 ,5931,1186,1011,8128
10/29/2015,2015,10,29, 2 ,5774,1149,972,7895
10/29/2015,2015,10,29, 3 ,5619,1112,958,7689
10/29/2015,2015,10,29, 4 ,5559,1090,931,7580
10/29/2015,2015,10,29, 5 ,5531,1094,952,7577
10/29/2015,2015,10,29, 6 ,5576,1091,965,7632
10/29/2015,2015,10,29, 7 ,5759,1115,955,7829
10/29/2015,2015,10,29, 8 ,6500,1280,1102,8882
10/29/2015,2015,10,29, 9 ,7256,1470,1266,9992
10/29/2015,2015,10,29, 10 ,7734,1519,1346,10599
10/29/2015,2015,10,29, 11 ,8057,1562,1375,10994
10/29/2015,2015,10,29, 12 ,7827,1553,1336,10716
10/29/2015,2015,10,29, 13 ,7849,1560,1330,10739
10/29/2015,2015,10,29, 14 ,8113,1628,1357,11098
10/29/2015,2015,10,29, 15 ,7986,1585,1353,10924
10/29/2015,2015,10,29, 16 ,7807,1556,1344,10707
10/29/2015,2015,10,29, 17 ,7402,1504,1332,10238
10/29/2015,2015,10,29, 18 ,7767,1657,1457,10881
10/29/2015,2015,10,29, 19 ,7563,1604,1385,10552
10/29/2015,2015,10,29, 20 ,7340,1569,1335,10244
10/29/2015,2015,10,29, 21 ,7182,1494,1272,9948
10/29/2015,2015,10,29, 22 ,6917,1381,1141,9439
10/29/2015,2015,10,29, 23 ,6487,1278,1085,8850
10/29/2015,2015,10,29, 24 ,6108,1200,1018,8326
10/30/2015,2015,10,30, 1 ,5924,1159,978,8061
10/30/2015,2015,10,30, 2 ,5729,1136,953,7818
10/30/2015,2015,10,30, 3 ,5549,1106,932,7587
10/30/2015,2015,10,30, 4 ,5421,1096,922,7439
10/30/2015,2015,10,30, 5 ,5515,1108,946,7569
10/30/2015,2015,10,30, 6 ,5500,1110,956,7566
10/30/2015,2015,10,30, 7 ,5759,1128,945,7832
10/30/2015,2015,10,30, 8 ,6438,1280,1090,8808
10/30/2015,2015,10,30, 9 ,7205,1483,1229,9917
10/30/2015,2015,10,30, 10 ,7728,1581,1301,10610
10/30/2015,2015,10,30, 11 ,8027,1637,1356,11020
10/30/2015,2015,10,30, 12 ,7909,1577,1313,10799
10/30/2015,2015,10,30, 13 ,7847,1562,1348,10757
10/30/2015,2015,10,30, 14 ,8127,1626,1316,11069
10/30/2015,2015,10,30, 15 ,7945,1598,1324,10867
10/30/2015,2015,10,30, 16 ,7721,1556,1303,10580
10/30/2015,2015,10,30, 17 ,7281,1479,1268,10028
10/30/2015,2015,10,30, 18 ,7625,1639,1360,10624
10/30/2015,2015,10,30, 19 ,7491,1590,1349,10430
10/30/2015,2015,10,30, 20 ,7341,1533,1308,10182
10/30/2015,2015,10,30, 21 ,7230,1454,1256,9940
10/30/2015,2015,10,30, 22 ,6943,1359,1183,9485
10/30/2015,2015,10,30, 23 ,6578,1267,1128,8973
10/30/2015,2015,10,30, 24 ,6219,1195,982,8396
10/31/2015,2015,10,31, 1 ,5954,1148,967,8069
10/31/2015,2015,10,31, 2 ,5789,1115,977,7881
10/31/2015,2015,10,31, 3 ,5552,1093,956,7601
10/31/2015,2015,10,31, 4 ,5445,1078,934,7457
10/31/2015,2015,10,31, 5 ,5445,1085,946,7476
10/31/2015,2015,10,31, 6 ,5338,1058,936,7332
10/31/2015,2015,10,31, 7 ,5318,1077,948,7343
10/31/2015,2015,10,31, 8 ,5744,1173,1024,7941
10/31/2015,2015,10,31, 9 ,6309,1322,1138,8769
10/31/2015,2015,10,31, 10 ,6761,1337,1183,9281
10/31/2015,2015,10,31, 11 ,7000,1373,1198,9571
10/31/2015,2015,10,31, 12 ,6877,1365,1177,9419
10/31/2015,2015,10,31, 13 ,6843,1336,1174,9353
10/31/2015,2015,10,31, 14 ,6907,1353,1184,9444
10/31/2015,2015,10,31, 15 ,6634,1305,1183,9122
10/31/2015,2015,10,31, 16 ,6362,1272,1191,8825
10/31/2015,2015,10,31, 17 ,6126,1297,1166,8589
10/31/2015,2015,10,31, 18 ,6694,1496,1277,9467
10/31/2015,2015,10,31, 19 ,6705,1477,1216,9398
10/31/2015,2015,10,31, 20 ,6619,1435,1190,9244
10/31/2015,2015,10,31, 21 ,6585,1373,1182,9140
10/31/2015,2015,10,31, 22 ,6322,1282,1110,8714
10/31/2015,2015,10,31, 23 ,5997,1185,1075,8257
10/31/2015,2015,10,31, 24 ,5656,1105,1014,7775
11/1/2015,2015,11,1, 1 ,5418,1075,971,7464
11/1/2015,2015,11,1, 2 ,5223,1044,940,7207
11/1/2015,2015,11,1, 3 ,4990,1019,916,6925
11/1/2015,2015,11,1, 4 ,4963,1005,891,6859
11/1/2015,2015,11,1, 5 ,4857,1009,899,6765
11/1/2015,2015,11,1, 6 ,4646,979,877,6502
11/1/2015,2015,11,1, 7 ,4495,982,857,6334
11/1/2015,2015,11,1, 8 ,4669,1018,869,6556
11/1/2015,2015,11,1, 9 ,4864,1072,905,6841
11/1/2015,2015,11,1, 10 ,5071,1116,968,7155
11/1/2015,2015,11,1, 11 ,5166,1160,1020,7346
11/1/2015,2015,11,1, 12 ,5286,1169,1025,7480
11/1/2015,2015,11,1, 13 ,5298,1174,1018,7490
11/1/2015,2015,11,1, 14 ,5240,1166,1025,7431
11/1/2015,2015,11,1, 15 ,5133,1163,1013,7309
11/1/2015,2015,11,1, 16 ,4999,1133,987,7119
11/1/2015,2015,11,1, 17 ,5040,1133,1053,7226
11/1/2015,2015,11,1, 18 ,5674,1347,1190,8211
11/1/2015,2015,11,1, 19 ,5790,1336,1183,8309
11/1/2015,2015,11,1, 20 ,5847,1320,1131,8298
11/1/2015,2015,11,1, 21 ,5737,1269,1120,8126
11/1/2015,2015,11,1, 22 ,5531,1208,1038,7777
11/1/2015,2015,11,1, 23 ,5279,1145,980,7404
11/1/2015,2015,11,1, 24 ,5030,1098,920,7048
11/2/2015,2015,11,2, 1 ,4836,1064,892,6792
11/2/2015,2015,11,2, 2 ,4649,1024,861,6534
11/2/2015,2015,11,2, 3 ,4509,988,853,6350
11/2/2015,2015,11,2, 4 ,4449,965,837,6251
11/2/2015,2015,11,2, 5 ,4505,985,867,6357
11/2/2015,2015,11,2, 6 ,4674,995,861,6530
11/2/2015,2015,11,2, 7 ,5041,1001,832,6874
11/2/2015,2015,11,2, 8 ,5890,1116,962,7968
11/2/2015,2015,11,2, 9 ,6718,1269,1062,9049
11/2/2015,2015,11,2, 10 ,7265,1350,1128,9743
11/2/2015,2015,11,2, 11 ,7554,1411,1139,10104
11/2/2015,2015,11,2, 12 ,7455,1399,1135,9989
11/2/2015,2015,11,2, 13 ,7410,1405,1127,9942
11/2/2015,2015,11,2, 14 ,7737,1434,1135,10306
11/2/2015,2015,11,2, 15 ,7567,1406,1153,10126
11/2/2015,2015,11,2, 16 ,7375,1385,1135,9895
11/2/2015,2015,11,2, 17 ,7076,1366,1181,9623
11/2/2015,2015,11,2, 18 ,7477,1539,1271,10287
11/2/2015,2015,11,2, 19 ,7369,1506,1247,10122
11/2/2015,2015,11,2, 20 ,7225,1469,1220,9914
11/2/2015,2015,11,2, 21 ,7024,1398,1142,9564
11/2/2015,2015,11,2, 22 ,6694,1287,1031,9012
11/2/2015,2015,11,2, 23 ,6281,1195,952,8428
11/2/2015,2015,11,2, 24 ,5915,1138,899,7952
11/3/2015,2015,11,3, 1 ,5695,1089,866,7650
11/3/2015,2015,11,3, 2 ,5522,1046,844,7412
11/3/2015,2015,11,3, 3 ,5328,1019,828,7175
11/3/2015,2015,11,3, 4 ,5243,1012,827,7082
11/3/2015,2015,11,3, 5 ,5339,1043,876,7258
11/3/2015,2015,11,3, 6 ,5514,1072,926,7512
11/3/2015,2015,11,3, 7 ,5633,1051,870,7554
11/3/2015,2015,11,3, 8 ,6423,1198,1009,8630
11/3/2015,2015,11,3, 9 ,7197,1413,1183,9793
11/3/2015,2015,11,3, 10 ,7625,1510,1283,10418
11/3/2015,2015,11,3, 11 ,7989,1568,1367,10924
11/3/2015,2015,11,3, 12 ,7847,1542,1327,10716
11/3/2015,2015,11,3, 13 ,7894,1528,1327,10749
11/3/2015,2015,11,3, 14 ,8158,1595,1373,11126
11/3/2015,2015,11,3, 15 ,8017,1584,1361,10962
11/3/2015,2015,11,3, 16 ,7831,1550,1314,10695
11/3/2015,2015,11,3, 17 ,7479,1477,1334,10290
11/3/2015,2015,11,3, 18 ,7797,1660,1443,10900
11/3/2015,2015,11,3, 19 ,7612,1627,1383,10622
11/3/2015,2015,11,3, 20 ,7459,1573,1328,10360
11/3/2015,2015,11,3, 21 ,7341,1493,1271,10105
11/3/2015,2015,11,3, 22 ,6923,1367,1140,9430
11/3/2015,2015,11,3, 23 ,6578,1273,1038,8889
11/3/2015,2015,11,3, 24 ,6221,1203,989,8413
11/4/2015,2015,11,4, 1 ,5940,1159,927,8026
11/4/2015,2015,11,4, 2 ,5731,1125,901,7757
11/4/2015,2015,11,4, 3 ,5572,1086,877,7535
11/4/2015,2015,11,4, 4 ,5467,1069,867,7403
11/4/2015,2015,11,4, 5 ,5635,1111,932,7678
11/4/2015,2015,11,4, 6 ,5686,1125,962,7773
11/4/2015,2015,11,4, 7 ,5798,1094,910,7802
11/4/2015,2015,11,4, 8 ,6637,1273,1045,8955
11/4/2015,2015,11,4, 9 ,7347,1462,1215,10024
11/4/2015,2015,11,4, 10 ,7836,1544,1333,10713
11/4/2015,2015,11,4, 11 ,8118,1595,1358,11071
11/4/2015,2015,11,4, 12 ,7948,1556,1308,10812
11/4/2015,2015,11,4, 13 ,8001,1562,1323,10886
11/4/2015,2015,11,4, 14 ,8305,1631,1362,11298
11/4/2015,2015,11,4, 15 ,8178,1613,1333,11124
11/4/2015,2015,11,4, 16 ,7992,1565,1307,10864
11/4/2015,2015,11,4, 17 ,7641,1508,1308,10457
11/4/2015,2015,11,4, 18 ,7984,1672,1439,11095
11/4/2015,2015,11,4, 19 ,7872,1637,1384,10893
11/4/2015,2015,11,4, 20 ,7696,1578,1330,10604
11/4/2015,2015,11,4, 21 ,7558,1521,1284,10363
11/4/2015,2015,11,4, 22 ,7155,1384,1150,9689
11/4/2015,2015,11,4, 23 ,6807,1283,1070,9160
11/4/2015,2015,11,4, 24 ,6393,1208,994,8595
11/5/2015,2015,11,5, 1 ,6124,1162,964,8250
11/5/2015,2015,11,5, 2 ,5914,1132,932,7978
11/5/2015,2015,11,5, 3 ,5724,1097,912,7733
11/5/2015,2015,11,5, 4 ,5598,1088,901,7587
11/5/2015,2015,11,5, 5 ,5752,1116,946,7814
11/5/2015,2015,11,5, 6 ,5758,1135,970,7863
11/5/2015,2015,11,5, 7 ,5860,1101,915,7876
11/5/2015,2015,11,5, 8 ,6563,1259,1067,8889
11/5/2015,2015,11,5, 9 ,7376,1463,1233,10072
11/5/2015,2015,11,5, 10 ,7924,1543,1319,10786
11/5/2015,2015,11,5, 11 ,8234,1604,1353,11191
11/5/2015,2015,11,5, 12 ,8018,1562,1316,10896
11/5/2015,2015,11,5, 13 ,8070,1546,1340,10956
11/5/2015,2015,11,5, 14 ,8338,1627,1366,11331
11/5/2015,2015,11,5, 15 ,8240,1591,1347,11178
11/5/2015,2015,11,5, 16 ,8030,1549,1325,10904
11/5/2015,2015,11,5, 17 ,7674,1500,1341,10515
11/5/2015,2015,11,5, 18 ,8003,1680,1434,11117
11/5/2015,2015,11,5, 19 ,7874,1646,1387,10907
11/5/2015,2015,11,5, 20 ,7693,1575,1350,10618
11/5/2015,2015,11,5, 21 ,7527,1503,1268,10298
11/5/2015,2015,11,5, 22 ,7195,1372,1146,9713
11/5/2015,2015,11,5, 23 ,6801,1281,1086,9168
11/5/2015,2015,11,5, 24 ,6391,1199,1028,8618
11/6/2015,2015,11,6, 1 ,6132,1157,971,8260
11/6/2015,2015,11,6, 2 ,5924,1127,941,7992
11/6/2015,2015,11,6, 3 ,5742,1095,919,7756
11/6/2015,2015,11,6, 4 ,5625,1078,917,7620
11/6/2015,2015,11,6, 5 ,5801,1120,964,7885
11/6/2015,2015,11,6, 6 ,5802,1129,990,7921
11/6/2015,2015,11,6, 7 ,5873,1106,946,7925
11/6/2015,2015,11,6, 8 ,6650,1288,1067,9005
11/6/2015,2015,11,6, 9 ,7448,1509,1227,10184
11/6/2015,2015,11,6, 10 ,7990,1585,1339,10914
11/6/2015,2015,11,6, 11 ,8233,1627,1356,11216
11/6/2015,2015,11,6, 12 ,8052,1571,1308,10931
11/6/2015,2015,11,6, 13 ,8111,1580,1324,11015
11/6/2015,2015,11,6, 14 ,8367,1648,1374,11389
11/6/2015,2015,11,6, 15 ,8213,1594,1365,11172
11/6/2015,2015,11,6, 16 ,8018,1573,1349,10940
11/6/2015,2015,11,6, 17 ,7615,1531,1332,10478
11/6/2015,2015,11,6, 18 ,7992,1670,1464,11126
11/6/2015,2015,11,6, 19 ,7795,1633,1389,10817
11/6/2015,2015,11,6, 20 ,7639,1577,1356,10572
11/6/2015,2015,11,6, 21 ,7506,1516,1282,10304
11/6/2015,2015,11,6, 22 ,7187,1388,1189,9764
11/6/2015,2015,11,6, 23 ,6801,1280,1092,9173
11/6/2015,2015,11,6, 24 ,6453,1209,1014,8676
11/7/2015,2015,11,7, 1 ,6149,1157,974,8280
11/7/2015,2015,11,7, 2 ,5982,1118,924,8024
11/7/2015,2015,11,7, 3 ,5766,1091,927,7784
11/7/2015,2015,11,7, 4 ,5610,1074,915,7599
11/7/2015,2015,11,7, 5 ,5637,1082,944,7663
11/7/2015,2015,11,7, 6 ,5551,1073,945,7569
11/7/2015,2015,11,7, 7 ,5651,1089,931,7671
11/7/2015,2015,11,7, 8 ,6217,1196,1032,8445
11/7/2015,2015,11,7, 9 ,6791,1344,1143,9278
11/7/2015,2015,11,7, 10 ,7334,1438,1241,10013
11/7/2015,2015,11,7, 11 ,7692,1503,1322,10517
11/7/2015,2015,11,7, 12 ,7521,1465,1295,10281
11/7/2015,2015,11,7, 13 ,7479,1460,1322,10261
11/7/2015,2015,11,7, 14 ,7754,1479,1310,10543
11/7/2015,2015,11,7, 15 ,7512,1448,1210,10170
11/7/2015,2015,11,7, 16 ,7324,1409,1216,9949
11/7/2015,2015,11,7, 17 ,6962,1394,1224,9580
11/7/2015,2015,11,7, 18 ,7543,1599,1365,10507
11/7/2015,2015,11,7, 19 ,7531,1566,1336,10433
11/7/2015,2015,11,7, 20 ,7454,1517,1296,10267
11/7/2015,2015,11,7, 21 ,7385,1460,1244,10089
11/7/2015,2015,11,7, 22 ,7154,1367,1164,9685
11/7/2015,2015,11,7, 23 ,6678,1281,1070,9029
11/7/2015,2015,11,7, 24 ,6327,1221,1036,8584
11/8/2015,2015,11,8, 1 ,6073,1152,954,8179
11/8/2015,2015,11,8, 2 ,5918,1116,920,7954
11/8/2015,2015,11,8, 3 ,5691,1082,897,7670
11/8/2015,2015,11,8, 4 ,5483,1061,883,7427
11/8/2015,2015,11,8, 5 ,5468,1066,894,7428
11/8/2015,2015,11,8, 6 ,5259,1031,903,7193
11/8/2015,2015,11,8, 7 ,5244,1042,887,7173
11/8/2015,2015,11,8, 8 ,5513,1105,922,7540
11/8/2015,2015,11,8, 9 ,5919,1189,1010,8118
11/8/2015,2015,11,8, 10 ,6378,1259,1087,8724
11/8/2015,2015,11,8, 11 ,6595,1304,1152,9051
11/8/2015,2015,11,8, 12 ,6538,1302,1146,8986
11/8/2015,2015,11,8, 13 ,6613,1314,1136,9063
11/8/2015,2015,11,8, 14 ,6668,1325,1149,9142
11/8/2015,2015,11,8, 15 ,6583,1303,1135,9021
11/8/2015,2015,11,8, 16 ,6427,1286,1129,8842
11/8/2015,2015,11,8, 17 ,6303,1270,1163,8736
11/8/2015,2015,11,8, 18 ,7007,1511,1345,9863
11/8/2015,2015,11,8, 19 ,7060,1506,1299,9865
11/8/2015,2015,11,8, 20 ,7119,1486,1284,9889
11/8/2015,2015,11,8, 21 ,7032,1406,1231,9669
11/8/2015,2015,11,8, 22 ,6755,1337,1151,9243
11/8/2015,2015,11,8, 23 ,6406,1254,1055,8715
11/8/2015,2015,11,8, 24 ,6031,1164,982,8177
11/9/2015,2015,11,9, 1 ,5741,1112,915,7768
11/9/2015,2015,11,9, 2 ,5498,1081,895,7474
11/9/2015,2015,11,9, 3 ,5333,1046,874,7253
11/9/2015,2015,11,9, 4 ,5331,1042,868,7241
11/9/2015,2015,11,9, 5 ,5469,1076,921,7466
11/9/2015,2015,11,9, 6 ,5636,1091,956,7683
11/9/2015,2015,11,9, 7 ,5789,1071,871,7731
11/9/2015,2015,11,9, 8 ,6597,1249,1044,8890
11/9/2015,2015,11,9, 9 ,7274,1457,1209,9940
11/9/2015,2015,11,9, 10 ,7756,1556,1317,10629
11/9/2015,2015,11,9, 11 ,7999,1621,1372,10992
11/9/2015,2015,11,9, 12 ,7753,1576,1329,10658
11/9/2015,2015,11,9, 13 ,7689,1583,1327,10599
11/9/2015,2015,11,9, 14 ,8104,1636,1411,11151
11/9/2015,2015,11,9, 15 ,7974,1598,1388,10960
11/9/2015,2015,11,9, 16 ,7854,1559,1337,10750
11/9/2015,2015,11,9, 17 ,7570,1505,1356,10431
11/9/2015,2015,11,9, 18 ,7892,1684,1430,11006
11/9/2015,2015,11,9, 19 ,7722,1656,1386,10764
11/9/2015,2015,11,9, 20 ,7628,1591,1348,10567
11/9/2015,2015,11,9, 21 ,7346,1510,1304,10160
11/9/2015,2015,11,9, 22 ,6936,1388,1179,9503
11/9/2015,2015,11,9, 23 ,6633,1254,1060,8947
11/9/2015,2015,11,9, 24 ,6219,1165,1017,8401
11/10/2015,2015,11,10, 1 ,5884,1168,977,8029
11/10/2015,2015,11,10, 2 ,5743,1147,940,7830
11/10/2015,2015,11,10, 3 ,5605,1111,908,7624
11/10/2015,2015,11,10, 4 ,5522,1098,914,7534
11/10/2015,2015,11,10, 5 ,5668,1126,974,7768
11/10/2015,2015,11,10, 6 ,5747,1150,997,7894
11/10/2015,2015,11,10, 7 ,5791,1111,931,7833
11/10/2015,2015,11,10, 8 ,6648,1285,1085,9018
11/10/2015,2015,11,10, 9 ,7339,1470,1225,10034
11/10/2015,2015,11,10, 10 ,7809,1523,1330,10662
11/10/2015,2015,11,10, 11 ,8083,1638,1362,11083
11/10/2015,2015,11,10, 12 ,7902,1568,1355,10825
11/10/2015,2015,11,10, 13 ,7959,1567,1354,10880
11/10/2015,2015,11,10, 14 ,8217,1662,1360,11239
11/10/2015,2015,11,10, 15 ,8054,1628,1268,10950
11/10/2015,2015,11,10, 16 ,7887,1597,1283,10767
11/10/2015,2015,11,10, 17 ,7517,1545,1271,10333
11/10/2015,2015,11,10, 18 ,7986,1711,1417,11114
11/10/2015,2015,11,10, 19 ,7832,1677,1414,10923
11/10/2015,2015,11,10, 20 ,7730,1622,1311,10663
11/10/2015,2015,11,10, 21 ,7479,1553,1251,10283
11/10/2015,2015,11,10, 22 ,7155,1423,1140,9718
11/10/2015,2015,11,10, 23 ,6694,1315,1042,9051
11/10/2015,2015,11,10, 24 ,6289,1236,1010,8535
11/11/2015,2015,11,11, 1 ,6010,1159,951,8120
11/11/2015,2015,11,11, 2 ,5798,1147,930,7875
11/11/2015,2015,11,11, 3 ,5658,1121,909,7688
11/11/2015,2015,11,11, 4 ,5593,1108,902,7603
11/11/2015,2015,11,11, 5 ,5755,1150,950,7855
11/11/2015,2015,11,11, 6 ,5814,1168,979,7961
11/11/2015,2015,11,11, 7 ,5839,1134,938,7911
11/11/2015,2015,11,11, 8 ,6650,1298,1081,9029
11/11/2015,2015,11,11, 9 ,7455,1509,1269,10233
11/11/2015,2015,11,11, 10 ,7967,1605,1355,10927
11/11/2015,2015,11,11, 11 ,8232,1674,1462,11368
11/11/2015,2015,11,11, 12 ,8046,1616,1446,11108
11/11/2015,2015,11,11, 13 ,8039,1621,1466,11126
11/11/2015,2015,11,11, 14 ,8403,1671,1468,11542
11/11/2015,2015,11,11, 15 ,8234,1656,1411,11301
11/11/2015,2015,11,11, 16 ,8062,1622,1382,11066
11/11/2015,2015,11,11, 17 ,7689,1534,1353,10576
11/11/2015,2015,11,11, 18 ,7982,1714,1485,11181
11/11/2015,2015,11,11, 19 ,7866,1688,1426,10980
11/11/2015,2015,11,11, 20 ,7706,1629,1378,10713
11/11/2015,2015,11,11, 21 ,7510,1559,1329,10398
11/11/2015,2015,11,11, 22 ,7104,1419,1158,9681
11/11/2015,2015,11,11, 23 ,6703,1302,1053,9058
11/11/2015,2015,11,11, 24 ,6366,1224,907,8497
11/12/2015,2015,11,12, 1 ,6060,1199,978,8237
11/12/2015,2015,11,12, 2 ,5873,1170,951,7994
11/12/2015,2015,11,12, 3 ,5729,1140,920,7789
11/12/2015,2015,11,12, 4 ,5622,1130,922,7674
11/12/2015,2015,11,12, 5 ,5803,1160,960,7923
11/12/2015,2015,11,12, 6 ,5821,1171,881,7873
11/12/2015,2015,11,12, 7 ,5859,1148,928,7935
11/12/2015,2015,11,12, 8 ,6701,1301,1064,9066
11/12/2015,2015,11,12, 9 ,7442,1508,1213,10163
11/12/2015,2015,11,12, 10 ,7896,1602,1316,10814
11/12/2015,2015,11,12, 11 ,8201,1641,1393,11235
11/12/2015,2015,11,12, 12 ,8065,1630,1363,11058
11/12/2015,2015,11,12, 13 ,8027,1617,1383,11027
11/12/2015,2015,11,12, 14 ,8368,1703,1400,11471
11/12/2015,2015,11,12, 15 ,8221,1665,1385,11271
11/12/2015,2015,11,12, 16 ,8032,1633,1388,11053
11/12/2015,2015,11,12, 17 ,7690,1552,1346,10588
11/12/2015,2015,11,12, 18 ,8015,1720,1519,11254
11/12/2015,2015,11,12, 19 ,7866,1693,1477,11036
11/12/2015,2015,11,12, 20 ,7756,1642,1410,10808
11/12/2015,2015,11,12, 21 ,7524,1576,1327,10427
11/12/2015,2015,11,12, 22 ,7172,1439,1138,9749
11/12/2015,2015,11,12, 23 ,6781,1336,1082,9199
11/12/2015,2015,11,12, 24 ,6373,1263,992,8628
11/13/2015,2015,11,13, 1 ,6064,1220,991,8275
11/13/2015,2015,11,13, 2 ,5881,1172,960,8013
11/13/2015,2015,11,13, 3 ,5698,1150,914,7762
11/13/2015,2015,11,13, 4 ,5633,1132,937,7702
11/13/2015,2015,11,13, 5 ,5780,1150,985,7915
11/13/2015,2015,11,13, 6 ,5791,1157,999,7947
11/13/2015,2015,11,13, 7 ,5866,1115,936,7917
11/13/2015,2015,11,13, 8 ,6725,1301,1064,9090
11/13/2015,2015,11,13, 9 ,7533,1493,1260,10286
11/13/2015,2015,11,13, 10 ,7986,1602,1361,10949
11/13/2015,2015,11,13, 11 ,8206,1654,1376,11236
11/13/2015,2015,11,13, 12 ,8055,1600,1378,11033
11/13/2015,2015,11,13, 13 ,8112,1635,1398,11145
11/13/2015,2015,11,13, 14 ,8336,1697,1425,11458
11/13/2015,2015,11,13, 15 ,8130,1654,1377,11161
11/13/2015,2015,11,13, 16 ,7995,1580,1345,10920
11/13/2015,2015,11,13, 17 ,7565,1538,1360,10463
11/13/2015,2015,11,13, 18 ,7926,1717,1487,11130
11/13/2015,2015,11,13, 19 ,7791,1679,1423,10893
11/13/2015,2015,11,13, 20 ,7626,1633,1365,10624
11/13/2015,2015,11,13, 21 ,7466,1547,1302,10315
11/13/2015,2015,11,13, 22 ,7170,1438,1151,9759
11/13/2015,2015,11,13, 23 ,6698,1334,1036,9068
11/13/2015,2015,11,13, 24 ,6347,1257,985,8589
11/14/2015,2015,11,14, 1 ,5998,1210,956,8164
11/14/2015,2015,11,14, 2 ,5838,1164,932,7934
11/14/2015,2015,11,14, 3 ,5637,1136,903,7676
11/14/2015,2015,11,14, 4 ,5537,1114,897,7548
11/14/2015,2015,11,14, 5 ,5563,1123,918,7604
11/14/2015,2015,11,14, 6 ,5467,1115,924,7506
11/14/2015,2015,11,14, 7 ,5518,1125,892,7535
11/14/2015,2015,11,14, 8 ,6106,1248,968,8322
11/14/2015,2015,11,14, 9 ,6739,1411,1082,9232
11/14/2015,2015,11,14, 10 ,7284,1494,1182,9960
11/14/2015,2015,11,14, 11 ,7635,1530,1253,10418
11/14/2015,2015,11,14, 12 ,7519,1510,1240,10269
11/14/2015,2015,11,14, 13 ,7500,1513,1255,10268
11/14/2015,2015,11,14, 14 ,7695,1553,1265,10513
11/14/2015,2015,11,14, 15 ,7514,1524,1295,10333
11/14/2015,2015,11,14, 16 ,7249,1480,1217,9946
11/14/2015,2015,11,14, 17 ,6965,1418,1234,9617
11/14/2015,2015,11,14, 18 ,7483,1653,1340,10476
11/14/2015,2015,11,14, 19 ,7421,1618,1373,10412
11/14/2015,2015,11,14, 20 ,7403,1579,1345,10327
11/14/2015,2015,11,14, 21 ,7232,1512,1307,10051
11/14/2015,2015,11,14, 22 ,7018,1412,1203,9633
11/14/2015,2015,11,14, 23 ,6635,1317,1110,9062
11/14/2015,2015,11,14, 24 ,6271,1221,1015,8507
11/15/2015,2015,11,15, 1 ,5922,1178,949,8049
11/15/2015,2015,11,15, 2 ,5779,1139,910,7828
11/15/2015,2015,11,15, 3 ,5570,1104,877,7551
11/15/2015,2015,11,15, 4 ,5390,1075,860,7325
11/15/2015,2015,11,15, 5 ,5334,1074,874,7282
11/15/2015,2015,11,15, 6 ,5237,1047,862,7146
11/15/2015,2015,11,15, 7 ,5188,1036,829,7053
11/15/2015,2015,11,15, 8 ,5438,1100,861,7399
11/15/2015,2015,11,15, 9 ,5852,1159,928,7939
11/15/2015,2015,11,15, 10 ,6341,1236,1002,8579
11/15/2015,2015,11,15, 11 ,6587,1293,1131,9011
11/15/2015,2015,11,15, 12 ,6477,1310,1152,8939
11/15/2015,2015,11,15, 13 ,6465,1321,1158,8944
11/15/2015,2015,11,15, 14 ,6486,1342,1171,8999
11/15/2015,2015,11,15, 15 ,6335,1306,1155,8796
11/15/2015,2015,11,15, 16 ,6135,1272,1131,8538
11/15/2015,2015,11,15, 17 ,6013,1283,1124,8420
11/15/2015,2015,11,15, 18 ,6821,1563,1363,9747
11/15/2015,2015,11,15, 19 ,6880,1562,1353,9795
11/15/2015,2015,11,15, 20 ,6918,1531,1317,9766
11/15/2015,2015,11,15, 21 ,6732,1444,1251,9427
11/15/2015,2015,11,15, 22 ,6448,1361,1172,8981
11/15/2015,2015,11,15, 23 ,6016,1280,1066,8362
11/15/2015,2015,11,15, 24 ,5754,1203,1005,7962
11/16/2015,2015,11,16, 1 ,5477,1150,946,7573
11/16/2015,2015,11,16, 2 ,5328,1117,901,7346
11/16/2015,2015,11,16, 3 ,5158,1080,880,7118
11/16/2015,2015,11,16, 4 ,5118,1082,879,7079
11/16/2015,2015,11,16, 5 ,5250,1114,930,7294
11/16/2015,2015,11,16, 6 ,5438,1139,957,7534
11/16/2015,2015,11,16, 7 ,5548,1103,896,7547
11/16/2015,2015,11,16, 8 ,6355,1286,1064,8705
11/16/2015,2015,11,16, 9 ,7324,1493,1245,10062
11/16/2015,2015,11,16, 10 ,7860,1590,1332,10782
11/16/2015,2015,11,16, 11 ,8132,1660,1394,11186
11/16/2015,2015,11,16, 12 ,8051,1625,1363,11039
11/16/2015,2015,11,16, 13 ,8053,1640,1394,11087
11/16/2015,2015,11,16, 14 ,8265,1701,1419,11385
11/16/2015,2015,11,16, 15 ,8177,1682,1414,11273
11/16/2015,2015,11,16, 16 ,8030,1645,1391,11066
11/16/2015,2015,11,16, 17 ,7673,1574,1372,10619
11/16/2015,2015,11,16, 18 ,8025,1746,1469,11240
11/16/2015,2015,11,16, 19 ,7860,1726,1439,11025
11/16/2015,2015,11,16, 20 ,7737,1663,1392,10792
11/16/2015,2015,11,16, 21 ,7487,1581,1346,10414
11/16/2015,2015,11,16, 22 ,7070,1445,1216,9731
11/16/2015,2015,11,16, 23 ,6729,1334,1116,9179
11/16/2015,2015,11,16, 24 ,6333,1266,1047,8646
11/17/2015,2015,11,17, 1 ,6028,1205,1006,8239
11/17/2015,2015,11,17, 2 ,5818,1171,970,7959
11/17/2015,2015,11,17, 3 ,5650,1158,947,7755
11/17/2015,2015,11,17, 4 ,5573,1146,943,7662
11/17/2015,2015,11,17, 5 ,5652,1175,991,7818
11/17/2015,2015,11,17, 6 ,5705,1195,994,7894
11/17/2015,2015,11,17, 7 ,5756,1135,940,7831
11/17/2015,2015,11,17, 8 ,6550,1325,1094,8969
11/17/2015,2015,11,17, 9 ,7265,1540,1264,10069
11/17/2015,2015,11,17, 10 ,7787,1635,1338,10760
11/17/2015,2015,11,17, 11 ,8092,1694,1365,11151
11/17/2015,2015,11,17, 12 ,7950,1650,1320,10920
11/17/2015,2015,11,17, 13 ,7951,1652,1344,10947
11/17/2015,2015,11,17, 14 ,8267,1736,1365,11368
11/17/2015,2015,11,17, 15 ,8105,1665,1344,11114
11/17/2015,2015,11,17, 16 ,7925,1629,1351,10905
11/17/2015,2015,11,17, 17 ,7627,1575,1367,10569
11/17/2015,2015,11,17, 18 ,8030,1763,1445,11238
11/17/2015,2015,11,17, 19 ,7839,1714,1401,10954
11/17/2015,2015,11,17, 20 ,7697,1658,1350,10705
11/17/2015,2015,11,17, 21 ,7540,1592,1300,10432
11/17/2015,2015,11,17, 22 ,7161,1475,1163,9799
11/17/2015,2015,11,17, 23 ,6754,1359,1071,9184
11/17/2015,2015,11,17, 24 ,6385,1280,1050,8715
11/18/2015,2015,11,18, 1 ,6129,1229,974,8332
11/18/2015,2015,11,18, 2 ,5936,1196,948,8080
11/18/2015,2015,11,18, 3 ,5757,1168,921,7846
11/18/2015,2015,11,18, 4 ,5673,1153,921,7747
11/18/2015,2015,11,18, 5 ,5773,1179,978,7930
11/18/2015,2015,11,18, 6 ,5755,1181,994,7930
11/18/2015,2015,11,18, 7 ,5660,1141,934,7735
11/18/2015,2015,11,18, 8 ,6155,1311,1062,8528
11/18/2015,2015,11,18, 9 ,6733,1526,1237,9496
11/18/2015,2015,11,18, 10 ,7192,1621,1316,10129
11/18/2015,2015,11,18, 11 ,7458,1678,1355,10491
11/18/2015,2015,11,18, 12 ,7347,1649,1306,10302
11/18/2015,2015,11,18, 13 ,7427,1658,1336,10421
11/18/2015,2015,11,18, 14 ,7698,1728,1369,10795
11/18/2015,2015,11,18, 15 ,7498,1703,1336,10537
11/18/2015,2015,11,18, 16 ,7412,1660,1324,10396
11/18/2015,2015,11,18, 17 ,7097,1596,1309,10002
11/18/2015,2015,11,18, 18 ,7608,1763,1416,10787
11/18/2015,2015,11,18, 19 ,7540,1730,1369,10639
11/18/2015,2015,11,18, 20 ,7516,1686,1359,10561
11/18/2015,2015,11,18, 21 ,7288,1595,1283,10166
11/18/2015,2015,11,18, 22 ,6933,1441,1132,9506
11/18/2015,2015,11,18, 23 ,6486,1337,1044,8867
11/18/2015,2015,11,18, 24 ,6146,1254,1021,8421
11/19/2015,2015,11,19, 1 ,5828,1209,944,7981
11/19/2015,2015,11,19, 2 ,5649,1171,907,7727
11/19/2015,2015,11,19, 3 ,5494,1136,885,7515
11/19/2015,2015,11,19, 4 ,5434,1123,883,7440
11/19/2015,2015,11,19, 5 ,5525,1152,937,7614
11/19/2015,2015,11,19, 6 ,5531,1176,968,7675
11/19/2015,2015,11,19, 7 ,5472,1143,916,7531
11/19/2015,2015,11,19, 8 ,6024,1297,1043,8364
11/19/2015,2015,11,19, 9 ,6572,1513,1222,9307
11/19/2015,2015,11,19, 10 ,7023,1613,1327,9963
11/19/2015,2015,11,19, 11 ,7312,1683,1362,10357
11/19/2015,2015,11,19, 12 ,7155,1650,1348,10153
11/19/2015,2015,11,19, 13 ,7171,1641,1362,10174
11/19/2015,2015,11,19, 14 ,7452,1713,1384,10549
11/19/2015,2015,11,19, 15 ,7301,1671,1344,10316
11/19/2015,2015,11,19, 16 ,7198,1631,1319,10148
11/19/2015,2015,11,19, 17 ,6928,1562,1320,9810
11/19/2015,2015,11,19, 18 ,7495,1742,1464,10701
11/19/2015,2015,11,19, 19 ,7422,1707,1403,10532
11/19/2015,2015,11,19, 20 ,7405,1647,1349,10401
11/19/2015,2015,11,19, 21 ,7220,1572,1282,10074
11/19/2015,2015,11,19, 22 ,6859,1422,1177,9458
11/19/2015,2015,11,19, 23 ,6480,1300,1070,8850
11/19/2015,2015,11,19, 24 ,6161,1236,1020,8417
11/20/2015,2015,11,20, 1 ,5831,1177,946,7954
11/20/2015,2015,11,20, 2 ,5637,1140,942,7719
11/20/2015,2015,11,20, 3 ,5476,1114,912,7502
11/20/2015,2015,11,20, 4 ,5327,1111,904,7342
11/20/2015,2015,11,20, 5 ,5463,1141,945,7549
11/20/2015,2015,11,20, 6 ,5495,1144,968,7607
11/20/2015,2015,11,20, 7 ,5581,1093,914,7588
11/20/2015,2015,11,20, 8 ,6411,1266,1052,8729
11/20/2015,2015,11,20, 9 ,7076,1483,1238,9797
11/20/2015,2015,11,20, 10 ,7518,1578,1304,10400
11/20/2015,2015,11,20, 11 ,7791,1621,1334,10746
11/20/2015,2015,11,20, 12 ,7671,1572,1307,10550
11/20/2015,2015,11,20, 13 ,7670,1597,1341,10608
11/20/2015,2015,11,20, 14 ,7927,1666,1375,10968
11/20/2015,2015,11,20, 15 ,7794,1631,1350,10775
11/20/2015,2015,11,20, 16 ,7604,1587,1328,10519
11/20/2015,2015,11,20, 17 ,7330,1520,1314,10164
11/20/2015,2015,11,20, 18 ,7730,1705,1438,10873
11/20/2015,2015,11,20, 19 ,7575,1663,1389,10627
11/20/2015,2015,11,20, 20 ,7460,1607,1363,10430
11/20/2015,2015,11,20, 21 ,7213,1531,1299,10043
11/20/2015,2015,11,20, 22 ,6837,1403,1204,9444
11/20/2015,2015,11,20, 23 ,6396,1304,1085,8785
11/20/2015,2015,11,20, 24 ,6063,1222,1094,8379
11/21/2015,2015,11,21, 1 ,5738,1172,976,7886
11/21/2015,2015,11,21, 2 ,5572,1134,948,7654
11/21/2015,2015,11,21, 3 ,5370,1099,920,7389
11/21/2015,2015,11,21, 4 ,5307,1093,907,7307
11/21/2015,2015,11,21, 5 ,5316,1091,936,7343
11/21/2015,2015,11,21, 6 ,5259,1089,938,7286
11/21/2015,2015,11,21, 7 ,5417,1097,940,7454
11/21/2015,2015,11,21, 8 ,5982,1218,1026,8226
11/21/2015,2015,11,21, 9 ,6582,1366,1151,9099
11/21/2015,2015,11,21, 10 ,7056,1442,1259,9757
11/21/2015,2015,11,21, 11 ,7363,1474,1291,10128
11/21/2015,2015,11,21, 12 ,7301,1452,1261,10014
11/21/2015,2015,11,21, 13 ,7232,1463,1267,9962
11/21/2015,2015,11,21, 14 ,7456,1494,1310,10260
11/21/2015,2015,11,21, 15 ,7226,1446,1277,9949
11/21/2015,2015,11,21, 16 ,7052,1420,1256,9728
11/21/2015,2015,11,21, 17 ,6717,1419,1273,9409
11/21/2015,2015,11,21, 18 ,7319,1595,1400,10314
11/21/2015,2015,11,21, 19 ,7279,1530,1354,10163
11/21/2015,2015,11,21, 20 ,7238,1482,1342,10062
11/21/2015,2015,11,21, 21 ,7093,1411,1278,9782
11/21/2015,2015,11,21, 22 ,6844,1317,1189,9350
11/21/2015,2015,11,21, 23 ,6434,1236,1106,8776
11/21/2015,2015,11,21, 24 ,6078,1153,1028,8259
11/22/2015,2015,11,22, 1 ,5744,1111,960,7815
11/22/2015,2015,11,22, 2 ,5666,1077,933,7676
11/22/2015,2015,11,22, 3 ,5488,1057,909,7454
11/22/2015,2015,11,22, 4 ,5364,1028,892,7284
11/22/2015,2015,11,22, 5 ,5294,1037,905,7236
11/22/2015,2015,11,22, 6 ,5133,1023,885,7041
11/22/2015,2015,11,22, 7 ,5072,1029,877,6978
11/22/2015,2015,11,22, 8 ,5412,1089,887,7388
11/22/2015,2015,11,22, 9 ,5760,1182,941,7883
11/22/2015,2015,11,22, 10 ,6221,1265,1005,8491
11/22/2015,2015,11,22, 11 ,6480,1303,1052,8835
11/22/2015,2015,11,22, 12 ,6433,1316,1037,8786
11/22/2015,2015,11,22, 13 ,6503,1338,1053,8894
11/22/2015,2015,11,22, 14 ,6566,1360,1041,8967
11/22/2015,2015,11,22, 15 ,6432,1336,1033,8801
11/22/2015,2015,11,22, 16 ,6262,1307,1026,8595
11/22/2015,2015,11,22, 17 ,6111,1299,1076,8486
11/22/2015,2015,11,22, 18 ,6881,1541,1280,9702
11/22/2015,2015,11,22, 19 ,6972,1533,1268,9773
11/22/2015,2015,11,22, 20 ,6991,1492,1214,9697
11/22/2015,2015,11,22, 21 ,6817,1427,1098,9342
11/22/2015,2015,11,22, 22 ,6575,1328,1046,8949
11/22/2015,2015,11,22, 23 ,6173,1238,992,8403
11/22/2015,2015,11,22, 24 ,5810,1150,950,7910
11/23/2015,2015,11,23, 1 ,5523,1110,891,7524
11/23/2015,2015,11,23, 2 ,5333,1067,858,7258
11/23/2015,2015,11,23, 3 ,5233,1041,838,7112
11/23/2015,2015,11,23, 4 ,5120,1009,842,6971
11/23/2015,2015,11,23, 5 ,5246,1057,897,7200
11/23/2015,2015,11,23, 6 ,5471,1096,941,7508
11/23/2015,2015,11,23, 7 ,5581,1070,880,7531
11/23/2015,2015,11,23, 8 ,6378,1240,1014,8632
11/23/2015,2015,11,23, 9 ,7198,1475,1186,9859
11/23/2015,2015,11,23, 10 ,7700,1588,1278,10566
11/23/2015,2015,11,23, 11 ,8085,1635,1276,10996
11/23/2015,2015,11,23, 12 ,7875,1615,1251,10741
11/23/2015,2015,11,23, 13 ,7816,1615,1292,10723
11/23/2015,2015,11,23, 14 ,8184,1662,1343,11189
11/23/2015,2015,11,23, 15 ,8079,1654,1271,11004
11/23/2015,2015,11,23, 16 ,7876,1608,1250,10734
11/23/2015,2015,11,23, 17 ,7560,1554,1234,10348
11/23/2015,2015,11,23, 18 ,7985,1725,1300,11010
11/23/2015,2015,11,23, 19 ,7845,1688,1304,10837
11/23/2015,2015,11,23, 20 ,7608,1624,1298,10530
11/23/2015,2015,11,23, 21 ,7349,1546,1270,10165
11/23/2015,2015,11,23, 22 ,7029,1408,1157,9594
11/23/2015,2015,11,23, 23 ,6521,1297,1088,8906
11/23/2015,2015,11,23, 24 ,6154,1225,891,8270
11/24/2015,2015,11,24, 1 ,5890,1162,972,8024
11/24/2015,2015,11,24, 2 ,5668,1125,954,7747
11/24/2015,2015,11,24, 3 ,5528,1098,941,7567
11/24/2015,2015,11,24, 4 ,5457,1091,933,7481
11/24/2015,2015,11,24, 5 ,5578,1125,990,7693
11/24/2015,2015,11,24, 6 ,5687,1139,1022,7848
11/24/2015,2015,11,24, 7 ,5688,1101,953,7742
11/24/2015,2015,11,24, 8 ,6493,1258,1072,8823
11/24/2015,2015,11,24, 9 ,7340,1479,1217,10036
11/24/2015,2015,11,24, 10 ,7764,1581,1268,10613
11/24/2015,2015,11,24, 11 ,8100,1611,1322,11033
11/24/2015,2015,11,24, 12 ,7989,1563,1267,10819
11/24/2015,2015,11,24, 13 ,7955,1579,1319,10853
11/24/2015,2015,11,24, 14 ,8272,1636,1321,11229
11/24/2015,2015,11,24, 15 ,8140,1611,1339,11090
11/24/2015,2015,11,24, 16 ,7971,1574,1320,10865
11/24/2015,2015,11,24, 17 ,7683,1524,1305,10512
11/24/2015,2015,11,24, 18 ,8056,1701,1351,11108
11/24/2015,2015,11,24, 19 ,7792,1683,1310,10785
11/24/2015,2015,11,24, 20 ,7659,1645,1316,10620
11/24/2015,2015,11,24, 21 ,7482,1547,1262,10291
11/24/2015,2015,11,24, 22 ,7041,1420,1212,9673
11/24/2015,2015,11,24, 23 ,6632,1310,1104,9046
11/24/2015,2015,11,24, 24 ,6221,1236,1052,8509
11/25/2015,2015,11,25, 1 ,5942,1187,1038,8167
11/25/2015,2015,11,25, 2 ,5796,1153,1004,7953
11/25/2015,2015,11,25, 3 ,5602,1126,968,7696
11/25/2015,2015,11,25, 4 ,5500,1109,913,7522
11/25/2015,2015,11,25, 5 ,5633,1135,1006,7774
11/25/2015,2015,11,25, 6 ,5725,1161,1038,7924
11/25/2015,2015,11,25, 7 ,5801,1128,966,7895
11/25/2015,2015,11,25, 8 ,6544,1292,1090,8926
11/25/2015,2015,11,25, 9 ,7290,1500,1281,10071
11/25/2015,2015,11,25, 10 ,7754,1581,1344,10679
11/25/2015,2015,11,25, 11 ,8099,1632,1342,11073
11/25/2015,2015,11,25, 12 ,7931,1566,1335,10832
11/25/2015,2015,11,25, 13 ,7969,1522,1345,10836
11/25/2015,2015,11,25, 14 ,8235,1594,1320,11149
11/25/2015,2015,11,25, 15 ,8144,1555,1306,11005
11/25/2015,2015,11,25, 16 ,7935,1538,1315,10788
11/25/2015,2015,11,25, 17 ,7632,1513,1319,10464
11/25/2015,2015,11,25, 18 ,7959,1703,1401,11063
11/25/2015,2015,11,25, 19 ,7717,1659,1364,10740
11/25/2015,2015,11,25, 20 ,7667,1568,1359,10594
11/25/2015,2015,11,25, 21 ,7357,1503,1307,10167
11/25/2015,2015,11,25, 22 ,7003,1370,1180,9553
11/25/2015,2015,11,25, 23 ,6593,1265,1096,8954
11/25/2015,2015,11,25, 24 ,6178,1195,1025,8398
11/26/2015,2015,11,26, 1 ,5928,1153,986,8067
11/26/2015,2015,11,26, 2 ,5734,1108,953,7795
11/26/2015,2015,11,26, 3 ,5546,1083,934,7563
11/26/2015,2015,11,26, 4 ,5479,1075,928,7482
11/26/2015,2015,11,26, 5 ,5625,1103,989,7717
11/26/2015,2015,11,26, 6 ,5695,1132,1024,7851
11/26/2015,2015,11,26, 7 ,5717,1098,953,7768
11/26/2015,2015,11,26, 8 ,6522,1256,1085,8863
11/26/2015,2015,11,26, 9 ,7264,1469,1232,9965
11/26/2015,2015,11,26, 10 ,7769,1570,1291,10630
11/26/2015,2015,11,26, 11 ,7997,1624,1334,10955
11/26/2015,2015,11,26, 12 ,7870,1569,1322,10761
11/26/2015,2015,11,26, 13 ,7843,1586,1329,10758
11/26/2015,2015,11,26, 14 ,8168,1643,1323,11134
11/26/2015,2015,11,26, 15 ,8015,1604,1334,10953
11/26/2015,2015,11,26, 16 ,7835,1578,1317,10730
11/26/2015,2015,11,26, 17 ,7508,1535,1304,10347
11/26/2015,2015,11,26, 18 ,7860,1707,1359,10926
11/26/2015,2015,11,26, 19 ,7687,1673,1367,10727
11/26/2015,2015,11,26, 20 ,7505,1619,1344,10468
11/26/2015,2015,11,26, 21 ,7277,1535,1288,10100
11/26/2015,2015,11,26, 22 ,6906,1388,1205,9499
11/26/2015,2015,11,26, 23 ,6539,1277,1141,8957
11/26/2015,2015,11,26, 24 ,6088,1195,1023,8306
11/27/2015,2015,11,27, 1 ,5824,1138,1008,7970
11/27/2015,2015,11,27, 2 ,5656,1109,982,7747
11/27/2015,2015,11,27, 3 ,5499,1078,954,7531
11/27/2015,2015,11,27, 4 ,5428,1071,948,7447
11/27/2015,2015,11,27, 5 ,5570,1105,995,7670
11/27/2015,2015,11,27, 6 ,5655,1120,1018,7793
11/27/2015,2015,11,27, 7 ,5706,1097,961,7764
11/27/2015,2015,11,27, 8 ,6477,1258,1055,8790
11/27/2015,2015,11,27, 9 ,7213,1453,1214,9880
11/27/2015,2015,11,27, 10 ,7733,1563,1344,10640
11/27/2015,2015,11,27, 11 ,7978,1607,1296,10881
11/27/2015,2015,11,27, 12 ,7812,1571,1293,10676
11/27/2015,2015,11,27, 13 ,7780,1571,1328,10679
11/27/2015,2015,11,27, 14 ,8081,1655,1329,11065
11/27/2015,2015,11,27, 15 ,7916,1621,1335,10872
11/27/2015,2015,11,27, 16 ,7733,1579,1321,10633
11/27/2015,2015,11,27, 17 ,7410,1509,1306,10225
11/27/2015,2015,11,27, 18 ,7780,1696,1355,10831
11/27/2015,2015,11,27, 19 ,7648,1655,1363,10666
11/27/2015,2015,11,27, 20 ,7470,1594,1355,10419
11/27/2015,2015,11,27, 21 ,7294,1494,1312,10100
11/27/2015,2015,11,27, 22 ,6937,1387,1230,9554
11/27/2015,2015,11,27, 23 ,6566,1288,1130,8984
11/27/2015,2015,11,27, 24 ,6161,1212,1089,8462
11/28/2015,2015,11,28, 1 ,5876,1163,1018,8057
11/28/2015,2015,11,28, 2 ,5742,1129,979,7850
11/28/2015,2015,11,28, 3 ,5584,1105,962,7651
11/28/2015,2015,11,28, 4 ,5457,1096,940,7493
11/28/2015,2015,11,28, 5 ,5440,1101,965,7506
11/28/2015,2015,11,28, 6 ,5489,1095,976,7560
11/28/2015,2015,11,28, 7 ,5510,1111,962,7583
11/28/2015,2015,11,28, 8 ,6043,1215,1058,8316
11/28/2015,2015,11,28, 9 ,6641,1384,1157,9182
11/28/2015,2015,11,28, 10 ,7129,1466,1242,9837
11/28/2015,2015,11,28, 11 ,7419,1499,1239,10157
11/28/2015,2015,11,28, 12 ,7306,1479,1229,10014
11/28/2015,2015,11,28, 13 ,7234,1477,1263,9974
11/28/2015,2015,11,28, 14 ,7392,1498,1287,10177
11/28/2015,2015,11,28, 15 ,7219,1465,1253,9937
11/28/2015,2015,11,28, 16 ,6986,1416,1252,9654
11/28/2015,2015,11,28, 17 ,6827,1391,1252,9470
11/28/2015,2015,11,28, 18 ,7405,1584,1304,10293
11/28/2015,2015,11,28, 19 ,7313,1557,1333,10203
11/28/2015,2015,11,28, 20 ,7223,1525,1352,10100
11/28/2015,2015,11,28, 21 ,7136,1448,1305,9889
11/28/2015,2015,11,28, 22 ,6857,1354,1228,9439
11/28/2015,2015,11,28, 23 ,6496,1221,1084,8801
11/28/2015,2015,11,28, 24 ,6121,1133,905,8159
11/29/2015,2015,11,29, 1 ,5854,1085,988,7927
11/29/2015,2015,11,29, 2 ,5700,1071,957,7728
11/29/2015,2015,11,29, 3 ,5528,1035,935,7498
11/29/2015,2015,11,29, 4 ,5333,1014,914,7261
11/29/2015,2015,11,29, 5 ,5276,1020,886,7182
11/29/2015,2015,11,29, 6 ,5214,1013,827,7054
11/29/2015,2015,11,29, 7 ,5187,1017,813,7017
11/29/2015,2015,11,29, 8 ,5375,1069,852,7296
11/29/2015,2015,11,29, 9 ,5681,1138,882,7701
11/29/2015,2015,11,29, 10 ,6090,1216,955,8261
11/29/2015,2015,11,29, 11 ,6352,1264,1007,8623
11/29/2015,2015,11,29, 12 ,6282,1283,1052,8617
11/29/2015,2015,11,29, 13 ,6276,1256,1070,8602
11/29/2015,2015,11,29, 14 ,6373,1256,1066,8695
11/29/2015,2015,11,29, 15 ,6245,1253,1073,8571
11/29/2015,2015,11,29, 16 ,6098,1218,1134,8450
11/29/2015,2015,11,29, 17 ,6026,1237,1136,8399
11/29/2015,2015,11,29, 18 ,6734,1500,1319,9553
11/29/2015,2015,11,29, 19 ,6800,1484,1310,9594
11/29/2015,2015,11,29, 20 ,6776,1439,1262,9477
11/29/2015,2015,11,29, 21 ,6653,1367,1225,9245
11/29/2015,2015,11,29, 22 ,6396,1274,1150,8820
11/29/2015,2015,11,29, 23 ,6012,1180,1055,8247
11/29/2015,2015,11,29, 24 ,5686,1111,989,7786
11/30/2015,2015,11,30, 1 ,5476,1062,923,7461
11/30/2015,2015,11,30, 2 ,5239,1030,905,7174
11/30/2015,2015,11,30, 3 ,5124,995,880,6999
11/30/2015,2015,11,30, 4 ,4956,979,866,6801
11/30/2015,2015,11,30, 5 ,4984,993,877,6854
11/30/2015,2015,11,30, 6 ,4936,987,886,6809
11/30/2015,2015,11,30, 7 ,4976,996,885,6857
11/30/2015,2015,11,30, 8 ,5326,1089,956,7371
11/30/2015,2015,11,30, 9 ,5796,1211,1082,8089
11/30/2015,2015,11,30, 10 ,6434,1310,1178,8922
11/30/2015,2015,11,30, 11 ,6702,1374,1230,9306
11/30/2015,2015,11,30, 12 ,6628,1362,1225,9215
11/30/2015,2015,11,30, 13 ,6742,1368,1232,9342
11/30/2015,2015,11,30, 14 ,6870,1397,1257,9524
11/30/2015,2015,11,30, 15 ,6767,1378,1260,9405
11/30/2015,2015,11,30, 16 ,6589,1345,1228,9162
11/30/2015,2015,11,30, 17 ,6517,1327,1222,9066
11/30/2015,2015,11,30, 18 ,7137,1574,1358,10069
11/30/2015,2015,11,30, 19 ,7135,1570,1347,10052
11/30/2015,2015,11,30, 20 ,7136,1525,1289,9950
11/30/2015,2015,11,30, 21 ,6975,1451,1274,9700
11/30/2015,2015,11,30, 22 ,6652,1334,1171,9157
11/30/2015,2015,11,30, 23 ,6182,1214,1081,8477
11/30/2015,2015,11,30, 24 ,5765,1149,1027,7941
12/1/2015,2015,12,1, 1 ,5520,1106,973,7599
12/1/2015,2015,12,1, 2 ,5325,1065,946,7336
12/1/2015,2015,12,1, 3 ,5219,1038,924,7181
12/1/2015,2015,12,1, 4 ,5138,1025,910,7073
12/1/2015,2015,12,1, 5 ,5302,1065,949,7316
12/1/2015,2015,12,1, 6 ,5420,1094,983,7497
12/1/2015,2015,12,1, 7 ,5529,1055,919,7503
12/1/2015,2015,12,1, 8 ,6381,1217,1058,8656
12/1/2015,2015,12,1, 9 ,7183,1453,1239,9875
12/1/2015,2015,12,1, 10 ,7705,1559,1296,10560
12/1/2015,2015,12,1, 11 ,8025,1612,1321,10958
12/1/2015,2015,12,1, 12 ,7848,1569,1308,10725
12/1/2015,2015,12,1, 13 ,7796,1567,1341,10704
12/1/2015,2015,12,1, 14 ,8063,1633,1376,11072
12/1/2015,2015,12,1, 15 ,7893,1597,1333,10823
12/1/2015,2015,12,1, 16 ,7752,1564,1328,10644
12/1/2015,2015,12,1, 17 ,7470,1519,1322,10311
12/1/2015,2015,12,1, 18 ,7846,1691,1384,10921
12/1/2015,2015,12,1, 19 ,7675,1660,1356,10691
12/1/2015,2015,12,1, 20 ,7545,1612,1326,10483
12/1/2015,2015,12,1, 21 ,7315,1521,1277,10113
12/1/2015,2015,12,1, 22 ,6925,1374,1216,9515
12/1/2015,2015,12,1, 23 ,6409,1255,1067,8731
12/1/2015,2015,12,1, 24 ,5974,1173,1012,8159
12/2/2015,2015,12,2, 1 ,5706,1127,1001,7834
12/2/2015,2015,12,2, 2 ,5531,1100,966,7597
12/2/2015,2015,12,2, 3 ,5409,1063,947,7419
12/2/2015,2015,12,2, 4 ,5280,1055,933,7268
12/2/2015,2015,12,2, 5 ,5401,1095,977,7473
12/2/2015,2015,12,2, 6 ,5563,1121,996,7680
12/2/2015,2015,12,2, 7 ,5629,1084,924,7637
12/2/2015,2015,12,2, 8 ,6369,1235,1056,8660
12/2/2015,2015,12,2, 9 ,7125,1450,1191,9766
12/2/2015,2015,12,2, 10 ,7646,1544,1233,10423
12/2/2015,2015,12,2, 11 ,7938,1597,1269,10804
12/2/2015,2015,12,2, 12 ,7825,1550,1242,10617
12/2/2015,2015,12,2, 13 ,7828,1551,1235,10614
12/2/2015,2015,12,2, 14 ,8182,1608,1260,11050
12/2/2015,2015,12,2, 15 ,8052,1583,1276,10911
12/2/2015,2015,12,2, 16 ,7894,1551,1253,10698
12/2/2015,2015,12,2, 17 ,7612,1512,1209,10333
12/2/2015,2015,12,2, 18 ,7944,1689,1289,10922
12/2/2015,2015,12,2, 19 ,7766,1664,1306,10736
12/2/2015,2015,12,2, 20 ,7600,1594,1324,10518
12/2/2015,2015,12,2, 21 ,7384,1520,1273,10177
12/2/2015,2015,12,2, 22 ,6959,1352,1125,9436
12/2/2015,2015,12,2, 23 ,6485,1235,1030,8750
12/2/2015,2015,12,2, 24 ,6037,1166,1067,8270
12/3/2015,2015,12,3, 1 ,5723,1138,860,7721
12/3/2015,2015,12,3, 2 ,5514,1111,877,7502
12/3/2015,2015,12,3, 3 ,5416,1079,867,7362
12/3/2015,2015,12,3, 4 ,5356,1076,892,7324
12/3/2015,2015,12,3, 5 ,5462,1092,936,7490
12/3/2015,2015,12,3, 6 ,5575,1105,988,7668
12/3/2015,2015,12,3, 7 ,5564,1077,930,7571
12/3/2015,2015,12,3, 8 ,6338,1203,1077,8618
12/3/2015,2015,12,3, 9 ,7177,1429,1187,9793
12/3/2015,2015,12,3, 10 ,7649,1537,1249,10435
12/3/2015,2015,12,3, 11 ,8020,1593,1281,10894
12/3/2015,2015,12,3, 12 ,7878,1543,1248,10669
12/3/2015,2015,12,3, 13 ,7812,1550,1255,10617
12/3/2015,2015,12,3, 14 ,8177,1595,1265,11037
12/3/2015,2015,12,3, 15 ,8052,1571,1262,10885
12/3/2015,2015,12,3, 16 ,7867,1557,1254,10678
12/3/2015,2015,12,3, 17 ,7550,1504,1206,10260
12/3/2015,2015,12,3, 18 ,7932,1686,1261,10879
12/3/2015,2015,12,3, 19 ,7784,1637,1256,10677
12/3/2015,2015,12,3, 20 ,7602,1587,1266,10455
12/3/2015,2015,12,3, 21 ,7447,1512,1240,10199
12/3/2015,2015,12,3, 22 ,7046,1376,1186,9608
12/3/2015,2015,12,3, 23 ,6551,1248,1087,8886
12/3/2015,2015,12,3, 24 ,6090,1169,1020,8279
12/4/2015,2015,12,4, 1 ,5842,1120,995,7957
12/4/2015,2015,12,4, 2 ,5660,1090,970,7720
12/4/2015,2015,12,4, 3 ,5503,1064,943,7510
12/4/2015,2015,12,4, 4 ,5365,1050,939,7354
12/4/2015,2015,12,4, 5 ,5515,1082,976,7573
12/4/2015,2015,12,4, 6 ,5615,1109,1023,7747
12/4/2015,2015,12,4, 7 ,5713,1074,948,7735
12/4/2015,2015,12,4, 8 ,6434,1233,1052,8719
12/4/2015,2015,12,4, 9 ,7257,1458,1197,9912
12/4/2015,2015,12,4, 10 ,7737,1552,1223,10512
12/4/2015,2015,12,4, 11 ,8000,1594,1197,10791
12/4/2015,2015,12,4, 12 ,7858,1554,1201,10613
12/4/2015,2015,12,4, 13 ,7834,1547,1228,10609
12/4/2015,2015,12,4, 14 ,8196,1616,1240,11052
12/4/2015,2015,12,4, 15 ,8027,1595,1251,10873
12/4/2015,2015,12,4, 16 ,7838,1560,1243,10641
12/4/2015,2015,12,4, 17 ,7460,1505,1224,10189
12/4/2015,2015,12,4, 18 ,7865,1692,1362,10919
12/4/2015,2015,12,4, 19 ,7676,1651,1302,10629
12/4/2015,2015,12,4, 20 ,7583,1602,1320,10505
12/4/2015,2015,12,4, 21 ,7322,1519,1270,10111
12/4/2015,2015,12,4, 22 ,6940,1373,1194,9507
12/4/2015,2015,12,4, 23 ,6553,1253,1112,8918
12/4/2015,2015,12,4, 24 ,6117,1187,1082,8386
12/5/2015,2015,12,5, 1 ,5843,1133,1029,8005
12/5/2015,2015,12,5, 2 ,5690,1100,1003,7793
12/5/2015,2015,12,5, 3 ,5534,1063,981,7578
12/5/2015,2015,12,5, 4 ,5436,1032,970,7438
12/5/2015,2015,12,5, 5 ,5408,1061,981,7450
12/5/2015,2015,12,5, 6 ,5449,1069,982,7500
12/5/2015,2015,12,5, 7 ,5459,1085,986,7530
12/5/2015,2015,12,5, 8 ,5917,1191,1039,8147
12/5/2015,2015,12,5, 9 ,6462,1349,1197,9008
12/5/2015,2015,12,5, 10 ,7003,1447,1254,9704
12/5/2015,2015,12,5, 11 ,7313,1512,1252,10077
12/5/2015,2015,12,5, 12 ,7149,1484,1231,9864
12/5/2015,2015,12,5, 13 ,7056,1475,1239,9770
12/5/2015,2015,12,5, 14 ,7243,1518,1258,10019
12/5/2015,2015,12,5, 15 ,7096,1489,1270,9855
12/5/2015,2015,12,5, 16 ,6937,1455,1257,9649
12/5/2015,2015,12,5, 17 ,6686,1405,1230,9321
12/5/2015,2015,12,5, 18 ,7388,1641,1316,10345
12/5/2015,2015,12,5, 19 ,7333,1615,1343,10291
12/5/2015,2015,12,5, 20 ,7194,1565,1326,10085
12/5/2015,2015,12,5, 21 ,7118,1486,1272,9876
12/5/2015,2015,12,5, 22 ,6856,1391,1208,9455
12/5/2015,2015,12,5, 23 ,6427,1278,1167,8872
12/5/2015,2015,12,5, 24 ,6025,1169,1084,8278
12/6/2015,2015,12,6, 1 ,5714,1139,1022,7875
12/6/2015,2015,12,6, 2 ,5583,1089,995,7667
12/6/2015,2015,12,6, 3 ,5414,1060,903,7377
12/6/2015,2015,12,6, 4 ,5296,1040,945,7281
12/6/2015,2015,12,6, 5 ,5266,1044,954,7264
12/6/2015,2015,12,6, 6 ,5117,1024,949,7090
12/6/2015,2015,12,6, 7 ,5116,1014,930,7060
12/6/2015,2015,12,6, 8 ,5407,1078,965,7450
12/6/2015,2015,12,6, 9 ,5763,1177,1024,7964
12/6/2015,2015,12,6, 10 ,6254,1260,1097,8611
12/6/2015,2015,12,6, 11 ,6512,1319,1136,8967
12/6/2015,2015,12,6, 12 ,6519,1314,1124,8957
12/6/2015,2015,12,6, 13 ,6547,1309,1135,8991
12/6/2015,2015,12,6, 14 ,6633,1320,1149,9102
12/6/2015,2015,12,6, 15 ,6514,1296,1126,8936
12/6/2015,2015,12,6, 16 ,6366,1280,1140,8786
12/6/2015,2015,12,6, 17 ,6202,1288,1140,8630
12/6/2015,2015,12,6, 18 ,6958,1559,1254,9771
12/6/2015,2015,12,6, 19 ,7019,1551,1223,9793
12/6/2015,2015,12,6, 20 ,7033,1521,1216,9770
12/6/2015,2015,12,6, 21 ,6869,1453,1209,9531
12/6/2015,2015,12,6, 22 ,6614,1333,1128,9075
12/6/2015,2015,12,6, 23 ,6203,1235,1074,8512
12/6/2015,2015,12,6, 24 ,5850,1160,1021,8031
12/7/2015,2015,12,7, 1 ,5536,1103,954,7593
12/7/2015,2015,12,7, 2 ,5313,1057,917,7287
12/7/2015,2015,12,7, 3 ,5187,1034,918,7139
12/7/2015,2015,12,7, 4 ,5105,1022,908,7035
12/7/2015,2015,12,7, 5 ,5247,1058,958,7263
12/7/2015,2015,12,7, 6 ,5464,1099,991,7554
12/7/2015,2015,12,7, 7 ,5525,1069,937,7531
12/7/2015,2015,12,7, 8 ,6353,1220,1089,8662
12/7/2015,2015,12,7, 9 ,7303,1460,1264,10027
12/7/2015,2015,12,7, 10 ,7827,1568,1329,10724
12/7/2015,2015,12,7, 11 ,8084,1626,1297,11007
12/7/2015,2015,12,7, 12 ,7938,1587,1278,10803
12/7/2015,2015,12,7, 13 ,7961,1591,1303,10855
12/7/2015,2015,12,7, 14 ,8267,1646,1354,11267
12/7/2015,2015,12,7, 15 ,8161,1624,1299,11084
12/7/2015,2015,12,7, 16 ,7970,1591,1305,10866
12/7/2015,2015,12,7, 17 ,7667,1533,1286,10486
12/7/2015,2015,12,7, 18 ,7989,1708,1351,11048
12/7/2015,2015,12,7, 19 ,7899,1696,1357,10952
12/7/2015,2015,12,7, 20 ,7731,1606,1335,10672
12/7/2015,2015,12,7, 21 ,7599,1534,1330,10463
12/7/2015,2015,12,7, 22 ,7189,1398,1178,9765
12/7/2015,2015,12,7, 23 ,6734,1296,1131,9161
12/7/2015,2015,12,7, 24 ,6268,1214,1164,8646
12/8/2015,2015,12,8, 1 ,5973,1175,1046,8194
12/8/2015,2015,12,8, 2 ,5823,1131,1010,7964
12/8/2015,2015,12,8, 3 ,5641,1097,945,7683
12/8/2015,2015,12,8, 4 ,5577,1072,958,7607
12/8/2015,2015,12,8, 5 ,5679,1109,1004,7792
12/8/2015,2015,12,8, 6 ,5771,1122,1002,7895
12/8/2015,2015,12,8, 7 ,5808,1089,968,7865
12/8/2015,2015,12,8, 8 ,6474,1239,1138,8851
12/8/2015,2015,12,8, 9 ,7184,1461,1235,9880
12/8/2015,2015,12,8, 10 ,7676,1567,1281,10524
12/8/2015,2015,12,8, 11 ,7931,1616,1319,10866
12/8/2015,2015,12,8, 12 ,7807,1572,1276,10655
12/8/2015,2015,12,8, 13 ,7804,1584,1296,10684
12/8/2015,2015,12,8, 14 ,8103,1643,1310,11056
12/8/2015,2015,12,8, 15 ,7957,1601,1324,10882
12/8/2015,2015,12,8, 16 ,7816,1577,1336,10729
12/8/2015,2015,12,8, 17 ,7505,1529,1294,10328
12/8/2015,2015,12,8, 18 ,7928,1702,1406,11036
12/8/2015,2015,12,8, 19 ,7809,1678,1380,10867
12/8/2015,2015,12,8, 20 ,7661,1601,1348,10610
12/8/2015,2015,12,8, 21 ,7499,1544,1332,10375
12/8/2015,2015,12,8, 22 ,7204,1392,1241,9837
12/8/2015,2015,12,8, 23 ,6754,1285,1136,9175
12/8/2015,2015,12,8, 24 ,6311,1188,1074,8573
12/9/2015,2015,12,9, 1 ,6012,1157,1021,8190
12/9/2015,2015,12,9, 2 ,5848,1116,989,7953
12/9/2015,2015,12,9, 3 ,5662,1089,960,7711
12/9/2015,2015,12,9, 4 ,5634,1075,946,7655
12/9/2015,2015,12,9, 5 ,5785,1102,993,7880
12/9/2015,2015,12,9, 6 ,5888,1131,1025,8044
12/9/2015,2015,12,9, 7 ,5863,1085,963,7911
12/9/2015,2015,12,9, 8 ,6591,1240,1104,8935
12/9/2015,2015,12,9, 9 ,7377,1456,1240,10073
12/9/2015,2015,12,9, 10 ,7811,1549,1313,10673
12/9/2015,2015,12,9, 11 ,8075,1614,1322,11011
12/9/2015,2015,12,9, 12 ,7959,1572,1300,10831
12/9/2015,2015,12,9, 13 ,7876,1573,1315,10764
12/9/2015,2015,12,9, 14 ,8239,1635,1332,11206
12/9/2015,2015,12,9, 15 ,8134,1607,1346,11087
12/9/2015,2015,12,9, 16 ,7989,1585,1318,10892
12/9/2015,2015,12,9, 17 ,7694,1526,1265,10485
12/9/2015,2015,12,9, 18 ,8093,1725,1365,11183
12/9/2015,2015,12,9, 19 ,7941,1678,1353,10972
12/9/2015,2015,12,9, 20 ,7816,1636,1359,10811
12/9/2015,2015,12,9, 21 ,7609,1551,1323,10483
12/9/2015,2015,12,9, 22 ,7313,1399,1239,9951
12/9/2015,2015,12,9, 23 ,6820,1288,1182,9290
12/9/2015,2015,12,9, 24 ,6404,1211,1094,8709
12/10/2015,2015,12,10, 1 ,6082,1148,1032,8262
12/10/2015,2015,12,10, 2 ,5887,1113,1007,8007
12/10/2015,2015,12,10, 3 ,5714,1072,980,7766
12/10/2015,2015,12,10, 4 ,5635,1058,977,7670
12/10/2015,2015,12,10, 5 ,5781,1097,1012,7890
12/10/2015,2015,12,10, 6 ,5852,1117,1046,8015
12/10/2015,2015,12,10, 7 ,5874,1075,988,7937
12/10/2015,2015,12,10, 8 ,6658,1243,1098,8999
12/10/2015,2015,12,10, 9 ,7527,1475,1267,10269
12/10/2015,2015,12,10, 10 ,7946,1586,1363,10895
12/10/2015,2015,12,10, 11 ,8288,1620,1389,11297
12/10/2015,2015,12,10, 12 ,8122,1592,1337,11051
12/10/2015,2015,12,10, 13 ,8141,1598,1357,11096
12/10/2015,2015,12,10, 14 ,8440,1667,1405,11512
12/10/2015,2015,12,10, 15 ,8313,1652,1385,11350
12/10/2015,2015,12,10, 16 ,8153,1608,1369,11130
12/10/2015,2015,12,10, 17 ,7858,1540,1336,10734
12/10/2015,2015,12,10, 18 ,8203,1721,1437,11361
12/10/2015,2015,12,10, 19 ,8090,1700,1389,11179
12/10/2015,2015,12,10, 20 ,7978,1634,1365,10977
12/10/2015,2015,12,10, 21 ,7808,1550,1330,10688
12/10/2015,2015,12,10, 22 ,7443,1417,1219,10079
12/10/2015,2015,12,10, 23 ,6934,1301,1116,9351
12/10/2015,2015,12,10, 24 ,6455,1207,1032,8694
12/11/2015,2015,12,11, 1 ,6162,1154,1000,8316
12/11/2015,2015,12,11, 2 ,5998,1111,956,8065
12/11/2015,2015,12,11, 3 ,5775,1085,931,7791
12/11/2015,2015,12,11, 4 ,5687,1065,917,7669
12/11/2015,2015,12,11, 5 ,5754,1103,953,7810
12/11/2015,2015,12,11, 6 ,5829,1119,980,7928
12/11/2015,2015,12,11, 7 ,5888,1083,935,7906
12/11/2015,2015,12,11, 8 ,6568,1250,1067,8885
12/11/2015,2015,12,11, 9 ,7349,1469,1250,10068
12/11/2015,2015,12,11, 10 ,7880,1546,1334,10760
12/11/2015,2015,12,11, 11 ,8126,1615,1371,11112
12/11/2015,2015,12,11, 12 ,7975,1579,1316,10870
12/11/2015,2015,12,11, 13 ,8011,1605,1380,10996
12/11/2015,2015,12,11, 14 ,8292,1664,1417,11373
12/11/2015,2015,12,11, 15 ,8140,1644,1358,11142
12/11/2015,2015,12,11, 16 ,7961,1617,1342,10920
12/11/2015,2015,12,11, 17 ,7686,1538,1324,10548
12/11/2015,2015,12,11, 18 ,8057,1706,1431,11194
12/11/2015,2015,12,11, 19 ,7911,1691,1392,10994
12/11/2015,2015,12,11, 20 ,7783,1646,1380,10809
12/11/2015,2015,12,11, 21 ,7607,1576,1347,10530
12/11/2015,2015,12,11, 22 ,7257,1442,1276,9975
12/11/2015,2015,12,11, 23 ,6805,1330,1177,9312
12/11/2015,2015,12,11, 24 ,6401,1237,1115,8753
12/12/2015,2015,12,12, 1 ,6051,1182,1047,8280
12/12/2015,2015,12,12, 2 ,5861,1139,1006,8006
12/12/2015,2015,12,12, 3 ,5670,1112,977,7759
12/12/2015,2015,12,12, 4 ,5566,1090,960,7616
12/12/2015,2015,12,12, 5 ,5505,1086,975,7566
12/12/2015,2015,12,12, 6 ,5483,1075,955,7513
12/12/2015,2015,12,12, 7 ,5549,1081,969,7599
12/12/2015,2015,12,12, 8 ,6103,1130,1044,8277
12/12/2015,2015,12,12, 9 ,6645,1340,1197,9182
12/12/2015,2015,12,12, 10 ,7190,1441,1267,9898
12/12/2015,2015,12,12, 11 ,7407,1483,1290,10180
12/12/2015,2015,12,12, 12 ,7267,1477,1253,9997
12/12/2015,2015,12,12, 13 ,7271,1486,1275,10032
12/12/2015,2015,12,12, 14 ,7500,1514,1321,10335
12/12/2015,2015,12,12, 15 ,7281,1474,1305,10060
12/12/2015,2015,12,12, 16 ,7148,1433,1289,9870
12/12/2015,2015,12,12, 17 ,6922,1390,1267,9579
12/12/2015,2015,12,12, 18 ,7454,1627,1420,10501
12/12/2015,2015,12,12, 19 ,7479,1612,1393,10484
12/12/2015,2015,12,12, 20 ,7431,1563,1369,10363
12/12/2015,2015,12,12, 21 ,7289,1493,1342,10124
12/12/2015,2015,12,12, 22 ,7086,1379,1270,9735
12/12/2015,2015,12,12, 23 ,6741,1287,1166,9194
12/12/2015,2015,12,12, 24 ,6269,1171,1089,8529
12/13/2015,2015,12,13, 1 ,5969,1118,1017,8104
12/13/2015,2015,12,13, 2 ,5742,1073,982,7797
12/13/2015,2015,12,13, 3 ,5586,1039,951,7576
12/13/2015,2015,12,13, 4 ,5457,1024,943,7424
12/13/2015,2015,12,13, 5 ,5390,1015,946,7351
12/13/2015,2015,12,13, 6 ,5329,1002,952,7283
12/13/2015,2015,12,13, 7 ,5228,992,939,7159
12/13/2015,2015,12,13, 8 ,5521,1043,707,7271
12/13/2015,2015,12,13, 9 ,5929,1116,1057,8102
12/13/2015,2015,12,13, 10 ,6420,1202,1126,8748
12/13/2015,2015,12,13, 11 ,6616,1258,1161,9035
12/13/2015,2015,12,13, 12 ,6607,1260,1150,9017
12/13/2015,2015,12,13, 13 ,6592,1253,1161,9006
12/13/2015,2015,12,13, 14 ,6643,1256,1159,9058
12/13/2015,2015,12,13, 15 ,6575,1233,1160,8968
12/13/2015,2015,12,13, 16 ,6406,1229,1128,8763
12/13/2015,2015,12,13, 17 ,6214,1247,1170,8631
12/13/2015,2015,12,13, 18 ,6919,1510,1329,9758
12/13/2015,2015,12,13, 19 ,7068,1530,1357,9955
12/13/2015,2015,12,13, 20 ,7060,1502,1342,9904
12/13/2015,2015,12,13, 21 ,6955,1421,1311,9687
12/13/2015,2015,12,13, 22 ,6676,1325,1173,9174
12/13/2015,2015,12,13, 23 ,6253,1201,1095,8549
12/13/2015,2015,12,13, 24 ,5883,1139,1058,8080
12/14/2015,2015,12,14, 1 ,5561,1084,990,7635
12/14/2015,2015,12,14, 2 ,5384,1049,936,7369
12/14/2015,2015,12,14, 3 ,5237,1019,924,7180
12/14/2015,2015,12,14, 4 ,5174,1010,916,7100
12/14/2015,2015,12,14, 5 ,5336,1042,953,7331
12/14/2015,2015,12,14, 6 ,5560,1088,1009,7657
12/14/2015,2015,12,14, 7 ,5639,1061,950,7650
12/14/2015,2015,12,14, 8 ,6343,1185,1062,8590
12/14/2015,2015,12,14, 9 ,7199,1389,1259,9847
12/14/2015,2015,12,14, 10 ,7620,1484,1355,10459
12/14/2015,2015,12,14, 11 ,7923,1506,1410,10839
12/14/2015,2015,12,14, 12 ,7756,1456,1379,10591
12/14/2015,2015,12,14, 13 ,7698,1453,1381,10532
12/14/2015,2015,12,14, 14 ,8064,1509,1410,10983
12/14/2015,2015,12,14, 15 ,7943,1501,1406,10850
12/14/2015,2015,12,14, 16 ,7747,1497,1379,10623
12/14/2015,2015,12,14, 17 ,7535,1469,1322,10326
12/14/2015,2015,12,14, 18 ,7873,1611,1410,10894
12/14/2015,2015,12,14, 19 ,7653,1577,1411,10641
12/14/2015,2015,12,14, 20 ,7502,1531,1388,10421
12/14/2015,2015,12,14, 21 ,7253,1460,1307,10020
12/14/2015,2015,12,14, 22 ,6920,1332,1217,9469
12/14/2015,2015,12,14, 23 ,6448,1214,1167,8829
12/14/2015,2015,12,14, 24 ,6009,1142,1064,8215
12/15/2015,2015,12,15, 1 ,5729,1100,1025,7854
12/15/2015,2015,12,15, 2 ,5514,1068,1005,7587
12/15/2015,2015,12,15, 3 ,5381,1041,986,7408
12/15/2015,2015,12,15, 4 ,5336,1025,969,7330
12/15/2015,2015,12,15, 5 ,5430,1058,1010,7498
12/15/2015,2015,12,15, 6 ,5527,1100,1044,7671
12/15/2015,2015,12,15, 7 ,5659,1066,972,7697
12/15/2015,2015,12,15, 8 ,6330,1197,1120,8647
12/15/2015,2015,12,15, 9 ,6922,1408,1275,9605
12/15/2015,2015,12,15, 10 ,7245,1502,1349,10096
12/15/2015,2015,12,15, 11 ,7425,1549,1378,10352
12/15/2015,2015,12,15, 12 ,7168,1520,1392,10080
12/15/2015,2015,12,15, 13 ,6998,1529,1389,9916
12/15/2015,2015,12,15, 14 ,7165,1589,1388,10142
12/15/2015,2015,12,15, 15 ,7020,1545,1352,9917
12/15/2015,2015,12,15, 16 ,6982,1539,1336,9857
12/15/2015,2015,12,15, 17 ,6931,1512,1318,9761
12/15/2015,2015,12,15, 18 ,7113,1661,1409,10183
12/15/2015,2015,12,15, 19 ,6873,1667,1419,9959
12/15/2015,2015,12,15, 20 ,6692,1616,1374,9682
12/15/2015,2015,12,15, 21 ,6460,1541,1339,9340
12/15/2015,2015,12,15, 22 ,6079,1401,1219,8699
12/15/2015,2015,12,15, 23 ,5661,1295,1157,8113
12/15/2015,2015,12,15, 24 ,5268,1201,1081,7550
12/16/2015,2015,12,16, 1 ,5040,1148,1066,7254
12/16/2015,2015,12,16, 2 ,4893,1111,1012,7016
12/16/2015,2015,12,16, 3 ,4808,1087,1000,6895
12/16/2015,2015,12,16, 4 ,4796,1084,990,6870
12/16/2015,2015,12,16, 5 ,4913,1087,1011,7011
12/16/2015,2015,12,16, 6 ,5057,1117,1024,7198
12/16/2015,2015,12,16, 7 ,5384,1101,979,7464
12/16/2015,2015,12,16, 8 ,5721,1241,1128,8090
12/16/2015,2015,12,16, 9 ,6531,1449,1234,9214
12/16/2015,2015,12,16, 10 ,6774,1542,1312,9628
12/16/2015,2015,12,16, 11 ,7100,1593,1343,10036
12/16/2015,2015,12,16, 12 ,6972,1569,1335,9876
12/16/2015,2015,12,16, 13 ,6778,1571,1366,9715
12/16/2015,2015,12,16, 14 ,7024,1608,1383,10015
12/16/2015,2015,12,16, 15 ,6943,1600,1380,9923
12/16/2015,2015,12,16, 16 ,6938,1551,1373,9862
12/16/2015,2015,12,16, 17 ,6849,1508,1337,9694
12/16/2015,2015,12,16, 18 ,7013,1693,1436,10142
12/16/2015,2015,12,16, 19 ,6812,1662,1435,9909
12/16/2015,2015,12,16, 20 ,6576,1628,1413,9617
12/16/2015,2015,12,16, 21 ,6392,1560,1335,9287
12/16/2015,2015,12,16, 22 ,5843,1410,1220,8473
12/16/2015,2015,12,16, 23 ,5661,1292,1147,8100
12/16/2015,2015,12,16, 24 ,5062,1216,1157,7435
12/17/2015,2015,12,17, 1 ,4767,1163,1034,6964
12/17/2015,2015,12,17, 2 ,4661,1121,998,6780
12/17/2015,2015,12,17, 3 ,4582,1099,964,6645
12/17/2015,2015,12,17, 4 ,4619,1092,960,6671
12/17/2015,2015,12,17, 5 ,4815,1101,978,6894
12/17/2015,2015,12,17, 6 ,5011,1128,1021,7160
12/17/2015,2015,12,17, 7 ,5212,1107,982,7301
12/17/2015,2015,12,17, 8 ,5800,1243,1106,8149
12/17/2015,2015,12,17, 9 ,6317,1430,1268,9015
12/17/2015,2015,12,17, 10 ,6681,1532,1349,9562
12/17/2015,2015,12,17, 11 ,6865,1575,1394,9834
12/17/2015,2015,12,17, 12 ,6693,1534,1379,9606
12/17/2015,2015,12,17, 13 ,6582,1534,1409,9525
12/17/2015,2015,12,17, 14 ,6863,1595,1427,9885
12/17/2015,2015,12,17, 15 ,6715,1573,1396,9684
12/17/2015,2015,12,17, 16 ,6655,1549,1387,9591
12/17/2015,2015,12,17, 17 ,6583,1504,1340,9427
12/17/2015,2015,12,17, 18 ,6990,1679,1473,10142
12/17/2015,2015,12,17, 19 ,6812,1649,1439,9900
12/17/2015,2015,12,17, 20 ,6637,1601,1399,9637
12/17/2015,2015,12,17, 21 ,6409,1514,1340,9263
12/17/2015,2015,12,17, 22 ,5969,1373,1258,8600
12/17/2015,2015,12,17, 23 ,5556,1257,1142,7955
12/17/2015,2015,12,17, 24 ,5153,1185,1083,7421
12/18/2015,2015,12,18, 1 ,5002,1133,1043,7178
12/18/2015,2015,12,18, 2 ,4884,1100,1009,6993
12/18/2015,2015,12,18, 3 ,4770,1076,989,6835
12/18/2015,2015,12,18, 4 ,4728,1068,979,6775
12/18/2015,2015,12,18, 5 ,4831,1070,994,6895
12/18/2015,2015,12,18, 6 ,4986,1111,1030,7127
12/18/2015,2015,12,18, 7 ,5231,1096,995,7322
12/18/2015,2015,12,18, 8 ,5845,1219,1107,8171
12/18/2015,2015,12,18, 9 ,6378,1382,1277,9037
12/18/2015,2015,12,18, 10 ,6828,1462,1337,9627
12/18/2015,2015,12,18, 11 ,7036,1480,1405,9921
12/18/2015,2015,12,18, 12 ,6973,1425,1365,9763
12/18/2015,2015,12,18, 13 ,6840,1391,1394,9625
12/18/2015,2015,12,18, 14 ,7113,1452,1432,9997
12/18/2015,2015,12,18, 15 ,7026,1411,1397,9834
12/18/2015,2015,12,18, 16 ,6888,1418,1371,9677
12/18/2015,2015,12,18, 17 ,6772,1426,1377,9575
12/18/2015,2015,12,18, 18 ,7254,1561,1438,10253
12/18/2015,2015,12,18, 19 ,7089,1536,1450,10075
12/18/2015,2015,12,18, 20 ,6890,1476,1401,9767
12/18/2015,2015,12,18, 21 ,6685,1390,1337,9412
12/18/2015,2015,12,18, 22 ,6333,1261,1251,8845
12/18/2015,2015,12,18, 23 ,5892,1163,1143,8198
12/18/2015,2015,12,18, 24 ,5449,1082,1109,7640
12/19/2015,2015,12,19, 1 ,5109,1034,989,7132
12/19/2015,2015,12,19, 2 ,4993,1008,957,6958
12/19/2015,2015,12,19, 3 ,4811,981,944,6736
12/19/2015,2015,12,19, 4 ,4849,972,937,6758
12/19/2015,2015,12,19, 5 ,4861,979,921,6761
12/19/2015,2015,12,19, 6 ,5023,1005,953,6981
12/19/2015,2015,12,19, 7 ,5051,1025,968,7044
12/19/2015,2015,12,19, 8 ,5529,1104,999,7632
12/19/2015,2015,12,19, 9 ,6086,1235,1083,8404
12/19/2015,2015,12,19, 10 ,6366,1290,1117,8773
12/19/2015,2015,12,19, 11 ,6487,1352,1189,9028
12/19/2015,2015,12,19, 12 ,6342,1307,1139,8788
12/19/2015,2015,12,19, 13 ,6148,1281,1130,8559
12/19/2015,2015,12,19, 14 ,6206,1310,1126,8642
12/19/2015,2015,12,19, 15 ,6009,1279,1126,8414
12/19/2015,2015,12,19, 16 ,5916,1268,1111,8295
12/19/2015,2015,12,19, 17 ,5949,1261,1156,8366
12/19/2015,2015,12,19, 18 ,6366,1470,1309,9145
12/19/2015,2015,12,19, 19 ,6364,1441,1285,9090
12/19/2015,2015,12,19, 20 ,6133,1389,1214,8736
12/19/2015,2015,12,19, 21 ,5964,1329,1168,8461
12/19/2015,2015,12,19, 22 ,5585,1234,1064,7883
12/19/2015,2015,12,19, 23 ,5251,1143,981,7375
12/19/2015,2015,12,19, 24 ,4921,1054,907,6882
12/20/2015,2015,12,20, 1 ,4671,997,850,6518
12/20/2015,2015,12,20, 2 ,4528,971,830,6329
12/20/2015,2015,12,20, 3 ,4399,952,813,6164
12/20/2015,2015,12,20, 4 ,4404,943,813,6160
12/20/2015,2015,12,20, 5 ,4369,945,827,6141
12/20/2015,2015,12,20, 6 ,4423,942,851,6216
12/20/2015,2015,12,20, 7 ,4423,944,860,6227
12/20/2015,2015,12,20, 8 ,4690,972,896,6558
12/20/2015,2015,12,20, 9 ,5184,1058,961,7203
12/20/2015,2015,12,20, 10 ,5673,1137,1044,7854
12/20/2015,2015,12,20, 11 ,5826,1199,1065,8090
12/20/2015,2015,12,20, 12 ,5852,1204,1073,8129
12/20/2015,2015,12,20, 13 ,5720,1213,1084,8017
12/20/2015,2015,12,20, 14 ,5784,1237,1138,8159
12/20/2015,2015,12,20, 15 ,5720,1235,1138,8093
12/20/2015,2015,12,20, 16 ,5630,1215,1133,7978
12/20/2015,2015,12,20, 17 ,5593,1229,1132,7954
12/20/2015,2015,12,20, 18 ,6404,1486,1350,9240
12/20/2015,2015,12,20, 19 ,6464,1503,1356,9323
12/20/2015,2015,12,20, 20 ,6406,1472,1326,9204
12/20/2015,2015,12,20, 21 ,6280,1375,1211,8866
12/20/2015,2015,12,20, 22 ,5969,1287,1119,8375
12/20/2015,2015,12,20, 23 ,5578,1174,1038,7790
12/20/2015,2015,12,20, 24 ,5181,1099,969,7249
12/21/2015,2015,12,21, 1 ,4976,1025,926,6927
12/21/2015,2015,12,21, 2 ,4744,984,897,6625
12/21/2015,2015,12,21, 3 ,4634,967,871,6472
12/21/2015,2015,12,21, 4 ,4619,962,867,6448
12/21/2015,2015,12,21, 5 ,4649,974,888,6511
12/21/2015,2015,12,21, 6 ,4838,998,904,6740
12/21/2015,2015,12,21, 7 ,5032,1011,934,6977
12/21/2015,2015,12,21, 8 ,5792,1148,1057,7997
12/21/2015,2015,12,21, 9 ,6552,1371,1238,9161
12/21/2015,2015,12,21, 10 ,7097,1485,1337,9919
12/21/2015,2015,12,21, 11 ,7381,1539,1422,10342
12/21/2015,2015,12,21, 12 ,7309,1497,1373,10179
12/21/2015,2015,12,21, 13 ,7239,1504,1408,10151
12/21/2015,2015,12,21, 14 ,7491,1561,1446,10498
12/21/2015,2015,12,21, 15 ,7357,1535,1419,10311
12/21/2015,2015,12,21, 16 ,7216,1505,1415,10136
12/21/2015,2015,12,21, 17 ,6975,1409,1358,9742
12/21/2015,2015,12,21, 18 ,7347,1599,1500,10446
12/21/2015,2015,12,21, 19 ,7188,1586,1467,10241
12/21/2015,2015,12,21, 20 ,6953,1541,1430,9924
12/21/2015,2015,12,21, 21 ,6645,1482,1356,9483
12/21/2015,2015,12,21, 22 ,6358,1354,1246,8958
12/21/2015,2015,12,21, 23 ,5938,1232,1158,8328
12/21/2015,2015,12,21, 24 ,5584,1159,1114,7857
12/22/2015,2015,12,22, 1 ,5252,1103,1007,7362
12/22/2015,2015,12,22, 2 ,5050,1063,974,7087
12/22/2015,2015,12,22, 3 ,4978,1050,950,6978
12/22/2015,2015,12,22, 4 ,4908,1035,933,6876
12/22/2015,2015,12,22, 5 ,4985,1040,947,6972
12/22/2015,2015,12,22, 6 ,5115,1054,964,7133
12/22/2015,2015,12,22, 7 ,5255,1070,960,7285
12/22/2015,2015,12,22, 8 ,5867,1191,1069,8127
12/22/2015,2015,12,22, 9 ,6548,1396,1241,9185
12/22/2015,2015,12,22, 10 ,6981,1507,1202,9690
12/22/2015,2015,12,22, 11 ,7273,1566,1407,10246
12/22/2015,2015,12,22, 12 ,7169,1508,1386,10063
12/22/2015,2015,12,22, 13 ,7142,1509,1412,10063
12/22/2015,2015,12,22, 14 ,7439,1568,1414,10421
12/22/2015,2015,12,22, 15 ,7262,1516,1391,10169
12/22/2015,2015,12,22, 16 ,7148,1480,1387,10015
12/22/2015,2015,12,22, 17 ,6824,1436,1322,9582
12/22/2015,2015,12,22, 18 ,7187,1613,1510,10310
12/22/2015,2015,12,22, 19 ,7073,1604,1468,10145
12/22/2015,2015,12,22, 20 ,6870,1569,1415,9854
12/22/2015,2015,12,22, 21 ,6681,1475,1354,9510
12/22/2015,2015,12,22, 22 ,6375,1327,1260,8962
12/22/2015,2015,12,22, 23 ,5939,1222,1107,8268
12/22/2015,2015,12,22, 24 ,5485,1141,1033,7659
12/23/2015,2015,12,23, 1 ,5216,1076,1002,7294
12/23/2015,2015,12,23, 2 ,4973,1043,959,6975
12/23/2015,2015,12,23, 3 ,4836,1034,931,6801
12/23/2015,2015,12,23, 4 ,4754,1020,928,6702
12/23/2015,2015,12,23, 5 ,4804,1023,933,6760
12/23/2015,2015,12,23, 6 ,4899,1029,944,6872
12/23/2015,2015,12,23, 7 ,4984,1026,946,6956
12/23/2015,2015,12,23, 8 ,5592,1139,1053,7784
12/23/2015,2015,12,23, 9 ,6214,1320,1180,8714
12/23/2015,2015,12,23, 10 ,6716,1415,1273,9404
12/23/2015,2015,12,23, 11 ,7030,1466,1331,9827
12/23/2015,2015,12,23, 12 ,6885,1434,1192,9511
12/23/2015,2015,12,23, 13 ,6885,1438,1270,9593
12/23/2015,2015,12,23, 14 ,7077,1471,1353,9901
12/23/2015,2015,12,23, 15 ,6885,1431,1340,9656
12/23/2015,2015,12,23, 16 ,6709,1405,1316,9430
12/23/2015,2015,12,23, 17 ,6385,1391,1295,9071
12/23/2015,2015,12,23, 18 ,6807,1523,1455,9785
12/23/2015,2015,12,23, 19 ,6739,1545,1415,9699
12/23/2015,2015,12,23, 20 ,6590,1503,1405,9498
12/23/2015,2015,12,23, 21 ,6428,1430,1369,9227
12/23/2015,2015,12,23, 22 ,6121,1296,1242,8659
12/23/2015,2015,12,23, 23 ,5777,1196,1157,8130
12/23/2015,2015,12,23, 24 ,5379,1110,1055,7544
12/24/2015,2015,12,24, 1 ,5082,1054,1004,7140
12/24/2015,2015,12,24, 2 ,4852,1018,972,6842
12/24/2015,2015,12,24, 3 ,4681,1002,937,6620
12/24/2015,2015,12,24, 4 ,4566,987,925,6478
12/24/2015,2015,12,24, 5 ,4567,988,926,6481
12/24/2015,2015,12,24, 6 ,4553,996,924,6473
12/24/2015,2015,12,24, 7 ,4449,998,924,6371
12/24/2015,2015,12,24, 8 ,4650,1058,982,6690
12/24/2015,2015,12,24, 9 ,5090,1154,1111,7355
12/24/2015,2015,12,24, 10 ,5429,1205,1183,7817
12/24/2015,2015,12,24, 11 ,5685,1244,1218,8147
12/24/2015,2015,12,24, 12 ,5689,1227,1207,8123
12/24/2015,2015,12,24, 13 ,5731,1227,1225,8183
12/24/2015,2015,12,24, 14 ,5784,1237,1232,8253
12/24/2015,2015,12,24, 15 ,5657,1220,1219,8096
12/24/2015,2015,12,24, 16 ,5494,1203,1176,7873
12/24/2015,2015,12,24, 17 ,5392,1232,1153,7777
12/24/2015,2015,12,24, 18 ,6017,1443,1332,8792
12/24/2015,2015,12,24, 19 ,6073,1439,1327,8839
12/24/2015,2015,12,24, 20 ,5761,1358,1253,8372
12/24/2015,2015,12,24, 21 ,5448,1292,1211,7951
12/24/2015,2015,12,24, 22 ,5212,1215,1144,7571
12/24/2015,2015,12,24, 23 ,5019,1161,1047,7227
12/24/2015,2015,12,24, 24 ,4841,1130,1058,7029
12/25/2015,2015,12,25, 1 ,4589,1082,1016,6687
12/25/2015,2015,12,25, 2 ,4445,1025,955,6425
12/25/2015,2015,12,25, 3 ,4286,979,914,6179
12/25/2015,2015,12,25, 4 ,4124,962,883,5969
12/25/2015,2015,12,25, 5 ,4070,953,879,5902
12/25/2015,2015,12,25, 6 ,4018,937,844,5799
12/25/2015,2015,12,25, 7 ,3907,919,824,5650
12/25/2015,2015,12,25, 8 ,4008,942,856,5806
12/25/2015,2015,12,25, 9 ,4183,1003,894,6080
12/25/2015,2015,12,25, 10 ,4454,1051,950,6455
12/25/2015,2015,12,25, 11 ,4629,1100,996,6725
12/25/2015,2015,12,25, 12 ,4808,1140,1013,6961
12/25/2015,2015,12,25, 13 ,4847,1154,1035,7036
12/25/2015,2015,12,25, 14 ,4904,1155,1059,7118
12/25/2015,2015,12,25, 15 ,4884,1142,1050,7076
12/25/2015,2015,12,25, 16 ,4791,1122,1037,6950
12/25/2015,2015,12,25, 17 ,4765,1121,1036,6922
12/25/2015,2015,12,25, 18 ,5344,1356,1100,7800
12/25/2015,2015,12,25, 19 ,5587,1390,1275,8252
12/25/2015,2015,12,25, 20 ,5521,1337,1222,8080
12/25/2015,2015,12,25, 21 ,5401,1278,1196,7875
12/25/2015,2015,12,25, 22 ,5127,1182,1075,7384
12/25/2015,2015,12,25, 23 ,4797,1087,981,6865
12/25/2015,2015,12,25, 24 ,4519,1023,928,6470
12/26/2015,2015,12,26, 1 ,4286,981,883,6150
12/26/2015,2015,12,26, 2 ,4129,951,846,5926
12/26/2015,2015,12,26, 3 ,3997,924,826,5747
12/26/2015,2015,12,26, 4 ,3918,909,810,5637
12/26/2015,2015,12,26, 5 ,3925,900,811,5636
12/26/2015,2015,12,26, 6 ,4007,905,816,5728
12/26/2015,2015,12,26, 7 ,4114,917,834,5865
12/26/2015,2015,12,26, 8 ,4431,1011,914,6356
12/26/2015,2015,12,26, 9 ,4964,1149,1043,7156
12/26/2015,2015,12,26, 10 ,5486,1228,1136,7850
12/26/2015,2015,12,26, 11 ,5756,1287,1188,8231
12/26/2015,2015,12,26, 12 ,5745,1300,1197,8242
12/26/2015,2015,12,26, 13 ,5753,1303,1217,8273
12/26/2015,2015,12,26, 14 ,5813,1329,1230,8372
12/26/2015,2015,12,26, 15 ,5764,1310,1227,8301
12/26/2015,2015,12,26, 16 ,5714,1282,1206,8202
12/26/2015,2015,12,26, 17 ,5598,1255,1190,8043
12/26/2015,2015,12,26, 18 ,6205,1471,1346,9022
12/26/2015,2015,12,26, 19 ,6341,1499,1375,9215
12/26/2015,2015,12,26, 20 ,6241,1454,1327,9022
12/26/2015,2015,12,26, 21 ,6111,1380,1268,8759
12/26/2015,2015,12,26, 22 ,5713,1268,1172,8153
12/26/2015,2015,12,26, 23 ,5358,1179,1078,7615
12/26/2015,2015,12,26, 24 ,4979,1090,988,7057
12/27/2015,2015,12,27, 1 ,4739,1016,942,6697
12/27/2015,2015,12,27, 2 ,4571,1000,901,6472
12/27/2015,2015,12,27, 3 ,4416,964,876,6256
12/27/2015,2015,12,27, 4 ,4316,952,863,6131
12/27/2015,2015,12,27, 5 ,4279,955,869,6103
12/27/2015,2015,12,27, 6 ,4309,949,870,6128
12/27/2015,2015,12,27, 7 ,4381,951,863,6195
12/27/2015,2015,12,27, 8 ,4704,1003,921,6628
12/27/2015,2015,12,27, 9 ,5066,1098,1012,7176
12/27/2015,2015,12,27, 10 ,5570,1177,1099,7846
12/27/2015,2015,12,27, 11 ,5845,1218,1142,8205
12/27/2015,2015,12,27, 12 ,5822,1205,1119,8146
12/27/2015,2015,12,27, 13 ,5812,1202,1147,8161
12/27/2015,2015,12,27, 14 ,5879,1214,1151,8244
12/27/2015,2015,12,27, 15 ,5872,1198,1147,8217
12/27/2015,2015,12,27, 16 ,5761,1196,1131,8088
12/27/2015,2015,12,27, 17 ,5695,1201,1166,8062
12/27/2015,2015,12,27, 18 ,6268,1390,1342,9000
12/27/2015,2015,12,27, 19 ,6406,1458,1355,9219
12/27/2015,2015,12,27, 20 ,6322,1414,1298,9034
12/27/2015,2015,12,27, 21 ,6150,1349,1250,8749
12/27/2015,2015,12,27, 22 ,5788,1255,1133,8176
12/27/2015,2015,12,27, 23 ,5404,1168,1071,7643
12/27/2015,2015,12,27, 24 ,5104,1097,1007,7208
12/28/2015,2015,12,28, 1 ,4785,1026,950,6761
12/28/2015,2015,12,28, 2 ,4612,994,919,6525
12/28/2015,2015,12,28, 3 ,4466,966,875,6307
12/28/2015,2015,12,28, 4 ,4344,955,869,6168
12/28/2015,2015,12,28, 5 ,4357,974,880,6211
12/28/2015,2015,12,28, 6 ,4522,988,897,6407
12/28/2015,2015,12,28, 7 ,4620,997,909,6526
12/28/2015,2015,12,28, 8 ,5252,1110,1029,7391
12/28/2015,2015,12,28, 9 ,5990,1304,1184,8478
12/28/2015,2015,12,28, 10 ,6447,1409,1283,9139
12/28/2015,2015,12,28, 11 ,6832,1454,1303,9589
12/28/2015,2015,12,28, 12 ,6721,1414,1229,9364
12/28/2015,2015,12,28, 13 ,6727,1416,1255,9398
12/28/2015,2015,12,28, 14 ,6927,1464,1304,9695
12/28/2015,2015,12,28, 15 ,6820,1440,1320,9580
12/28/2015,2015,12,28, 16 ,6637,1400,1281,9318
12/28/2015,2015,12,28, 17 ,6359,1344,1251,8954
12/28/2015,2015,12,28, 18 ,6690,1493,1377,9560
12/28/2015,2015,12,28, 19 ,6663,1493,1348,9504
12/28/2015,2015,12,28, 20 ,6445,1451,1300,9196
12/28/2015,2015,12,28, 21 ,6226,1370,1234,8830
12/28/2015,2015,12,28, 22 ,5831,1255,1093,8179
12/28/2015,2015,12,28, 23 ,5382,1156,1008,7546
12/28/2015,2015,12,28, 24 ,4985,1085,936,7006
12/29/2015,2015,12,29, 1 ,4755,1037,902,6694
12/29/2015,2015,12,29, 2 ,4584,995,882,6461
12/29/2015,2015,12,29, 3 ,4472,970,858,6300
12/29/2015,2015,12,29, 4 ,4399,964,857,6220
12/29/2015,2015,12,29, 5 ,4453,980,865,6298
12/29/2015,2015,12,29, 6 ,4533,985,882,6400
12/29/2015,2015,12,29, 7 ,4700,995,890,6585
12/29/2015,2015,12,29, 8 ,5227,1093,1005,7325
12/29/2015,2015,12,29, 9 ,5908,1278,1186,8372
12/29/2015,2015,12,29, 10 ,6474,1356,1271,9101
12/29/2015,2015,12,29, 11 ,6618,1401,1335,9354
12/29/2015,2015,12,29, 12 ,6578,1355,1322,9255
12/29/2015,2015,12,29, 13 ,6551,1349,1325,9225
12/29/2015,2015,12,29, 14 ,6782,1397,1378,9557
12/29/2015,2015,12,29, 15 ,6644,1382,1366,9392
12/29/2015,2015,12,29, 16 ,6428,1332,1347,9107
12/29/2015,2015,12,29, 17 ,6176,1297,1258,8731
12/29/2015,2015,12,29, 18 ,6512,1469,1415,9396
12/29/2015,2015,12,29, 19 ,6562,1475,1404,9441
12/29/2015,2015,12,29, 20 ,6376,1422,1364,9162
12/29/2015,2015,12,29, 21 ,6136,1339,1299,8774
12/29/2015,2015,12,29, 22 ,5740,1206,1198,8144
12/29/2015,2015,12,29, 23 ,5355,1109,1102,7566
12/29/2015,2015,12,29, 24 ,5012,1043,1021,7076
12/30/2015,2015,12,30, 1 ,4790,991,962,6743
12/30/2015,2015,12,30, 2 ,4571,963,934,6468
12/30/2015,2015,12,30, 3 ,4416,939,903,6258
12/30/2015,2015,12,30, 4 ,4325,917,885,6127
12/30/2015,2015,12,30, 5 ,4342,929,898,6169
12/30/2015,2015,12,30, 6 ,4385,925,890,6200
12/30/2015,2015,12,30, 7 ,4310,932,890,6132
12/30/2015,2015,12,30, 8 ,4588,1001,967,6556
12/30/2015,2015,12,30, 9 ,4970,1121,1075,7166
12/30/2015,2015,12,30, 10 ,5509,1220,1153,7882
12/30/2015,2015,12,30, 11 ,5700,1270,1202,8172
12/30/2015,2015,12,30, 12 ,5713,1268,1202,8183
12/30/2015,2015,12,30, 13 ,5697,1261,1202,8160
12/30/2015,2015,12,30, 14 ,5751,1282,1219,8252
12/30/2015,2015,12,30, 15 ,5695,1264,1197,8156
12/30/2015,2015,12,30, 16 ,5535,1239,1178,7952
12/30/2015,2015,12,30, 17 ,5454,1219,1188,7861
12/30/2015,2015,12,30, 18 ,5949,1435,1371,8755
12/30/2015,2015,12,30, 19 ,6160,1471,1385,9016
12/30/2015,2015,12,30, 20 ,6060,1428,1321,8809
12/30/2015,2015,12,30, 21 ,5860,1360,1293,8513
12/30/2015,2015,12,30, 22 ,5492,1247,1204,7943
12/30/2015,2015,12,30, 23 ,5191,1137,1110,7438
12/30/2015,2015,12,30, 24 ,4854,1061,1014,6929
12/31/2015,2015,12,31, 1 ,4576,1005,973,6554
12/31/2015,2015,12,31, 2 ,4384,980,932,6296
12/31/2015,2015,12,31, 3 ,4226,955,904,6085
12/31/2015,2015,12,31, 4 ,4121,934,890,5945
12/31/2015,2015,12,31, 5 ,4133,939,895,5967
12/31/2015,2015,12,31, 6 ,4160,947,904,6011
12/31/2015,2015,12,31, 7 ,4157,949,888,5994
12/31/2015,2015,12,31, 8 ,4309,1023,945,6277
12/31/2015,2015,12,31, 9 ,4658,1121,986,6765
12/31/2015,2015,12,31, 10 ,4959,1175,1112,7246
12/31/2015,2015,12,31, 11 ,5180,1219,1115,7514
12/31/2015,2015,12,31, 12 ,5193,1221,1154,7568
12/31/2015,2015,12,31, 13 ,5089,1221,1160,7470
12/31/2015,2015,12,31, 14 ,5057,1239,1177,7473
12/31/2015,2015,12,31, 15 ,4953,1218,1163,7334
12/31/2015,2015,12,31, 16 ,4905,1199,1122,7226
12/31/2015,2015,12,31, 17 ,4965,1203,1106,7274
12/31/2015,2015,12,31, 18 ,5544,1412,1260,8216
12/31/2015,2015,12,31, 19 ,5590,1455,1306,8351
12/31/2015,2015,12,31, 20 ,5369,1391,1236,7996
12/31/2015,2015,12,31, 21 ,5193,1332,1200,7725
12/31/2015,2015,12,31, 22 ,5025,1290,1169,7484
12/31/2015,2015,12,31, 23 ,4907,1261,1140,7308
12/31/2015,2015,12,31, 24 ,4808,1281,1114,7203
1/1/2016,2016,1,1, 1 ,4694,1216,1036,6946
1/1/2016,2016,1,1, 2 ,4332,1093,965,6390
1/1/2016,2016,1,1, 3 ,4090,1023,922,6035
1/1/2016,2016,1,1, 4 ,3948,980,877,5805
1/1/2016,2016,1,1, 5 ,3848,954,845,5647
1/1/2016,2016,1,1, 6 ,3775,901,803,5479
1/1/2016,2016,1,1, 7 ,3654,878,786,5318
1/1/2016,2016,1,1, 8 ,3678,902,808,5388
1/1/2016,2016,1,1, 9 ,3771,927,829,5527
1/1/2016,2016,1,1, 10 ,3948,960,863,5771
1/1/2016,2016,1,1, 11 ,4172,1001,893,6066
1/1/2016,2016,1,1, 12 ,4381,1050,924,6355
1/1/2016,2016,1,1, 13 ,4420,1076,962,6458
1/1/2016,2016,1,1, 14 ,4401,1079,973,6453
1/1/2016,2016,1,1, 15 ,4369,1068,978,6415
1/1/2016,2016,1,1, 16 ,4345,1047,962,6354
1/1/2016,2016,1,1, 17 ,4397,1024,940,6361
1/1/2016,2016,1,1, 18 ,5033,1250,1094,7377
1/1/2016,2016,1,1, 19 ,5247,1320,1205,7772
1/1/2016,2016,1,1, 20 ,5209,1246,1185,7640
1/1/2016,2016,1,1, 21 ,5088,1211,1163,7462
1/1/2016,2016,1,1, 22 ,4783,1125,1081,6989
1/1/2016,2016,1,1, 23 ,4528,1056,1008,6592
1/1/2016,2016,1,1, 24 ,4281,1003,984,6268
1/2/2016,2016,1,2, 1 ,4107,957,880,5944
1/2/2016,2016,1,2, 2 ,3963,920,848,5731
1/2/2016,2016,1,2, 3 ,3833,901,830,5564
1/2/2016,2016,1,2, 4 ,3778,879,807,5464
1/2/2016,2016,1,2, 5 ,3766,877,834,5477
1/2/2016,2016,1,2, 6 ,3828,873,828,5529
1/2/2016,2016,1,2, 7 ,3906,891,817,5614
1/2/2016,2016,1,2, 8 ,4268,945,856,6069
1/2/2016,2016,1,2, 9 ,4647,1049,945,6641
1/2/2016,2016,1,2, 10 ,5219,1148,1025,7392
1/2/2016,2016,1,2, 11 ,5474,1205,1093,7772
1/2/2016,2016,1,2, 12 ,5514,1206,1103,7823
1/2/2016,2016,1,2, 13 ,5532,1224,1084,7840
1/2/2016,2016,1,2, 14 ,5599,1244,1098,7941
1/2/2016,2016,1,2, 15 ,5500,1232,1111,7843
1/2/2016,2016,1,2, 16 ,5424,1196,1118,7738
1/2/2016,2016,1,2, 17 ,5420,1170,1120,7710
1/2/2016,2016,1,2, 18 ,5977,1391,1264,8632
1/2/2016,2016,1,2, 19 ,6160,1446,1306,8912
1/2/2016,2016,1,2, 20 ,5953,1391,1242,8586
1/2/2016,2016,1,2, 21 ,5789,1314,1173,8276
1/2/2016,2016,1,2, 22 ,5506,1213,1095,7814
1/2/2016,2016,1,2, 23 ,5144,1127,1010,7281
1/2/2016,2016,1,2, 24 ,4886,1048,920,6854
1/3/2016,2016,1,3, 1 ,4666,998,880,6544
1/3/2016,2016,1,3, 2 ,4527,963,866,6356
1/3/2016,2016,1,3, 3 ,4405,928,850,6183
1/3/2016,2016,1,3, 4 ,4285,903,833,6021
1/3/2016,2016,1,3, 5 ,4255,909,844,6008
1/3/2016,2016,1,3, 6 ,4299,913,792,6004
1/3/2016,2016,1,3, 7 ,4267,901,843,6011
1/3/2016,2016,1,3, 8 ,4622,960,870,6452
1/3/2016,2016,1,3, 9 ,4974,1063,970,7007
1/3/2016,2016,1,3, 10 ,5454,1133,1047,7634
1/3/2016,2016,1,3, 11 ,5731,1195,1085,8011
1/3/2016,2016,1,3, 12 ,5740,1191,1113,8044
1/3/2016,2016,1,3, 13 ,5715,1193,1120,8028
1/3/2016,2016,1,3, 14 ,5836,1204,1132,8172
1/3/2016,2016,1,3, 15 ,5765,1184,1116,8065
1/3/2016,2016,1,3, 16 ,5619,1162,1119,7900
1/3/2016,2016,1,3, 17 ,5482,1160,1108,7750
1/3/2016,2016,1,3, 18 ,6072,1251,1299,8622
1/3/2016,2016,1,3, 19 ,6304,1393,1339,9036
1/3/2016,2016,1,3, 20 ,6258,1367,1295,8920
1/3/2016,2016,1,3, 21 ,6050,1280,1232,8562
1/3/2016,2016,1,3, 22 ,5687,1193,1142,8022
1/3/2016,2016,1,3, 23 ,5357,1109,1073,7539
1/3/2016,2016,1,3, 24 ,5006,1028,975,7009
1/4/2016,2016,1,4, 1 ,4740,982,928,6650
1/4/2016,2016,1,4, 2 ,4553,946,902,6401
1/4/2016,2016,1,4, 3 ,4390,927,877,6194
1/4/2016,2016,1,4, 4 ,4400,924,870,6194
1/4/2016,2016,1,4, 5 ,4523,965,911,6399
1/4/2016,2016,1,4, 6 ,4793,1026,970,6789
1/4/2016,2016,1,4, 7 ,4893,987,902,6782
1/4/2016,2016,1,4, 8 ,5670,1120,1024,7814
1/4/2016,2016,1,4, 9 ,6527,1345,1209,9081
1/4/2016,2016,1,4, 10 ,7116,1452,1298,9866
1/4/2016,2016,1,4, 11 ,7452,1517,1350,10319
1/4/2016,2016,1,4, 12 ,7385,1493,1347,10225
1/4/2016,2016,1,4, 13 ,7427,1491,1366,10284
1/4/2016,2016,1,4, 14 ,7753,1571,1406,10730
1/4/2016,2016,1,4, 15 ,7642,1573,1396,10611
1/4/2016,2016,1,4, 16 ,7508,1515,1373,10396
1/4/2016,2016,1,4, 17 ,7126,1455,1328,9909
1/4/2016,2016,1,4, 18 ,7307,1593,1436,10336
1/4/2016,2016,1,4, 19 ,7312,1580,1430,10322
1/4/2016,2016,1,4, 20 ,7131,1535,1389,10055
1/4/2016,2016,1,4, 21 ,6869,1464,1303,9636
1/4/2016,2016,1,4, 22 ,6428,1315,1185,8928
1/4/2016,2016,1,4, 23 ,5998,1222,1090,8310
1/4/2016,2016,1,4, 24 ,5588,1140,1014,7742
1/5/2016,2016,1,5, 1 ,5364,1088,971,7423
1/5/2016,2016,1,5, 2 ,5163,1054,939,7156
1/5/2016,2016,1,5, 3 ,5037,1011,910,6958
1/5/2016,2016,1,5, 4 ,4929,1005,896,6830
1/5/2016,2016,1,5, 5 ,5053,1041,930,7024
1/5/2016,2016,1,5, 6 ,5240,1083,995,7318
1/5/2016,2016,1,5, 7 ,5298,1035,921,7254
1/5/2016,2016,1,5, 8 ,5999,1163,1038,8200
1/5/2016,2016,1,5, 9 ,6842,1399,1223,9464
1/5/2016,2016,1,5, 10 ,7262,1503,1264,10029
1/5/2016,2016,1,5, 11 ,7717,1549,1404,10670
1/5/2016,2016,1,5, 12 ,7606,1527,1375,10508
1/5/2016,2016,1,5, 13 ,7585,1522,1389,10496
1/5/2016,2016,1,5, 14 ,7894,1577,1424,10895
1/5/2016,2016,1,5, 15 ,7756,1565,1389,10710
1/5/2016,2016,1,5, 16 ,7549,1534,1381,10464
1/5/2016,2016,1,5, 17 ,7228,1456,1345,10029
1/5/2016,2016,1,5, 18 ,7328,1568,1436,10332
1/5/2016,2016,1,5, 19 ,7387,1588,1448,10423
1/5/2016,2016,1,5, 20 ,7180,1530,1389,10099
1/5/2016,2016,1,5, 21 ,6838,1446,1334,9618
1/5/2016,2016,1,5, 22 ,6433,1307,1190,8930
1/5/2016,2016,1,5, 23 ,6007,1206,1097,8310
1/5/2016,2016,1,5, 24 ,5690,1131,985,7806
1/6/2016,2016,1,6, 1 ,5353,1079,977,7409
1/6/2016,2016,1,6, 2 ,5164,1042,943,7149
1/6/2016,2016,1,6, 3 ,5053,1011,906,6970
1/6/2016,2016,1,6, 4 ,4941,1006,897,6844
1/6/2016,2016,1,6, 5 ,5074,1042,943,7059
1/6/2016,2016,1,6, 6 ,5323,1088,984,7395
1/6/2016,2016,1,6, 7 ,5381,1045,915,7341
1/6/2016,2016,1,6, 8 ,5993,1170,1025,8188
1/6/2016,2016,1,6, 9 ,6783,1407,1225,9415
1/6/2016,2016,1,6, 10 ,7126,1505,1352,9983
1/6/2016,2016,1,6, 11 ,7540,1551,1396,10487
1/6/2016,2016,1,6, 12 ,7405,1516,1363,10284
1/6/2016,2016,1,6, 13 ,7426,1520,1395,10341
1/6/2016,2016,1,6, 14 ,7719,1595,1422,10736
1/6/2016,2016,1,6, 15 ,7584,1540,1426,10550
1/6/2016,2016,1,6, 16 ,7467,1535,1391,10393
1/6/2016,2016,1,6, 17 ,7249,1479,1338,10066
1/6/2016,2016,1,6, 18 ,7474,1576,1436,10486
1/6/2016,2016,1,6, 19 ,7493,1598,1463,10554
1/6/2016,2016,1,6, 20 ,7323,1561,1403,10287
1/6/2016,2016,1,6, 21 ,7094,1476,1343,9913
1/6/2016,2016,1,6, 22 ,6618,1339,1225,9182
1/6/2016,2016,1,6, 23 ,6225,1233,1119,8577
1/6/2016,2016,1,6, 24 ,5790,1149,1025,7964
1/7/2016,2016,1,7, 1 ,5532,1119,998,7649
1/7/2016,2016,1,7, 2 ,5338,1082,971,7391
1/7/2016,2016,1,7, 3 ,5267,1059,943,7269
1/7/2016,2016,1,7, 4 ,5211,1033,934,7178
1/7/2016,2016,1,7, 5 ,5336,1066,967,7369
1/7/2016,2016,1,7, 6 ,5557,1107,1015,7679
1/7/2016,2016,1,7, 7 ,5597,1061,926,7584
1/7/2016,2016,1,7, 8 ,6205,1195,1087,8487
1/7/2016,2016,1,7, 9 ,6942,1414,1259,9615
1/7/2016,2016,1,7, 10 ,7479,1501,1367,10347
1/7/2016,2016,1,7, 11 ,7752,1565,1419,10736
1/7/2016,2016,1,7, 12 ,7639,1541,1401,10581
1/7/2016,2016,1,7, 13 ,7589,1531,1403,10523
1/7/2016,2016,1,7, 14 ,7916,1607,1466,10989
1/7/2016,2016,1,7, 15 ,7702,1584,1439,10725
1/7/2016,2016,1,7, 16 ,7540,1528,1410,10478
1/7/2016,2016,1,7, 17 ,7243,1463,1361,10067
1/7/2016,2016,1,7, 18 ,7382,1581,1460,10423
1/7/2016,2016,1,7, 19 ,7379,1608,1478,10465
1/7/2016,2016,1,7, 20 ,7134,1541,1385,10060
1/7/2016,2016,1,7, 21 ,6856,1467,1347,9670
1/7/2016,2016,1,7, 22 ,6434,1304,1230,8968
1/7/2016,2016,1,7, 23 ,6070,1216,1128,8414
1/7/2016,2016,1,7, 24 ,5689,1130,1050,7869
1/8/2016,2016,1,8, 1 ,5491,1087,1013,7591
1/8/2016,2016,1,8, 2 ,5298,1059,972,7329
1/8/2016,2016,1,8, 3 ,5157,1036,941,7134
1/8/2016,2016,1,8, 4 ,5058,1017,932,7007
1/8/2016,2016,1,8, 5 ,5206,1043,966,7215
1/8/2016,2016,1,8, 6 ,5409,1092,1005,7506
1/8/2016,2016,1,8, 7 ,5390,1039,939,7368
1/8/2016,2016,1,8, 8 ,6055,1170,1071,8296
1/8/2016,2016,1,8, 9 ,6876,1383,1195,9454
1/8/2016,2016,1,8, 10 ,7396,1492,1368,10256
1/8/2016,2016,1,8, 11 ,7695,1551,1395,10641
1/8/2016,2016,1,8, 12 ,7561,1517,1385,10463
1/8/2016,2016,1,8, 13 ,7564,1526,1388,10478
1/8/2016,2016,1,8, 14 ,7868,1608,1456,10932
1/8/2016,2016,1,8, 15 ,7717,1585,1426,10728
1/8/2016,2016,1,8, 16 ,7544,1553,1410,10507
1/8/2016,2016,1,8, 17 ,7252,1467,1334,10053
1/8/2016,2016,1,8, 18 ,7399,1578,1457,10434
1/8/2016,2016,1,8, 19 ,7434,1612,1435,10481
1/8/2016,2016,1,8, 20 ,7221,1552,1394,10167
1/8/2016,2016,1,8, 21 ,7036,1470,1337,9843
1/8/2016,2016,1,8, 22 ,6627,1335,1196,9158
1/8/2016,2016,1,8, 23 ,6251,1236,1098,8585
1/8/2016,2016,1,8, 24 ,5881,1169,1048,8098
1/9/2016,2016,1,9, 1 ,5580,1114,1009,7703
1/9/2016,2016,1,9, 2 ,5362,1082,988,7432
1/9/2016,2016,1,9, 3 ,5193,1056,951,7200
1/9/2016,2016,1,9, 4 ,5069,1039,984,7092
1/9/2016,2016,1,9, 5 ,5098,1049,981,7128
1/9/2016,2016,1,9, 6 ,5196,1057,963,7216
1/9/2016,2016,1,9, 7 ,5212,1062,954,7228
1/9/2016,2016,1,9, 8 ,5689,1158,1022,7869
1/9/2016,2016,1,9, 9 ,6289,1328,1150,8767
1/9/2016,2016,1,9, 10 ,6873,1437,1253,9563
1/9/2016,2016,1,9, 11 ,7105,1502,1295,9902
1/9/2016,2016,1,9, 12 ,6992,1472,1276,9740
1/9/2016,2016,1,9, 13 ,6969,1473,1275,9717
1/9/2016,2016,1,9, 14 ,7191,1525,1323,10039
1/9/2016,2016,1,9, 15 ,7053,1495,1284,9832
1/9/2016,2016,1,9, 16 ,6858,1451,1274,9583
1/9/2016,2016,1,9, 17 ,6598,1377,1251,9226
1/9/2016,2016,1,9, 18 ,6872,1531,1358,9761
1/9/2016,2016,1,9, 19 ,7032,1576,1370,9978
1/9/2016,2016,1,9, 20 ,6790,1538,1323,9651
1/9/2016,2016,1,9, 21 ,6648,1456,1257,9361
1/9/2016,2016,1,9, 22 ,6314,1347,1152,8813
1/9/2016,2016,1,9, 23 ,5953,1254,1058,8265
1/9/2016,2016,1,9, 24 ,5594,1182,989,7765
1/10/2016,2016,1,10, 1 ,5389,1132,954,7475
1/10/2016,2016,1,10, 2 ,5188,1096,928,7212
1/10/2016,2016,1,10, 3 ,5063,1071,899,7033
1/10/2016,2016,1,10, 4 ,4949,1042,883,6874
1/10/2016,2016,1,10, 5 ,4894,1053,894,6841
1/10/2016,2016,1,10, 6 ,4838,1038,891,6767
1/10/2016,2016,1,10, 7 ,4824,1033,899,6756
1/10/2016,2016,1,10, 8 ,5056,1078,908,7042
1/10/2016,2016,1,10, 9 ,5435,1150,974,7559
1/10/2016,2016,1,10, 10 ,5925,1225,1083,8233
1/10/2016,2016,1,10, 11 ,6223,1269,1121,8613
1/10/2016,2016,1,10, 12 ,6181,1271,1132,8584
1/10/2016,2016,1,10, 13 ,6189,1271,1148,8608
1/10/2016,2016,1,10, 14 ,6217,1266,1142,8625
1/10/2016,2016,1,10, 15 ,6192,1257,1139,8588
1/10/2016,2016,1,10, 16 ,6073,1231,1127,8431
1/10/2016,2016,1,10, 17 ,5883,1242,1134,8259
1/10/2016,2016,1,10, 18 ,6407,1429,1316,9152
1/10/2016,2016,1,10, 19 ,6649,1491,1339,9479
1/10/2016,2016,1,10, 20 ,6550,1449,1313,9312
1/10/2016,2016,1,10, 21 ,6364,1378,1234,8976
1/10/2016,2016,1,10, 22 ,6082,1280,1144,8506
1/10/2016,2016,1,10, 23 ,5667,1179,1052,7898
1/10/2016,2016,1,10, 24 ,5378,1112,991,7481
1/11/2016,2016,1,11, 1 ,5073,1067,936,7076
1/11/2016,2016,1,11, 2 ,4906,1032,908,6846
1/11/2016,2016,1,11, 3 ,4794,1002,878,6674
1/11/2016,2016,1,11, 4 ,4722,1002,870,6594
1/11/2016,2016,1,11, 5 ,4936,1037,909,6882
1/11/2016,2016,1,11, 6 ,5176,1086,971,7233
1/11/2016,2016,1,11, 7 ,5336,1063,904,7303
1/11/2016,2016,1,11, 8 ,5999,1196,1047,8242
1/11/2016,2016,1,11, 9 ,6879,1433,1240,9552
1/11/2016,2016,1,11, 10 ,7401,1539,1363,10303
1/11/2016,2016,1,11, 11 ,7734,1603,1422,10759
1/11/2016,2016,1,11, 12 ,7619,1572,1408,10599
1/11/2016,2016,1,11, 13 ,7627,1584,1430,10641
1/11/2016,2016,1,11, 14 ,8012,1645,1497,11154
1/11/2016,2016,1,11, 15 ,7901,1618,1469,10988
1/11/2016,2016,1,11, 16 ,7752,1589,1421,10762
1/11/2016,2016,1,11, 17 ,7467,1513,1362,10342
1/11/2016,2016,1,11, 18 ,7577,1639,1451,10667
1/11/2016,2016,1,11, 19 ,7627,1679,1486,10792
1/11/2016,2016,1,11, 20 ,7516,1615,1441,10572
1/11/2016,2016,1,11, 21 ,7262,1537,1349,10148
1/11/2016,2016,1,11, 22 ,6837,1392,1248,9477
1/11/2016,2016,1,11, 23 ,6498,1275,1138,8911
1/11/2016,2016,1,11, 24 ,6085,1204,1057,8346
1/12/2016,2016,1,12, 1 ,5744,1166,1020,7930
1/12/2016,2016,1,12, 2 ,5572,1128,979,7679
1/12/2016,2016,1,12, 3 ,5385,1100,951,7436
1/12/2016,2016,1,12, 4 ,5295,1085,944,7324
1/12/2016,2016,1,12, 5 ,5481,1109,972,7562
1/12/2016,2016,1,12, 6 ,5666,1148,1033,7847
1/12/2016,2016,1,12, 7 ,5652,1100,954,7706
1/12/2016,2016,1,12, 8 ,6293,1243,1079,8615
1/12/2016,2016,1,12, 9 ,7070,1482,1258,9810
1/12/2016,2016,1,12, 10 ,7534,1586,1365,10485
1/12/2016,2016,1,12, 11 ,7831,1652,1416,10899
1/12/2016,2016,1,12, 12 ,7732,1611,1399,10742
1/12/2016,2016,1,12, 13 ,7732,1614,1419,10765
1/12/2016,2016,1,12, 14 ,8090,1693,1458,11241
1/12/2016,2016,1,12, 15 ,7992,1667,1424,11083
1/12/2016,2016,1,12, 16 ,7747,1618,1394,10759
1/12/2016,2016,1,12, 17 ,7444,1543,1326,10313
1/12/2016,2016,1,12, 18 ,7502,1643,1471,10616
1/12/2016,2016,1,12, 19 ,7543,1685,1480,10708
1/12/2016,2016,1,12, 20 ,7335,1639,1416,10390
1/12/2016,2016,1,12, 21 ,7038,1565,1374,9977
1/12/2016,2016,1,12, 22 ,6619,1411,1276,9306
1/12/2016,2016,1,12, 23 ,6200,1308,1097,8605
1/12/2016,2016,1,12, 24 ,5798,1226,1039,8063
1/13/2016,2016,1,13, 1 ,5551,1177,999,7727
1/13/2016,2016,1,13, 2 ,5397,1146,966,7509
1/13/2016,2016,1,13, 3 ,5305,1110,918,7333
1/13/2016,2016,1,13, 4 ,5171,1095,944,7210
1/13/2016,2016,1,13, 5 ,5363,1126,985,7474
1/13/2016,2016,1,13, 6 ,5545,1174,1059,7778
1/13/2016,2016,1,13, 7 ,5547,1136,988,7671
1/13/2016,2016,1,13, 8 ,6185,1251,1088,8524
1/13/2016,2016,1,13, 9 ,7027,1475,1271,9773
1/13/2016,2016,1,13, 10 ,7459,1585,1386,10430
1/13/2016,2016,1,13, 11 ,7779,1643,1422,10844
1/13/2016,2016,1,13, 12 ,7663,1618,1390,10671
1/13/2016,2016,1,13, 13 ,7648,1622,1379,10649
1/13/2016,2016,1,13, 14 ,7969,1684,1450,11103
1/13/2016,2016,1,13, 15 ,7860,1643,1422,10925
1/13/2016,2016,1,13, 16 ,7736,1608,1389,10733
1/13/2016,2016,1,13, 17 ,7449,1529,1343,10321
1/13/2016,2016,1,13, 18 ,7513,1620,1426,10559
1/13/2016,2016,1,13, 19 ,7651,1654,1470,10775
1/13/2016,2016,1,13, 20 ,7470,1604,1406,10480
1/13/2016,2016,1,13, 21 ,7270,1531,1334,10135
1/13/2016,2016,1,13, 22 ,6835,1406,1209,9450
1/13/2016,2016,1,13, 23 ,6377,1284,1118,8779
1/13/2016,2016,1,13, 24 ,6022,1211,1020,8253
1/14/2016,2016,1,14, 1 ,5711,1172,958,7841
1/14/2016,2016,1,14, 2 ,5565,1132,928,7625
1/14/2016,2016,1,14, 3 ,5402,1098,898,7398
1/14/2016,2016,1,14, 4 ,5342,1084,909,7335
1/14/2016,2016,1,14, 5 ,5488,1110,956,7554
1/14/2016,2016,1,14, 6 ,5623,1153,1018,7794
1/14/2016,2016,1,14, 7 ,5661,1106,949,7716
1/14/2016,2016,1,14, 8 ,6285,1242,1087,8614
1/14/2016,2016,1,14, 9 ,7045,1470,1238,9753
1/14/2016,2016,1,14, 10 ,7514,1552,1345,10411
1/14/2016,2016,1,14, 11 ,7815,1628,1388,10831
1/14/2016,2016,1,14, 12 ,7687,1593,1413,10693
1/14/2016,2016,1,14, 13 ,7699,1588,1378,10665
1/14/2016,2016,1,14, 14 ,8072,1674,1442,11188
1/14/2016,2016,1,14, 15 ,7941,1641,1412,10994
1/14/2016,2016,1,14, 16 ,7814,1611,1410,10835
1/14/2016,2016,1,14, 17 ,7440,1528,1325,10293
1/14/2016,2016,1,14, 18 ,7512,1608,1442,10562
1/14/2016,2016,1,14, 19 ,7574,1670,1473,10717
1/14/2016,2016,1,14, 20 ,7387,1605,1395,10387
1/14/2016,2016,1,14, 21 ,7156,1527,1324,10007
1/14/2016,2016,1,14, 22 ,6775,1381,1208,9364
1/14/2016,2016,1,14, 23 ,6336,1283,1088,8707
1/14/2016,2016,1,14, 24 ,5959,1202,960,8121
1/15/2016,2016,1,15, 1 ,5962,1150,928,8040
1/15/2016,2016,1,15, 2 ,5525,1116,883,7524
1/15/2016,2016,1,15, 3 ,5387,1093,878,7358
1/15/2016,2016,1,15, 4 ,5318,1076,892,7286
1/15/2016,2016,1,15, 5 ,5429,1098,940,7467
1/15/2016,2016,1,15, 6 ,5673,1139,993,7805
1/15/2016,2016,1,15, 7 ,5598,1096,937,7631
1/15/2016,2016,1,15, 8 ,6229,1234,1033,8496
1/15/2016,2016,1,15, 9 ,7030,1453,1220,9703
1/15/2016,2016,1,15, 10 ,7534,1555,1327,10416
1/15/2016,2016,1,15, 11 ,7831,1607,1370,10808
1/15/2016,2016,1,15, 12 ,7610,1571,1347,10528
1/15/2016,2016,1,15, 13 ,7621,1567,1366,10554
1/15/2016,2016,1,15, 14 ,7952,1642,1422,11016
1/15/2016,2016,1,15, 15 ,7851,1620,1402,10873
1/15/2016,2016,1,15, 16 ,7639,1588,1379,10606
1/15/2016,2016,1,15, 17 ,7318,1494,1317,10129
1/15/2016,2016,1,15, 18 ,7347,1573,1400,10320
1/15/2016,2016,1,15, 19 ,7462,1636,1430,10528
1/15/2016,2016,1,15, 20 ,7281,1577,1396,10254
1/15/2016,2016,1,15, 21 ,7085,1503,1331,9919
1/15/2016,2016,1,15, 22 ,6705,1371,1219,9295
1/15/2016,2016,1,15, 23 ,6339,1266,1104,8709
1/15/2016,2016,1,15, 24 ,5918,1186,971,8075
1/16/2016,2016,1,16, 1 ,5636,1130,949,7715
1/16/2016,2016,1,16, 2 ,5512,1084,914,7510
1/16/2016,2016,1,16, 3 ,5345,1046,914,7305
1/16/2016,2016,1,16, 4 ,5234,1030,922,7186
1/16/2016,2016,1,16, 5 ,5280,1039,919,7238
1/16/2016,2016,1,16, 6 ,5304,1059,962,7325
1/16/2016,2016,1,16, 7 ,5426,1058,925,7409
1/16/2016,2016,1,16, 8 ,5695,1155,1000,7850
1/16/2016,2016,1,16, 9 ,6423,1326,1129,8878
1/16/2016,2016,1,16, 10 ,6942,1397,1235,9574
1/16/2016,2016,1,16, 11 ,7250,1448,1291,9989
1/16/2016,2016,1,16, 12 ,7115,1427,1292,9834
1/16/2016,2016,1,16, 13 ,7095,1422,1313,9830
1/16/2016,2016,1,16, 14 ,7331,1463,1348,10142
1/16/2016,2016,1,16, 15 ,7162,1438,1339,9939
1/16/2016,2016,1,16, 16 ,6983,1396,1296,9675
1/16/2016,2016,1,16, 17 ,6647,1332,1243,9222
1/16/2016,2016,1,16, 18 ,6933,1474,1361,9768
1/16/2016,2016,1,16, 19 ,7137,1522,1401,10060
1/16/2016,2016,1,16, 20 ,7027,1470,1363,9860
1/16/2016,2016,1,16, 21 ,6859,1392,1296,9547
1/16/2016,2016,1,16, 22 ,6614,1293,1164,9071
1/16/2016,2016,1,16, 23 ,6233,1198,1096,8527
1/16/2016,2016,1,16, 24 ,5842,1118,982,7942
1/17/2016,2016,1,17, 1 ,5562,1064,810,7436
1/17/2016,2016,1,17, 2 ,5465,1028,863,7356
1/17/2016,2016,1,17, 3 ,5261,1006,830,7097
1/17/2016,2016,1,17, 4 ,5132,990,844,6966
1/17/2016,2016,1,17, 5 ,5073,976,869,6918
1/17/2016,2016,1,17, 6 ,5065,979,884,6928
1/17/2016,2016,1,17, 7 ,5011,976,879,6866
1/17/2016,2016,1,17, 8 ,5225,1024,914,7163
1/17/2016,2016,1,17, 9 ,5554,1118,976,7648
1/17/2016,2016,1,17, 10 ,5554,1170,1047,7771
1/17/2016,2016,1,17, 11 ,6287,1237,1121,8645
1/17/2016,2016,1,17, 12 ,6289,1224,1128,8641
1/17/2016,2016,1,17, 13 ,6325,1229,1139,8693
1/17/2016,2016,1,17, 14 ,6414,1241,1170,8825
1/17/2016,2016,1,17, 15 ,6307,1224,1151,8682
1/17/2016,2016,1,17, 16 ,6128,1205,1123,8456
1/17/2016,2016,1,17, 17 ,6000,1183,1114,8297
1/17/2016,2016,1,17, 18 ,6433,1352,1277,9062
1/17/2016,2016,1,17, 19 ,6810,1473,1342,9625
1/17/2016,2016,1,17, 20 ,6824,1424,1313,9561
1/17/2016,2016,1,17, 21 ,6630,1331,1245,9206
1/17/2016,2016,1,17, 22 ,6320,1231,1137,8688
1/17/2016,2016,1,17, 23 ,5941,1129,1044,8114
1/17/2016,2016,1,17, 24 ,5614,1073,991,7678
1/18/2016,2016,1,18, 1 ,5335,1023,934,7292
1/18/2016,2016,1,18, 2 ,5106,984,900,6990
1/18/2016,2016,1,18, 3 ,4986,954,879,6819
1/18/2016,2016,1,18, 4 ,4972,946,872,6790
1/18/2016,2016,1,18, 5 ,5075,983,906,6964
1/18/2016,2016,1,18, 6 ,5367,1041,981,7389
1/18/2016,2016,1,18, 7 ,5450,1023,902,7375
1/18/2016,2016,1,18, 8 ,6168,1148,1031,8347
1/18/2016,2016,1,18, 9 ,7050,1375,1135,9560
1/18/2016,2016,1,18, 10 ,7558,1481,1336,10375
1/18/2016,2016,1,18, 11 ,7900,1545,1393,10838
1/18/2016,2016,1,18, 12 ,7793,1537,1375,10705
1/18/2016,2016,1,18, 13 ,7812,1551,1362,10725
1/18/2016,2016,1,18, 14 ,8143,1612,1425,11180
1/18/2016,2016,1,18, 15 ,8029,1593,1425,11047
1/18/2016,2016,1,18, 16 ,7888,1549,1357,10794
1/18/2016,2016,1,18, 17 ,7525,1480,1344,10349
1/18/2016,2016,1,18, 18 ,7547,1575,1430,10552
1/18/2016,2016,1,18, 19 ,7656,1626,1411,10693
1/18/2016,2016,1,18, 20 ,7423,1563,1408,10394
1/18/2016,2016,1,18, 21 ,7217,1473,1355,10045
1/18/2016,2016,1,18, 22 ,6807,1325,1229,9361
1/18/2016,2016,1,18, 23 ,6387,1211,1155,8753
1/18/2016,2016,1,18, 24 ,6004,1132,1082,8218
1/19/2016,2016,1,19, 1 ,5740,1086,1021,7847
1/19/2016,2016,1,19, 2 ,5566,1050,996,7612
1/19/2016,2016,1,19, 3 ,5402,1035,970,7407
1/19/2016,2016,1,19, 4 ,5348,1019,958,7325
1/19/2016,2016,1,19, 5 ,5527,1053,1001,7581
1/19/2016,2016,1,19, 6 ,5711,1114,1057,7882
1/19/2016,2016,1,19, 7 ,5660,1063,982,7705
1/19/2016,2016,1,19, 8 ,6390,1208,1084,8682
1/19/2016,2016,1,19, 9 ,7170,1433,1257,9860
1/19/2016,2016,1,19, 10 ,7645,1535,1337,10517
1/19/2016,2016,1,19, 11 ,7936,1586,1370,10892
1/19/2016,2016,1,19, 12 ,7739,1548,1362,10649
1/19/2016,2016,1,19, 13 ,7707,1542,1377,10626
1/19/2016,2016,1,19, 14 ,8047,1609,1410,11066
1/19/2016,2016,1,19, 15 ,7883,1586,1410,10879
1/19/2016,2016,1,19, 16 ,7766,1557,1397,10720
1/19/2016,2016,1,19, 17 ,7492,1483,1340,10315
1/19/2016,2016,1,19, 18 ,7549,1572,1432,10553
1/19/2016,2016,1,19, 19 ,7680,1633,1452,10765
1/19/2016,2016,1,19, 20 ,7469,1573,1388,10430
1/19/2016,2016,1,19, 21 ,7258,1481,1311,10050
1/19/2016,2016,1,19, 22 ,6854,1354,1194,9402
1/19/2016,2016,1,19, 23 ,6464,1239,1098,8801
1/19/2016,2016,1,19, 24 ,6066,1164,1014,8244
1/20/2016,2016,1,20, 1 ,5834,1114,955,7903
1/20/2016,2016,1,20, 2 ,5678,1082,922,7682
1/20/2016,2016,1,20, 3 ,5499,1054,935,7488
1/20/2016,2016,1,20, 4 ,5433,1044,928,7405
1/20/2016,2016,1,20, 5 ,5539,1069,970,7578
1/20/2016,2016,1,20, 6 ,5707,1116,1027,7850
1/20/2016,2016,1,20, 7 ,5705,1081,966,7752
1/20/2016,2016,1,20, 8 ,6368,1213,1064,8645
1/20/2016,2016,1,20, 9 ,7140,1427,1223,9790
1/20/2016,2016,1,20, 10 ,7601,1511,1341,10453
1/20/2016,2016,1,20, 11 ,7889,1576,1396,10861
1/20/2016,2016,1,20, 12 ,7689,1539,1366,10594
1/20/2016,2016,1,20, 13 ,7667,1556,1359,10582
1/20/2016,2016,1,20, 14 ,8022,1643,1437,11102
1/20/2016,2016,1,20, 15 ,7839,1615,1427,10881
1/20/2016,2016,1,20, 16 ,7683,1572,1400,10655
1/20/2016,2016,1,20, 17 ,7346,1496,1352,10194
1/20/2016,2016,1,20, 18 ,7347,1568,1415,10330
1/20/2016,2016,1,20, 19 ,7551,1631,1444,10626
1/20/2016,2016,1,20, 20 ,7376,1556,1414,10346
1/20/2016,2016,1,20, 21 ,7057,1488,1329,9874
1/20/2016,2016,1,20, 22 ,6721,1349,1227,9297
1/20/2016,2016,1,20, 23 ,6305,1254,1139,8698
1/20/2016,2016,1,20, 24 ,5937,1182,996,8115
1/21/2016,2016,1,21, 1 ,5648,1118,1023,7789
1/21/2016,2016,1,21, 2 ,5489,1091,997,7577
1/21/2016,2016,1,21, 3 ,5333,1066,969,7368
1/21/2016,2016,1,21, 4 ,5264,1051,945,7260
1/21/2016,2016,1,21, 5 ,5431,1080,985,7496
1/21/2016,2016,1,21, 6 ,5691,1129,1056,7876
1/21/2016,2016,1,21, 7 ,5692,1089,982,7763
1/21/2016,2016,1,21, 8 ,6349,1215,1091,8655
1/21/2016,2016,1,21, 9 ,7160,1433,1269,9862
1/21/2016,2016,1,21, 10 ,7613,1533,1339,10485
1/21/2016,2016,1,21, 11 ,7903,1600,1349,10852
1/21/2016,2016,1,21, 12 ,7769,1581,1354,10704
1/21/2016,2016,1,21, 13 ,7748,1587,1361,10696
1/21/2016,2016,1,21, 14 ,8122,1658,1422,11202
1/21/2016,2016,1,21, 15 ,7933,1618,1395,10946
1/21/2016,2016,1,21, 16 ,7782,1580,1381,10743
1/21/2016,2016,1,21, 17 ,7465,1523,1325,10313
1/21/2016,2016,1,21, 18 ,7432,1597,1398,10427
1/21/2016,2016,1,21, 19 ,7692,1660,1433,10785
1/21/2016,2016,1,21, 20 ,7435,1609,1420,10464
1/21/2016,2016,1,21, 21 ,7191,1540,1368,10099
1/21/2016,2016,1,21, 22 ,6818,1410,1245,9473
1/21/2016,2016,1,21, 23 ,6394,1298,1150,8842
1/21/2016,2016,1,21, 24 ,5994,1215,1114,8323
1/22/2016,2016,1,22, 1 ,5715,1159,1000,7874
1/22/2016,2016,1,22, 2 ,5555,1125,977,7657
1/22/2016,2016,1,22, 3 ,5451,1102,946,7499
1/22/2016,2016,1,22, 4 ,5303,1084,890,7277
1/22/2016,2016,1,22, 5 ,5484,1103,966,7553
1/22/2016,2016,1,22, 6 ,5684,1139,1029,7852
1/22/2016,2016,1,22, 7 ,5700,1104,962,7766
1/22/2016,2016,1,22, 8 ,6270,1236,1092,8598
1/22/2016,2016,1,22, 9 ,7115,1450,1268,9833
1/22/2016,2016,1,22, 10 ,7606,1552,1369,10527
1/22/2016,2016,1,22, 11 ,7873,1603,1420,10896
1/22/2016,2016,1,22, 12 ,7712,1560,1410,10682
1/22/2016,2016,1,22, 13 ,7659,1578,1403,10640
1/22/2016,2016,1,22, 14 ,8087,1675,1462,11224
1/22/2016,2016,1,22, 15 ,7922,1638,1399,10959
1/22/2016,2016,1,22, 16 ,7821,1584,1392,10797
1/22/2016,2016,1,22, 17 ,7465,1503,1285,10253
1/22/2016,2016,1,22, 18 ,7478,1577,1420,10475
1/22/2016,2016,1,22, 19 ,7715,1647,1397,10759
1/22/2016,2016,1,22, 20 ,7492,1592,1366,10450
1/22/2016,2016,1,22, 21 ,7275,1521,1307,10103
1/22/2016,2016,1,22, 22 ,6939,1403,1220,9562
1/22/2016,2016,1,22, 23 ,6533,1295,1118,8946
1/22/2016,2016,1,22, 24 ,6109,1217,1053,8379
1/23/2016,2016,1,23, 1 ,5824,1166,1023,8013
1/23/2016,2016,1,23, 2 ,5611,1112,1007,7730
1/23/2016,2016,1,23, 3 ,5447,1083,972,7502
1/23/2016,2016,1,23, 4 ,5354,1064,966,7384
1/23/2016,2016,1,23, 5 ,5338,1068,977,7383
1/23/2016,2016,1,23, 6 ,5347,1080,1004,7431
1/23/2016,2016,1,23, 7 ,5438,1067,987,7492
1/23/2016,2016,1,23, 8 ,5852,1144,1056,8052
1/23/2016,2016,1,23, 9 ,6569,1331,1168,9068
1/23/2016,2016,1,23, 10 ,7076,1443,1204,9723
1/23/2016,2016,1,23, 11 ,7364,1496,1239,10099
1/23/2016,2016,1,23, 12 ,7265,1457,1242,9964
1/23/2016,2016,1,23, 13 ,7241,1470,1253,9964
1/23/2016,2016,1,23, 14 ,7456,1521,1143,10120
1/23/2016,2016,1,23, 15 ,7348,1494,1267,10109
1/23/2016,2016,1,23, 16 ,7106,1460,1260,9826
1/23/2016,2016,1,23, 17 ,6802,1371,1220,9393
1/23/2016,2016,1,23, 18 ,6989,1490,1344,9823
1/23/2016,2016,1,23, 19 ,7317,1575,1319,10211
1/23/2016,2016,1,23, 20 ,7199,1527,1325,10051
1/23/2016,2016,1,23, 21 ,7044,1457,1260,9761
1/23/2016,2016,1,23, 22 ,6747,1363,1182,9292
1/23/2016,2016,1,23, 23 ,6428,1256,1118,8802
1/23/2016,2016,1,23, 24 ,6006,1172,1076,8254
1/24/2016,2016,1,24, 1 ,5805,1121,994,7920
1/24/2016,2016,1,24, 2 ,5600,1087,966,7653
1/24/2016,2016,1,24, 3 ,5404,1062,929,7395
1/24/2016,2016,1,24, 4 ,5301,1046,910,7257
1/24/2016,2016,1,24, 5 ,5226,1046,918,7190
1/24/2016,2016,1,24, 6 ,5182,1027,933,7142
1/24/2016,2016,1,24, 7 ,5063,1033,920,7016
1/24/2016,2016,1,24, 8 ,5283,1091,950,7324
1/24/2016,2016,1,24, 9 ,5613,1180,982,7775
1/24/2016,2016,1,24, 10 ,6012,1251,1065,8328
1/24/2016,2016,1,24, 11 ,6206,1302,1110,8618
1/24/2016,2016,1,24, 12 ,6091,1294,1117,8502
1/24/2016,2016,1,24, 13 ,6180,1303,1137,8620
1/24/2016,2016,1,24, 14 ,6166,1304,1162,8632
1/24/2016,2016,1,24, 15 ,6043,1300,1144,8487
1/24/2016,2016,1,24, 16 ,5881,1264,1142,8287
1/24/2016,2016,1,24, 17 ,5828,1241,1116,8185
1/24/2016,2016,1,24, 18 ,6162,1390,1252,8804
1/24/2016,2016,1,24, 19 ,6513,1498,1317,9328
1/24/2016,2016,1,24, 20 ,6439,1467,1298,9204
1/24/2016,2016,1,24, 21 ,6235,1399,1234,8868
1/24/2016,2016,1,24, 22 ,5291,1291,1122,7704
1/24/2016,2016,1,24, 23 ,5596,1203,1015,7814
1/24/2016,2016,1,24, 24 ,5268,1132,1014,7414
1/25/2016,2016,1,25, 1 ,5018,1082,859,6959
1/25/2016,2016,1,25, 2 ,4837,1044,831,6712
1/25/2016,2016,1,25, 3 ,4734,1024,802,6560
1/25/2016,2016,1,25, 4 ,4738,1010,789,6537
1/25/2016,2016,1,25, 5 ,4935,1038,840,6813
1/25/2016,2016,1,25, 6 ,5183,1092,933,7208
1/25/2016,2016,1,25, 7 ,5263,1074,876,7213
1/25/2016,2016,1,25, 8 ,5857,1177,1021,8055
1/25/2016,2016,1,25, 9 ,6656,1404,1139,9199
1/25/2016,2016,1,25, 10 ,7103,1491,1199,9793
1/25/2016,2016,1,25, 11 ,7394,1518,1253,10165
1/25/2016,2016,1,25, 12 ,7229,1504,1228,9961
1/25/2016,2016,1,25, 13 ,7159,1454,1246,9859
1/25/2016,2016,1,25, 14 ,7473,1507,1267,10247
1/25/2016,2016,1,25, 15 ,7310,1482,1288,10080
1/25/2016,2016,1,25, 16 ,7181,1452,1266,9899
1/25/2016,2016,1,25, 17 ,6915,1420,1233,9568
1/25/2016,2016,1,25, 18 ,6920,1514,1288,9722
1/25/2016,2016,1,25, 19 ,7103,1526,1307,9936
1/25/2016,2016,1,25, 20 ,6839,1452,1306,9597
1/25/2016,2016,1,25, 21 ,6563,1348,1225,9136
1/25/2016,2016,1,25, 22 ,6151,1228,1118,8497
1/25/2016,2016,1,25, 23 ,5697,1126,1010,7833
1/25/2016,2016,1,25, 24 ,5419,1061,932,7412
1/26/2016,2016,1,26, 1 ,5195,1026,923,7144
1/26/2016,2016,1,26, 2 ,4997,998,898,6893
1/26/2016,2016,1,26, 3 ,4895,978,862,6735
1/26/2016,2016,1,26, 4 ,4832,958,859,6649
1/26/2016,2016,1,26, 5 ,5066,1007,892,6965
1/26/2016,2016,1,26, 6 ,5374,1071,963,7408
1/26/2016,2016,1,26, 7 ,5503,1064,911,7478
1/26/2016,2016,1,26, 8 ,5999,1145,987,8131
1/26/2016,2016,1,26, 9 ,6646,1333,1151,9130
1/26/2016,2016,1,26, 10 ,7101,1404,1251,9756
1/26/2016,2016,1,26, 11 ,7314,1427,1310,10051
1/26/2016,2016,1,26, 12 ,7124,1392,1234,9750
1/26/2016,2016,1,26, 13 ,7076,1381,1281,9738
1/26/2016,2016,1,26, 14 ,7368,1456,1285,10109
1/26/2016,2016,1,26, 15 ,7212,1423,1248,9883
1/26/2016,2016,1,26, 16 ,7112,1410,1236,9758
1/26/2016,2016,1,26, 17 ,6851,1400,1194,9445
1/26/2016,2016,1,26, 18 ,6887,1496,1262,9645
1/26/2016,2016,1,26, 19 ,7051,1511,1242,9804
1/26/2016,2016,1,26, 20 ,6772,1445,1234,9451
1/26/2016,2016,1,26, 21 ,6556,1331,1189,9076
1/26/2016,2016,1,26, 22 ,6119,1195,1098,8412
1/26/2016,2016,1,26, 23 ,5641,1095,1010,7746
1/26/2016,2016,1,26, 24 ,5369,1031,955,7355
1/27/2016,2016,1,27, 1 ,5134,995,928,7057
1/27/2016,2016,1,27, 2 ,5059,973,890,6922
1/27/2016,2016,1,27, 3 ,4893,959,874,6726
1/27/2016,2016,1,27, 4 ,4902,928,861,6691
1/27/2016,2016,1,27, 5 ,5138,991,910,7039
1/27/2016,2016,1,27, 6 ,5385,1045,970,7400
1/27/2016,2016,1,27, 7 ,5409,1041,892,7342
1/27/2016,2016,1,27, 8 ,5969,1118,1009,8096
1/27/2016,2016,1,27, 9 ,6618,1289,1140,9047
1/27/2016,2016,1,27, 10 ,7092,1350,1207,9649
1/27/2016,2016,1,27, 11 ,7371,1413,1268,10052
1/27/2016,2016,1,27, 12 ,7177,1337,1266,9780
1/27/2016,2016,1,27, 13 ,7183,1319,1285,9787
1/27/2016,2016,1,27, 14 ,7461,1377,1293,10131
1/27/2016,2016,1,27, 15 ,7355,1353,1270,9978
1/27/2016,2016,1,27, 16 ,7261,1353,1282,9896
1/27/2016,2016,1,27, 17 ,6998,1345,1219,9562
1/27/2016,2016,1,27, 18 ,7047,1452,1283,9782
1/27/2016,2016,1,27, 19 ,7160,1477,1311,9948
1/27/2016,2016,1,27, 20 ,6933,1385,1287,9605
1/27/2016,2016,1,27, 21 ,6683,1301,1254,9238
1/27/2016,2016,1,27, 22 ,6292,1176,1096,8564
1/27/2016,2016,1,27, 23 ,5572,1071,992,7635
1/27/2016,2016,1,27, 24 ,5922,1008,957,7887
1/28/2016,2016,1,28, 1 ,5322,956,909,7187
1/28/2016,2016,1,28, 2 ,5209,933,876,7018
1/28/2016,2016,1,28, 3 ,5062,919,853,6834
1/28/2016,2016,1,28, 4 ,4997,916,844,6757
1/28/2016,2016,1,28, 5 ,5229,950,884,7063
1/28/2016,2016,1,28, 6 ,5477,1018,925,7420
1/28/2016,2016,1,28, 7 ,5534,1013,870,7417
1/28/2016,2016,1,28, 8 ,6095,1093,979,8167
1/28/2016,2016,1,28, 9 ,6900,1296,1142,9338
1/28/2016,2016,1,28, 10 ,7299,1403,1208,9910
1/28/2016,2016,1,28, 11 ,7627,1437,1231,10295
1/28/2016,2016,1,28, 12 ,7438,1431,1214,10083
1/28/2016,2016,1,28, 13 ,7424,1421,1229,10074
1/28/2016,2016,1,28, 14 ,7779,1498,1293,10570
1/28/2016,2016,1,28, 15 ,7630,1483,1282,10395
1/28/2016,2016,1,28, 16 ,7508,1472,1302,10282
1/28/2016,2016,1,28, 17 ,7185,1424,1258,9867
1/28/2016,2016,1,28, 18 ,7196,1516,1310,10022
1/28/2016,2016,1,28, 19 ,7373,1559,1339,10271
1/28/2016,2016,1,28, 20 ,7161,1489,1320,9970
1/28/2016,2016,1,28, 21 ,6944,1412,1289,9645
1/28/2016,2016,1,28, 22 ,6549,1271,1199,9019
1/28/2016,2016,1,28, 23 ,6105,1169,1104,8378
1/28/2016,2016,1,28, 24 ,5736,1098,1008,7842
1/29/2016,2016,1,29, 1 ,5534,1058,980,7572
1/29/2016,2016,1,29, 2 ,5344,1014,950,7308
1/29/2016,2016,1,29, 3 ,5247,984,918,7149
1/29/2016,2016,1,29, 4 ,5202,977,900,7079
1/29/2016,2016,1,29, 5 ,5352,1015,951,7318
1/29/2016,2016,1,29, 6 ,5581,1063,1016,7660
1/29/2016,2016,1,29, 7 ,5640,1048,955,7643
1/29/2016,2016,1,29, 8 ,6286,1168,1056,8510
1/29/2016,2016,1,29, 9 ,7050,1384,1174,9608
1/29/2016,2016,1,29, 10 ,7553,1480,1277,10310
1/29/2016,2016,1,29, 11 ,7801,1550,1309,10660
1/29/2016,2016,1,29, 12 ,7514,1512,1290,10316
1/29/2016,2016,1,29, 13 ,7525,1517,1336,10378
1/29/2016,2016,1,29, 14 ,7892,1599,1341,10832
1/29/2016,2016,1,29, 15 ,7719,1561,1358,10638
1/29/2016,2016,1,29, 16 ,7560,1529,1321,10410
1/29/2016,2016,1,29, 17 ,7287,1453,1248,9988
1/29/2016,2016,1,29, 18 ,7375,1511,1331,10217
1/29/2016,2016,1,29, 19 ,7554,1605,1321,10480
1/29/2016,2016,1,29, 20 ,7346,1532,1324,10202
1/29/2016,2016,1,29, 21 ,7138,1463,1278,9879
1/29/2016,2016,1,29, 22 ,6743,1336,1205,9284
1/29/2016,2016,1,29, 23 ,6324,1210,1104,8638
1/29/2016,2016,1,29, 24 ,5953,1144,1039,8136
1/30/2016,2016,1,30, 1 ,5700,1090,983,7773
1/30/2016,2016,1,30, 2 ,5538,1063,938,7539
1/30/2016,2016,1,30, 3 ,5413,1032,873,7318
1/30/2016,2016,1,30, 4 ,5313,1011,854,7178
1/30/2016,2016,1,30, 5 ,5296,1025,930,7251
1/30/2016,2016,1,30, 6 ,5369,1043,939,7351
1/30/2016,2016,1,30, 7 ,5454,1053,939,7446
1/30/2016,2016,1,30, 8 ,5855,1143,1010,8008
1/30/2016,2016,1,30, 9 ,6513,1294,1130,8937
1/30/2016,2016,1,30, 10 ,6978,1410,1214,9602
1/30/2016,2016,1,30, 11 ,7241,1453,1265,9959
1/30/2016,2016,1,30, 12 ,7159,1436,1292,9887
1/30/2016,2016,1,30, 13 ,7179,1438,1294,9911
1/30/2016,2016,1,30, 14 ,7405,1479,1338,10222
1/30/2016,2016,1,30, 15 ,7281,1455,1315,10051
1/30/2016,2016,1,30, 16 ,7067,1397,1311,9775
1/30/2016,2016,1,30, 17 ,6762,1334,1233,9329
1/30/2016,2016,1,30, 18 ,6861,1393,1316,9570
1/30/2016,2016,1,30, 19 ,7274,1564,1386,10224
1/30/2016,2016,1,30, 20 ,7181,1507,1339,10027
1/30/2016,2016,1,30, 21 ,6980,1436,1309,9725
1/30/2016,2016,1,30, 22 ,6687,1350,1219,9256
1/30/2016,2016,1,30, 23 ,6327,1239,1139,8705
1/30/2016,2016,1,30, 24 ,6021,1157,1039,8217
1/31/2016,2016,1,31, 1 ,5705,1100,946,7751
1/31/2016,2016,1,31, 2 ,5505,1060,956,7521
1/31/2016,2016,1,31, 3 ,5384,1033,923,7340
1/31/2016,2016,1,31, 4 ,5231,1016,902,7149
1/31/2016,2016,1,31, 5 ,5147,1014,905,7066
1/31/2016,2016,1,31, 6 ,5147,1025,915,7087
1/31/2016,2016,1,31, 7 ,5058,1009,904,6971
1/31/2016,2016,1,31, 8 ,5313,1070,934,7317
1/31/2016,2016,1,31, 9 ,5650,1135,991,7776
1/31/2016,2016,1,31, 10 ,6048,1216,1046,8310
1/31/2016,2016,1,31, 11 ,6323,1249,1132,8704
1/31/2016,2016,1,31, 12 ,6255,1250,1167,8672
1/31/2016,2016,1,31, 13 ,6218,1247,1159,8624
1/31/2016,2016,1,31, 14 ,6237,1250,1197,8684
1/31/2016,2016,1,31, 15 ,6049,1236,1163,8448
1/31/2016,2016,1,31, 16 ,5944,1211,1151,8306
1/31/2016,2016,1,31, 17 ,5863,1197,1140,8200
1/31/2016,2016,1,31, 18 ,6134,1325,1250,8709
1/31/2016,2016,1,31, 19 ,6656,1463,1296,9415
1/31/2016,2016,1,31, 20 ,6638,1427,1299,9364
1/31/2016,2016,1,31, 21 ,6522,1349,1241,9112
1/31/2016,2016,1,31, 22 ,6235,1262,1168,8665
1/31/2016,2016,1,31, 23 ,5909,1160,1067,8136
1/31/2016,2016,1,31, 24 ,5536,1090,1009,7635
2/1/2016,2016,2,1, 1 ,5261,1030,968,7259
2/1/2016,2016,2,1, 2 ,5086,1000,931,7017
2/1/2016,2016,2,1, 3 ,4881,979,910,6770
2/1/2016,2016,2,1, 4 ,4843,970,905,6718
2/1/2016,2016,2,1, 5 ,5002,999,946,6947
2/1/2016,2016,2,1, 6 ,5280,1057,1012,7349
2/1/2016,2016,2,1, 7 ,5341,1034,944,7319
2/1/2016,2016,2,1, 8 ,6085,1115,1068,8268
2/1/2016,2016,2,1, 9 ,6933,1319,1244,9496
2/1/2016,2016,2,1, 10 ,7465,1424,1313,10202
2/1/2016,2016,2,1, 11 ,7836,1458,1357,10651
2/1/2016,2016,2,1, 12 ,7740,1415,1334,10489
2/1/2016,2016,2,1, 13 ,7723,1375,1360,10458
2/1/2016,2016,2,1, 14 ,8127,1475,1363,10965
2/1/2016,2016,2,1, 15 ,7976,1452,1335,10763
2/1/2016,2016,2,1, 16 ,7830,1442,1339,10611
2/1/2016,2016,2,1, 17 ,7442,1418,1294,10154
2/1/2016,2016,2,1, 18 ,7408,1523,1336,10267
2/1/2016,2016,2,1, 19 ,7635,1548,1336,10519
2/1/2016,2016,2,1, 20 ,7381,1470,1340,10191
2/1/2016,2016,2,1, 21 ,7208,1382,1295,9885
2/1/2016,2016,2,1, 22 ,6874,1259,1218,9351
2/1/2016,2016,2,1, 23 ,6343,1141,1097,8581
2/1/2016,2016,2,1, 24 ,5952,1073,1034,8059
2/2/2016,2016,2,2, 1 ,5649,1031,987,7667
2/2/2016,2016,2,2, 2 ,5493,1012,966,7471
2/2/2016,2016,2,2, 3 ,5362,986,954,7302
2/2/2016,2016,2,2, 4 ,5277,985,934,7196
2/2/2016,2016,2,2, 5 ,5416,1026,972,7414
2/2/2016,2016,2,2, 6 ,5613,1091,1021,7725
2/2/2016,2016,2,2, 7 ,5662,1070,953,7685
2/2/2016,2016,2,2, 8 ,6267,1169,1057,8493
2/2/2016,2016,2,2, 9 ,7116,1371,1225,9712
2/2/2016,2016,2,2, 10 ,7461,1466,1313,10240
2/2/2016,2016,2,2, 11 ,7821,1510,1342,10673
2/2/2016,2016,2,2, 12 ,7680,1447,1317,10444
2/2/2016,2016,2,2, 13 ,7692,1418,1337,10447
2/2/2016,2016,2,2, 14 ,8049,1493,1369,10911
2/2/2016,2016,2,2, 15 ,7938,1461,1356,10755
2/2/2016,2016,2,2, 16 ,7750,1450,1351,10551
2/2/2016,2016,2,2, 17 ,7394,1435,1303,10132
2/2/2016,2016,2,2, 18 ,7365,1521,1365,10251
2/2/2016,2016,2,2, 19 ,7589,1543,1403,10535
2/2/2016,2016,2,2, 20 ,7348,1470,1355,10173
2/2/2016,2016,2,2, 21 ,7137,1386,1293,9816
2/2/2016,2016,2,2, 22 ,6720,1247,1193,9160
2/2/2016,2016,2,2, 23 ,6282,1147,1081,8510
2/2/2016,2016,2,2, 24 ,5984,1071,969,8024
2/3/2016,2016,2,3, 1 ,5634,1033,982,7649
2/3/2016,2016,2,3, 2 ,5497,1005,959,7461
2/3/2016,2016,2,3, 3 ,5396,983,935,7314
2/3/2016,2016,2,3, 4 ,5332,976,931,7239
2/3/2016,2016,2,3, 5 ,5477,1015,960,7452
2/3/2016,2016,2,3, 6 ,5708,1080,1033,7821
2/3/2016,2016,2,3, 7 ,5708,1052,953,7713
2/3/2016,2016,2,3, 8 ,6339,1176,1022,8537
2/3/2016,2016,2,3, 9 ,7125,1385,1235,9745
2/3/2016,2016,2,3, 10 ,7522,1478,1328,10328
2/3/2016,2016,2,3, 11 ,7779,1529,1333,10641
2/3/2016,2016,2,3, 12 ,7576,1490,1301,10367
2/3/2016,2016,2,3, 13 ,7525,1493,1329,10347
2/3/2016,2016,2,3, 14 ,7742,1597,1394,10733
2/3/2016,2016,2,3, 15 ,7576,1571,1368,10515
2/3/2016,2016,2,3, 16 ,7486,1547,1356,10389
2/3/2016,2016,2,3, 17 ,7216,1470,1275,9961
2/3/2016,2016,2,3, 18 ,7299,1537,1354,10190
2/3/2016,2016,2,3, 19 ,7524,1621,1355,10500
2/3/2016,2016,2,3, 20 ,7323,1556,1324,10203
2/3/2016,2016,2,3, 21 ,7093,1495,1302,9890
2/3/2016,2016,2,3, 22 ,6780,1359,1185,9324
2/3/2016,2016,2,3, 23 ,6325,1226,1082,8633
2/3/2016,2016,2,3, 24 ,5942,1146,1047,8135
2/4/2016,2016,2,4, 1 ,5668,1092,967,7727
2/4/2016,2016,2,4, 2 ,5530,1065,933,7528
2/4/2016,2016,2,4, 3 ,5433,1020,910,7363
2/4/2016,2016,2,4, 4 ,5333,1011,890,7234
2/4/2016,2016,2,4, 5 ,5558,1054,927,7539
2/4/2016,2016,2,4, 6 ,5776,1109,955,7840
2/4/2016,2016,2,4, 7 ,5738,1079,908,7725
2/4/2016,2016,2,4, 8 ,6328,1206,1030,8564
2/4/2016,2016,2,4, 9 ,7152,1418,1213,9783
2/4/2016,2016,2,4, 10 ,7554,1515,1312,10381
2/4/2016,2016,2,4, 11 ,7856,1580,1353,10789
2/4/2016,2016,2,4, 12 ,7696,1548,1344,10588
2/4/2016,2016,2,4, 13 ,7713,1554,1360,10627
2/4/2016,2016,2,4, 14 ,7954,1627,1388,10969
2/4/2016,2016,2,4, 15 ,7971,1601,1433,11005
2/4/2016,2016,2,4, 16 ,7815,1574,1414,10803
2/4/2016,2016,2,4, 17 ,7526,1505,1363,10394
2/4/2016,2016,2,4, 18 ,7559,1563,1426,10548
2/4/2016,2016,2,4, 19 ,7822,1650,1472,10944
2/4/2016,2016,2,4, 20 ,7586,1591,1412,10589
2/4/2016,2016,2,4, 21 ,7376,1519,1335,10230
2/4/2016,2016,2,4, 22 ,6994,1373,1230,9597
2/4/2016,2016,2,4, 23 ,6558,1259,1168,8985
2/4/2016,2016,2,4, 24 ,6154,1184,1056,8394
2/5/2016,2016,2,5, 1 ,5874,1130,1035,8039
2/5/2016,2016,2,5, 2 ,5701,1099,1008,7808
2/5/2016,2016,2,5, 3 ,5509,1072,982,7563
2/5/2016,2016,2,5, 4 ,5435,1069,973,7477
2/5/2016,2016,2,5, 5 ,5572,1097,999,7668
2/5/2016,2016,2,5, 6 ,5715,1142,1047,7904
2/5/2016,2016,2,5, 7 ,5847,1112,983,7942
2/5/2016,2016,2,5, 8 ,6457,1231,1095,8783
2/5/2016,2016,2,5, 9 ,7182,1431,1297,9910
2/5/2016,2016,2,5, 10 ,7696,1539,1387,10622
2/5/2016,2016,2,5, 11 ,8023,1607,1438,11068
2/5/2016,2016,2,5, 12 ,7893,1572,1406,10871
2/5/2016,2016,2,5, 13 ,7912,1581,1397,10890
2/5/2016,2016,2,5, 14 ,8163,1651,1451,11265
2/5/2016,2016,2,5, 15 ,8010,1620,1400,11030
2/5/2016,2016,2,5, 16 ,7870,1591,1397,10858
2/5/2016,2016,2,5, 17 ,7567,1511,1350,10428
2/5/2016,2016,2,5, 18 ,7548,1560,1339,10447
2/5/2016,2016,2,5, 19 ,7784,1668,1361,10813
2/5/2016,2016,2,5, 20 ,7484,1593,1352,10429
2/5/2016,2016,2,5, 21 ,7297,1535,1308,10140
2/5/2016,2016,2,5, 22 ,6896,1389,1204,9489
2/5/2016,2016,2,5, 23 ,6547,1282,1107,8936
2/5/2016,2016,2,5, 24 ,6130,1197,939,8266
2/6/2016,2016,2,6, 1 ,5927,1147,981,8055
2/6/2016,2016,2,6, 2 ,5750,1121,947,7818
2/6/2016,2016,2,6, 3 ,5595,1088,915,7598
2/6/2016,2016,2,6, 4 ,5493,1070,899,7462
2/6/2016,2016,2,6, 5 ,5449,1074,900,7423
2/6/2016,2016,2,6, 6 ,5431,1083,925,7439
2/6/2016,2016,2,6, 7 ,5517,1083,910,7510
2/6/2016,2016,2,6, 8 ,5933,1174,978,8085
2/6/2016,2016,2,6, 9 ,6422,1362,1107,8891
2/6/2016,2016,2,6, 10 ,6791,1454,1204,9449
2/6/2016,2016,2,6, 11 ,7029,1527,1279,9835
2/6/2016,2016,2,6, 12 ,6757,1469,1261,9487
2/6/2016,2016,2,6, 13 ,6627,1501,1267,9395
2/6/2016,2016,2,6, 14 ,6729,1540,1308,9577
2/6/2016,2016,2,6, 15 ,6593,1509,1301,9403
2/6/2016,2016,2,6, 16 ,6480,1472,1260,9212
2/6/2016,2016,2,6, 17 ,6330,1410,1201,8941
2/6/2016,2016,2,6, 18 ,6556,1468,1284,9308
2/6/2016,2016,2,6, 19 ,6878,1605,1320,9803
2/6/2016,2016,2,6, 20 ,6722,1550,1293,9565
2/6/2016,2016,2,6, 21 ,6586,1496,1258,9340
2/6/2016,2016,2,6, 22 ,6250,1393,1202,8845
2/6/2016,2016,2,6, 23 ,5866,1305,1104,8275
2/6/2016,2016,2,6, 24 ,5478,1198,994,7670
2/7/2016,2016,2,7, 1 ,5223,1145,976,7344
2/7/2016,2016,2,7, 2 ,5075,1107,944,7126
2/7/2016,2016,2,7, 3 ,4914,1064,914,6892
2/7/2016,2016,2,7, 4 ,4865,1048,897,6810
2/7/2016,2016,2,7, 5 ,4831,1046,849,6726
2/7/2016,2016,2,7, 6 ,4792,1037,896,6725
2/7/2016,2016,2,7, 7 ,4776,1032,860,6668
2/7/2016,2016,2,7, 8 ,4989,1068,886,6943
2/7/2016,2016,2,7, 9 ,5242,1165,953,7360
2/7/2016,2016,2,7, 10 ,5635,1252,1028,7915
2/7/2016,2016,2,7, 11 ,5887,1303,1090,8280
2/7/2016,2016,2,7, 12 ,5755,1311,1082,8148
2/7/2016,2016,2,7, 13 ,5687,1314,1078,8079
2/7/2016,2016,2,7, 14 ,5750,1321,1097,8168
2/7/2016,2016,2,7, 15 ,5633,1307,1090,8030
2/7/2016,2016,2,7, 16 ,5460,1277,1067,7804
2/7/2016,2016,2,7, 17 ,5411,1258,1084,7753
2/7/2016,2016,2,7, 18 ,5764,1381,1174,8319
2/7/2016,2016,2,7, 19 ,6095,1499,1259,8853
2/7/2016,2016,2,7, 20 ,5988,1453,1244,8685
2/7/2016,2016,2,7, 21 ,5745,1397,1181,8323
2/7/2016,2016,2,7, 22 ,5441,1300,1102,7843
2/7/2016,2016,2,7, 23 ,5061,1214,1022,7297
2/7/2016,2016,2,7, 24 ,4766,1131,1031,6928
2/8/2016,2016,2,8, 1 ,4546,1074,887,6507
2/8/2016,2016,2,8, 2 ,4405,1037,863,6305
2/8/2016,2016,2,8, 3 ,4274,1004,822,6100
2/8/2016,2016,2,8, 4 ,4226,973,800,5999
2/8/2016,2016,2,8, 5 ,4209,981,812,6002
2/8/2016,2016,2,8, 6 ,4378,1010,841,6229
2/8/2016,2016,2,8, 7 ,4516,1030,844,6390
2/8/2016,2016,2,8, 8 ,4901,1100,923,6924
2/8/2016,2016,2,8, 9 ,5381,1232,1011,7624
2/8/2016,2016,2,8, 10 ,5899,1332,1134,8365
2/8/2016,2016,2,8, 11 ,6078,1373,930,8381
2/8/2016,2016,2,8, 12 ,5991,1351,1179,8521
2/8/2016,2016,2,8, 13 ,5994,1349,1207,8550
2/8/2016,2016,2,8, 14 ,6083,1409,1260,8752
2/8/2016,2016,2,8, 15 ,5973,1396,1179,8548
2/8/2016,2016,2,8, 16 ,5848,1357,1175,8380
2/8/2016,2016,2,8, 17 ,5733,1317,1131,8181
2/8/2016,2016,2,8, 18 ,6015,1425,1272,8712
2/8/2016,2016,2,8, 19 ,6405,1533,1335,9273
2/8/2016,2016,2,8, 20 ,6220,1436,1320,8976
2/8/2016,2016,2,8, 21 ,5926,1391,1246,8563
2/8/2016,2016,2,8, 22 ,5567,1280,1160,8007
2/8/2016,2016,2,8, 23 ,5090,1180,1048,7318
2/8/2016,2016,2,8, 24 ,4775,1100,976,6851
2/9/2016,2016,2,9, 1 ,4554,1064,990,6608
2/9/2016,2016,2,9, 2 ,4452,1031,956,6439
2/9/2016,2016,2,9, 3 ,4328,1004,922,6254
2/9/2016,2016,2,9, 4 ,4374,993,906,6273
2/9/2016,2016,2,9, 5 ,4647,1032,958,6637
2/9/2016,2016,2,9, 6 ,4990,1097,1019,7106
2/9/2016,2016,2,9, 7 ,5109,1066,945,7120
2/9/2016,2016,2,9, 8 ,5730,1199,1070,7999
2/9/2016,2016,2,9, 9 ,6467,1426,1270,9163
2/9/2016,2016,2,9, 10 ,6983,1517,1339,9839
2/9/2016,2016,2,9, 11 ,7223,1570,1400,10193
2/9/2016,2016,2,9, 12 ,7045,1530,1379,9954
2/9/2016,2016,2,9, 13 ,6995,1520,1390,9905
2/9/2016,2016,2,9, 14 ,7261,1612,1420,10293
2/9/2016,2016,2,9, 15 ,7193,1574,1418,10185
2/9/2016,2016,2,9, 16 ,7123,1546,1399,10068
2/9/2016,2016,2,9, 17 ,6866,1483,1334,9683
2/9/2016,2016,2,9, 18 ,6906,1531,1413,9850
2/9/2016,2016,2,9, 19 ,7170,1634,1432,10236
2/9/2016,2016,2,9, 20 ,6863,1577,1408,9848
2/9/2016,2016,2,9, 21 ,6586,1501,1358,9445
2/9/2016,2016,2,9, 22 ,6175,1358,1251,8784
2/9/2016,2016,2,9, 23 ,5667,1258,1143,8068
2/9/2016,2016,2,9, 24 ,5352,1176,1027,7555
2/10/2016,2016,2,10, 1 ,5161,1124,1018,7303
2/10/2016,2016,2,10, 2 ,5069,1092,981,7142
2/10/2016,2016,2,10, 3 ,4964,1070,928,6962
2/10/2016,2016,2,10, 4 ,4938,1049,926,6913
2/10/2016,2016,2,10, 5 ,5135,1086,993,7214
2/10/2016,2016,2,10, 6 ,5428,1143,1037,7608
2/10/2016,2016,2,10, 7 ,5436,1096,973,7505
2/10/2016,2016,2,10, 8 ,6019,1239,1127,8385
2/10/2016,2016,2,10, 9 ,6742,1454,1218,9414
2/10/2016,2016,2,10, 10 ,7278,1556,1359,10193
2/10/2016,2016,2,10, 11 ,7612,1621,1397,10630
2/10/2016,2016,2,10, 12 ,7392,1583,1352,10327
2/10/2016,2016,2,10, 13 ,7398,1584,1374,10356
2/10/2016,2016,2,10, 14 ,7721,1648,1392,10761
2/10/2016,2016,2,10, 15 ,7579,1610,1382,10571
2/10/2016,2016,2,10, 16 ,7477,1559,1372,10408
2/10/2016,2016,2,10, 17 ,7136,1501,1329,9966
2/10/2016,2016,2,10, 18 ,7058,1567,1384,10009
2/10/2016,2016,2,10, 19 ,7403,1652,1437,10492
2/10/2016,2016,2,10, 20 ,7124,1597,1330,10051
2/10/2016,2016,2,10, 21 ,6897,1447,1319,9663
2/10/2016,2016,2,10, 22 ,6494,1332,1206,9032
2/10/2016,2016,2,10, 23 ,6076,1231,1111,8418
2/10/2016,2016,2,10, 24 ,5618,1164,1044,7826
2/11/2016,2016,2,11, 1 ,5381,1126,1017,7524
2/11/2016,2016,2,11, 2 ,5259,1101,964,7324
2/11/2016,2016,2,11, 3 ,5064,1076,937,7077
2/11/2016,2016,2,11, 4 ,5085,1062,913,7060
2/11/2016,2016,2,11, 5 ,5270,1087,963,7320
2/11/2016,2016,2,11, 6 ,5470,1127,1017,7614
2/11/2016,2016,2,11, 7 ,5538,1096,950,7584
2/11/2016,2016,2,11, 8 ,6106,1194,1094,8394
2/11/2016,2016,2,11, 9 ,6941,1407,1264,9612
2/11/2016,2016,2,11, 10 ,7445,1516,1350,10311
2/11/2016,2016,2,11, 11 ,7705,1570,1379,10654
2/11/2016,2016,2,11, 12 ,7550,1501,1347,10398
2/11/2016,2016,2,11, 13 ,7573,1527,1339,10439
2/11/2016,2016,2,11, 14 ,7842,1599,1416,10857
2/11/2016,2016,2,11, 15 ,7590,1568,1388,10546
2/11/2016,2016,2,11, 16 ,7630,1537,1407,10574
2/11/2016,2016,2,11, 17 ,7299,1472,1334,10105
2/11/2016,2016,2,11, 18 ,7199,1529,1377,10105
2/11/2016,2016,2,11, 19 ,7537,1646,1396,10579
2/11/2016,2016,2,11, 20 ,7277,1585,1371,10233
2/11/2016,2016,2,11, 21 ,6999,1472,1301,9772
2/11/2016,2016,2,11, 22 ,6674,1376,1144,9194
2/11/2016,2016,2,11, 23 ,6198,1259,1053,8510
2/11/2016,2016,2,11, 24 ,5818,1175,982,7975
2/12/2016,2016,2,12, 1 ,5578,1131,897,7606
2/12/2016,2016,2,12, 2 ,5372,1087,887,7346
2/12/2016,2016,2,12, 3 ,5229,1071,837,7137
2/12/2016,2016,2,12, 4 ,5203,1056,847,7106
2/12/2016,2016,2,12, 5 ,5314,1080,889,7283
2/12/2016,2016,2,12, 6 ,5498,1126,943,7567
2/12/2016,2016,2,12, 7 ,5548,1094,887,7529
2/12/2016,2016,2,12, 8 ,6221,1229,1029,8479
2/12/2016,2016,2,12, 9 ,6942,1420,1196,9558
2/12/2016,2016,2,12, 10 ,7487,1516,1292,10295
2/12/2016,2016,2,12, 11 ,7752,1569,1351,10672
2/12/2016,2016,2,12, 12 ,7586,1545,1321,10452
2/12/2016,2016,2,12, 13 ,7629,1557,1348,10534
2/12/2016,2016,2,12, 14 ,7962,1638,1386,10986
2/12/2016,2016,2,12, 15 ,7824,1605,1357,10786
2/12/2016,2016,2,12, 16 ,7685,1552,1315,10552
2/12/2016,2016,2,12, 17 ,7314,1464,1257,10035
2/12/2016,2016,2,12, 18 ,7199,1517,1318,10034
2/12/2016,2016,2,12, 19 ,7442,1633,1378,10453
2/12/2016,2016,2,12, 20 ,7196,1572,1350,10118
2/12/2016,2016,2,12, 21 ,6935,1497,1311,9743
2/12/2016,2016,2,12, 22 ,6603,1371,1203,9177
2/12/2016,2016,2,12, 23 ,6144,1260,1100,8504
2/12/2016,2016,2,12, 24 ,5745,1183,1010,7938
2/13/2016,2016,2,13, 1 ,5504,1130,990,7624
2/13/2016,2016,2,13, 2 ,5355,1096,948,7399
2/13/2016,2016,2,13, 3 ,5201,1067,916,7184
2/13/2016,2016,2,13, 4 ,5083,1053,928,7064
2/13/2016,2016,2,13, 5 ,5088,1075,913,7076
2/13/2016,2016,2,13, 6 ,5154,1083,947,7184
2/13/2016,2016,2,13, 7 ,5186,1082,932,7200
2/13/2016,2016,2,13, 8 ,5665,1191,1027,7883
2/13/2016,2016,2,13, 9 ,6280,1342,1147,8769
2/13/2016,2016,2,13, 10 ,6862,1446,1252,9560
2/13/2016,2016,2,13, 11 ,7158,1483,1292,9933
2/13/2016,2016,2,13, 12 ,7049,1468,1268,9785
2/13/2016,2016,2,13, 13 ,7122,1470,1282,9874
2/13/2016,2016,2,13, 14 ,7346,1546,1317,10209
2/13/2016,2016,2,13, 15 ,7254,1521,1315,10090
2/13/2016,2016,2,13, 16 ,7068,1478,1292,9838
2/13/2016,2016,2,13, 17 ,6732,1413,1247,9392
2/13/2016,2016,2,13, 18 ,6749,1486,1343,9578
2/13/2016,2016,2,13, 19 ,7212,1617,1362,10191
2/13/2016,2016,2,13, 20 ,7065,1567,1348,9980
2/13/2016,2016,2,13, 21 ,6843,1496,1257,9596
2/13/2016,2016,2,13, 22 ,6595,1407,1204,9206
2/13/2016,2016,2,13, 23 ,6224,1307,1108,8639
2/13/2016,2016,2,13, 24 ,5820,1210,1046,8076
2/14/2016,2016,2,14, 1 ,5530,1162,980,7672
2/14/2016,2016,2,14, 2 ,5325,1117,963,7405
2/14/2016,2016,2,14, 3 ,5171,1095,943,7209
2/14/2016,2016,2,14, 4 ,5004,1066,927,6997
2/14/2016,2016,2,14, 5 ,4968,1064,948,6980
2/14/2016,2016,2,14, 6 ,4957,1059,936,6952
2/14/2016,2016,2,14, 7 ,4879,1053,927,6859
2/14/2016,2016,2,14, 8 ,5059,1093,947,7099
2/14/2016,2016,2,14, 9 ,5462,1166,997,7625
2/14/2016,2016,2,14, 10 ,5956,1237,1053,8246
2/14/2016,2016,2,14, 11 ,6233,1277,1082,8592
2/14/2016,2016,2,14, 12 ,6216,1263,1077,8556
2/14/2016,2016,2,14, 13 ,6217,1245,1080,8542
2/14/2016,2016,2,14, 14 ,6292,1226,1099,8617
2/14/2016,2016,2,14, 15 ,6245,1213,1080,8538
2/14/2016,2016,2,14, 16 ,6135,1201,1081,8417
2/14/2016,2016,2,14, 17 ,6033,1211,1086,8330
2/14/2016,2016,2,14, 18 ,6200,1365,1214,8779
2/14/2016,2016,2,14, 19 ,6762,1440,1314,9516
2/14/2016,2016,2,14, 20 ,6681,1382,1278,9341
2/14/2016,2016,2,14, 21 ,6507,1307,1218,9032
2/14/2016,2016,2,14, 22 ,6212,1202,1119,8533
2/14/2016,2016,2,14, 23 ,5358,1123,1030,7511
2/14/2016,2016,2,14, 24 ,5485,1048,963,7496
2/15/2016,2016,2,15, 1 ,5209,1003,907,7119
2/15/2016,2016,2,15, 2 ,4997,975,873,6845
2/15/2016,2016,2,15, 3 ,4859,952,850,6661
2/15/2016,2016,2,15, 4 ,4806,948,844,6598
2/15/2016,2016,2,15, 5 ,4997,987,881,6865
2/15/2016,2016,2,15, 6 ,5294,1063,961,7318
2/15/2016,2016,2,15, 7 ,5321,1051,900,7272
2/15/2016,2016,2,15, 8 ,5973,1162,1014,8149
2/15/2016,2016,2,15, 9 ,6800,1389,1200,9389
2/15/2016,2016,2,15, 10 ,7349,1501,1300,10150
2/15/2016,2016,2,15, 11 ,7659,1569,1321,10549
2/15/2016,2016,2,15, 12 ,7480,1537,1311,10328
2/15/2016,2016,2,15, 13 ,7456,1537,1380,10373
2/15/2016,2016,2,15, 14 ,7787,1610,1414,10811
2/15/2016,2016,2,15, 15 ,7577,1590,1418,10585
2/15/2016,2016,2,15, 16 ,7472,1570,1392,10434
2/15/2016,2016,2,15, 17 ,7286,1501,1339,10126
2/15/2016,2016,2,15, 18 ,7210,1540,1356,10106
2/15/2016,2016,2,15, 19 ,7448,1665,1425,10538
2/15/2016,2016,2,15, 20 ,7237,1587,1407,10231
2/15/2016,2016,2,15, 21 ,6974,1514,1333,9821
2/15/2016,2016,2,15, 22 ,6648,1393,1237,9278
2/15/2016,2016,2,15, 23 ,6201,1266,1125,8592
2/15/2016,2016,2,15, 24 ,5858,1182,1065,8105
2/16/2016,2016,2,16, 1 ,5658,1124,1020,7802
2/16/2016,2016,2,16, 2 ,5485,1084,986,7555
2/16/2016,2016,2,16, 3 ,5329,1064,964,7357
2/16/2016,2016,2,16, 4 ,5268,1045,949,7262
2/16/2016,2016,2,16, 5 ,5423,1082,984,7489
2/16/2016,2016,2,16, 6 ,5719,1121,1046,7886
2/16/2016,2016,2,16, 7 ,5813,1090,967,7870
2/16/2016,2016,2,16, 8 ,6339,1220,1069,8628
2/16/2016,2016,2,16, 9 ,7109,1436,1251,9796
2/16/2016,2016,2,16, 10 ,7652,1534,1330,10516
2/16/2016,2016,2,16, 11 ,7837,1575,1409,10821
2/16/2016,2016,2,16, 12 ,7652,1534,1387,10573
2/16/2016,2016,2,16, 13 ,7619,1534,1428,10581
2/16/2016,2016,2,16, 14 ,7848,1602,1391,10841
2/16/2016,2016,2,16, 15 ,7676,1581,1381,10638
2/16/2016,2016,2,16, 16 ,7544,1527,1362,10433
2/16/2016,2016,2,16, 17 ,7278,1476,1328,10082
2/16/2016,2016,2,16, 18 ,7267,1548,1380,10195
2/16/2016,2016,2,16, 19 ,7486,1598,1352,10436
2/16/2016,2016,2,16, 20 ,7232,1532,1345,10109
2/16/2016,2016,2,16, 21 ,6949,1454,1313,9716
2/16/2016,2016,2,16, 22 ,6578,1316,1258,9152
2/16/2016,2016,2,16, 23 ,6096,1220,1152,8468
2/16/2016,2016,2,16, 24 ,5732,1154,1075,7961
2/17/2016,2016,2,17, 1 ,5467,1110,1027,7604
2/17/2016,2016,2,17, 2 ,5319,1064,997,7380
2/17/2016,2016,2,17, 3 ,5132,1040,961,7133
2/17/2016,2016,2,17, 4 ,5085,1028,957,7070
2/17/2016,2016,2,17, 5 ,5304,1072,993,7369
2/17/2016,2016,2,17, 6 ,5532,1126,1051,7709
2/17/2016,2016,2,17, 7 ,5567,1108,973,7648
2/17/2016,2016,2,17, 8 ,6166,1202,1087,8455
2/17/2016,2016,2,17, 9 ,6953,1384,1252,9589
2/17/2016,2016,2,17, 10 ,7420,1482,1316,10218
2/17/2016,2016,2,17, 11 ,7624,1540,1343,10507
2/17/2016,2016,2,17, 12 ,7435,1475,1358,10268
2/17/2016,2016,2,17, 13 ,7503,1477,1379,10359
2/17/2016,2016,2,17, 14 ,7805,1557,1393,10755
2/17/2016,2016,2,17, 15 ,7725,1509,1360,10594
2/17/2016,2016,2,17, 16 ,7554,1491,1358,10403
2/17/2016,2016,2,17, 17 ,7290,1452,1308,10050
2/17/2016,2016,2,17, 18 ,7252,1525,1363,10140
2/17/2016,2016,2,17, 19 ,7534,1583,1377,10494
2/17/2016,2016,2,17, 20 ,7245,1519,1376,10140
2/17/2016,2016,2,17, 21 ,6988,1426,1349,9763
2/17/2016,2016,2,17, 22 ,6624,1287,1238,9149
2/17/2016,2016,2,17, 23 ,6173,1181,1131,8485
2/17/2016,2016,2,17, 24 ,5754,1108,1073,7935
2/18/2016,2016,2,18, 1 ,5488,1064,1018,7570
2/18/2016,2016,2,18, 2 ,5327,1036,986,7349
2/18/2016,2016,2,18, 3 ,5205,1005,955,7165
2/18/2016,2016,2,18, 4 ,5203,1010,940,7153
2/18/2016,2016,2,18, 5 ,5345,1050,977,7372
2/18/2016,2016,2,18, 6 ,5600,1115,1040,7755
2/18/2016,2016,2,18, 7 ,5564,1075,967,7606
2/18/2016,2016,2,18, 8 ,6277,1196,1081,8554
2/18/2016,2016,2,18, 9 ,6920,1370,1246,9536
2/18/2016,2016,2,18, 10 ,7321,1467,1321,10109
2/18/2016,2016,2,18, 11 ,7654,1515,1340,10509
2/18/2016,2016,2,18, 12 ,7426,1470,1305,10201
2/18/2016,2016,2,18, 13 ,7390,1463,1340,10193
2/18/2016,2016,2,18, 14 ,7715,1520,1386,10621
2/18/2016,2016,2,18, 15 ,7650,1518,1342,10510
2/18/2016,2016,2,18, 16 ,7540,1466,1350,10356
2/18/2016,2016,2,18, 17 ,7297,1427,1300,10024
2/18/2016,2016,2,18, 18 ,7245,1511,1309,10065
2/18/2016,2016,2,18, 19 ,7528,1592,1343,10463
2/18/2016,2016,2,18, 20 ,7251,1511,1333,10095
2/18/2016,2016,2,18, 21 ,6992,1421,1306,9719
2/18/2016,2016,2,18, 22 ,6603,1294,1219,9116
2/18/2016,2016,2,18, 23 ,6211,1185,1101,8497
2/18/2016,2016,2,18, 24 ,5789,1106,1001,7896
2/19/2016,2016,2,19, 1 ,5539,1071,985,7595
2/19/2016,2016,2,19, 2 ,5367,1038,948,7353
2/19/2016,2016,2,19, 3 ,5163,1005,926,7094
2/19/2016,2016,2,19, 4 ,5138,1002,909,7049
2/19/2016,2016,2,19, 5 ,5352,1048,942,7342
2/19/2016,2016,2,19, 6 ,5519,1105,993,7617
2/19/2016,2016,2,19, 7 ,5563,1078,932,7573
2/19/2016,2016,2,19, 8 ,6184,1192,1039,8415
2/19/2016,2016,2,19, 9 ,6978,1386,1210,9574
2/19/2016,2016,2,19, 10 ,7504,1482,1272,10258
2/19/2016,2016,2,19, 11 ,7741,1534,1275,10550
2/19/2016,2016,2,19, 12 ,7620,1483,1264,10367
2/19/2016,2016,2,19, 13 ,7643,1491,1321,10455
2/19/2016,2016,2,19, 14 ,7934,1563,1359,10856
2/19/2016,2016,2,19, 15 ,7789,1533,1336,10658
2/19/2016,2016,2,19, 16 ,7642,1513,1325,10480
2/19/2016,2016,2,19, 17 ,7391,1458,1275,10124
2/19/2016,2016,2,19, 18 ,7320,1534,1312,10166
2/19/2016,2016,2,19, 19 ,7563,1599,1306,10468
2/19/2016,2016,2,19, 20 ,7336,1542,1329,10207
2/19/2016,2016,2,19, 21 ,7084,1457,1283,9824
2/19/2016,2016,2,19, 22 ,6803,1327,1176,9306
2/19/2016,2016,2,19, 23 ,6354,1235,1089,8678
2/19/2016,2016,2,19, 24 ,5954,1101,1010,8065
2/20/2016,2016,2,20, 1 ,5697,1091,959,7747
2/20/2016,2016,2,20, 2 ,5455,1061,943,7459
2/20/2016,2016,2,20, 3 ,5309,1026,918,7253
2/20/2016,2016,2,20, 4 ,5224,1020,902,7146
2/20/2016,2016,2,20, 5 ,5296,1037,911,7244
2/20/2016,2016,2,20, 6 ,5388,1056,916,7360
2/20/2016,2016,2,20, 7 ,5420,1068,929,7417
2/20/2016,2016,2,20, 8 ,5819,1185,1011,8015
2/20/2016,2016,2,20, 9 ,6510,1304,1120,8934
2/20/2016,2016,2,20, 10 ,7024,1395,1203,9622
2/20/2016,2016,2,20, 11 ,7332,1442,1242,10016
2/20/2016,2016,2,20, 12 ,7207,1404,1200,9811
2/20/2016,2016,2,20, 13 ,7158,1421,1212,9791
2/20/2016,2016,2,20, 14 ,7374,1482,1271,10127
2/20/2016,2016,2,20, 15 ,7228,1464,1265,9957
2/20/2016,2016,2,20, 16 ,7010,1410,1239,9659
2/20/2016,2016,2,20, 17 ,6699,1356,1228,9283
2/20/2016,2016,2,20, 18 ,6754,1427,1274,9455
2/20/2016,2016,2,20, 19 ,7204,1571,1299,10074
2/20/2016,2016,2,20, 20 ,7096,1521,1285,9902
2/20/2016,2016,2,20, 21 ,6895,1438,1220,9553
2/20/2016,2016,2,20, 22 ,6584,1343,1155,9082
2/20/2016,2016,2,20, 23 ,6205,1221,1067,8493
2/20/2016,2016,2,20, 24 ,5795,1133,973,7901
2/21/2016,2016,2,21, 1 ,5513,1076,898,7487
2/21/2016,2016,2,21, 2 ,5360,1034,863,7257
2/21/2016,2016,2,21, 3 ,5174,1005,868,7047
2/21/2016,2016,2,21, 4 ,5062,984,849,6895
2/21/2016,2016,2,21, 5 ,4971,984,830,6785
2/21/2016,2016,2,21, 6 ,4901,994,857,6752
2/21/2016,2016,2,21, 7 ,4858,987,849,6694
2/21/2016,2016,2,21, 8 ,5121,1055,873,7049
2/21/2016,2016,2,21, 9 ,5466,1115,946,7527
2/21/2016,2016,2,21, 10 ,5912,1211,1009,8132
2/21/2016,2016,2,21, 11 ,6143,1269,1095,8507
2/21/2016,2016,2,21, 12 ,6127,1266,1049,8442
2/21/2016,2016,2,21, 13 ,6107,1260,1058,8425
2/21/2016,2016,2,21, 14 ,6125,1279,1088,8492
2/21/2016,2016,2,21, 15 ,6057,1275,1083,8415
2/21/2016,2016,2,21, 16 ,5976,1236,1052,8264
2/21/2016,2016,2,21, 17 ,5886,1219,1059,8164
2/21/2016,2016,2,21, 18 ,6159,1327,1232,8718
2/21/2016,2016,2,21, 19 ,6710,1481,1270,9461
2/21/2016,2016,2,21, 20 ,6611,1453,1268,9332
2/21/2016,2016,2,21, 21 ,6435,1387,1180,9002
2/21/2016,2016,2,21, 22 ,6125,1284,1108,8517
2/21/2016,2016,2,21, 23 ,5769,1180,1029,7978
2/21/2016,2016,2,21, 24 ,5378,1103,967,7448
2/22/2016,2016,2,22, 1 ,5136,1053,919,7108
2/22/2016,2016,2,22, 2 ,4964,1015,883,6862
2/22/2016,2016,2,22, 3 ,4844,987,862,6693
2/22/2016,2016,2,22, 4 ,4805,977,817,6599
2/22/2016,2016,2,22, 5 ,5009,1016,891,6916
2/22/2016,2016,2,22, 6 ,5305,1078,974,7357
2/22/2016,2016,2,22, 7 ,5420,1041,902,7363
2/22/2016,2016,2,22, 8 ,6110,1183,1012,8305
2/22/2016,2016,2,22, 9 ,6968,1405,1148,9521
2/22/2016,2016,2,22, 10 ,7575,1506,1238,10319
2/22/2016,2016,2,22, 11 ,7857,1561,1253,10671
2/22/2016,2016,2,22, 12 ,7732,1522,1288,10542
2/22/2016,2016,2,22, 13 ,7692,1548,1293,10533
2/22/2016,2016,2,22, 14 ,8029,1629,1359,11017
2/22/2016,2016,2,22, 15 ,7987,1605,1326,10918
2/22/2016,2016,2,22, 16 ,7863,1558,1320,10741
2/22/2016,2016,2,22, 17 ,7549,1477,1286,10312
2/22/2016,2016,2,22, 18 ,7391,1532,1286,10209
2/22/2016,2016,2,22, 19 ,7719,1645,1320,10684
2/22/2016,2016,2,22, 20 ,7451,1587,1308,10346
2/22/2016,2016,2,22, 21 ,7200,1485,1283,9968
2/22/2016,2016,2,22, 22 ,6846,1368,1182,9396
2/22/2016,2016,2,22, 23 ,6363,1270,1108,8741
2/22/2016,2016,2,22, 24 ,5922,1186,979,8087
2/23/2016,2016,2,23, 1 ,5680,1127,986,7793
2/23/2016,2016,2,23, 2 ,5539,1102,969,7610
2/23/2016,2016,2,23, 3 ,5347,1058,948,7353
2/23/2016,2016,2,23, 4 ,5297,1045,921,7263
2/23/2016,2016,2,23, 5 ,5449,1081,954,7484
2/23/2016,2016,2,23, 6 ,5713,1133,933,7779
2/23/2016,2016,2,23, 7 ,5736,1088,865,7689
2/23/2016,2016,2,23, 8 ,6366,1231,1033,8630
2/23/2016,2016,2,23, 9 ,7190,1452,1173,9815
2/23/2016,2016,2,23, 10 ,7653,1544,1256,10453
2/23/2016,2016,2,23, 11 ,7927,1613,1295,10835
2/23/2016,2016,2,23, 12 ,7778,1563,1274,10615
2/23/2016,2016,2,23, 13 ,7795,1581,1253,10629
2/23/2016,2016,2,23, 14 ,8120,1638,1306,11064
2/23/2016,2016,2,23, 15 ,8006,1637,1275,10918
2/23/2016,2016,2,23, 16 ,7872,1593,1281,10746
2/23/2016,2016,2,23, 17 ,7549,1484,1259,10292
2/23/2016,2016,2,23, 18 ,7334,1545,1306,10185
2/23/2016,2016,2,23, 19 ,7688,1669,1316,10673
2/23/2016,2016,2,23, 20 ,7456,1605,1314,10375
2/23/2016,2016,2,23, 21 ,7161,1513,1261,9935
2/23/2016,2016,2,23, 22 ,6809,1377,1202,9388
2/23/2016,2016,2,23, 23 ,6364,1274,1112,8750
2/23/2016,2016,2,23, 24 ,5963,1194,1012,8169
2/24/2016,2016,2,24, 1 ,5963,1169,998,8130
2/24/2016,2016,2,24, 2 ,5519,1124,952,7595
2/24/2016,2016,2,24, 3 ,5336,1103,943,7382
2/24/2016,2016,2,24, 4 ,5278,1074,934,7286
2/24/2016,2016,2,24, 5 ,5436,1111,981,7528
2/24/2016,2016,2,24, 6 ,5618,1137,1023,7778
2/24/2016,2016,2,24, 7 ,5622,1091,951,7664
2/24/2016,2016,2,24, 8 ,6248,1225,1064,8537
2/24/2016,2016,2,24, 9 ,7082,1417,1202,9701
2/24/2016,2016,2,24, 10 ,7613,1525,1283,10421
2/24/2016,2016,2,24, 11 ,7812,1603,1299,10714
2/24/2016,2016,2,24, 12 ,7639,1536,1288,10463
2/24/2016,2016,2,24, 13 ,7651,1538,1319,10508
2/24/2016,2016,2,24, 14 ,7923,1615,1326,10864
2/24/2016,2016,2,24, 15 ,7777,1585,1319,10681
2/24/2016,2016,2,24, 16 ,7634,1564,1301,10499
2/24/2016,2016,2,24, 17 ,7371,1495,1251,10117
2/24/2016,2016,2,24, 18 ,7251,1528,1294,10073
2/24/2016,2016,2,24, 19 ,7524,1640,1292,10456
2/24/2016,2016,2,24, 20 ,7314,1587,1290,10191
2/24/2016,2016,2,24, 21 ,7037,1496,1258,9791
2/24/2016,2016,2,24, 22 ,6633,1374,1208,9215
2/24/2016,2016,2,24, 23 ,6231,1268,1122,8621
2/24/2016,2016,2,24, 24 ,5843,1183,1057,8083
2/25/2016,2016,2,25, 1 ,5421,1122,979,7522
2/25/2016,2016,2,25, 2 ,5349,1092,973,7414
2/25/2016,2016,2,25, 3 ,5206,1070,946,7222
2/25/2016,2016,2,25, 4 ,5157,1056,926,7139
2/25/2016,2016,2,25, 5 ,5191,1069,921,7181
2/25/2016,2016,2,25, 6 ,5189,1042,912,7143
2/25/2016,2016,2,25, 7 ,5201,1070,918,7189
2/25/2016,2016,2,25, 8 ,5613,1163,1045,7821
2/25/2016,2016,2,25, 9 ,6215,1319,1127,8661
2/25/2016,2016,2,25, 10 ,6589,1400,1222,9211
2/25/2016,2016,2,25, 11 ,6760,1461,1245,9466
2/25/2016,2016,2,25, 12 ,6704,1416,1222,9342
2/25/2016,2016,2,25, 13 ,6688,1431,1243,9362
2/25/2016,2016,2,25, 14 ,6888,1500,1268,9656
2/25/2016,2016,2,25, 15 ,6806,1472,1251,9529
2/25/2016,2016,2,25, 16 ,6627,1410,1222,9259
2/25/2016,2016,2,25, 17 ,6444,1371,1195,9010
2/25/2016,2016,2,25, 18 ,6713,1476,1237,9426
2/25/2016,2016,2,25, 19 ,7111,1573,1234,9918
2/25/2016,2016,2,25, 20 ,6934,1514,1258,9706
2/25/2016,2016,2,25, 21 ,6739,1449,1237,9425
2/25/2016,2016,2,25, 22 ,6390,1345,1141,8876
2/25/2016,2016,2,25, 23 ,6011,1224,1064,8299
2/25/2016,2016,2,25, 24 ,5642,1147,991,7780
2/26/2016,2016,2,26, 1 ,5397,1097,974,7468
2/26/2016,2016,2,26, 2 ,5230,1073,947,7250
2/26/2016,2016,2,26, 3 ,5121,1052,906,7079
2/26/2016,2016,2,26, 4 ,5036,1033,902,6971
2/26/2016,2016,2,26, 5 ,5087,1072,935,7094
2/26/2016,2016,2,26, 6 ,5369,1114,981,7464
2/26/2016,2016,2,26, 7 ,5497,1090,933,7520
2/26/2016,2016,2,26, 8 ,6198,1205,1070,8473
2/26/2016,2016,2,26, 9 ,6854,1440,1205,9499
2/26/2016,2016,2,26, 10 ,7328,1544,1219,10091
2/26/2016,2016,2,26, 11 ,7564,1592,1239,10395
2/26/2016,2016,2,26, 12 ,7375,1556,1207,10138
2/26/2016,2016,2,26, 13 ,7269,1538,1236,10043
2/26/2016,2016,2,26, 14 ,7595,1605,1278,10478
2/26/2016,2016,2,26, 15 ,7461,1583,1269,10313
2/26/2016,2016,2,26, 16 ,7379,1531,1268,10178
2/26/2016,2016,2,26, 17 ,7101,1488,1251,9840
2/26/2016,2016,2,26, 18 ,6987,1539,1299,9825
2/26/2016,2016,2,26, 19 ,7299,1611,1281,10191
2/26/2016,2016,2,26, 20 ,7006,1548,1280,9834
2/26/2016,2016,2,26, 21 ,6829,1474,1263,9566
2/26/2016,2016,2,26, 22 ,6463,1326,1210,8999
2/26/2016,2016,2,26, 23 ,6072,1232,1120,8424
2/26/2016,2016,2,26, 24 ,5734,1159,1015,7908
2/27/2016,2016,2,27, 1 ,5461,1120,1023,7604
2/27/2016,2016,2,27, 2 ,5265,1078,972,7315
2/27/2016,2016,2,27, 3 ,5090,1043,963,7096
2/27/2016,2016,2,27, 4 ,5009,1028,962,6999
2/27/2016,2016,2,27, 5 ,5020,1040,961,7021
2/27/2016,2016,2,27, 6 ,5098,1067,912,7077
2/27/2016,2016,2,27, 7 ,5161,1067,980,7208
2/27/2016,2016,2,27, 8 ,5651,1155,1072,7878
2/27/2016,2016,2,27, 9 ,6288,1313,1127,8728
2/27/2016,2016,2,27, 10 ,6790,1386,1151,9327
2/27/2016,2016,2,27, 11 ,7104,1438,1207,9749
2/27/2016,2016,2,27, 12 ,6960,1392,1191,9543
2/27/2016,2016,2,27, 13 ,6954,1407,1212,9573
2/27/2016,2016,2,27, 14 ,7168,1450,1231,9849
2/27/2016,2016,2,27, 15 ,6997,1422,1228,9647
2/27/2016,2016,2,27, 16 ,6773,1378,1214,9365
2/27/2016,2016,2,27, 17 ,6534,1331,1180,9045
2/27/2016,2016,2,27, 18 ,6637,1434,1218,9289
2/27/2016,2016,2,27, 19 ,7059,1515,1194,9768
2/27/2016,2016,2,27, 20 ,6910,1486,1221,9617
2/27/2016,2016,2,27, 21 ,6769,1421,1179,9369
2/27/2016,2016,2,27, 22 ,6538,1336,1111,8985
2/27/2016,2016,2,27, 23 ,6202,1240,1082,8524
2/27/2016,2016,2,27, 24 ,5773,1146,1015,7934
2/28/2016,2016,2,28, 1 ,5539,1095,1003,7637
2/28/2016,2016,2,28, 2 ,5358,1065,965,7388
2/28/2016,2016,2,28, 3 ,5185,1036,934,7155
2/28/2016,2016,2,28, 4 ,5106,1019,921,7046
2/28/2016,2016,2,28, 5 ,5080,1011,929,7020
2/28/2016,2016,2,28, 6 ,5053,1019,940,7012
2/28/2016,2016,2,28, 7 ,5027,1011,916,6954
2/28/2016,2016,2,28, 8 ,5188,1062,958,7208
2/28/2016,2016,2,28, 9 ,5541,1134,1025,7700
2/28/2016,2016,2,28, 10 ,5971,1216,1093,8280
2/28/2016,2016,2,28, 11 ,6203,1261,1120,8584
2/28/2016,2016,2,28, 12 ,6154,1250,1078,8482
2/28/2016,2016,2,28, 13 ,6107,1236,1120,8463
2/28/2016,2016,2,28, 14 ,6141,1221,1132,8494
2/28/2016,2016,2,28, 15 ,6056,1226,1018,8300
2/28/2016,2016,2,28, 16 ,5913,1203,1088,8204
2/28/2016,2016,2,28, 17 ,5846,1192,1097,8135
2/28/2016,2016,2,28, 18 ,6132,1340,1184,8656
2/28/2016,2016,2,28, 19 ,6535,1490,1216,9241
2/28/2016,2016,2,28, 20 ,6464,1465,1236,9165
2/28/2016,2016,2,28, 21 ,6360,1401,1204,8965
2/28/2016,2016,2,28, 22 ,6037,1300,1125,8462
2/28/2016,2016,2,28, 23 ,5720,1206,1049,7975
2/28/2016,2016,2,28, 24 ,5371,1117,974,7462
2/29/2016,2016,2,29, 1 ,5157,1068,950,7175
2/29/2016,2016,2,29, 2 ,4975,1032,919,6926
2/29/2016,2016,2,29, 3 ,4867,1000,884,6751
2/29/2016,2016,2,29, 4 ,4850,1001,879,6730
2/29/2016,2016,2,29, 5 ,5047,1034,940,7021
2/29/2016,2016,2,29, 6 ,5374,1093,960,7427
2/29/2016,2016,2,29, 7 ,5459,1058,879,7396
2/29/2016,2016,2,29, 8 ,6133,1192,1029,8354
2/29/2016,2016,2,29, 9 ,6935,1407,1147,9489
2/29/2016,2016,2,29, 10 ,7469,1518,1212,10199
2/29/2016,2016,2,29, 11 ,7783,1574,1238,10595
2/29/2016,2016,2,29, 12 ,7586,1535,1239,10360
2/29/2016,2016,2,29, 13 ,7676,1540,1285,10501
2/29/2016,2016,2,29, 14 ,7986,1616,1279,10881
2/29/2016,2016,2,29, 15 ,7824,1602,1284,10710
2/29/2016,2016,2,29, 16 ,7686,1572,1271,10529
2/29/2016,2016,2,29, 17 ,7365,1487,1261,10113
2/29/2016,2016,2,29, 18 ,7259,1536,1325,10120
2/29/2016,2016,2,29, 19 ,7540,1654,1369,10563
2/29/2016,2016,2,29, 20 ,7299,1596,1349,10244
2/29/2016,2016,2,29, 21 ,7050,1519,1330,9899
2/29/2016,2016,2,29, 22 ,6614,1373,1254,9241
2/29/2016,2016,2,29, 23 ,6214,1264,1129,8607
2/29/2016,2016,2,29, 24 ,5794,1179,1085,8058
3/1/2016,2016,3,1, 1 ,5563,1121,1006,7690
3/1/2016,2016,3,1, 2 ,5378,1087,990,7455
3/1/2016,2016,3,1, 3 ,5256,1062,959,7277
3/1/2016,2016,3,1, 4 ,5203,1045,948,7196
3/1/2016,2016,3,1, 5 ,5365,1089,989,7443
3/1/2016,2016,3,1, 6 ,5572,1138,1038,7748
3/1/2016,2016,3,1, 7 ,5629,1092,960,7681
3/1/2016,2016,3,1, 8 ,6268,1224,1078,8570
3/1/2016,2016,3,1, 9 ,7008,1427,1243,9678
3/1/2016,2016,3,1, 10 ,7427,1513,1354,10294
3/1/2016,2016,3,1, 11 ,7725,1554,1356,10635
3/1/2016,2016,3,1, 12 ,7496,1539,1269,10304
3/1/2016,2016,3,1, 13 ,7549,1540,1304,10393
3/1/2016,2016,3,1, 14 ,7813,1628,1385,10826
3/1/2016,2016,3,1, 15 ,7650,1608,1427,10685
3/1/2016,2016,3,1, 16 ,7483,1585,1360,10428
3/1/2016,2016,3,1, 17 ,7219,1511,1315,10045
3/1/2016,2016,3,1, 18 ,7181,1534,1357,10072
3/1/2016,2016,3,1, 19 ,7419,1653,1404,10476
3/1/2016,2016,3,1, 20 ,7180,1585,1409,10174
3/1/2016,2016,3,1, 21 ,6944,1496,1348,9788
3/1/2016,2016,3,1, 22 ,6569,1380,1264,9213
3/1/2016,2016,3,1, 23 ,6137,1274,1156,8567
3/1/2016,2016,3,1, 24 ,5793,1195,1052,8040
3/2/2016,2016,3,2, 1 ,5534,1141,1029,7704
3/2/2016,2016,3,2, 2 ,5382,1113,995,7490
3/2/2016,2016,3,2, 3 ,5271,1084,970,7325
3/2/2016,2016,3,2, 4 ,5240,1060,959,7259
3/2/2016,2016,3,2, 5 ,5371,1096,980,7447
3/2/2016,2016,3,2, 6 ,5628,1145,1031,7804
3/2/2016,2016,3,2, 7 ,5684,1107,852,7643
3/2/2016,2016,3,2, 8 ,6243,1247,1072,8562
3/2/2016,2016,3,2, 9 ,6890,1449,1239,9578
3/2/2016,2016,3,2, 10 ,7323,1569,1252,10144
3/2/2016,2016,3,2, 11 ,7521,1626,1242,10389
3/2/2016,2016,3,2, 12 ,7373,1597,1219,10189
3/2/2016,2016,3,2, 13 ,7290,1591,1254,10135
3/2/2016,2016,3,2, 14 ,7582,1668,1281,10531
3/2/2016,2016,3,2, 15 ,7455,1651,1288,10394
3/2/2016,2016,3,2, 16 ,7326,1623,1254,10203
3/2/2016,2016,3,2, 17 ,7126,1552,1275,9953
3/2/2016,2016,3,2, 18 ,7158,1573,1279,10010
3/2/2016,2016,3,2, 19 ,7359,1687,1324,10370
3/2/2016,2016,3,2, 20 ,7137,1626,1340,10103
3/2/2016,2016,3,2, 21 ,6948,1562,1337,9847
3/2/2016,2016,3,2, 22 ,6514,1416,1246,9176
3/2/2016,2016,3,2, 23 ,6067,1302,1164,8533
3/2/2016,2016,3,2, 24 ,5701,1229,1080,8010
3/3/2016,2016,3,3, 1 ,5483,1174,1046,7703
3/3/2016,2016,3,3, 2 ,5355,1139,997,7491
3/3/2016,2016,3,3, 3 ,5191,1111,963,7265
3/3/2016,2016,3,3, 4 ,5176,1101,960,7237
3/3/2016,2016,3,3, 5 ,5348,1134,985,7467
3/3/2016,2016,3,3, 6 ,5612,1179,1054,7845
3/3/2016,2016,3,3, 7 ,5673,1127,986,7786
3/3/2016,2016,3,3, 8 ,6251,1272,1125,8648
3/3/2016,2016,3,3, 9 ,7019,1438,1291,9748
3/3/2016,2016,3,3, 10 ,7470,1515,1370,10355
3/3/2016,2016,3,3, 11 ,7743,1598,1406,10747
3/3/2016,2016,3,3, 12 ,7572,1567,1368,10507
3/3/2016,2016,3,3, 13 ,7547,1551,1375,10473
3/3/2016,2016,3,3, 14 ,7845,1653,1410,10908
3/3/2016,2016,3,3, 15 ,7719,1632,1383,10734
3/3/2016,2016,3,3, 16 ,7562,1604,1376,10542
3/3/2016,2016,3,3, 17 ,7302,1538,1360,10200
3/3/2016,2016,3,3, 18 ,7277,1566,1393,10236
3/3/2016,2016,3,3, 19 ,7473,1689,1425,10587
3/3/2016,2016,3,3, 20 ,7255,1651,1405,10311
3/3/2016,2016,3,3, 21 ,6995,1558,1375,9928
3/3/2016,2016,3,3, 22 ,6740,1427,1293,9460
3/3/2016,2016,3,3, 23 ,6256,1312,1157,8725
3/3/2016,2016,3,3, 24 ,5876,1238,1111,8225
3/4/2016,2016,3,4, 1 ,5629,1197,1070,7896
3/4/2016,2016,3,4, 2 ,5429,1163,1030,7622
3/4/2016,2016,3,4, 3 ,5285,1136,1001,7422
3/4/2016,2016,3,4, 4 ,5241,1124,987,7352
3/4/2016,2016,3,4, 5 ,5405,1143,1022,7570
3/4/2016,2016,3,4, 6 ,5572,1181,1065,7818
3/4/2016,2016,3,4, 7 ,5624,1131,998,7753
3/4/2016,2016,3,4, 8 ,6224,1267,1107,8598
3/4/2016,2016,3,4, 9 ,6918,1477,1266,9661
3/4/2016,2016,3,4, 10 ,7501,1604,1330,10435
3/4/2016,2016,3,4, 11 ,7713,1641,1344,10698
3/4/2016,2016,3,4, 12 ,7524,1602,1333,10459
3/4/2016,2016,3,4, 13 ,7480,1611,1375,10466
3/4/2016,2016,3,4, 14 ,7755,1703,1378,10836
3/4/2016,2016,3,4, 15 ,7654,1656,1363,10673
3/4/2016,2016,3,4, 16 ,7574,1635,1335,10544
3/4/2016,2016,3,4, 17 ,7387,1560,1325,10272
3/4/2016,2016,3,4, 18 ,7320,1593,1347,10260
3/4/2016,2016,3,4, 19 ,7602,1701,1397,10700
3/4/2016,2016,3,4, 20 ,7441,1637,1376,10454
3/4/2016,2016,3,4, 21 ,7267,1574,1336,10177
3/4/2016,2016,3,4, 22 ,6923,1460,1236,9619
3/4/2016,2016,3,4, 23 ,6424,1338,1162,8924
3/4/2016,2016,3,4, 24 ,6101,1266,1170,8537
3/5/2016,2016,3,5, 1 ,5803,1215,1061,8079
3/5/2016,2016,3,5, 2 ,5662,1183,1027,7872
3/5/2016,2016,3,5, 3 ,5505,1132,995,7632
3/5/2016,2016,3,5, 4 ,5437,1121,978,7536
3/5/2016,2016,3,5, 5 ,5432,1127,994,7553
3/5/2016,2016,3,5, 6 ,5475,1127,1000,7602
3/5/2016,2016,3,5, 7 ,5556,1123,982,7661
3/5/2016,2016,3,5, 8 ,6031,1232,1077,8340
3/5/2016,2016,3,5, 9 ,6697,1395,1195,9287
3/5/2016,2016,3,5, 10 ,7204,1488,1249,9941
3/5/2016,2016,3,5, 11 ,7543,1546,1258,10347
3/5/2016,2016,3,5, 12 ,7446,1520,1241,10207
3/5/2016,2016,3,5, 13 ,7449,1519,1260,10228
3/5/2016,2016,3,5, 14 ,7690,1568,1267,10525
3/5/2016,2016,3,5, 15 ,7601,1544,1236,10381
3/5/2016,2016,3,5, 16 ,7403,1510,1250,10163
3/5/2016,2016,3,5, 17 ,7108,1425,1224,9757
3/5/2016,2016,3,5, 18 ,7052,1510,1263,9825
3/5/2016,2016,3,5, 19 ,7526,1643,1274,10443
3/5/2016,2016,3,5, 20 ,7429,1606,1306,10341
3/5/2016,2016,3,5, 21 ,7302,1546,1274,10122
3/5/2016,2016,3,5, 22 ,7142,1468,1197,9807
3/5/2016,2016,3,5, 23 ,6706,1368,1161,9235
3/5/2016,2016,3,5, 24 ,6312,1269,1069,8650
3/6/2016,2016,3,6, 1 ,6019,1206,1040,8265
3/6/2016,2016,3,6, 2 ,5824,1171,1017,8012
3/6/2016,2016,3,6, 3 ,5607,1138,983,7728
3/6/2016,2016,3,6, 4 ,5486,1108,961,7555
3/6/2016,2016,3,6, 5 ,5401,1105,952,7458
3/6/2016,2016,3,6, 6 ,5261,1089,948,7298
3/6/2016,2016,3,6, 7 ,5169,1078,938,7185
3/6/2016,2016,3,6, 8 ,5497,1130,966,7593
3/6/2016,2016,3,6, 9 ,5931,1231,1031,8193
3/6/2016,2016,3,6, 10 ,6379,1315,1134,8828
3/6/2016,2016,3,6, 11 ,6671,1345,1178,9194
3/6/2016,2016,3,6, 12 ,6541,1364,1165,9070
3/6/2016,2016,3,6, 13 ,6718,1390,1169,9277
3/6/2016,2016,3,6, 14 ,6839,1380,1129,9348
3/6/2016,2016,3,6, 15 ,6713,1381,1189,9283
3/6/2016,2016,3,6, 16 ,6648,1351,1185,9184
3/6/2016,2016,3,6, 17 ,6418,1322,1150,8890
3/6/2016,2016,3,6, 18 ,6576,1412,1241,9229
3/6/2016,2016,3,6, 19 ,7183,1594,1302,10079
3/6/2016,2016,3,6, 20 ,7168,1550,1305,10023
3/6/2016,2016,3,6, 21 ,7073,1483,1239,9795
3/6/2016,2016,3,6, 22 ,6850,1387,1173,9410
3/6/2016,2016,3,6, 23 ,6540,1291,1090,8921
3/6/2016,2016,3,6, 24 ,6132,1212,1168,8512
3/7/2016,2016,3,7, 1 ,5833,1160,1000,7993
3/7/2016,2016,3,7, 2 ,5563,1107,954,7624
3/7/2016,2016,3,7, 3 ,5472,1071,921,7464
3/7/2016,2016,3,7, 4 ,5345,1051,909,7305
3/7/2016,2016,3,7, 5 ,5483,1094,944,7521
3/7/2016,2016,3,7, 6 ,5776,1138,934,7848
3/7/2016,2016,3,7, 7 ,5865,1089,791,7745
3/7/2016,2016,3,7, 8 ,6562,1253,1050,8865
3/7/2016,2016,3,7, 9 ,7468,1481,1221,10170
3/7/2016,2016,3,7, 10 ,7997,1581,1326,10904
3/7/2016,2016,3,7, 11 ,8343,1651,1358,11352
3/7/2016,2016,3,7, 12 ,8241,1624,1353,11218
3/7/2016,2016,3,7, 13 ,8274,1627,1385,11286
3/7/2016,2016,3,7, 14 ,8675,1694,1414,11783
3/7/2016,2016,3,7, 15 ,8583,1657,1403,11643
3/7/2016,2016,3,7, 16 ,8393,1635,1399,11427
3/7/2016,2016,3,7, 17 ,8099,1557,1370,11026
3/7/2016,2016,3,7, 18 ,7847,1576,1361,10784
3/7/2016,2016,3,7, 19 ,8223,1720,1434,11377
3/7/2016,2016,3,7, 20 ,8049,1671,1431,11151
3/7/2016,2016,3,7, 21 ,7801,1587,1371,10759
3/7/2016,2016,3,7, 22 ,7431,1469,1288,10188
3/7/2016,2016,3,7, 23 ,7122,1369,1180,9671
3/7/2016,2016,3,7, 24 ,6663,1285,1102,9050
3/8/2016,2016,3,8, 1 ,6332,1230,1058,8620
3/8/2016,2016,3,8, 2 ,6129,1189,1022,8340
3/8/2016,2016,3,8, 3 ,5946,1154,988,8088
3/8/2016,2016,3,8, 4 ,5818,1142,974,7934
3/8/2016,2016,3,8, 5 ,5938,1164,1007,8109
3/8/2016,2016,3,8, 6 ,6088,1187,1034,8309
3/8/2016,2016,3,8, 7 ,6075,1145,961,8181
3/8/2016,2016,3,8, 8 ,6842,1296,1105,9243
3/8/2016,2016,3,8, 9 ,7655,1506,1283,10444
3/8/2016,2016,3,8, 10 ,8170,1608,1374,11152
3/8/2016,2016,3,8, 11 ,8444,1671,1432,11547
3/8/2016,2016,3,8, 12 ,8313,1634,1393,11340
3/8/2016,2016,3,8, 13 ,8375,1633,1424,11432
3/8/2016,2016,3,8, 14 ,8729,1729,1462,11920
3/8/2016,2016,3,8, 15 ,8651,1672,1434,11757
3/8/2016,2016,3,8, 16 ,8421,1652,1415,11488
3/8/2016,2016,3,8, 17 ,8085,1590,1383,11058
3/8/2016,2016,3,8, 18 ,7819,1619,1421,10859
3/8/2016,2016,3,8, 19 ,8177,1729,1445,11351
3/8/2016,2016,3,8, 20 ,7955,1667,1432,11054
3/8/2016,2016,3,8, 21 ,7809,1583,1402,10794
3/8/2016,2016,3,8, 22 ,7346,1453,1316,10115
3/8/2016,2016,3,8, 23 ,7024,1335,1204,9563
3/8/2016,2016,3,8, 24 ,6575,1262,1131,8968
3/9/2016,2016,3,9, 1 ,6250,1219,1072,8541
3/9/2016,2016,3,9, 2 ,6119,1178,1037,8334
3/9/2016,2016,3,9, 3 ,5848,1147,1008,8003
3/9/2016,2016,3,9, 4 ,5787,1139,992,7918
3/9/2016,2016,3,9, 5 ,5856,1167,1032,8055
3/9/2016,2016,3,9, 6 ,5989,1198,1031,8218
3/9/2016,2016,3,9, 7 ,5959,1142,992,8093
3/9/2016,2016,3,9, 8 ,6741,1286,1121,9148
3/9/2016,2016,3,9, 9 ,7522,1488,1288,10298
3/9/2016,2016,3,9, 10 ,8046,1584,1354,10984
3/9/2016,2016,3,9, 11 ,8319,1656,1438,11413
3/9/2016,2016,3,9, 12 ,8232,1618,1422,11272
3/9/2016,2016,3,9, 13 ,8301,1620,1433,11354
3/9/2016,2016,3,9, 14 ,8759,1702,1457,11918
3/9/2016,2016,3,9, 15 ,8641,1685,1402,11728
3/9/2016,2016,3,9, 16 ,8476,1656,1314,11446
3/9/2016,2016,3,9, 17 ,8213,1580,1297,11090
3/9/2016,2016,3,9, 18 ,7861,1594,1361,10816
3/9/2016,2016,3,9, 19 ,8262,1718,1380,11360
3/9/2016,2016,3,9, 20 ,8114,1681,1385,11180
3/9/2016,2016,3,9, 21 ,7935,1585,1348,10868
3/9/2016,2016,3,9, 22 ,8083,1438,1252,10773
3/9/2016,2016,3,9, 23 ,7162,1336,1171,9669
3/9/2016,2016,3,9, 24 ,6754,1247,1086,9087
3/10/2016,2016,3,10, 1 ,6447,1189,1043,8679
3/10/2016,2016,3,10, 2 ,6262,1152,1004,8418
3/10/2016,2016,3,10, 3 ,6016,1128,964,8108
3/10/2016,2016,3,10, 4 ,5933,1110,952,7995
3/10/2016,2016,3,10, 5 ,6042,1135,992,8169
3/10/2016,2016,3,10, 6 ,6141,1172,1045,8358
3/10/2016,2016,3,10, 7 ,6127,1121,966,8214
3/10/2016,2016,3,10, 8 ,6820,1277,1109,9206
3/10/2016,2016,3,10, 9 ,7604,1497,1276,10377
3/10/2016,2016,3,10, 10 ,8150,1597,1317,11064
3/10/2016,2016,3,10, 11 ,8406,1663,1364,11433
3/10/2016,2016,3,10, 12 ,8312,1630,1371,11313
3/10/2016,2016,3,10, 13 ,8359,1643,1389,11391
3/10/2016,2016,3,10, 14 ,8739,1715,1413,11867
3/10/2016,2016,3,10, 15 ,8631,1688,1423,11742
3/10/2016,2016,3,10, 16 ,8519,1656,1383,11558
3/10/2016,2016,3,10, 17 ,8181,1564,1290,11035
3/10/2016,2016,3,10, 18 ,7942,1578,1368,10888
3/10/2016,2016,3,10, 19 ,8276,1730,1400,11406
3/10/2016,2016,3,10, 20 ,8147,1654,1401,11202
3/10/2016,2016,3,10, 21 ,7908,1550,1364,10822
3/10/2016,2016,3,10, 22 ,7618,1414,1262,10294
3/10/2016,2016,3,10, 23 ,7259,1317,1158,9734
3/10/2016,2016,3,10, 24 ,6773,1241,1104,9118
3/11/2016,2016,3,11, 1 ,6445,1165,1038,8648
3/11/2016,2016,3,11, 2 ,6269,1129,985,8383
3/11/2016,2016,3,11, 3 ,6094,1099,971,8164
3/11/2016,2016,3,11, 4 ,5953,1087,958,7998
3/11/2016,2016,3,11, 5 ,6059,1113,990,8162
3/11/2016,2016,3,11, 6 ,6103,1144,1021,8268
3/11/2016,2016,3,11, 7 ,6115,1106,972,8193
3/11/2016,2016,3,11, 8 ,6760,1279,1110,9149
3/11/2016,2016,3,11, 9 ,7557,1489,1285,10331
3/11/2016,2016,3,11, 10 ,8046,1602,1326,10974
3/11/2016,2016,3,11, 11 ,8405,1655,1396,11456
3/11/2016,2016,3,11, 12 ,8233,1611,1385,11229
3/11/2016,2016,3,11, 13 ,8253,1634,1395,11282
3/11/2016,2016,3,11, 14 ,8662,1722,1449,11833
3/11/2016,2016,3,11, 15 ,8525,1708,1404,11637
3/11/2016,2016,3,11, 16 ,8403,1662,1385,11450
3/11/2016,2016,3,11, 17 ,8019,1578,1368,10965
3/11/2016,2016,3,11, 18 ,7749,1574,1375,10698
3/11/2016,2016,3,11, 19 ,8113,1683,1410,11206
3/11/2016,2016,3,11, 20 ,7885,1607,1365,10857
3/11/2016,2016,3,11, 21 ,7752,1535,1341,10628
3/11/2016,2016,3,11, 22 ,7409,1420,1208,10037
3/11/2016,2016,3,11, 23 ,7061,1316,1116,9493
3/11/2016,2016,3,11, 24 ,6674,1250,1050,8974
3/12/2016,2016,3,12, 1 ,6378,1198,1027,8603
3/12/2016,2016,3,12, 2 ,6134,1159,997,8290
3/12/2016,2016,3,12, 3 ,5949,1127,966,8042
3/12/2016,2016,3,12, 4 ,5811,1112,958,7881
3/12/2016,2016,3,12, 5 ,5783,1127,970,7880
3/12/2016,2016,3,12, 6 ,5732,1122,986,7840
3/12/2016,2016,3,12, 7 ,5724,1121,978,7823
3/12/2016,2016,3,12, 8 ,6184,1225,1027,8436
3/12/2016,2016,3,12, 9 ,6856,1391,1201,9448
3/12/2016,2016,3,12, 10 ,7368,1475,1254,10097
3/12/2016,2016,3,12, 11 ,7688,1537,1332,10557
3/12/2016,2016,3,12, 12 ,7529,1502,1294,10325
3/12/2016,2016,3,12, 13 ,7524,1522,1351,10397
3/12/2016,2016,3,12, 14 ,7836,1562,1366,10764
3/12/2016,2016,3,12, 15 ,7708,1532,1336,10576
3/12/2016,2016,3,12, 16 ,7561,1491,1273,10325
3/12/2016,2016,3,12, 17 ,7182,1412,1258,9852
3/12/2016,2016,3,12, 18 ,7037,1445,1327,9809
3/12/2016,2016,3,12, 19 ,7621,1599,1417,10637
3/12/2016,2016,3,12, 20 ,7478,1562,1363,10403
3/12/2016,2016,3,12, 21 ,7403,1510,1328,10241
3/12/2016,2016,3,12, 22 ,7158,1438,1264,9860
3/12/2016,2016,3,12, 23 ,6845,1341,1163,9349
3/12/2016,2016,3,12, 24 ,6414,1239,1051,8704
3/13/2016,2016,3,13, 1 ,6085,1179,1021,8285
3/13/2016,2016,3,13, 2 ,5871,1139,960,7970
3/13/2016,2016,3,13, 3 ,5703,1106,955,7764
3/13/2016,2016,3,13, 4 ,5544,1080,939,7563
3/13/2016,2016,3,13, 5 ,5452,1076,942,7470
3/13/2016,2016,3,13, 6 ,5303,1052,863,7218
3/13/2016,2016,3,13, 7 ,5281,1042,858,7181
3/13/2016,2016,3,13, 8 ,5500,1116,887,7503
3/13/2016,2016,3,13, 9 ,5985,1206,990,8181
3/13/2016,2016,3,13, 10 ,6406,1295,1071,8772
3/13/2016,2016,3,13, 11 ,6699,1346,1150,9195
3/13/2016,2016,3,13, 12 ,6670,1343,1146,9159
3/13/2016,2016,3,13, 13 ,6758,1365,1161,9284
3/13/2016,2016,3,13, 14 ,6755,1362,1166,9283
3/13/2016,2016,3,13, 15 ,6790,1330,1161,9281
3/13/2016,2016,3,13, 16 ,6640,1311,1144,9095
3/13/2016,2016,3,13, 17 ,6432,1283,1126,8841
3/13/2016,2016,3,13, 18 ,6536,1376,1201,9113
3/13/2016,2016,3,13, 19 ,7261,1572,1334,10167
3/13/2016,2016,3,13, 20 ,7250,1534,1324,10108
3/13/2016,2016,3,13, 21 ,7181,1468,1270,9919
3/13/2016,2016,3,13, 22 ,6877,1361,1165,9403
3/13/2016,2016,3,13, 23 ,6572,1262,1086,8920
3/13/2016,2016,3,13, 24 ,6117,1184,975,8276
3/14/2016,2016,3,14, 1 ,5809,1126,966,7901
3/14/2016,2016,3,14, 2 ,5554,1086,921,7561
3/14/2016,2016,3,14, 3 ,5358,1058,900,7316
3/14/2016,2016,3,14, 4 ,5232,1043,895,7170
3/14/2016,2016,3,14, 5 ,5360,1068,958,7386
3/14/2016,2016,3,14, 6 ,5537,1111,1002,7650
3/14/2016,2016,3,14, 7 ,5643,1080,925,7648
3/14/2016,2016,3,14, 8 ,6472,1237,1034,8743
3/14/2016,2016,3,14, 9 ,7436,1475,1230,10141
3/14/2016,2016,3,14, 10 ,7959,1590,1372,10921
3/14/2016,2016,3,14, 11 ,8282,1657,1420,11359
3/14/2016,2016,3,14, 12 ,8155,1627,1283,11065
3/14/2016,2016,3,14, 13 ,8262,1651,1411,11324
3/14/2016,2016,3,14, 14 ,8646,1726,1444,11816
3/14/2016,2016,3,14, 15 ,8547,1697,1411,11655
3/14/2016,2016,3,14, 16 ,8468,1663,1403,11534
3/14/2016,2016,3,14, 17 ,8010,1576,1354,10940
3/14/2016,2016,3,14, 18 ,7789,1575,1392,10756
3/14/2016,2016,3,14, 19 ,8164,1721,1444,11329
3/14/2016,2016,3,14, 20 ,8017,1660,1420,11097
3/14/2016,2016,3,14, 21 ,7831,1579,1371,10781
3/14/2016,2016,3,14, 22 ,7500,1435,1284,10219
3/14/2016,2016,3,14, 23 ,7042,1303,1168,9513
3/14/2016,2016,3,14, 24 ,6636,1219,1043,8898
3/15/2016,2016,3,15, 1 ,6339,1172,1036,8547
3/15/2016,2016,3,15, 2 ,6123,1135,1007,8265
3/15/2016,2016,3,15, 3 ,5923,1099,971,7993
3/15/2016,2016,3,15, 4 ,5784,1083,959,7826
3/15/2016,2016,3,15, 5 ,5902,1112,979,7993
3/15/2016,2016,3,15, 6 ,6002,1147,1026,8175
3/15/2016,2016,3,15, 7 ,6007,1112,957,8076
3/15/2016,2016,3,15, 8 ,6813,1279,1088,9180
3/15/2016,2016,3,15, 9 ,7591,1497,1264,10352
3/15/2016,2016,3,15, 10 ,8084,1614,1270,10968
3/15/2016,2016,3,15, 11 ,8307,1684,1308,11299
3/15/2016,2016,3,15, 12 ,8150,1640,1358,11148
3/15/2016,2016,3,15, 13 ,8130,1658,1408,11196
3/15/2016,2016,3,15, 14 ,8518,1731,1444,11693
3/15/2016,2016,3,15, 15 ,8363,1714,1417,11494
3/15/2016,2016,3,15, 16 ,8220,1665,1424,11309
3/15/2016,2016,3,15, 17 ,7931,1573,1352,10856
3/15/2016,2016,3,15, 18 ,7721,1580,1388,10689
3/15/2016,2016,3,15, 19 ,8078,1713,1434,11225
3/15/2016,2016,3,15, 20 ,7925,1658,1408,10991
3/15/2016,2016,3,15, 21 ,7727,1571,1368,10666
3/15/2016,2016,3,15, 22 ,7342,1444,1209,9995
3/15/2016,2016,3,15, 23 ,6907,1338,1133,9378
3/15/2016,2016,3,15, 24 ,6512,1255,1031,8798
3/16/2016,2016,3,16, 1 ,6283,1193,1040,8516
3/16/2016,2016,3,16, 2 ,6045,1165,1009,8219
3/16/2016,2016,3,16, 3 ,5867,1131,979,7977
3/16/2016,2016,3,16, 4 ,5798,1118,962,7878
3/16/2016,2016,3,16, 5 ,5885,1131,990,8006
3/16/2016,2016,3,16, 6 ,5961,1156,1019,8136
3/16/2016,2016,3,16, 7 ,6026,1123,944,8093
3/16/2016,2016,3,16, 8 ,6746,1285,1072,9103
3/16/2016,2016,3,16, 9 ,7631,1484,1243,10358
3/16/2016,2016,3,16, 10 ,8097,1597,1359,11053
3/16/2016,2016,3,16, 11 ,8403,1656,1445,11504
3/16/2016,2016,3,16, 12 ,8264,1664,1432,11360
3/16/2016,2016,3,16, 13 ,8298,1660,1434,11392
3/16/2016,2016,3,16, 14 ,8694,1722,1482,11898
3/16/2016,2016,3,16, 15 ,8654,1715,1458,11827
3/16/2016,2016,3,16, 16 ,8483,1679,1431,11593
3/16/2016,2016,3,16, 17 ,8097,1569,1358,11024
3/16/2016,2016,3,16, 18 ,7894,1592,1436,10922
3/16/2016,2016,3,16, 19 ,8197,1704,1456,11357
3/16/2016,2016,3,16, 20 ,8068,1651,1460,11179
3/16/2016,2016,3,16, 21 ,7921,1575,1397,10893
3/16/2016,2016,3,16, 22 ,7587,1453,1270,10310
3/16/2016,2016,3,16, 23 ,7207,1321,1174,9702
3/16/2016,2016,3,16, 24 ,6805,1249,1109,9163
3/17/2016,2016,3,17, 1 ,6445,1195,1070,8710
3/17/2016,2016,3,17, 2 ,6266,1154,1041,8461
3/17/2016,2016,3,17, 3 ,6061,1124,1008,8193
3/17/2016,2016,3,17, 4 ,5880,1115,985,7980
3/17/2016,2016,3,17, 5 ,5930,1136,1007,8073
3/17/2016,2016,3,17, 6 ,6039,1149,1034,8222
3/17/2016,2016,3,17, 7 ,6069,1123,978,8170
3/17/2016,2016,3,17, 8 ,6800,1283,1100,9183
3/17/2016,2016,3,17, 9 ,7581,1505,1262,10348
3/17/2016,2016,3,17, 10 ,8117,1622,1352,11091
3/17/2016,2016,3,17, 11 ,8314,1678,1419,11411
3/17/2016,2016,3,17, 12 ,8201,1640,1397,11238
3/17/2016,2016,3,17, 13 ,8208,1629,1411,11248
3/17/2016,2016,3,17, 14 ,8551,1729,1419,11699
3/17/2016,2016,3,17, 15 ,8499,1705,1449,11653
3/17/2016,2016,3,17, 16 ,8340,1666,1424,11430
3/17/2016,2016,3,17, 17 ,7963,1564,1353,10880
3/17/2016,2016,3,17, 18 ,7796,1565,1361,10722
3/17/2016,2016,3,17, 19 ,8206,1701,1468,11375
3/17/2016,2016,3,17, 20 ,8046,1647,1459,11152
3/17/2016,2016,3,17, 21 ,7832,1582,1401,10815
3/17/2016,2016,3,17, 22 ,7540,1459,1285,10284
3/17/2016,2016,3,17, 23 ,7109,1349,1180,9638
3/17/2016,2016,3,17, 24 ,6713,1260,1113,9086
3/18/2016,2016,3,18, 1 ,6393,1190,1048,8631
3/18/2016,2016,3,18, 2 ,6171,1139,1003,8313
3/18/2016,2016,3,18, 3 ,5989,1105,966,8060
3/18/2016,2016,3,18, 4 ,5876,1091,955,7922
3/18/2016,2016,3,18, 5 ,5904,1104,992,8000
3/18/2016,2016,3,18, 6 ,5911,1094,1009,8014
3/18/2016,2016,3,18, 7 ,6029,1084,965,8078
3/18/2016,2016,3,18, 8 ,6792,1238,1090,9120
3/18/2016,2016,3,18, 9 ,7650,1438,1301,10389
3/18/2016,2016,3,18, 10 ,8160,1537,1386,11083
3/18/2016,2016,3,18, 11 ,8466,1593,1432,11491
3/18/2016,2016,3,18, 12 ,8329,1606,1430,11365
3/18/2016,2016,3,18, 13 ,8372,1617,1451,11440
3/18/2016,2016,3,18, 14 ,8683,1678,1484,11845
3/18/2016,2016,3,18, 15 ,8592,1665,1485,11742
3/18/2016,2016,3,18, 16 ,8507,1626,1466,11599
3/18/2016,2016,3,18, 17 ,8088,1533,1380,11001
3/18/2016,2016,3,18, 18 ,7846,1553,1409,10808
3/18/2016,2016,3,18, 19 ,8149,1685,1429,11263
3/18/2016,2016,3,18, 20 ,8000,1638,1166,10804
3/18/2016,2016,3,18, 21 ,7917,1582,1117,10616
3/18/2016,2016,3,18, 22 ,7608,1451,1022,10081
3/18/2016,2016,3,18, 23 ,7213,1334,914,9461
3/18/2016,2016,3,18, 24 ,6805,1254,775,8834
3/19/2016,2016,3,19, 1 ,6452,1198,1067,8717
3/19/2016,2016,3,19, 2 ,6277,1149,1026,8452
3/19/2016,2016,3,19, 3 ,6044,1110,995,8149
3/19/2016,2016,3,19, 4 ,5860,1095,978,7933
3/19/2016,2016,3,19, 5 ,5821,1115,992,7928
3/19/2016,2016,3,19, 6 ,5792,1111,1000,7903
3/19/2016,2016,3,19, 7 ,5842,1112,923,7877
3/19/2016,2016,3,19, 8 ,6317,1236,1027,8580
3/19/2016,2016,3,19, 9 ,6942,1413,1176,9531
3/19/2016,2016,3,19, 10 ,7559,1516,1270,10345
3/19/2016,2016,3,19, 11 ,7716,1558,1329,10603
3/19/2016,2016,3,19, 12 ,7604,1525,1321,10450
3/19/2016,2016,3,19, 13 ,7685,1543,1342,10570
3/19/2016,2016,3,19, 14 ,7926,1586,1381,10893
3/19/2016,2016,3,19, 15 ,7734,1552,1347,10633
3/19/2016,2016,3,19, 16 ,7511,1490,1317,10318
3/19/2016,2016,3,19, 17 ,7168,1428,1258,9854
3/19/2016,2016,3,19, 18 ,7093,1481,1373,9947
3/19/2016,2016,3,19, 19 ,7625,1610,1396,10631
3/19/2016,2016,3,19, 20 ,7589,1590,1404,10583
3/19/2016,2016,3,19, 21 ,7395,1502,1349,10246
3/19/2016,2016,3,19, 22 ,7213,1447,1282,9942
3/19/2016,2016,3,19, 23 ,6860,1346,1195,9401
3/19/2016,2016,3,19, 24 ,6508,1253,1070,8831
3/20/2016,2016,3,20, 1 ,6247,1192,1041,8480
3/20/2016,2016,3,20, 2 ,6022,1145,1003,8170
3/20/2016,2016,3,20, 3 ,5816,1119,970,7905
3/20/2016,2016,3,20, 4 ,5655,1098,949,7702
3/20/2016,2016,3,20, 5 ,5606,1095,954,7655
3/20/2016,2016,3,20, 6 ,5398,1074,943,7415
3/20/2016,2016,3,20, 7 ,5292,1069,897,7258
3/20/2016,2016,3,20, 8 ,5636,1136,952,7724
3/20/2016,2016,3,20, 9 ,6045,1228,1027,8300
3/20/2016,2016,3,20, 10 ,6516,1295,1106,8917
3/20/2016,2016,3,20, 11 ,6803,1353,1177,9333
3/20/2016,2016,3,20, 12 ,6811,1340,1181,9332
3/20/2016,2016,3,20, 13 ,6845,1353,1180,9378
3/20/2016,2016,3,20, 14 ,6966,1375,1208,9549
3/20/2016,2016,3,20, 15 ,6939,1363,1190,9492
3/20/2016,2016,3,20, 16 ,6833,1342,1160,9335
3/20/2016,2016,3,20, 17 ,6618,1299,1116,9033
3/20/2016,2016,3,20, 18 ,6677,1385,1236,9298
3/20/2016,2016,3,20, 19 ,7268,1557,1319,10144
3/20/2016,2016,3,20, 20 ,7255,1528,1303,10086
3/20/2016,2016,3,20, 21 ,7215,1471,1269,9955
3/20/2016,2016,3,20, 22 ,6935,1373,1179,9487
3/20/2016,2016,3,20, 23 ,6656,1286,1101,9043
3/20/2016,2016,3,20, 24 ,6277,1209,1127,8613
3/21/2016,2016,3,21, 1 ,5945,1147,1001,8093
3/21/2016,2016,3,21, 2 ,5756,1108,962,7826
3/21/2016,2016,3,21, 3 ,5500,1084,940,7524
3/21/2016,2016,3,21, 4 ,5406,1062,920,7388
3/21/2016,2016,3,21, 5 ,5434,1079,943,7456
3/21/2016,2016,3,21, 6 ,5576,1090,962,7628
3/21/2016,2016,3,21, 7 ,5745,1070,930,7745
3/21/2016,2016,3,21, 8 ,6520,1220,1080,8820
3/21/2016,2016,3,21, 9 ,7428,1453,1205,10086
3/21/2016,2016,3,21, 10 ,8023,1570,1339,10932
3/21/2016,2016,3,21, 11 ,8341,1626,1426,11393
3/21/2016,2016,3,21, 12 ,8260,1620,1407,11287
3/21/2016,2016,3,21, 13 ,8275,1628,1424,11327
3/21/2016,2016,3,21, 14 ,8603,1693,1455,11751
3/21/2016,2016,3,21, 15 ,8548,1673,1316,11537
3/21/2016,2016,3,21, 16 ,8420,1650,1395,11465
3/21/2016,2016,3,21, 17 ,8022,1565,1337,10924
3/21/2016,2016,3,21, 18 ,7739,1553,1384,10676
3/21/2016,2016,3,21, 19 ,8078,1698,1438,11214
3/21/2016,2016,3,21, 20 ,7903,1638,1300,10841
3/21/2016,2016,3,21, 21 ,7769,1575,1284,10628
3/21/2016,2016,3,21, 22 ,7406,1440,1226,10072
3/21/2016,2016,3,21, 23 ,6987,1320,1143,9450
3/21/2016,2016,3,21, 24 ,6665,1249,1043,8957
3/22/2016,2016,3,22, 1 ,6320,1182,1014,8516
3/22/2016,2016,3,22, 2 ,6137,1157,980,8274
3/22/2016,2016,3,22, 3 ,5929,1123,957,8009
3/22/2016,2016,3,22, 4 ,5762,1103,941,7806
3/22/2016,2016,3,22, 5 ,5772,1119,965,7856
3/22/2016,2016,3,22, 6 ,5817,1129,998,7944
3/22/2016,2016,3,22, 7 ,5926,1115,956,7997
3/22/2016,2016,3,22, 8 ,6684,1281,1067,9032
3/22/2016,2016,3,22, 9 ,7489,1499,1282,10270
3/22/2016,2016,3,22, 10 ,7840,1594,1366,10800
3/22/2016,2016,3,22, 11 ,8298,1649,1411,11358
3/22/2016,2016,3,22, 12 ,8169,1643,1406,11218
3/22/2016,2016,3,22, 13 ,8224,1669,1432,11325
3/22/2016,2016,3,22, 14 ,8552,1711,1422,11685
3/22/2016,2016,3,22, 15 ,8420,1700,1419,11539
3/22/2016,2016,3,22, 16 ,8275,1644,1389,11308
3/22/2016,2016,3,22, 17 ,7883,1551,1295,10729
3/22/2016,2016,3,22, 18 ,7685,1567,1362,10614
3/22/2016,2016,3,22, 19 ,8056,1693,1400,11149
3/22/2016,2016,3,22, 20 ,7880,1632,1387,10899
3/22/2016,2016,3,22, 21 ,7766,1536,1328,10630
3/22/2016,2016,3,22, 22 ,7467,1421,1233,10121
3/22/2016,2016,3,22, 23 ,7107,1332,1145,9584
3/22/2016,2016,3,22, 24 ,6729,1250,1066,9045
3/23/2016,2016,3,23, 1 ,6396,1198,1018,8612
3/23/2016,2016,3,23, 2 ,6204,1165,988,8357
3/23/2016,2016,3,23, 3 ,5939,1135,955,8029
3/23/2016,2016,3,23, 4 ,5811,1110,944,7865
3/23/2016,2016,3,23, 5 ,5755,1131,957,7843
3/23/2016,2016,3,23, 6 ,5768,1122,970,7860
3/23/2016,2016,3,23, 7 ,5883,1125,953,7961
3/23/2016,2016,3,23, 8 ,6600,1276,1089,8965
3/23/2016,2016,3,23, 9 ,7390,1487,1273,10150
3/23/2016,2016,3,23, 10 ,7925,1589,1312,10826
3/23/2016,2016,3,23, 11 ,8214,1659,1381,11254
3/23/2016,2016,3,23, 12 ,8074,1601,1357,11032
3/23/2016,2016,3,23, 13 ,8051,1624,1376,11051
3/23/2016,2016,3,23, 14 ,8289,1651,1406,11346
3/23/2016,2016,3,23, 15 ,8101,1651,1400,11152
3/23/2016,2016,3,23, 16 ,7920,1582,1374,10876
3/23/2016,2016,3,23, 17 ,7364,1491,1295,10150
3/23/2016,2016,3,23, 18 ,7200,1511,1318,10029
3/23/2016,2016,3,23, 19 ,7608,1658,1381,10647
3/23/2016,2016,3,23, 20 ,7463,1604,1348,10415
3/23/2016,2016,3,23, 21 ,7458,1544,1309,10311
3/23/2016,2016,3,23, 22 ,7160,1438,1204,9802
3/23/2016,2016,3,23, 23 ,6729,1322,1122,9173
3/23/2016,2016,3,23, 24 ,6378,1242,1045,8665
3/24/2016,2016,3,24, 1 ,6085,1190,1014,8289
3/24/2016,2016,3,24, 2 ,5796,1147,977,7920
3/24/2016,2016,3,24, 3 ,5600,1103,939,7642
3/24/2016,2016,3,24, 4 ,5408,1070,907,7385
3/24/2016,2016,3,24, 5 ,5272,1063,910,7245
3/24/2016,2016,3,24, 6 ,4990,999,887,6876
3/24/2016,2016,3,24, 7 ,4759,994,872,6625
3/24/2016,2016,3,24, 8 ,4902,1075,940,6917
3/24/2016,2016,3,24, 9 ,5138,1138,1043,7319
3/24/2016,2016,3,24, 10 ,5422,1189,1102,7713
3/24/2016,2016,3,24, 11 ,5678,1230,1170,8078
3/24/2016,2016,3,24, 12 ,5738,1254,1187,8179
3/24/2016,2016,3,24, 13 ,5759,1245,1178,8182
3/24/2016,2016,3,24, 14 ,5912,1236,1188,8336
3/24/2016,2016,3,24, 15 ,5875,1224,1156,8255
3/24/2016,2016,3,24, 16 ,5725,1210,1125,8060
3/24/2016,2016,3,24, 17 ,5596,1177,1090,7863
3/24/2016,2016,3,24, 18 ,5579,1286,1175,8040
3/24/2016,2016,3,24, 19 ,6254,1443,1278,8975
3/24/2016,2016,3,24, 20 ,6217,1404,1254,8875
3/24/2016,2016,3,24, 21 ,6228,1366,1230,8824
3/24/2016,2016,3,24, 22 ,6188,1300,1141,8629
3/24/2016,2016,3,24, 23 ,5996,1216,1060,8272
3/24/2016,2016,3,24, 24 ,5738,1116,746,7600
3/25/2016,2016,3,25, 1 ,6085,1069,956,8110
3/25/2016,2016,3,25, 2 ,5796,1032,918,7746
3/25/2016,2016,3,25, 3 ,5600,997,886,7483
3/25/2016,2016,3,25, 4 ,5408,982,855,7245
3/25/2016,2016,3,25, 5 ,5272,969,842,7083
3/25/2016,2016,3,25, 6 ,4990,924,809,6723
3/25/2016,2016,3,25, 7 ,4759,912,801,6472
3/25/2016,2016,3,25, 8 ,4902,957,832,6691
3/25/2016,2016,3,25, 9 ,5138,1002,860,7000
3/25/2016,2016,3,25, 10 ,5422,1020,894,7336
3/25/2016,2016,3,25, 11 ,5678,1045,944,7667
3/25/2016,2016,3,25, 12 ,5738,1063,935,7736
3/25/2016,2016,3,25, 13 ,5759,1068,955,7782
3/25/2016,2016,3,25, 14 ,5912,1078,973,7963
3/25/2016,2016,3,25, 15 ,5875,1061,955,7891
3/25/2016,2016,3,25, 16 ,5725,1017,910,7652
3/25/2016,2016,3,25, 17 ,5596,982,911,7489
3/25/2016,2016,3,25, 18 ,5579,1058,1023,7660
3/25/2016,2016,3,25, 19 ,6254,1252,1166,8672
3/25/2016,2016,3,25, 20 ,6217,1272,1066,8555
3/25/2016,2016,3,25, 21 ,6228,1256,1161,8645
3/25/2016,2016,3,25, 22 ,6188,1222,1117,8527
3/25/2016,2016,3,25, 23 ,5996,1128,1027,8151
3/25/2016,2016,3,25, 24 ,5738,1075,945,7758
3/26/2016,2016,3,26, 1 ,5215,1023,901,7139
3/26/2016,2016,3,26, 2 ,4996,992,884,6872
3/26/2016,2016,3,26, 3 ,4858,963,848,6669
3/26/2016,2016,3,26, 4 ,4711,941,823,6475
3/26/2016,2016,3,26, 5 ,4649,949,832,6430
3/26/2016,2016,3,26, 6 ,4528,931,828,6287
3/26/2016,2016,3,26, 7 ,4587,965,840,6392
3/26/2016,2016,3,26, 8 ,4922,1047,910,6879
3/26/2016,2016,3,26, 9 ,5343,1144,1046,7533
3/26/2016,2016,3,26, 10 ,5725,1234,1105,8064
3/26/2016,2016,3,26, 11 ,5987,1286,1183,8456
3/26/2016,2016,3,26, 12 ,5999,1309,1182,8490
3/26/2016,2016,3,26, 13 ,6056,1310,1203,8569
3/26/2016,2016,3,26, 14 ,6192,1323,1230,8745
3/26/2016,2016,3,26, 15 ,6146,1304,1199,8649
3/26/2016,2016,3,26, 16 ,6003,1267,1186,8456
3/26/2016,2016,3,26, 17 ,5865,1236,1159,8260
3/26/2016,2016,3,26, 18 ,6062,1333,1266,8661
3/26/2016,2016,3,26, 19 ,6636,1491,1329,9456
3/26/2016,2016,3,26, 20 ,6579,1453,1313,9345
3/26/2016,2016,3,26, 21 ,6475,1366,1232,9073
3/26/2016,2016,3,26, 22 ,6314,1277,1155,8746
3/26/2016,2016,3,26, 23 ,5995,1195,1096,8286
3/26/2016,2016,3,26, 24 ,5676,1118,1015,7809
3/27/2016,2016,3,27, 1 ,5416,1076,968,7460
3/27/2016,2016,3,27, 2 ,5261,1044,939,7244
3/27/2016,2016,3,27, 3 ,5120,1011,914,7045
3/27/2016,2016,3,27, 4 ,4983,995,890,6868
3/27/2016,2016,3,27, 5 ,4891,996,893,6780
3/27/2016,2016,3,27, 6 ,4786,972,866,6624
3/27/2016,2016,3,27, 7 ,4831,979,884,6694
3/27/2016,2016,3,27, 8 ,5048,1052,925,7025
3/27/2016,2016,3,27, 9 ,5369,1139,1013,7521
3/27/2016,2016,3,27, 10 ,5789,1234,1090,8113
3/27/2016,2016,3,27, 11 ,6061,1283,1160,8504
3/27/2016,2016,3,27, 12 ,5998,1268,1162,8428
3/27/2016,2016,3,27, 13 ,6083,1283,1162,8528
3/27/2016,2016,3,27, 14 ,6204,1293,1175,8672
3/27/2016,2016,3,27, 15 ,6186,1282,1173,8641
3/27/2016,2016,3,27, 16 ,5960,1254,1151,8365
3/27/2016,2016,3,27, 17 ,5880,1238,1170,8288
3/27/2016,2016,3,27, 18 ,6041,1332,1270,8643
3/27/2016,2016,3,27, 19 ,6552,1509,1358,9419
3/27/2016,2016,3,27, 20 ,6502,1476,1336,9314
3/27/2016,2016,3,27, 21 ,6458,1422,1282,9162
3/27/2016,2016,3,27, 22 ,6261,1329,1189,8779
3/27/2016,2016,3,27, 23 ,5944,1243,1119,8306
3/27/2016,2016,3,27, 24 ,5701,1152,1029,7882
3/28/2016,2016,3,28, 1 ,5418,1116,986,7520
3/28/2016,2016,3,28, 2 ,5252,1081,945,7278
3/28/2016,2016,3,28, 3 ,5081,1067,924,7072
3/28/2016,2016,3,28, 4 ,4988,1045,908,6941
3/28/2016,2016,3,28, 5 ,5057,1064,941,7062
3/28/2016,2016,3,28, 6 ,5189,1086,948,7223
3/28/2016,2016,3,28, 7 ,5402,1095,931,7428
3/28/2016,2016,3,28, 8 ,6222,1246,1062,8530
3/28/2016,2016,3,28, 9 ,7007,1470,1246,9723
3/28/2016,2016,3,28, 10 ,7530,1595,1320,10445
3/28/2016,2016,3,28, 11 ,7854,1659,1407,10920
3/28/2016,2016,3,28, 12 ,7650,1640,1405,10695
3/28/2016,2016,3,28, 13 ,7672,1649,1418,10739
3/28/2016,2016,3,28, 14 ,7951,1695,1455,11101
3/28/2016,2016,3,28, 15 ,7880,1675,1432,10987
3/28/2016,2016,3,28, 16 ,7757,1650,1397,10804
3/28/2016,2016,3,28, 17 ,7404,1548,1351,10303
3/28/2016,2016,3,28, 18 ,7266,1545,1389,10200
3/28/2016,2016,3,28, 19 ,7506,1678,1430,10614
3/28/2016,2016,3,28, 20 ,7288,1615,1392,10295
3/28/2016,2016,3,28, 21 ,7003,1551,1358,9912
3/28/2016,2016,3,28, 22 ,6678,1434,1278,9390
3/28/2016,2016,3,28, 23 ,6323,1322,1202,8847
3/28/2016,2016,3,28, 24 ,5970,1244,1106,8320
3/29/2016,2016,3,29, 1 ,5702,1198,1070,7970
3/29/2016,2016,3,29, 2 ,5531,1160,1030,7721
3/29/2016,2016,3,29, 3 ,5377,1129,1004,7510
3/29/2016,2016,3,29, 4 ,5297,1109,989,7395
3/29/2016,2016,3,29, 5 ,5338,1119,1005,7462
3/29/2016,2016,3,29, 6 ,5420,1151,1005,7576
3/29/2016,2016,3,29, 7 ,5634,1133,993,7760
3/29/2016,2016,3,29, 8 ,6427,1299,1139,8865
3/29/2016,2016,3,29, 9 ,7150,1500,1316,9966
3/29/2016,2016,3,29, 10 ,7678,1633,1280,10591
3/29/2016,2016,3,29, 11 ,7987,1685,1406,11078
3/29/2016,2016,3,29, 12 ,7854,1657,1390,10901
3/29/2016,2016,3,29, 13 ,7900,1645,1400,10945
3/29/2016,2016,3,29, 14 ,8163,1717,1424,11304
3/29/2016,2016,3,29, 15 ,8083,1693,1409,11185
3/29/2016,2016,3,29, 16 ,8054,1660,1395,11109
3/29/2016,2016,3,29, 17 ,7602,1564,1351,10517
3/29/2016,2016,3,29, 18 ,7450,1567,1352,10369
3/29/2016,2016,3,29, 19 ,7756,1704,1446,10906
3/29/2016,2016,3,29, 20 ,7571,1641,1420,10632
3/29/2016,2016,3,29, 21 ,7364,1589,1364,10317
3/29/2016,2016,3,29, 22 ,7008,1470,1286,9764
3/29/2016,2016,3,29, 23 ,6589,1358,1200,9147
3/29/2016,2016,3,29, 24 ,6273,1270,1118,8661
3/30/2016,2016,3,30, 1 ,6048,1219,1081,8348
3/30/2016,2016,3,30, 2 ,5834,1169,1047,8050
3/30/2016,2016,3,30, 3 ,5685,1153,1009,7847
3/30/2016,2016,3,30, 4 ,5584,1132,990,7706
3/30/2016,2016,3,30, 5 ,5660,1142,953,7755
3/30/2016,2016,3,30, 6 ,5686,1135,947,7768
3/30/2016,2016,3,30, 7 ,5879,1152,945,7976
3/30/2016,2016,3,30, 8 ,6630,1304,1079,9013
3/30/2016,2016,3,30, 9 ,7440,1515,1299,10254
3/30/2016,2016,3,30, 10 ,7972,1624,1397,10993
3/30/2016,2016,3,30, 11 ,8296,1687,1399,11382
3/30/2016,2016,3,30, 12 ,8152,1655,1399,11206
3/30/2016,2016,3,30, 13 ,8160,1652,1462,11274
3/30/2016,2016,3,30, 14 ,8509,1734,1469,11712
3/30/2016,2016,3,30, 15 ,8438,1726,1447,11611
3/30/2016,2016,3,30, 16 ,8344,1675,1442,11461
3/30/2016,2016,3,30, 17 ,7959,1591,1387,10937
3/30/2016,2016,3,30, 18 ,7701,1586,1430,10717
3/30/2016,2016,3,30, 19 ,8020,1715,1457,11192
3/30/2016,2016,3,30, 20 ,7854,1663,1439,10956
3/30/2016,2016,3,30, 21 ,7597,1610,1399,10606
3/30/2016,2016,3,30, 22 ,7332,1493,1337,10162
3/30/2016,2016,3,30, 23 ,6968,1392,1206,9566
3/30/2016,2016,3,30, 24 ,6578,1304,1119,9001
3/31/2016,2016,3,31, 1 ,6295,1254,1090,8639
3/31/2016,2016,3,31, 2 ,6088,1216,1056,8360
3/31/2016,2016,3,31, 3 ,5905,1172,1022,8099
3/31/2016,2016,3,31, 4 ,5819,1156,994,7969
3/31/2016,2016,3,31, 5 ,5788,1165,1007,7960
3/31/2016,2016,3,31, 6 ,5816,1152,1025,7993
3/31/2016,2016,3,31, 7 ,6020,1163,1037,8220
3/31/2016,2016,3,31, 8 ,6782,1318,1147,9247
3/31/2016,2016,3,31, 9 ,7567,1533,1327,10427
3/31/2016,2016,3,31, 10 ,8094,1614,1402,11110
3/31/2016,2016,3,31, 11 ,8405,1692,1470,11567
3/31/2016,2016,3,31, 12 ,8247,1671,1434,11352
3/31/2016,2016,3,31, 13 ,8097,1680,1455,11232
3/31/2016,2016,3,31, 14 ,8522,1765,1437,11724
3/31/2016,2016,3,31, 15 ,8461,1740,1443,11644
3/31/2016,2016,3,31, 16 ,8302,1714,1416,11432
3/31/2016,2016,3,31, 17 ,7912,1598,1329,10839
3/31/2016,2016,3,31, 18 ,7677,1579,1382,10638
3/31/2016,2016,3,31, 19 ,8053,1721,1471,11245
3/31/2016,2016,3,31, 20 ,7835,1672,1442,10949
3/31/2016,2016,3,31, 21 ,7765,1620,1422,10807
3/31/2016,2016,3,31, 22 ,7429,1501,1315,10245
3/31/2016,2016,3,31, 23 ,7126,1403,1216,9745
3/31/2016,2016,3,31, 24 ,6755,1319,1137,9211
4/1/2016,2016,4,1, 1 ,6427,1259,1097,8783
4/1/2016,2016,4,1, 2 ,6212,1227,1059,8498
4/1/2016,2016,4,1, 3 ,6035,1197,1024,8256
4/1/2016,2016,4,1, 4 ,5892,1169,1009,8070
4/1/2016,2016,4,1, 5 ,5892,1185,1008,8085
4/1/2016,2016,4,1, 6 ,5886,1145,1015,8046
4/1/2016,2016,4,1, 7 ,6058,1147,1003,8208
4/1/2016,2016,4,1, 8 ,6851,1311,1155,9317
4/1/2016,2016,4,1, 9 ,7628,1501,1344,10473
4/1/2016,2016,4,1, 10 ,8113,1624,1424,11161
4/1/2016,2016,4,1, 11 ,8395,1694,1453,11542
4/1/2016,2016,4,1, 12 ,8323,1663,1431,11417
4/1/2016,2016,4,1, 13 ,8343,1673,1453,11469
4/1/2016,2016,4,1, 14 ,8689,1753,1478,11920
4/1/2016,2016,4,1, 15 ,8482,1722,1448,11652
4/1/2016,2016,4,1, 16 ,8271,1699,1425,11395
4/1/2016,2016,4,1, 17 ,7919,1593,1353,10865
4/1/2016,2016,4,1, 18 ,7707,1572,1405,10684
4/1/2016,2016,4,1, 19 ,8003,1709,1458,11170
4/1/2016,2016,4,1, 20 ,7849,1638,1438,10925
4/1/2016,2016,4,1, 21 ,7753,1584,1403,10740
4/1/2016,2016,4,1, 22 ,7466,1479,1295,10240
4/1/2016,2016,4,1, 23 ,7152,1380,1204,9736
4/1/2016,2016,4,1, 24 ,6780,1294,1137,9211
4/2/2016,2016,4,2, 1 ,6501,1229,1082,8812
4/2/2016,2016,4,2, 2 ,6284,1190,1034,8508
4/2/2016,2016,4,2, 3 ,6120,1158,997,8275
4/2/2016,2016,4,2, 4 ,5973,1128,980,8081
4/2/2016,2016,4,2, 5 ,5962,1130,983,8075
4/2/2016,2016,4,2, 6 ,5796,1119,970,7885
4/2/2016,2016,4,2, 7 ,5859,1126,955,7940
4/2/2016,2016,4,2, 8 ,6407,1237,1021,8665
4/2/2016,2016,4,2, 9 ,6961,1403,1155,9519
4/2/2016,2016,4,2, 10 ,7538,1460,1268,10266
4/2/2016,2016,4,2, 11 ,7880,1522,1332,10734
4/2/2016,2016,4,2, 12 ,7718,1499,1319,10536
4/2/2016,2016,4,2, 13 ,7728,1502,1329,10559
4/2/2016,2016,4,2, 14 ,7920,1563,1363,10846
4/2/2016,2016,4,2, 15 ,7716,1528,1343,10587
4/2/2016,2016,4,2, 16 ,7523,1480,1315,10318
4/2/2016,2016,4,2, 17 ,7231,1411,1177,9819
4/2/2016,2016,4,2, 18 ,7069,1457,1350,9876
4/2/2016,2016,4,2, 19 ,7631,1623,1410,10664
4/2/2016,2016,4,2, 20 ,7574,1610,1411,10595
4/2/2016,2016,4,2, 21 ,7516,1553,1325,10394
4/2/2016,2016,4,2, 22 ,7324,1471,1275,10070
4/2/2016,2016,4,2, 23 ,6928,1369,1180,9477
4/2/2016,2016,4,2, 24 ,6626,1277,1108,9011
4/3/2016,2016,4,3, 1 ,6292,1217,1050,8559
4/3/2016,2016,4,3, 2 ,6060,1170,1014,8244
4/3/2016,2016,4,3, 3 ,5877,1135,975,7987
4/3/2016,2016,4,3, 4 ,5728,1101,951,7780
4/3/2016,2016,4,3, 5 ,5625,1081,952,7658
4/3/2016,2016,4,3, 6 ,5405,1035,934,7374
4/3/2016,2016,4,3, 7 ,5339,1029,910,7278
4/3/2016,2016,4,3, 8 ,5667,1105,942,7714
4/3/2016,2016,4,3, 9 ,6059,1176,1033,8268
4/3/2016,2016,4,3, 10 ,6587,1259,1116,8962
4/3/2016,2016,4,3, 11 ,6882,1303,1169,9354
4/3/2016,2016,4,3, 12 ,6869,1303,1171,9343
4/3/2016,2016,4,3, 13 ,6854,1316,1175,9345
4/3/2016,2016,4,3, 14 ,6994,1336,1189,9519
4/3/2016,2016,4,3, 15 ,6880,1323,1193,9396
4/3/2016,2016,4,3, 16 ,6813,1272,1157,9242
4/3/2016,2016,4,3, 17 ,6564,1235,1152,8951
4/3/2016,2016,4,3, 18 ,6661,1331,1307,9299
4/3/2016,2016,4,3, 19 ,7280,1491,1376,10147
4/3/2016,2016,4,3, 20 ,7291,1462,1336,10089
4/3/2016,2016,4,3, 21 ,7213,1426,1300,9939
4/3/2016,2016,4,3, 22 ,7014,1355,1214,9583
4/3/2016,2016,4,3, 23 ,6720,1284,1154,9158
4/3/2016,2016,4,3, 24 ,6391,1193,1089,8673
4/4/2016,2016,4,4, 1 ,6053,1140,1027,8220
4/4/2016,2016,4,4, 2 ,5834,1088,997,7919
4/4/2016,2016,4,4, 3 ,5635,1060,966,7661
4/4/2016,2016,4,4, 4 ,5465,1050,958,7473
4/4/2016,2016,4,4, 5 ,5449,1063,959,7471
4/4/2016,2016,4,4, 6 ,5504,1072,964,7540
4/4/2016,2016,4,4, 7 ,5836,1105,981,7922
4/4/2016,2016,4,4, 8 ,6679,1277,1127,9083
4/4/2016,2016,4,4, 9 ,7516,1495,1205,10216
4/4/2016,2016,4,4, 10 ,8225,1586,1361,11172
4/4/2016,2016,4,4, 11 ,8513,1670,1381,11564
4/4/2016,2016,4,4, 12 ,8426,1638,1372,11436
4/4/2016,2016,4,4, 13 ,8472,1659,1397,11528
4/4/2016,2016,4,4, 14 ,8829,1731,1414,11974
4/4/2016,2016,4,4, 15 ,8723,1704,1406,11833
4/4/2016,2016,4,4, 16 ,8597,1690,1393,11680
4/4/2016,2016,4,4, 17 ,8134,1569,1331,11034
4/4/2016,2016,4,4, 18 ,7801,1590,1379,10770
4/4/2016,2016,4,4, 19 ,8188,1703,1415,11306
4/4/2016,2016,4,4, 20 ,8057,1640,1386,11083
4/4/2016,2016,4,4, 21 ,7940,1592,1349,10881
4/4/2016,2016,4,4, 22 ,7674,1472,1282,10428
4/4/2016,2016,4,4, 23 ,7286,1374,1196,9856
4/4/2016,2016,4,4, 24 ,6943,1297,1137,9377
4/5/2016,2016,4,5, 1 ,6615,1238,1079,8932
4/5/2016,2016,4,5, 2 ,6366,1198,1047,8611
4/5/2016,2016,4,5, 3 ,6202,1166,1022,8390
4/5/2016,2016,4,5, 4 ,5998,1150,1001,8149
4/5/2016,2016,4,5, 5 ,6011,1147,998,8156
4/5/2016,2016,4,5, 6 ,6032,1137,1012,8181
4/5/2016,2016,4,5, 7 ,6186,1137,1001,8324
4/5/2016,2016,4,5, 8 ,6895,1318,1157,9370
4/5/2016,2016,4,5, 9 ,7635,1540,1326,10501
4/5/2016,2016,4,5, 10 ,8037,1655,1357,11049
4/5/2016,2016,4,5, 11 ,8321,1726,1413,11460
4/5/2016,2016,4,5, 12 ,8309,1685,1405,11399
4/5/2016,2016,4,5, 13 ,8331,1672,1422,11425
4/5/2016,2016,4,5, 14 ,8708,1743,1431,11882
4/5/2016,2016,4,5, 15 ,8609,1727,1414,11750
4/5/2016,2016,4,5, 16 ,8500,1690,1362,11552
4/5/2016,2016,4,5, 17 ,8003,1588,1297,10888
4/5/2016,2016,4,5, 18 ,7783,1607,1386,10776
4/5/2016,2016,4,5, 19 ,8187,1731,1407,11325
4/5/2016,2016,4,5, 20 ,8028,1680,1399,11107
4/5/2016,2016,4,5, 21 ,7917,1613,1388,10918
4/5/2016,2016,4,5, 22 ,7637,1514,1298,10449
4/5/2016,2016,4,5, 23 ,7245,1394,1222,9861
4/5/2016,2016,4,5, 24 ,6852,1326,1136,9314
4/6/2016,2016,4,6, 1 ,6578,1265,1096,8939
4/6/2016,2016,4,6, 2 ,6432,1216,1061,8709
4/6/2016,2016,4,6, 3 ,6217,1181,1021,8419
4/6/2016,2016,4,6, 4 ,6073,1157,1009,8239
4/6/2016,2016,4,6, 5 ,6085,1160,1009,8254
4/6/2016,2016,4,6, 6 ,6063,1141,997,8201
4/6/2016,2016,4,6, 7 ,6273,1161,1010,8444
4/6/2016,2016,4,6, 8 ,7043,1335,1160,9538
4/6/2016,2016,4,6, 9 ,7798,1546,1360,10704
4/6/2016,2016,4,6, 10 ,8350,1656,1427,11433
4/6/2016,2016,4,6, 11 ,8605,1714,1442,11761
4/6/2016,2016,4,6, 12 ,8489,1667,1429,11585
4/6/2016,2016,4,6, 13 ,8520,1692,1434,11646
4/6/2016,2016,4,6, 14 ,8857,1770,1457,12084
4/6/2016,2016,4,6, 15 ,8690,1731,1270,11691
4/6/2016,2016,4,6, 16 ,8562,1690,1284,11536
4/6/2016,2016,4,6, 17 ,8133,1568,1207,10908
4/6/2016,2016,4,6, 18 ,7879,1569,1234,10682
4/6/2016,2016,4,6, 19 ,8191,1716,1235,11142
4/6/2016,2016,4,6, 20 ,8097,1666,1234,10997
4/6/2016,2016,4,6, 21 ,7888,1599,1149,10636
4/6/2016,2016,4,6, 22 ,7656,1482,1208,10346
4/6/2016,2016,4,6, 23 ,7251,1373,1129,9753
4/6/2016,2016,4,6, 24 ,6845,1295,1051,9191
4/7/2016,2016,4,7, 1 ,6571,1233,1059,8863
4/7/2016,2016,4,7, 2 ,6336,1188,1022,8546
4/7/2016,2016,4,7, 3 ,6131,1152,1002,8285
4/7/2016,2016,4,7, 4 ,5974,1136,979,8089
4/7/2016,2016,4,7, 5 ,5993,1134,996,8123
4/7/2016,2016,4,7, 6 ,5934,1125,997,8056
4/7/2016,2016,4,7, 7 ,6173,1145,996,8314
4/7/2016,2016,4,7, 8 ,6993,1320,1146,9459
4/7/2016,2016,4,7, 9 ,7882,1535,1248,10665
4/7/2016,2016,4,7, 10 ,8453,1672,1303,11428
4/7/2016,2016,4,7, 11 ,8697,1705,1319,11721
4/7/2016,2016,4,7, 12 ,8520,1676,1235,11431
4/7/2016,2016,4,7, 13 ,8599,1665,1210,11474
4/7/2016,2016,4,7, 14 ,8918,1749,1305,11972
4/7/2016,2016,4,7, 15 ,8847,1722,1302,11871
4/7/2016,2016,4,7, 16 ,8705,1697,1298,11700
4/7/2016,2016,4,7, 17 ,8265,1598,1218,11081
4/7/2016,2016,4,7, 18 ,7917,1599,1271,10787
4/7/2016,2016,4,7, 19 ,8323,1714,1291,11328
4/7/2016,2016,4,7, 20 ,8139,1654,1302,11095
4/7/2016,2016,4,7, 21 ,8048,1582,1291,10921
4/7/2016,2016,4,7, 22 ,7824,1475,1224,10523
4/7/2016,2016,4,7, 23 ,7360,1382,1167,9909
4/7/2016,2016,4,7, 24 ,7033,1307,1135,9475
4/8/2016,2016,4,8, 1 ,6694,1248,1058,9000
4/8/2016,2016,4,8, 2 ,6502,1207,1055,8764
4/8/2016,2016,4,8, 3 ,6307,1179,1022,8508
4/8/2016,2016,4,8, 4 ,6125,1162,1004,8291
4/8/2016,2016,4,8, 5 ,6029,1168,1009,8206
4/8/2016,2016,4,8, 6 ,5962,1142,1014,8118
4/8/2016,2016,4,8, 7 ,6184,1162,1024,8370
4/8/2016,2016,4,8, 8 ,7030,1314,1131,9475
4/8/2016,2016,4,8, 9 ,7819,1519,1243,10581
4/8/2016,2016,4,8, 10 ,8359,1652,1291,11302
4/8/2016,2016,4,8, 11 ,8709,1729,1312,11750
4/8/2016,2016,4,8, 12 ,8535,1663,1298,11496
4/8/2016,2016,4,8, 13 ,8517,1665,1255,11437
4/8/2016,2016,4,8, 14 ,8819,1736,1294,11849
4/8/2016,2016,4,8, 15 ,8782,1728,1242,11752
4/8/2016,2016,4,8, 16 ,8575,1679,1255,11509
4/8/2016,2016,4,8, 17 ,8150,1560,1248,10958
4/8/2016,2016,4,8, 18 ,7763,1574,1280,10617
4/8/2016,2016,4,8, 19 ,8150,1707,1290,11147
4/8/2016,2016,4,8, 20 ,8063,1656,1280,10999
4/8/2016,2016,4,8, 21 ,7929,1613,1275,10817
4/8/2016,2016,4,8, 22 ,7682,1490,1218,10390
4/8/2016,2016,4,8, 23 ,7302,1383,1150,9835
4/8/2016,2016,4,8, 24 ,6914,1302,1122,9338
4/9/2016,2016,4,9, 1 ,6606,1248,1029,8883
4/9/2016,2016,4,9, 2 ,6407,1215,923,8545
4/9/2016,2016,4,9, 3 ,6208,1175,1007,8390
4/9/2016,2016,4,9, 4 ,6032,1143,979,8154
4/9/2016,2016,4,9, 5 ,5924,1138,988,8050
4/9/2016,2016,4,9, 6 ,5690,1089,961,7740
4/9/2016,2016,4,9, 7 ,5642,1087,966,7695
4/9/2016,2016,4,9, 8 ,6001,1171,1005,8177
4/9/2016,2016,4,9, 9 ,6482,1308,1110,8900
4/9/2016,2016,4,9, 10 ,6997,1393,1168,9558
4/9/2016,2016,4,9, 11 ,7258,1478,1150,9886
4/9/2016,2016,4,9, 12 ,7221,1459,1186,9866
4/9/2016,2016,4,9, 13 ,7350,1483,1184,10017
4/9/2016,2016,4,9, 14 ,7500,1506,1193,10199
4/9/2016,2016,4,9, 15 ,7377,1492,1167,10036
4/9/2016,2016,4,9, 16 ,7134,1447,1213,9794
4/9/2016,2016,4,9, 17 ,6842,1377,1201,9420
4/9/2016,2016,4,9, 18 ,6804,1478,1271,9553
4/9/2016,2016,4,9, 19 ,7403,1640,1262,10305
4/9/2016,2016,4,9, 20 ,7413,1614,1287,10314
4/9/2016,2016,4,9, 21 ,7382,1563,1274,10219
4/9/2016,2016,4,9, 22 ,7136,1500,1233,9869
4/9/2016,2016,4,9, 23 ,6867,1389,1205,9461
4/9/2016,2016,4,9, 24 ,6489,1306,1097,8892
4/10/2016,2016,4,10, 1 ,6194,1239,970,8403
4/10/2016,2016,4,10, 2 ,6061,1187,1049,8297
4/10/2016,2016,4,10, 3 ,5813,1144,1003,7960
4/10/2016,2016,4,10, 4 ,5638,1125,996,7759
4/10/2016,2016,4,10, 5 ,5547,1117,999,7663
4/10/2016,2016,4,10, 6 ,5338,1073,962,7373
4/10/2016,2016,4,10, 7 ,5365,1058,966,7389
4/10/2016,2016,4,10, 8 ,5714,1121,1021,7856
4/10/2016,2016,4,10, 9 ,6165,1217,1101,8483
4/10/2016,2016,4,10, 10 ,6739,1339,1190,9268
4/10/2016,2016,4,10, 11 ,7022,1347,1253,9622
4/10/2016,2016,4,10, 12 ,6971,1380,1254,9605
4/10/2016,2016,4,10, 13 ,7104,1394,1272,9770
4/10/2016,2016,4,10, 14 ,7216,1426,1236,9878
4/10/2016,2016,4,10, 15 ,7182,1381,1221,9784
4/10/2016,2016,4,10, 16 ,6907,1302,1158,9367
4/10/2016,2016,4,10, 17 ,6754,1305,1156,9215
4/10/2016,2016,4,10, 18 ,6820,1400,1262,9482
4/10/2016,2016,4,10, 19 ,7480,1574,1291,10345
4/10/2016,2016,4,10, 20 ,7509,1547,1290,10346
4/10/2016,2016,4,10, 21 ,7433,1487,1253,10173
4/10/2016,2016,4,10, 22 ,7216,1424,1177,9817
4/10/2016,2016,4,10, 23 ,6992,1340,1136,9468
4/10/2016,2016,4,10, 24 ,6660,1259,1111,9030
4/11/2016,2016,4,11, 1 ,6356,1189,1021,8566
4/11/2016,2016,4,11, 2 ,6119,1165,988,8272
4/11/2016,2016,4,11, 3 ,5861,1144,967,7972
4/11/2016,2016,4,11, 4 ,5799,1122,945,7866
4/11/2016,2016,4,11, 5 ,5690,1134,955,7779
4/11/2016,2016,4,11, 6 ,5710,1123,971,7804
4/11/2016,2016,4,11, 7 ,6045,1153,992,8190
4/11/2016,2016,4,11, 8 ,6935,1336,1148,9419
4/11/2016,2016,4,11, 9 ,7836,1539,1226,10601
4/11/2016,2016,4,11, 10 ,8393,1697,1240,11330
4/11/2016,2016,4,11, 11 ,8732,1761,1287,11780
4/11/2016,2016,4,11, 12 ,8638,1721,1266,11625
4/11/2016,2016,4,11, 13 ,8726,1712,1305,11743
4/11/2016,2016,4,11, 14 ,9143,1802,1328,12273
4/11/2016,2016,4,11, 15 ,9060,1773,1318,12151
4/11/2016,2016,4,11, 16 ,8836,1751,1311,11898
4/11/2016,2016,4,11, 17 ,8418,1629,1260,11307
4/11/2016,2016,4,11, 18 ,7983,1622,1281,10886
4/11/2016,2016,4,11, 19 ,8418,1745,1278,11441
4/11/2016,2016,4,11, 20 ,8340,1696,1284,11320
4/11/2016,2016,4,11, 21 ,8164,1636,1273,11073
4/11/2016,2016,4,11, 22 ,7903,1539,1210,10652
4/11/2016,2016,4,11, 23 ,7561,1442,1162,10165
4/11/2016,2016,4,11, 24 ,7211,1365,1093,9669
4/12/2016,2016,4,12, 1 ,6973,1312,1071,9356
4/12/2016,2016,4,12, 2 ,6769,1270,1049,9088
4/12/2016,2016,4,12, 3 ,6480,1243,1035,8758
4/12/2016,2016,4,12, 4 ,6361,1214,1014,8589
4/12/2016,2016,4,12, 5 ,6324,1215,1020,8559
4/12/2016,2016,4,12, 6 ,6193,1190,1025,8408
4/12/2016,2016,4,12, 7 ,6451,1211,1047,8709
4/12/2016,2016,4,12, 8 ,7269,1394,1190,9853
4/12/2016,2016,4,12, 9 ,8019,1594,1260,10873
4/12/2016,2016,4,12, 10 ,8648,1706,1292,11646
4/12/2016,2016,4,12, 11 ,8868,1769,1308,11945
4/12/2016,2016,4,12, 12 ,8670,1724,1313,11707
4/12/2016,2016,4,12, 13 ,8756,1717,1291,11764
4/12/2016,2016,4,12, 14 ,9186,1792,1314,12292
4/12/2016,2016,4,12, 15 ,9131,1774,1297,12202
4/12/2016,2016,4,12, 16 ,8957,1733,1303,11993
4/12/2016,2016,4,12, 17 ,8452,1627,1280,11359
4/12/2016,2016,4,12, 18 ,8190,1657,1281,11128
4/12/2016,2016,4,12, 19 ,8620,1734,1279,11633
4/12/2016,2016,4,12, 20 ,8490,1685,1292,11467
4/12/2016,2016,4,12, 21 ,8442,1635,1289,11366
4/12/2016,2016,4,12, 22 ,8243,1527,1250,11020
4/12/2016,2016,4,12, 23 ,7826,1444,1194,10464
4/12/2016,2016,4,12, 24 ,7504,1371,1162,10037
4/13/2016,2016,4,13, 1 ,7174,1316,1100,9590
4/13/2016,2016,4,13, 2 ,6950,1271,1076,9297
4/13/2016,2016,4,13, 3 ,6764,1228,1046,9038
4/13/2016,2016,4,13, 4 ,6579,1208,1031,8818
4/13/2016,2016,4,13, 5 ,6418,1212,1050,8680
4/13/2016,2016,4,13, 6 ,6369,1184,1042,8595
4/13/2016,2016,4,13, 7 ,6613,1203,1033,8849
4/13/2016,2016,4,13, 8 ,7394,1392,1202,9988
4/13/2016,2016,4,13, 9 ,8139,1574,1281,10994
4/13/2016,2016,4,13, 10 ,8670,1705,1333,11708
4/13/2016,2016,4,13, 11 ,9037,1767,1345,12149
4/13/2016,2016,4,13, 12 ,8935,1733,1322,11990
4/13/2016,2016,4,13, 13 ,9020,1756,1340,12116
4/13/2016,2016,4,13, 14 ,9368,1822,1347,12537
4/13/2016,2016,4,13, 15 ,9279,1792,1336,12407
4/13/2016,2016,4,13, 16 ,9023,1729,1329,12081
4/13/2016,2016,4,13, 17 ,8512,1645,1282,11439
4/13/2016,2016,4,13, 18 ,8206,1676,1309,11191
4/13/2016,2016,4,13, 19 ,8659,1775,1308,11742
4/13/2016,2016,4,13, 20 ,8584,1753,1316,11653
4/13/2016,2016,4,13, 21 ,8524,1678,1325,11527
4/13/2016,2016,4,13, 22 ,8273,1561,1306,11140
4/13/2016,2016,4,13, 23 ,7924,1459,1125,10508
4/13/2016,2016,4,13, 24 ,7554,1398,1150,10102
4/14/2016,2016,4,14, 1 ,7219,1331,1128,9678
4/14/2016,2016,4,14, 2 ,6995,1287,1090,9372
4/14/2016,2016,4,14, 3 ,6796,1253,1046,9095
4/14/2016,2016,4,14, 4 ,6589,1226,968,8783
4/14/2016,2016,4,14, 5 ,6523,1225,1046,8794
4/14/2016,2016,4,14, 6 ,6380,1205,1040,8625
4/14/2016,2016,4,14, 7 ,6665,1218,1058,8941
4/14/2016,2016,4,14, 8 ,7565,1399,1222,10186
4/14/2016,2016,4,14, 9 ,8401,1637,1307,11345
4/14/2016,2016,4,14, 10 ,8895,1741,1312,11948
4/14/2016,2016,4,14, 11 ,9258,1798,1350,12406
4/14/2016,2016,4,14, 12 ,9156,1743,1342,12241
4/14/2016,2016,4,14, 13 ,9202,1730,1375,12307
4/14/2016,2016,4,14, 14 ,9496,1792,1419,12707
4/14/2016,2016,4,14, 15 ,9398,1769,1390,12557
4/14/2016,2016,4,14, 16 ,9211,1721,1367,12299
4/14/2016,2016,4,14, 17 ,8705,1615,1313,11633
4/14/2016,2016,4,14, 18 ,8322,1624,1353,11299
4/14/2016,2016,4,14, 19 ,8714,1729,1377,11820
4/14/2016,2016,4,14, 20 ,8627,1677,1358,11662
4/14/2016,2016,4,14, 21 ,8629,1639,1377,11645
4/14/2016,2016,4,14, 22 ,8394,1524,1253,11171
4/14/2016,2016,4,14, 23 ,8007,1451,1174,10632
4/14/2016,2016,4,14, 24 ,7737,1384,1160,10281
4/15/2016,2016,4,15, 1 ,7404,1321,1143,9868
4/15/2016,2016,4,15, 2 ,7128,1291,1097,9516
4/15/2016,2016,4,15, 3 ,6951,1250,1065,9266
4/15/2016,2016,4,15, 4 ,6749,1199,1043,8991
4/15/2016,2016,4,15, 5 ,6672,1181,1053,8906
4/15/2016,2016,4,15, 6 ,6494,1158,1033,8685
4/15/2016,2016,4,15, 7 ,6725,1197,1045,8967
4/15/2016,2016,4,15, 8 ,7521,1414,1179,10114
4/15/2016,2016,4,15, 9 ,8355,1628,1294,11277
4/15/2016,2016,4,15, 10 ,8805,1726,1326,11857
4/15/2016,2016,4,15, 11 ,9126,1773,1349,12248
4/15/2016,2016,4,15, 12 ,9051,1731,1353,12135
4/15/2016,2016,4,15, 13 ,9086,1734,1395,12215
4/15/2016,2016,4,15, 14 ,9374,1787,1385,12546
4/15/2016,2016,4,15, 15 ,9298,1776,1389,12463
4/15/2016,2016,4,15, 16 ,9088,1738,1369,12195
4/15/2016,2016,4,15, 17 ,8637,1635,1326,11598
4/15/2016,2016,4,15, 18 ,8260,1638,1345,11243
4/15/2016,2016,4,15, 19 ,8672,1750,1363,11785
4/15/2016,2016,4,15, 20 ,8568,1704,1392,11664
4/15/2016,2016,4,15, 21 ,8513,1639,1327,11479
4/15/2016,2016,4,15, 22 ,8259,1539,1273,11071
4/15/2016,2016,4,15, 23 ,7903,1450,1234,10587
4/15/2016,2016,4,15, 24 ,7618,1389,1137,10144
4/16/2016,2016,4,16, 1 ,7325,1342,1109,9776
4/16/2016,2016,4,16, 2 ,7068,1287,1070,9425
4/16/2016,2016,4,16, 3 ,6863,1238,1038,9139
4/16/2016,2016,4,16, 4 ,6648,1217,1014,8879
4/16/2016,2016,4,16, 5 ,6563,1217,1018,8798
4/16/2016,2016,4,16, 6 ,6321,1160,969,8450
4/16/2016,2016,4,16, 7 ,6327,1176,915,8418
4/16/2016,2016,4,16, 8 ,6938,1304,993,9235
4/16/2016,2016,4,16, 9 ,7554,1469,1176,10199
4/16/2016,2016,4,16, 10 ,8088,1576,1248,10912
4/16/2016,2016,4,16, 11 ,8452,1620,1270,11342
4/16/2016,2016,4,16, 12 ,8360,1610,1249,11219
4/16/2016,2016,4,16, 13 ,8361,1617,1294,11272
4/16/2016,2016,4,16, 14 ,8597,1654,1288,11539
4/16/2016,2016,4,16, 15 ,8515,1620,1286,11421
4/16/2016,2016,4,16, 16 ,8260,1555,1214,11029
4/16/2016,2016,4,16, 17 ,7774,1494,1180,10448
4/16/2016,2016,4,16, 18 ,7647,1551,1191,10389
4/16/2016,2016,4,16, 19 ,8208,1694,1338,11240
4/16/2016,2016,4,16, 20 ,8174,1656,1319,11149
4/16/2016,2016,4,16, 21 ,8173,1599,1329,11101
4/16/2016,2016,4,16, 22 ,8087,1518,1253,10858
4/16/2016,2016,4,16, 23 ,7795,1444,1162,10401
4/16/2016,2016,4,16, 24 ,7402,1353,1052,9807
4/17/2016,2016,4,17, 1 ,7173,1285,1076,9534
4/17/2016,2016,4,17, 2 ,6963,1242,1058,9263
4/17/2016,2016,4,17, 3 ,6704,1195,1000,8899
4/17/2016,2016,4,17, 4 ,6430,1164,988,8582
4/17/2016,2016,4,17, 5 ,6291,1137,981,8409
4/17/2016,2016,4,17, 6 ,5954,1074,936,7964
4/17/2016,2016,4,17, 7 ,5808,1077,920,7805
4/17/2016,2016,4,17, 8 ,6081,1147,939,8167
4/17/2016,2016,4,17, 9 ,6440,1256,1005,8701
4/17/2016,2016,4,17, 10 ,6997,1337,1115,9449
4/17/2016,2016,4,17, 11 ,7262,1385,1155,9802
4/17/2016,2016,4,17, 12 ,7251,1394,1190,9835
4/17/2016,2016,4,17, 13 ,7402,1405,1193,10000
4/17/2016,2016,4,17, 14 ,7349,1417,1074,9840
4/17/2016,2016,4,17, 15 ,7349,1367,1156,9872
4/17/2016,2016,4,17, 16 ,7161,1349,1153,9663
4/17/2016,2016,4,17, 17 ,6919,1333,1150,9402
4/17/2016,2016,4,17, 18 ,7006,1390,1308,9704
4/17/2016,2016,4,17, 19 ,7507,1596,1407,10510
4/17/2016,2016,4,17, 20 ,7638,1561,1399,10598
4/17/2016,2016,4,17, 21 ,7609,1530,1370,10509
4/17/2016,2016,4,17, 22 ,7594,1462,1286,10342
4/17/2016,2016,4,17, 23 ,7322,1365,1198,9885
4/17/2016,2016,4,17, 24 ,6979,1288,1132,9399
4/18/2016,2016,4,18, 1 ,6724,1240,1086,9050
4/18/2016,2016,4,18, 2 ,6426,1182,1024,8632
4/18/2016,2016,4,18, 3 ,6244,1144,996,8384
4/18/2016,2016,4,18, 4 ,6070,1131,971,8172
4/18/2016,2016,4,18, 5 ,5988,1133,986,8107
4/18/2016,2016,4,18, 6 ,5927,1109,976,8012
4/18/2016,2016,4,18, 7 ,6282,1142,983,8407
4/18/2016,2016,4,18, 8 ,7199,1326,1159,9684
4/18/2016,2016,4,18, 9 ,8054,1543,1265,10862
4/18/2016,2016,4,18, 10 ,8668,1670,1373,11711
4/18/2016,2016,4,18, 11 ,9064,1738,1357,12159
4/18/2016,2016,4,18, 12 ,8992,1714,1364,12070
4/18/2016,2016,4,18, 13 ,9147,1704,1421,12272
4/18/2016,2016,4,18, 14 ,9494,1779,1451,12724
4/18/2016,2016,4,18, 15 ,9386,1751,1408,12545
4/18/2016,2016,4,18, 16 ,9368,1730,1381,12479
4/18/2016,2016,4,18, 17 ,8758,1614,1342,11714
4/18/2016,2016,4,18, 18 ,8363,1594,1372,11329
4/18/2016,2016,4,18, 19 ,8678,1730,1408,11816
4/18/2016,2016,4,18, 20 ,8594,1670,1389,11653
4/18/2016,2016,4,18, 21 ,8449,1635,1395,11479
4/18/2016,2016,4,18, 22 ,8250,1507,1330,11087
4/18/2016,2016,4,18, 23 ,7915,1414,1245,10574
4/18/2016,2016,4,18, 24 ,7558,1332,1168,10058
4/19/2016,2016,4,19, 1 ,7235,1267,1124,9626
4/19/2016,2016,4,19, 2 ,6989,1234,1067,9290
4/19/2016,2016,4,19, 3 ,6716,1199,1029,8944
4/19/2016,2016,4,19, 4 ,6511,1164,1010,8685
4/19/2016,2016,4,19, 5 ,6463,1160,1027,8650
4/19/2016,2016,4,19, 6 ,6315,1130,1015,8460
4/19/2016,2016,4,19, 7 ,6614,1171,1017,8802
4/19/2016,2016,4,19, 8 ,7470,1365,1194,10029
4/19/2016,2016,4,19, 9 ,8212,1580,1340,11132
4/19/2016,2016,4,19, 10 ,8793,1691,1379,11863
4/19/2016,2016,4,19, 11 ,9082,1730,1364,12176
4/19/2016,2016,4,19, 12 ,8902,1693,1376,11971
4/19/2016,2016,4,19, 13 ,8976,1692,1385,12053
4/19/2016,2016,4,19, 14 ,9307,1773,1419,12499
4/19/2016,2016,4,19, 15 ,9178,1762,1427,12367
4/19/2016,2016,4,19, 16 ,8898,1716,1383,11997
4/19/2016,2016,4,19, 17 ,8433,1610,1338,11381
4/19/2016,2016,4,19, 18 ,8117,1570,1379,11066
4/19/2016,2016,4,19, 19 ,8479,1717,1399,11595
4/19/2016,2016,4,19, 20 ,8410,1666,1393,11469
4/19/2016,2016,4,19, 21 ,8372,1605,1365,11342
4/19/2016,2016,4,19, 22 ,8189,1499,1297,10985
4/19/2016,2016,4,19, 23 ,7775,1401,1229,10405
4/19/2016,2016,4,19, 24 ,7490,1332,1151,9973
4/20/2016,2016,4,20, 1 ,7197,1278,1120,9595
4/20/2016,2016,4,20, 2 ,7005,1232,1081,9318
4/20/2016,2016,4,20, 3 ,6757,1197,1050,9004
4/20/2016,2016,4,20, 4 ,6594,1177,1028,8799
4/20/2016,2016,4,20, 5 ,6591,1169,1038,8798
4/20/2016,2016,4,20, 6 ,6434,1143,1028,8605
4/20/2016,2016,4,20, 7 ,6626,1146,1043,8815
4/20/2016,2016,4,20, 8 ,7488,1319,1197,10004
4/20/2016,2016,4,20, 9 ,8241,1520,1344,11105
4/20/2016,2016,4,20, 10 ,8727,1647,1390,11764
4/20/2016,2016,4,20, 11 ,9052,1698,1361,12111
4/20/2016,2016,4,20, 12 ,8929,1659,1366,11954
4/20/2016,2016,4,20, 13 ,8976,1658,1413,12047
4/20/2016,2016,4,20, 14 ,9311,1723,1409,12443
4/20/2016,2016,4,20, 15 ,9197,1708,1375,12280
4/20/2016,2016,4,20, 16 ,9031,1677,1391,12099
4/20/2016,2016,4,20, 17 ,8504,1576,1334,11414
4/20/2016,2016,4,20, 18 ,8169,1583,1355,11107
4/20/2016,2016,4,20, 19 ,8536,1708,1422,11666
4/20/2016,2016,4,20, 20 ,8435,1680,1411,11526
4/20/2016,2016,4,20, 21 ,8347,1631,1379,11357
4/20/2016,2016,4,20, 22 ,8132,1513,1318,10963
4/20/2016,2016,4,20, 23 ,7734,1408,1220,10362
4/20/2016,2016,4,20, 24 ,7372,1334,1144,9850
4/21/2016,2016,4,21, 1 ,7049,1284,1092,9425
4/21/2016,2016,4,21, 2 ,6864,1230,1057,9151
4/21/2016,2016,4,21, 3 ,6628,1202,1033,8863
4/21/2016,2016,4,21, 4 ,6456,1184,958,8598
4/21/2016,2016,4,21, 5 ,6446,1176,984,8606
4/21/2016,2016,4,21, 6 ,6298,1143,996,8437
4/21/2016,2016,4,21, 7 ,6495,1156,1006,8657
4/21/2016,2016,4,21, 8 ,7357,1354,1168,9879
4/21/2016,2016,4,21, 9 ,8201,1552,1343,11096
4/21/2016,2016,4,21, 10 ,8631,1694,1393,11718
4/21/2016,2016,4,21, 11 ,8953,1744,1454,12151
4/21/2016,2016,4,21, 12 ,8816,1702,1415,11933
4/21/2016,2016,4,21, 13 ,8887,1713,1447,12047
4/21/2016,2016,4,21, 14 ,9316,1788,1481,12585
4/21/2016,2016,4,21, 15 ,9225,1779,1463,12467
4/21/2016,2016,4,21, 16 ,9028,1727,1460,12215
4/21/2016,2016,4,21, 17 ,8554,1617,1399,11570
4/21/2016,2016,4,21, 18 ,8166,1606,1424,11196
4/21/2016,2016,4,21, 19 ,8558,1742,1462,11762
4/21/2016,2016,4,21, 20 ,8440,1691,1438,11569
4/21/2016,2016,4,21, 21 ,8364,1640,1388,11392
4/21/2016,2016,4,21, 22 ,8126,1540,1309,10975
4/21/2016,2016,4,21, 23 ,7721,1443,1211,10375
4/21/2016,2016,4,21, 24 ,7401,1377,1158,9936
4/22/2016,2016,4,22, 1 ,7103,1312,1083,9498
4/22/2016,2016,4,22, 2 ,6871,1266,1041,9178
4/22/2016,2016,4,22, 3 ,6681,1234,1014,8929
4/22/2016,2016,4,22, 4 ,6482,1200,1002,8684
4/22/2016,2016,4,22, 5 ,6394,1208,1023,8625
4/22/2016,2016,4,22, 6 ,6219,1177,977,8373
4/22/2016,2016,4,22, 7 ,6449,1200,986,8635
4/22/2016,2016,4,22, 8 ,7332,1387,1156,9875
4/22/2016,2016,4,22, 9 ,8071,1595,1331,10997
4/22/2016,2016,4,22, 10 ,8639,1701,1381,11721
4/22/2016,2016,4,22, 11 ,8871,1777,1420,12068
4/22/2016,2016,4,22, 12 ,8783,1742,1389,11914
4/22/2016,2016,4,22, 13 ,8846,1749,1424,12019
4/22/2016,2016,4,22, 14 ,9234,1801,1417,12452
4/22/2016,2016,4,22, 15 ,9148,1753,1451,12352
4/22/2016,2016,4,22, 16 ,9018,1706,1445,12169
4/22/2016,2016,4,22, 17 ,8524,1605,1354,11483
4/22/2016,2016,4,22, 18 ,8161,1607,1423,11191
4/22/2016,2016,4,22, 19 ,8515,1732,1434,11681
4/22/2016,2016,4,22, 20 ,8384,1704,1421,11509
4/22/2016,2016,4,22, 21 ,8314,1651,1378,11343
4/22/2016,2016,4,22, 22 ,8092,1516,1289,10897
4/22/2016,2016,4,22, 23 ,7797,1423,1220,10440
4/22/2016,2016,4,22, 24 ,7439,1344,1133,9916
4/23/2016,2016,4,23, 1 ,7088,1286,1088,9462
4/23/2016,2016,4,23, 2 ,6863,1262,1055,9180
4/23/2016,2016,4,23, 3 ,6630,1219,1017,8866
4/23/2016,2016,4,23, 4 ,6397,1183,1007,8587
4/23/2016,2016,4,23, 5 ,6293,1191,1006,8490
4/23/2016,2016,4,23, 6 ,6032,1150,1012,8194
4/23/2016,2016,4,23, 7 ,6029,1155,984,8168
4/23/2016,2016,4,23, 8 ,6648,1270,1124,9042
4/23/2016,2016,4,23, 9 ,7261,1459,1230,9950
4/23/2016,2016,4,23, 10 ,7858,1566,1299,10723
4/23/2016,2016,4,23, 11 ,8119,1618,1365,11102
4/23/2016,2016,4,23, 12 ,8030,1574,1357,10961
4/23/2016,2016,4,23, 13 ,8071,1593,1383,11047
4/23/2016,2016,4,23, 14 ,8340,1643,1381,11364
4/23/2016,2016,4,23, 15 ,8247,1602,1361,11210
4/23/2016,2016,4,23, 16 ,7980,1517,1315,10812
4/23/2016,2016,4,23, 17 ,7531,1476,1276,10283
4/23/2016,2016,4,23, 18 ,7403,1533,1364,10300
4/23/2016,2016,4,23, 19 ,7930,1671,1441,11042
4/23/2016,2016,4,23, 20 ,7877,1637,1429,10943
4/23/2016,2016,4,23, 21 ,7919,1595,1399,10913
4/23/2016,2016,4,23, 22 ,7839,1520,1309,10668
4/23/2016,2016,4,23, 23 ,7606,1437,1211,10254
4/23/2016,2016,4,23, 24 ,7229,1350,1161,9740
4/24/2016,2016,4,24, 1 ,6965,1287,1079,9331
4/24/2016,2016,4,24, 2 ,6749,1251,1043,9043
4/24/2016,2016,4,24, 3 ,6468,1216,1005,8689
4/24/2016,2016,4,24, 4 ,6270,1187,984,8441
4/24/2016,2016,4,24, 5 ,6114,1166,995,8275
4/24/2016,2016,4,24, 6 ,5744,1120,964,7828
4/24/2016,2016,4,24, 7 ,5760,1117,953,7830
4/24/2016,2016,4,24, 8 ,6072,1171,1020,8263
4/24/2016,2016,4,24, 9 ,6490,1281,1082,8853
4/24/2016,2016,4,24, 10 ,7000,1373,1171,9544
4/24/2016,2016,4,24, 11 ,7240,1419,1238,9897
4/24/2016,2016,4,24, 12 ,7224,1358,1239,9821
4/24/2016,2016,4,24, 13 ,7357,1376,1260,9993
4/24/2016,2016,4,24, 14 ,7452,1407,1256,10115
4/24/2016,2016,4,24, 15 ,7412,1399,1236,10047
4/24/2016,2016,4,24, 16 ,7216,1359,1199,9774
4/24/2016,2016,4,24, 17 ,7016,1335,1192,9543
4/24/2016,2016,4,24, 18 ,7102,1452,1322,9876
4/24/2016,2016,4,24, 19 ,7727,1642,1404,10773
4/24/2016,2016,4,24, 20 ,7810,1627,1394,10831
4/24/2016,2016,4,24, 21 ,7771,1580,1356,10707
4/24/2016,2016,4,24, 22 ,7658,1504,1264,10426
4/24/2016,2016,4,24, 23 ,7428,1418,1189,10035
4/24/2016,2016,4,24, 24 ,7063,1329,1100,9492
4/25/2016,2016,4,25, 1 ,6758,1265,1053,9076
4/25/2016,2016,4,25, 2 ,6470,1222,1024,8716
4/25/2016,2016,4,25, 3 ,6300,1194,994,8488
4/25/2016,2016,4,25, 4 ,6110,1170,973,8253
4/25/2016,2016,4,25, 5 ,6081,1169,994,8244
4/25/2016,2016,4,25, 6 ,5904,1147,980,8031
4/25/2016,2016,4,25, 7 ,6306,1189,998,8493
4/25/2016,2016,4,25, 8 ,7210,1371,1049,9630
4/25/2016,2016,4,25, 9 ,8142,1582,1361,11085
4/25/2016,2016,4,25, 10 ,8665,1699,1459,11823
4/25/2016,2016,4,25, 11 ,9036,1772,1466,12274
4/25/2016,2016,4,25, 12 ,8907,1731,1449,12087
4/25/2016,2016,4,25, 13 ,8940,1736,1488,12164
4/25/2016,2016,4,25, 14 ,9360,1785,1512,12657
4/25/2016,2016,4,25, 15 ,9265,1779,1474,12518
4/25/2016,2016,4,25, 16 ,9115,1735,1489,12339
4/25/2016,2016,4,25, 17 ,8627,1637,1418,11682
4/25/2016,2016,4,25, 18 ,8179,1618,1458,11255
4/25/2016,2016,4,25, 19 ,8548,1774,1514,11836
4/25/2016,2016,4,25, 20 ,8486,1733,1495,11714
4/25/2016,2016,4,25, 21 ,8340,1677,1451,11468
4/25/2016,2016,4,25, 22 ,8254,1573,1316,11143
4/25/2016,2016,4,25, 23 ,7905,1468,1247,10620
4/25/2016,2016,4,25, 24 ,7534,1379,1135,10048
4/26/2016,2016,4,26, 1 ,7252,1324,1124,9700
4/26/2016,2016,4,26, 2 ,7027,1275,1089,9391
4/26/2016,2016,4,26, 3 ,6818,1233,1054,9105
4/26/2016,2016,4,26, 4 ,6599,1208,1043,8850
4/26/2016,2016,4,26, 5 ,6541,1205,1041,8787
4/26/2016,2016,4,26, 6 ,6405,1171,1012,8588
4/26/2016,2016,4,26, 7 ,6605,1209,1036,8850
4/26/2016,2016,4,26, 8 ,7472,1396,1180,10048
4/26/2016,2016,4,26, 9 ,8295,1619,1379,11293
4/26/2016,2016,4,26, 10 ,8864,1721,1440,12025
4/26/2016,2016,4,26, 11 ,9124,1778,1487,12389
4/26/2016,2016,4,26, 12 ,8991,1755,1469,12215
4/26/2016,2016,4,26, 13 ,9050,1753,1466,12269
4/26/2016,2016,4,26, 14 ,9429,1838,1505,12772
4/26/2016,2016,4,26, 15 ,9345,1822,1496,12663
4/26/2016,2016,4,26, 16 ,9142,1776,1484,12402
4/26/2016,2016,4,26, 17 ,8636,1673,1421,11730
4/26/2016,2016,4,26, 18 ,8172,1629,1455,11256
4/26/2016,2016,4,26, 19 ,8529,1777,1491,11797
4/26/2016,2016,4,26, 20 ,8373,1737,1473,11583
4/26/2016,2016,4,26, 21 ,8351,1692,1433,11476
4/26/2016,2016,4,26, 22 ,8128,1576,1345,11049
4/26/2016,2016,4,26, 23 ,7769,1480,1250,10499
4/26/2016,2016,4,26, 24 ,7406,1396,1168,9970
4/27/2016,2016,4,27, 1 ,7099,1347,1137,9583
4/27/2016,2016,4,27, 2 ,6871,1299,1104,9274
4/27/2016,2016,4,27, 3 ,6552,1269,1070,8891
4/27/2016,2016,4,27, 4 ,6442,1231,1053,8726
4/27/2016,2016,4,27, 5 ,6348,1237,1062,8647
4/27/2016,2016,4,27, 6 ,6195,1206,1048,8449
4/27/2016,2016,4,27, 7 ,6460,1217,1044,8721
4/27/2016,2016,4,27, 8 ,7354,1396,1191,9941
4/27/2016,2016,4,27, 9 ,8191,1623,1384,11198
4/27/2016,2016,4,27, 10 ,8710,1713,1425,11848
4/27/2016,2016,4,27, 11 ,9113,1764,1419,12296
4/27/2016,2016,4,27, 12 ,8957,1722,1435,12114
4/27/2016,2016,4,27, 13 ,9013,1754,1459,12226
4/27/2016,2016,4,27, 14 ,9452,1819,1469,12740
4/27/2016,2016,4,27, 15 ,9389,1813,1456,12658
4/27/2016,2016,4,27, 16 ,9206,1762,1448,12416
4/27/2016,2016,4,27, 17 ,8733,1649,1371,11753
4/27/2016,2016,4,27, 18 ,8397,1644,1415,11456
4/27/2016,2016,4,27, 19 ,8720,1759,1447,11926
4/27/2016,2016,4,27, 20 ,8703,1716,1443,11862
4/27/2016,2016,4,27, 21 ,8616,1676,1407,11699
4/27/2016,2016,4,27, 22 ,8400,1562,1312,11274
4/27/2016,2016,4,27, 23 ,8032,1451,1224,10707
4/27/2016,2016,4,27, 24 ,7648,1377,1151,10176
4/28/2016,2016,4,28, 1 ,7347,1335,1122,9804
4/28/2016,2016,4,28, 2 ,7146,1283,1089,9518
4/28/2016,2016,4,28, 3 ,6891,1235,1050,9176
4/28/2016,2016,4,28, 4 ,6693,1226,1031,8950
4/28/2016,2016,4,28, 5 ,6654,1225,1034,8913
4/28/2016,2016,4,28, 6 ,6472,1200,1030,8702
4/28/2016,2016,4,28, 7 ,6669,1219,1049,8937
4/28/2016,2016,4,28, 8 ,7596,1388,1211,10195
4/28/2016,2016,4,28, 9 ,8431,1636,1394,11461
4/28/2016,2016,4,28, 10 ,8873,1707,1462,12042
4/28/2016,2016,4,28, 11 ,9166,1754,1490,12410
4/28/2016,2016,4,28, 12 ,9060,1716,1474,12250
4/28/2016,2016,4,28, 13 ,9128,1735,1490,12353
4/28/2016,2016,4,28, 14 ,9557,1815,1508,12880
4/28/2016,2016,4,28, 15 ,9372,1808,1461,12641
4/28/2016,2016,4,28, 16 ,9187,1765,1470,12422
4/28/2016,2016,4,28, 17 ,8671,1639,1383,11693
4/28/2016,2016,4,28, 18 ,8327,1650,1424,11401
4/28/2016,2016,4,28, 19 ,8699,1773,1466,11938
4/28/2016,2016,4,28, 20 ,8651,1737,1476,11864
4/28/2016,2016,4,28, 21 ,8582,1676,1420,11678
4/28/2016,2016,4,28, 22 ,8367,1590,1305,11262
4/28/2016,2016,4,28, 23 ,8083,1484,1215,10782
4/28/2016,2016,4,28, 24 ,7681,1402,1164,10247
4/29/2016,2016,4,29, 1 ,7319,1345,1117,9781
4/29/2016,2016,4,29, 2 ,7080,1302,1091,9473
4/29/2016,2016,4,29, 3 ,6845,1257,1063,9165
4/29/2016,2016,4,29, 4 ,6620,1223,1046,8889
4/29/2016,2016,4,29, 5 ,6574,1222,1050,8846
4/29/2016,2016,4,29, 6 ,6422,1190,1034,8646
4/29/2016,2016,4,29, 7 ,6635,1207,1047,8889
4/29/2016,2016,4,29, 8 ,7435,1397,1237,10069
4/29/2016,2016,4,29, 9 ,8319,1640,1405,11364
4/29/2016,2016,4,29, 10 ,8793,1731,1458,11982
4/29/2016,2016,4,29, 11 ,9112,1821,1502,12435
4/29/2016,2016,4,29, 12 ,8977,1767,1459,12203
4/29/2016,2016,4,29, 13 ,9030,1779,1497,12306
4/29/2016,2016,4,29, 14 ,9344,1871,1515,12730
4/29/2016,2016,4,29, 15 ,9180,1821,1494,12495
4/29/2016,2016,4,29, 16 ,8886,1757,1500,12143
4/29/2016,2016,4,29, 17 ,8389,1655,1400,11444
4/29/2016,2016,4,29, 18 ,8130,1649,1453,11232
4/29/2016,2016,4,29, 19 ,8372,1764,1497,11633
4/29/2016,2016,4,29, 20 ,8253,1738,1483,11474
4/29/2016,2016,4,29, 21 ,8288,1684,1332,11304
4/29/2016,2016,4,29, 22 ,8054,1566,1253,10873
4/29/2016,2016,4,29, 23 ,7699,1478,1170,10347
4/29/2016,2016,4,29, 24 ,7365,1398,1111,9874
4/30/2016,2016,4,30, 1 ,7095,1341,1154,9590
4/30/2016,2016,4,30, 2 ,6856,1305,1118,9279
4/30/2016,2016,4,30, 3 ,6653,1262,1084,8999
4/30/2016,2016,4,30, 4 ,6463,1239,1067,8769
4/30/2016,2016,4,30, 5 ,6342,1226,1071,8639
4/30/2016,2016,4,30, 6 ,6041,1182,1012,8235
4/30/2016,2016,4,30, 7 ,6125,1177,1022,8324
4/30/2016,2016,4,30, 8 ,6747,1294,1085,9126
4/30/2016,2016,4,30, 9 ,7438,1493,1279,10210
4/30/2016,2016,4,30, 10 ,7925,1587,1335,10847
4/30/2016,2016,4,30, 11 ,8262,1652,1419,11333
4/30/2016,2016,4,30, 12 ,8145,1597,1379,11121
4/30/2016,2016,4,30, 13 ,8189,1610,1363,11162
4/30/2016,2016,4,30, 14 ,8426,1681,1393,11500
4/30/2016,2016,4,30, 15 ,8267,1648,1367,11282
4/30/2016,2016,4,30, 16 ,7978,1599,1352,10929
4/30/2016,2016,4,30, 17 ,7584,1520,1298,10402
4/30/2016,2016,4,30, 18 ,7516,1576,1359,10451
4/30/2016,2016,4,30, 19 ,8005,1723,1415,11143
4/30/2016,2016,4,30, 20 ,7984,1699,1399,11082
4/30/2016,2016,4,30, 21 ,7969,1656,1381,11006
4/30/2016,2016,4,30, 22 ,7916,1583,1330,10829
4/30/2016,2016,4,30, 23 ,7615,1497,1229,10341
4/30/2016,2016,4,30, 24 ,7230,1381,1164,9775
5/1/2016,2016,5,1, 1 ,6962,1323,1099,9384
5/1/2016,2016,5,1, 2 ,6694,1278,1053,9025
5/1/2016,2016,5,1, 3 ,6480,1233,1024,8737
5/1/2016,2016,5,1, 4 ,6240,1211,1004,8455
5/1/2016,2016,5,1, 5 ,6028,1193,1001,8222
5/1/2016,2016,5,1, 6 ,5639,1121,991,7751
5/1/2016,2016,5,1, 7 ,5472,1128,982,7582
5/1/2016,2016,5,1, 8 ,5741,1206,1030,7977
5/1/2016,2016,5,1, 9 ,6140,1297,1129,8566
5/1/2016,2016,5,1, 10 ,6590,1388,1211,9189
5/1/2016,2016,5,1, 11 ,6830,1426,1242,9498
5/1/2016,2016,5,1, 12 ,6857,1417,1218,9492
5/1/2016,2016,5,1, 13 ,6957,1428,1222,9607
5/1/2016,2016,5,1, 14 ,7036,1439,1257,9732
5/1/2016,2016,5,1, 15 ,7040,1429,1245,9714
5/1/2016,2016,5,1, 16 ,6877,1387,1204,9468
5/1/2016,2016,5,1, 17 ,6732,1352,1213,9297
5/1/2016,2016,5,1, 18 ,6765,1447,1326,9538
5/1/2016,2016,5,1, 19 ,7498,1640,1359,10497
5/1/2016,2016,5,1, 20 ,7589,1615,1363,10567
5/1/2016,2016,5,1, 21 ,7581,1601,1307,10489
5/1/2016,2016,5,1, 22 ,7425,1511,1234,10170
5/1/2016,2016,5,1, 23 ,7123,1433,1161,9717
5/1/2016,2016,5,1, 24 ,6941,1360,1080,9381
5/2/2016,2016,5,2, 1 ,6679,1307,1029,9015
5/2/2016,2016,5,2, 2 ,6444,1266,995,8705
5/2/2016,2016,5,2, 3 ,6222,1239,978,8439
5/2/2016,2016,5,2, 4 ,6040,1212,964,8216
5/2/2016,2016,5,2, 5 ,5993,1204,989,8186
5/2/2016,2016,5,2, 6 ,5915,1179,973,8067
5/2/2016,2016,5,2, 7 ,6379,1224,975,8578
5/2/2016,2016,5,2, 8 ,7277,1417,1156,9850
5/2/2016,2016,5,2, 9 ,8232,1650,1353,11235
5/2/2016,2016,5,2, 10 ,8754,1726,1411,11891
5/2/2016,2016,5,2, 11 ,9070,1798,1383,12251
5/2/2016,2016,5,2, 12 ,9069,1748,1438,12255
5/2/2016,2016,5,2, 13 ,9129,1761,1474,12364
5/2/2016,2016,5,2, 14 ,9480,1823,1505,12808
5/2/2016,2016,5,2, 15 ,9393,1803,1489,12685
5/2/2016,2016,5,2, 16 ,9204,1763,1476,12443
5/2/2016,2016,5,2, 17 ,8706,1670,1435,11811
5/2/2016,2016,5,2, 18 ,8244,1670,1468,11382
5/2/2016,2016,5,2, 19 ,8602,1797,1462,11861
5/2/2016,2016,5,2, 20 ,8560,1750,1463,11773
5/2/2016,2016,5,2, 21 ,8488,1715,1429,11632
5/2/2016,2016,5,2, 22 ,8262,1610,1326,11198
5/2/2016,2016,5,2, 23 ,7962,1527,1221,10710
5/2/2016,2016,5,2, 24 ,7611,1436,1117,10164
5/3/2016,2016,5,3, 1 ,7301,1374,1093,9768
5/3/2016,2016,5,3, 2 ,7010,1328,1081,9419
5/3/2016,2016,5,3, 3 ,6782,1298,1050,9130
5/3/2016,2016,5,3, 4 ,6632,1273,1026,8931
5/3/2016,2016,5,3, 5 ,6541,1278,1039,8858
5/3/2016,2016,5,3, 6 ,6345,1217,1024,8586
5/3/2016,2016,5,3, 7 ,6669,1256,1025,8950
5/3/2016,2016,5,3, 8 ,7426,1439,1213,10078
5/3/2016,2016,5,3, 9 ,8430,1670,1395,11495
5/3/2016,2016,5,3, 10 ,8889,1776,1405,12070
5/3/2016,2016,5,3, 11 ,9272,1833,1472,12577
5/3/2016,2016,5,3, 12 ,9180,1785,1436,12401
5/3/2016,2016,5,3, 13 ,9260,1796,1427,12483
5/3/2016,2016,5,3, 14 ,9664,1866,1458,12988
5/3/2016,2016,5,3, 15 ,9547,1857,1424,12828
5/3/2016,2016,5,3, 16 ,9325,1804,1421,12550
5/3/2016,2016,5,3, 17 ,8840,1682,1361,11883
5/3/2016,2016,5,3, 18 ,8357,1670,1384,11411
5/3/2016,2016,5,3, 19 ,8786,1800,1418,12004
5/3/2016,2016,5,3, 20 ,8709,1772,1419,11900
5/3/2016,2016,5,3, 21 ,8512,1719,1346,11577
5/3/2016,2016,5,3, 22 ,8426,1623,1266,11315
5/3/2016,2016,5,3, 23 ,8143,1533,1128,10804
5/3/2016,2016,5,3, 24 ,7772,1448,1096,10316
5/4/2016,2016,5,4, 1 ,7411,1385,1051,9847
5/4/2016,2016,5,4, 2 ,7182,1340,1037,9559
5/4/2016,2016,5,4, 3 ,6959,1308,1017,9284
5/4/2016,2016,5,4, 4 ,6757,1272,995,9024
5/4/2016,2016,5,4, 5 ,6667,1272,998,8937
5/4/2016,2016,5,4, 6 ,6406,1221,1005,8632
5/4/2016,2016,5,4, 7 ,6686,1248,1022,8956
5/4/2016,2016,5,4, 8 ,7589,1442,1173,10204
5/4/2016,2016,5,4, 9 ,8399,1653,1311,11363
5/4/2016,2016,5,4, 10 ,8933,1779,1455,12167
5/4/2016,2016,5,4, 11 ,9252,1829,1459,12540
5/4/2016,2016,5,4, 12 ,9153,1790,1462,12405
5/4/2016,2016,5,4, 13 ,9239,1783,1489,12511
5/4/2016,2016,5,4, 14 ,9657,1848,1535,13040
5/4/2016,2016,5,4, 15 ,9580,1825,1516,12921
5/4/2016,2016,5,4, 16 ,9427,1795,1508,12730
5/4/2016,2016,5,4, 17 ,8830,1691,1444,11965
5/4/2016,2016,5,4, 18 ,8342,1662,1461,11465
5/4/2016,2016,5,4, 19 ,8733,1809,1524,12066
5/4/2016,2016,5,4, 20 ,8636,1775,1496,11907
5/4/2016,2016,5,4, 21 ,8588,1749,1459,11796
5/4/2016,2016,5,4, 22 ,8355,1634,1335,11324
5/4/2016,2016,5,4, 23 ,8046,1532,1239,10817
5/4/2016,2016,5,4, 24 ,7642,1460,1193,10295
5/5/2016,2016,5,5, 1 ,7350,1391,1138,9879
5/5/2016,2016,5,5, 2 ,7112,1351,1104,9567
5/5/2016,2016,5,5, 3 ,6855,1318,1065,9238
5/5/2016,2016,5,5, 4 ,6708,1290,1040,9038
5/5/2016,2016,5,5, 5 ,6622,1271,1053,8946
5/5/2016,2016,5,5, 6 ,6402,1203,1036,8641
5/5/2016,2016,5,5, 7 ,6713,1248,1045,9006
5/5/2016,2016,5,5, 8 ,7566,1430,1183,10179
5/5/2016,2016,5,5, 9 ,8497,1648,1370,11515
5/5/2016,2016,5,5, 10 ,8889,1733,1448,12070
5/5/2016,2016,5,5, 11 ,9259,1790,1495,12544
5/5/2016,2016,5,5, 12 ,9106,1785,1457,12348
5/5/2016,2016,5,5, 13 ,9086,1805,1463,12354
5/5/2016,2016,5,5, 14 ,9441,1856,1513,12810
5/5/2016,2016,5,5, 15 ,9425,1852,1487,12764
5/5/2016,2016,5,5, 16 ,9208,1794,1455,12457
5/5/2016,2016,5,5, 17 ,8708,1682,1389,11779
5/5/2016,2016,5,5, 18 ,8269,1652,1441,11362
5/5/2016,2016,5,5, 19 ,8633,1769,1510,11912
5/5/2016,2016,5,5, 20 ,8613,1753,1470,11836
5/5/2016,2016,5,5, 21 ,8544,1697,1429,11670
5/5/2016,2016,5,5, 22 ,8366,1620,1327,11313
5/5/2016,2016,5,5, 23 ,8049,1526,1234,10809
5/5/2016,2016,5,5, 24 ,7655,1439,1146,10240
5/6/2016,2016,5,6, 1 ,7326,1383,1104,9813
5/6/2016,2016,5,6, 2 ,7056,1335,1062,9453
5/6/2016,2016,5,6, 3 ,6901,1287,1032,9220
5/6/2016,2016,5,6, 4 ,6683,1268,1013,8964
5/6/2016,2016,5,6, 5 ,6593,1262,1025,8880
5/6/2016,2016,5,6, 6 ,6365,1218,1023,8606
5/6/2016,2016,5,6, 7 ,6688,1252,1025,8965
5/6/2016,2016,5,6, 8 ,7538,1433,1181,10152
5/6/2016,2016,5,6, 9 ,8357,1637,1371,11365
5/6/2016,2016,5,6, 10 ,8915,1728,1475,12118
5/6/2016,2016,5,6, 11 ,9184,1799,1516,12499
5/6/2016,2016,5,6, 12 ,9064,1769,1476,12309
5/6/2016,2016,5,6, 13 ,9132,1771,1486,12389
5/6/2016,2016,5,6, 14 ,9523,1835,1543,12901
5/6/2016,2016,5,6, 15 ,9482,1803,1542,12827
5/6/2016,2016,5,6, 16 ,9231,1759,1503,12493
5/6/2016,2016,5,6, 17 ,8647,1656,1404,11707
5/6/2016,2016,5,6, 18 ,8237,1628,1432,11297
5/6/2016,2016,5,6, 19 ,8615,1770,1529,11914
5/6/2016,2016,5,6, 20 ,8559,1737,1488,11784
5/6/2016,2016,5,6, 21 ,8514,1701,1453,11668
5/6/2016,2016,5,6, 22 ,8302,1603,1355,11260
5/6/2016,2016,5,6, 23 ,7984,1534,1263,10781
5/6/2016,2016,5,6, 24 ,7702,1429,1145,10276
5/7/2016,2016,5,7, 1 ,7377,1385,1134,9896
5/7/2016,2016,5,7, 2 ,7135,1341,1091,9567
5/7/2016,2016,5,7, 3 ,6922,1299,1060,9281
5/7/2016,2016,5,7, 4 ,6646,1284,1039,8969
5/7/2016,2016,5,7, 5 ,6514,1277,1033,8824
5/7/2016,2016,5,7, 6 ,6208,1222,1011,8441
5/7/2016,2016,5,7, 7 ,6347,1226,1007,8580
5/7/2016,2016,5,7, 8 ,6908,1359,1112,9379
5/7/2016,2016,5,7, 9 ,7577,1546,1273,10396
5/7/2016,2016,5,7, 10 ,8101,1641,1352,11094
5/7/2016,2016,5,7, 11 ,8427,1708,1402,11537
5/7/2016,2016,5,7, 12 ,8273,1662,1390,11325
5/7/2016,2016,5,7, 13 ,8286,1665,1406,11357
5/7/2016,2016,5,7, 14 ,8515,1721,1444,11680
5/7/2016,2016,5,7, 15 ,8377,1678,1424,11479
5/7/2016,2016,5,7, 16 ,8100,1633,1370,11103
5/7/2016,2016,5,7, 17 ,7653,1550,1300,10503
5/7/2016,2016,5,7, 18 ,7453,1576,1382,10411
5/7/2016,2016,5,7, 19 ,8099,1742,1467,11308
5/7/2016,2016,5,7, 20 ,8080,1709,1434,11223
5/7/2016,2016,5,7, 21 ,8128,1662,1395,11185
5/7/2016,2016,5,7, 22 ,7937,1598,1330,10865
5/7/2016,2016,5,7, 23 ,7758,1521,1252,10531
5/7/2016,2016,5,7, 24 ,7470,1433,1165,10068
5/8/2016,2016,5,8, 1 ,7111,1363,1109,9583
5/8/2016,2016,5,8, 2 ,6876,1320,1083,9279
5/8/2016,2016,5,8, 3 ,6661,1278,1043,8982
5/8/2016,2016,5,8, 4 ,6449,1246,1019,8714
5/8/2016,2016,5,8, 5 ,6225,1226,1018,8469
5/8/2016,2016,5,8, 6 ,5852,1146,971,7969
5/8/2016,2016,5,8, 7 ,5860,1155,962,7977
5/8/2016,2016,5,8, 8 ,6158,1227,1018,8403
5/8/2016,2016,5,8, 9 ,6604,1322,1121,9047
5/8/2016,2016,5,8, 10 ,7030,1400,1186,9616
5/8/2016,2016,5,8, 11 ,7295,1449,1249,9993
5/8/2016,2016,5,8, 12 ,7291,1443,1264,9998
5/8/2016,2016,5,8, 13 ,7369,1460,1268,10097
5/8/2016,2016,5,8, 14 ,7481,1466,1278,10225
5/8/2016,2016,5,8, 15 ,7421,1465,1235,10121
5/8/2016,2016,5,8, 16 ,7240,1439,1215,9894
5/8/2016,2016,5,8, 17 ,6916,1391,1211,9518
5/8/2016,2016,5,8, 18 ,6926,1455,1291,9672
5/8/2016,2016,5,8, 19 ,7508,1649,1363,10520
5/8/2016,2016,5,8, 20 ,7555,1639,1333,10527
5/8/2016,2016,5,8, 21 ,7588,1580,1306,10474
5/8/2016,2016,5,8, 22 ,7574,1530,1245,10349
5/8/2016,2016,5,8, 23 ,7329,1476,1162,9967
5/8/2016,2016,5,8, 24 ,7160,1392,1094,9646
5/9/2016,2016,5,9, 1 ,6754,1323,1040,9117
5/9/2016,2016,5,9, 2 ,6557,1278,1001,8836
5/9/2016,2016,5,9, 3 ,6303,1248,967,8518
5/9/2016,2016,5,9, 4 ,6121,1213,954,8288
5/9/2016,2016,5,9, 5 ,6008,1218,970,8196
5/9/2016,2016,5,9, 6 ,5580,1121,906,7607
5/9/2016,2016,5,9, 7 ,5442,1104,870,7416
5/9/2016,2016,5,9, 8 ,5578,1135,908,7621
5/9/2016,2016,5,9, 9 ,5864,1190,940,7994
5/9/2016,2016,5,9, 10 ,6211,1254,1006,8471
5/9/2016,2016,5,9, 11 ,6562,1329,1080,8971
5/9/2016,2016,5,9, 12 ,6845,1372,1137,9354
5/9/2016,2016,5,9, 13 ,7035,1395,1159,9589
5/9/2016,2016,5,9, 14 ,7144,1416,1186,9746
5/9/2016,2016,5,9, 15 ,7160,1405,1174,9739
5/9/2016,2016,5,9, 16 ,7002,1370,1145,9517
5/9/2016,2016,5,9, 17 ,6767,1344,1126,9237
5/9/2016,2016,5,9, 18 ,6880,1448,1241,9569
5/9/2016,2016,5,9, 19 ,7669,1615,1296,10580
5/9/2016,2016,5,9, 20 ,7731,1622,1290,10643
5/9/2016,2016,5,9, 21 ,7714,1579,1290,10583
5/9/2016,2016,5,9, 22 ,7561,1512,1229,10302
5/9/2016,2016,5,9, 23 ,7354,1419,1141,9914
5/9/2016,2016,5,9, 24 ,7034,1340,1090,9464
5/10/2016,2016,5,10, 1 ,6750,1291,1030,9071
5/10/2016,2016,5,10, 2 ,6531,1242,989,8762
5/10/2016,2016,5,10, 3 ,6307,1195,962,8464
5/10/2016,2016,5,10, 4 ,6130,1168,938,8236
5/10/2016,2016,5,10, 5 ,6057,1178,959,8194
5/10/2016,2016,5,10, 6 ,5979,1161,974,8114
5/10/2016,2016,5,10, 7 ,6456,1213,983,8652
5/10/2016,2016,5,10, 8 ,7388,1394,1148,9930
5/10/2016,2016,5,10, 9 ,8273,1604,1311,11188
5/10/2016,2016,5,10, 10 ,8860,1722,1372,11954
5/10/2016,2016,5,10, 11 ,9217,1783,1417,12417
5/10/2016,2016,5,10, 12 ,9141,1759,1488,12388
5/10/2016,2016,5,10, 13 ,9219,1771,1501,12491
5/10/2016,2016,5,10, 14 ,9590,1844,1554,12988
5/10/2016,2016,5,10, 15 ,9490,1828,1522,12840
5/10/2016,2016,5,10, 16 ,9287,1774,1478,12539
5/10/2016,2016,5,10, 17 ,8760,1660,1397,11817
5/10/2016,2016,5,10, 18 ,8325,1655,1428,11408
5/10/2016,2016,5,10, 19 ,8760,1810,1481,12051
5/10/2016,2016,5,10, 20 ,8688,1762,1427,11877
5/10/2016,2016,5,10, 21 ,8578,1704,1373,11655
5/10/2016,2016,5,10, 22 ,8435,1584,1271,11290
5/10/2016,2016,5,10, 23 ,8058,1517,1170,10745
5/10/2016,2016,5,10, 24 ,7703,1450,1108,10261
5/11/2016,2016,5,11, 1 ,7419,1379,1055,9853
5/11/2016,2016,5,11, 2 ,7167,1324,1049,9540
5/11/2016,2016,5,11, 3 ,6937,1298,1018,9253
5/11/2016,2016,5,11, 4 ,6738,1263,993,8994
5/11/2016,2016,5,11, 5 ,6632,1259,977,8868
5/11/2016,2016,5,11, 6 ,6506,1222,991,8719
5/11/2016,2016,5,11, 7 ,6785,1262,1009,9056
5/11/2016,2016,5,11, 8 ,7674,1438,1159,10271
5/11/2016,2016,5,11, 9 ,8496,1653,1318,11467
5/11/2016,2016,5,11, 10 ,9025,1786,1454,12265
5/11/2016,2016,5,11, 11 ,9329,1824,1527,12680
5/11/2016,2016,5,11, 12 ,9248,1793,1490,12531
5/11/2016,2016,5,11, 13 ,9321,1788,1515,12624
5/11/2016,2016,5,11, 14 ,9679,1879,1554,13112
5/11/2016,2016,5,11, 15 ,9535,1839,1505,12879
5/11/2016,2016,5,11, 16 ,9339,1798,1507,12644
5/11/2016,2016,5,11, 17 ,8840,1695,1429,11964
5/11/2016,2016,5,11, 18 ,8456,1642,1456,11554
5/11/2016,2016,5,11, 19 ,8827,1803,1513,12143
5/11/2016,2016,5,11, 20 ,8704,1758,1479,11941
5/11/2016,2016,5,11, 21 ,8690,1714,1432,11836
5/11/2016,2016,5,11, 22 ,8616,1613,1324,11553
5/11/2016,2016,5,11, 23 ,8213,1529,1235,10977
5/11/2016,2016,5,11, 24 ,7885,1456,1139,10480
5/12/2016,2016,5,12, 1 ,7489,1396,1125,10010
5/12/2016,2016,5,12, 2 ,7279,1350,1081,9710
5/12/2016,2016,5,12, 3 ,7006,1325,1051,9382
5/12/2016,2016,5,12, 4 ,6832,1293,1031,9156
5/12/2016,2016,5,12, 5 ,6772,1289,1039,9100
5/12/2016,2016,5,12, 6 ,6603,1239,1023,8865
5/12/2016,2016,5,12, 7 ,6877,1281,1046,9204
5/12/2016,2016,5,12, 8 ,7655,1465,1200,10320
5/12/2016,2016,5,12, 9 ,8510,1669,1381,11560
5/12/2016,2016,5,12, 10 ,8928,1766,1463,12157
5/12/2016,2016,5,12, 11 ,9204,1827,1554,12585
5/12/2016,2016,5,12, 12 ,9075,1763,1523,12361
5/12/2016,2016,5,12, 13 ,9122,1795,1523,12440
5/12/2016,2016,5,12, 14 ,9421,1867,1562,12850
5/12/2016,2016,5,12, 15 ,9334,1846,1552,12732
5/12/2016,2016,5,12, 16 ,9125,1816,1517,12458
5/12/2016,2016,5,12, 17 ,8558,1680,1424,11662
5/12/2016,2016,5,12, 18 ,8203,1667,1466,11336
5/12/2016,2016,5,12, 19 ,8580,1806,1487,11873
5/12/2016,2016,5,12, 20 ,8497,1770,1459,11726
5/12/2016,2016,5,12, 21 ,8494,1744,1362,11600
5/12/2016,2016,5,12, 22 ,8305,1656,1260,11221
5/12/2016,2016,5,12, 23 ,7935,1543,1193,10671
5/12/2016,2016,5,12, 24 ,7593,1467,1137,10197
5/13/2016,2016,5,13, 1 ,7283,1400,1111,9794
5/13/2016,2016,5,13, 2 ,7081,1362,1037,9480
5/13/2016,2016,5,13, 3 ,6857,1326,1037,9220
5/13/2016,2016,5,13, 4 ,6655,1296,1000,8951
5/13/2016,2016,5,13, 5 ,6551,1293,1008,8852
5/13/2016,2016,5,13, 6 ,6372,1233,990,8595
5/13/2016,2016,5,13, 7 ,6709,1274,1009,8992
5/13/2016,2016,5,13, 8 ,7570,1466,1210,10246
5/13/2016,2016,5,13, 9 ,8451,1683,1395,11529
5/13/2016,2016,5,13, 10 ,8950,1795,1489,12234
5/13/2016,2016,5,13, 11 ,9228,1849,1566,12643
5/13/2016,2016,5,13, 12 ,9114,1796,1528,12438
5/13/2016,2016,5,13, 13 ,9131,1791,1539,12461
5/13/2016,2016,5,13, 14 ,9513,1862,1578,12953
5/13/2016,2016,5,13, 15 ,9377,1848,1590,12815
5/13/2016,2016,5,13, 16 ,9147,1795,1529,12471
5/13/2016,2016,5,13, 17 ,8615,1693,1443,11751
5/13/2016,2016,5,13, 18 ,8210,1680,1476,11366
5/13/2016,2016,5,13, 19 ,8615,1812,1548,11975
5/13/2016,2016,5,13, 20 ,8569,1766,1500,11835
5/13/2016,2016,5,13, 21 ,8575,1731,1473,11779
5/13/2016,2016,5,13, 22 ,8319,1622,1350,11291
5/13/2016,2016,5,13, 23 ,7996,1527,1266,10789
5/13/2016,2016,5,13, 24 ,7668,1448,1148,10264
5/14/2016,2016,5,14, 1 ,7345,1376,1129,9850
5/14/2016,2016,5,14, 2 ,7002,1338,1095,9435
5/14/2016,2016,5,14, 3 ,6665,1303,1060,9028
5/14/2016,2016,5,14, 4 ,6572,1265,1040,8877
5/14/2016,2016,5,14, 5 ,6448,1250,1041,8739
5/14/2016,2016,5,14, 6 ,6151,1192,999,8342
5/14/2016,2016,5,14, 7 ,6273,1205,1000,8478
5/14/2016,2016,5,14, 8 ,6913,1334,1147,9394
5/14/2016,2016,5,14, 9 ,7583,1518,1249,10350
5/14/2016,2016,5,14, 10 ,8129,1633,1374,11136
5/14/2016,2016,5,14, 11 ,8378,1670,1406,11454
5/14/2016,2016,5,14, 12 ,8257,1653,1351,11261
5/14/2016,2016,5,14, 13 ,8230,1656,1358,11244
5/14/2016,2016,5,14, 14 ,8538,1717,1413,11668
5/14/2016,2016,5,14, 15 ,8370,1674,1391,11435
5/14/2016,2016,5,14, 16 ,8107,1628,1354,11089
5/14/2016,2016,5,14, 17 ,7722,1544,1319,10585
5/14/2016,2016,5,14, 18 ,7597,1578,1377,10552
5/14/2016,2016,5,14, 19 ,8115,1748,1455,11318
5/14/2016,2016,5,14, 20 ,8182,1720,1429,11331
5/14/2016,2016,5,14, 21 ,8192,1681,1395,11268
5/14/2016,2016,5,14, 22 ,8045,1615,1294,10954
5/14/2016,2016,5,14, 23 ,7829,1515,1210,10554
5/14/2016,2016,5,14, 24 ,7435,1439,1127,10001
5/15/2016,2016,5,15, 1 ,7140,1371,1107,9618
5/15/2016,2016,5,15, 2 ,6901,1338,1068,9307
5/15/2016,2016,5,15, 3 ,6724,1299,1032,9055
5/15/2016,2016,5,15, 4 ,6553,1264,996,8813
5/15/2016,2016,5,15, 5 ,6371,1250,976,8597
5/15/2016,2016,5,15, 6 ,6001,1174,961,8136
5/15/2016,2016,5,15, 7 ,6011,1186,952,8149
5/15/2016,2016,5,15, 8 ,6280,1233,1012,8525
5/15/2016,2016,5,15, 9 ,6784,1328,1087,9199
5/15/2016,2016,5,15, 10 ,7226,1403,1166,9795
5/15/2016,2016,5,15, 11 ,7381,1409,1219,10009
5/15/2016,2016,5,15, 12 ,7429,1413,1228,10070
5/15/2016,2016,5,15, 13 ,7460,1440,1242,10142
5/15/2016,2016,5,15, 14 ,7563,1437,1252,10252
5/15/2016,2016,5,15, 15 ,7522,1448,1239,10209
5/15/2016,2016,5,15, 16 ,7563,1420,1202,10185
5/15/2016,2016,5,15, 17 ,7032,1384,1184,9600
5/15/2016,2016,5,15, 18 ,7040,1460,1333,9833
5/15/2016,2016,5,15, 19 ,7666,1647,1388,10701
5/15/2016,2016,5,15, 20 ,7740,1641,1362,10743
5/15/2016,2016,5,15, 21 ,7856,1589,1299,10744
5/15/2016,2016,5,15, 22 ,7694,1530,1195,10419
5/15/2016,2016,5,15, 23 ,7446,1454,1120,10020
5/15/2016,2016,5,15, 24 ,7185,1366,1087,9638
5/16/2016,2016,5,16, 1 ,6934,1305,1043,9282
5/16/2016,2016,5,16, 2 ,6658,1265,999,8922
5/16/2016,2016,5,16, 3 ,6438,1227,979,8644
5/16/2016,2016,5,16, 4 ,6261,1205,968,8434
5/16/2016,2016,5,16, 5 ,6218,1205,981,8404
5/16/2016,2016,5,16, 6 ,6138,1174,972,8284
5/16/2016,2016,5,16, 7 ,6502,1215,978,8695
5/16/2016,2016,5,16, 8 ,7349,1407,1136,9892
5/16/2016,2016,5,16, 9 ,8245,1623,1331,11199
5/16/2016,2016,5,16, 10 ,8773,1749,1456,11978
5/16/2016,2016,5,16, 11 ,9130,1815,1524,12469
5/16/2016,2016,5,16, 12 ,9100,1776,1506,12382
5/16/2016,2016,5,16, 13 ,9148,1758,1500,12406
5/16/2016,2016,5,16, 14 ,9469,1844,1559,12872
5/16/2016,2016,5,16, 15 ,9425,1846,1515,12786
5/16/2016,2016,5,16, 16 ,9226,1808,1448,12482
5/16/2016,2016,5,16, 17 ,8690,1699,1394,11783
5/16/2016,2016,5,16, 18 ,8381,1664,1405,11450
5/16/2016,2016,5,16, 19 ,8609,1804,1452,11865
5/16/2016,2016,5,16, 20 ,8465,1768,1393,11626
5/16/2016,2016,5,16, 21 ,8400,1715,1359,11474
5/16/2016,2016,5,16, 22 ,8317,1618,1245,11180
5/16/2016,2016,5,16, 23 ,7912,1525,1156,10593
5/16/2016,2016,5,16, 24 ,7515,1438,1041,9994
5/17/2016,2016,5,17, 1 ,7243,1382,1030,9655
5/17/2016,2016,5,17, 2 ,7051,1334,982,9367
5/17/2016,2016,5,17, 3 ,6831,1303,961,9095
5/17/2016,2016,5,17, 4 ,6636,1268,944,8848
5/17/2016,2016,5,17, 5 ,6526,1252,955,8733
5/17/2016,2016,5,17, 6 ,6349,1213,992,8554
5/17/2016,2016,5,17, 7 ,6691,1256,1014,8961
5/17/2016,2016,5,17, 8 ,7528,1462,1175,10165
5/17/2016,2016,5,17, 9 ,8350,1660,1363,11373
5/17/2016,2016,5,17, 10 ,8878,1798,1497,12173
5/17/2016,2016,5,17, 11 ,9168,1848,1526,12542
5/17/2016,2016,5,17, 12 ,9077,1803,1494,12374
5/17/2016,2016,5,17, 13 ,9075,1801,1510,12386
5/17/2016,2016,5,17, 14 ,9408,1805,1505,12718
5/17/2016,2016,5,17, 15 ,9289,1778,1495,12562
5/17/2016,2016,5,17, 16 ,9087,1682,1463,12232
5/17/2016,2016,5,17, 17 ,8628,1656,1410,11694
5/17/2016,2016,5,17, 18 ,8277,1664,1473,11414
5/17/2016,2016,5,17, 19 ,8686,1798,1514,11998
5/17/2016,2016,5,17, 20 ,8583,1759,1457,11799
5/17/2016,2016,5,17, 21 ,8493,1717,1426,11636
5/17/2016,2016,5,17, 22 ,8271,1584,1291,11146
5/17/2016,2016,5,17, 23 ,7980,1502,1213,10695
5/17/2016,2016,5,17, 24 ,7589,1424,1128,10141
5/18/2016,2016,5,18, 1 ,7251,1356,1031,9638
5/18/2016,2016,5,18, 2 ,6940,1315,1030,9285
5/18/2016,2016,5,18, 3 ,6759,1282,1000,9041
5/18/2016,2016,5,18, 4 ,6596,1254,977,8827
5/18/2016,2016,5,18, 5 ,6507,1254,997,8758
5/18/2016,2016,5,18, 6 ,6307,1214,1006,8527
5/18/2016,2016,5,18, 7 ,6641,1256,1019,8916
5/18/2016,2016,5,18, 8 ,7554,1433,1177,10164
5/18/2016,2016,5,18, 9 ,8402,1663,1384,11449
5/18/2016,2016,5,18, 10 ,8848,1755,1488,12091
5/18/2016,2016,5,18, 11 ,9198,1801,1547,12546
5/18/2016,2016,5,18, 12 ,9139,1757,1527,12423
5/18/2016,2016,5,18, 13 ,9169,1756,1530,12455
5/18/2016,2016,5,18, 14 ,9497,1823,1563,12883
5/18/2016,2016,5,18, 15 ,9276,1794,1562,12632
5/18/2016,2016,5,18, 16 ,8932,1666,1538,12136
5/18/2016,2016,5,18, 17 ,8510,1659,1451,11620
5/18/2016,2016,5,18, 18 ,8193,1679,1481,11353
5/18/2016,2016,5,18, 19 ,8395,1776,1536,11707
5/18/2016,2016,5,18, 20 ,8182,1743,1479,11404
5/18/2016,2016,5,18, 21 ,8168,1690,1433,11291
5/18/2016,2016,5,18, 22 ,7889,1590,1294,10773
5/18/2016,2016,5,18, 23 ,7500,1492,1199,10191
5/18/2016,2016,5,18, 24 ,7143,1413,1131,9687
5/19/2016,2016,5,19, 1 ,6784,1353,1088,9225
5/19/2016,2016,5,19, 2 ,6563,1309,1060,8932
5/19/2016,2016,5,19, 3 ,6410,1269,994,8673
5/19/2016,2016,5,19, 4 ,6239,1240,999,8478
5/19/2016,2016,5,19, 5 ,6186,1261,1022,8469
5/19/2016,2016,5,19, 6 ,6093,1205,993,8291
5/19/2016,2016,5,19, 7 ,6348,1252,1014,8614
5/19/2016,2016,5,19, 8 ,7210,1431,1221,9862
5/19/2016,2016,5,19, 9 ,8103,1658,1339,11100
5/19/2016,2016,5,19, 10 ,8485,1766,1479,11730
5/19/2016,2016,5,19, 11 ,8946,1837,1530,12313
5/19/2016,2016,5,19, 12 ,8918,1770,1501,12189
5/19/2016,2016,5,19, 13 ,8897,1763,1517,12177
5/19/2016,2016,5,19, 14 ,9097,1781,1540,12418
5/19/2016,2016,5,19, 15 ,8964,1790,1536,12290
5/19/2016,2016,5,19, 16 ,8825,1741,1499,12065
5/19/2016,2016,5,19, 17 ,8385,1646,1420,11451
5/19/2016,2016,5,19, 18 ,7977,1676,1454,11107
5/19/2016,2016,5,19, 19 ,8431,1756,1514,11701
5/19/2016,2016,5,19, 20 ,8379,1735,1469,11583
5/19/2016,2016,5,19, 21 ,8332,1677,1417,11426
5/19/2016,2016,5,19, 22 ,8089,1570,1283,10942
5/19/2016,2016,5,19, 23 ,7763,1480,1180,10423
5/19/2016,2016,5,19, 24 ,7397,1400,1126,9923
5/20/2016,2016,5,20, 1 ,7095,1341,1067,9503
5/20/2016,2016,5,20, 2 ,6826,1288,1044,9158
5/20/2016,2016,5,20, 3 ,6598,1256,1015,8869
5/20/2016,2016,5,20, 4 ,6463,1243,1007,8713
5/20/2016,2016,5,20, 5 ,6325,1235,1032,8592
5/20/2016,2016,5,20, 6 ,6249,1215,1017,8481
5/20/2016,2016,5,20, 7 ,6471,1240,1036,8747
5/20/2016,2016,5,20, 8 ,7181,1430,1237,9848
5/20/2016,2016,5,20, 9 ,7915,1656,1381,10952
5/20/2016,2016,5,20, 10 ,8392,1766,1450,11608
5/20/2016,2016,5,20, 11 ,8766,1802,1553,12121
5/20/2016,2016,5,20, 12 ,8640,1753,1503,11896
5/20/2016,2016,5,20, 13 ,8657,1719,1506,11882
5/20/2016,2016,5,20, 14 ,9014,1809,1522,12345
5/20/2016,2016,5,20, 15 ,8931,1787,1505,12223
5/20/2016,2016,5,20, 16 ,8718,1755,1454,11927
5/20/2016,2016,5,20, 17 ,8253,1655,1426,11334
5/20/2016,2016,5,20, 18 ,8041,1661,1356,11058
5/20/2016,2016,5,20, 19 ,8362,1781,1354,11497
5/20/2016,2016,5,20, 20 ,8262,1730,1311,11303
5/20/2016,2016,5,20, 21 ,8226,1705,1266,11197
5/20/2016,2016,5,20, 22 ,7856,1582,1193,10631
5/20/2016,2016,5,20, 23 ,7569,1490,1111,10170
5/20/2016,2016,5,20, 24 ,7192,1414,1082,9688
5/21/2016,2016,5,21, 1 ,6835,1361,1029,9225
5/21/2016,2016,5,21, 2 ,6664,1314,991,8969
5/21/2016,2016,5,21, 3 ,6486,1275,975,8736
5/21/2016,2016,5,21, 4 ,6294,1248,957,8499
5/21/2016,2016,5,21, 5 ,6239,1245,964,8448
5/21/2016,2016,5,21, 6 ,6025,1195,935,8155
5/21/2016,2016,5,21, 7 ,6166,1204,932,8302
5/21/2016,2016,5,21, 8 ,6858,1333,1009,9200
5/21/2016,2016,5,21, 9 ,7551,1506,1121,10178
5/21/2016,2016,5,21, 10 ,8030,1621,1233,10884
5/21/2016,2016,5,21, 11 ,8263,1651,1327,11241
5/21/2016,2016,5,21, 12 ,8138,1631,1318,11087
5/21/2016,2016,5,21, 13 ,8068,1636,1343,11047
5/21/2016,2016,5,21, 14 ,8409,1678,1397,11484
5/21/2016,2016,5,21, 15 ,8127,1628,1363,11118
5/21/2016,2016,5,21, 16 ,7799,1570,1345,10714
5/21/2016,2016,5,21, 17 ,7438,1508,1303,10249
5/21/2016,2016,5,21, 18 ,7406,1576,1368,10350
5/21/2016,2016,5,21, 19 ,7810,1719,1402,10931
5/21/2016,2016,5,21, 20 ,7891,1692,1377,10960
5/21/2016,2016,5,21, 21 ,7944,1646,1303,10893
5/21/2016,2016,5,21, 22 ,7804,1587,1220,10611
5/21/2016,2016,5,21, 23 ,7441,1483,1170,10094
5/21/2016,2016,5,21, 24 ,7106,1389,1059,9554
5/22/2016,2016,5,22, 1 ,6838,1310,1025,9173
5/22/2016,2016,5,22, 2 ,6541,1285,1002,8828
5/22/2016,2016,5,22, 3 ,6385,1253,973,8611
5/22/2016,2016,5,22, 4 ,6176,1222,959,8357
5/22/2016,2016,5,22, 5 ,6031,1203,972,8206
5/22/2016,2016,5,22, 6 ,5774,1146,940,7860
5/22/2016,2016,5,22, 7 ,5780,1152,927,7859
5/22/2016,2016,5,22, 8 ,6084,1223,995,8302
5/22/2016,2016,5,22, 9 ,6525,1327,1082,8934
5/22/2016,2016,5,22, 10 ,6973,1416,1169,9558
5/22/2016,2016,5,22, 11 ,7260,1470,1241,9971
5/22/2016,2016,5,22, 12 ,7257,1465,1232,9954
5/22/2016,2016,5,22, 13 ,7264,1452,1228,9944
5/22/2016,2016,5,22, 14 ,7280,1460,1249,9989
5/22/2016,2016,5,22, 15 ,7125,1434,1235,9794
5/22/2016,2016,5,22, 16 ,6909,1384,1185,9478
5/22/2016,2016,5,22, 17 ,6786,1397,1144,9327
5/22/2016,2016,5,22, 18 ,6983,1507,1266,9756
5/22/2016,2016,5,22, 19 ,7582,1629,1365,10576
5/22/2016,2016,5,22, 20 ,7614,1621,1343,10578
5/22/2016,2016,5,22, 21 ,7671,1534,1316,10521
5/22/2016,2016,5,22, 22 ,7469,1478,1226,10173
5/22/2016,2016,5,22, 23 ,7111,1386,1164,9661
5/22/2016,2016,5,22, 24 ,6740,1325,1071,9136
5/23/2016,2016,5,23, 1 ,6521,1261,1043,8825
5/23/2016,2016,5,23, 2 ,6287,1229,994,8510
5/23/2016,2016,5,23, 3 ,6105,1193,964,8262
5/23/2016,2016,5,23, 4 ,5956,1156,958,8070
5/23/2016,2016,5,23, 5 ,5928,1157,958,8043
5/23/2016,2016,5,23, 6 ,5905,1138,978,8021
5/23/2016,2016,5,23, 7 ,6278,1175,987,8440
5/23/2016,2016,5,23, 8 ,7225,1319,1112,9656
5/23/2016,2016,5,23, 9 ,8108,1524,1280,10912
5/23/2016,2016,5,23, 10 ,8731,1621,1396,11748
5/23/2016,2016,5,23, 11 ,8959,1628,1435,12022
5/23/2016,2016,5,23, 12 ,8865,1562,1403,11830
5/23/2016,2016,5,23, 13 ,8771,1586,1409,11766
5/23/2016,2016,5,23, 14 ,9117,1631,1459,12207
5/23/2016,2016,5,23, 15 ,8993,1626,1403,12022
5/23/2016,2016,5,23, 16 ,8808,1615,1392,11815
5/23/2016,2016,5,23, 17 ,8381,1540,1350,11271
5/23/2016,2016,5,23, 18 ,8151,1566,1380,11097
5/23/2016,2016,5,23, 19 ,8428,1647,1438,11513
5/23/2016,2016,5,23, 20 ,8414,1614,1397,11425
5/23/2016,2016,5,23, 21 ,8249,1561,1349,11159
5/23/2016,2016,5,23, 22 ,8084,1467,1235,10786
5/23/2016,2016,5,23, 23 ,7663,1371,1127,10161
5/23/2016,2016,5,23, 24 ,7196,1295,1079,9570
5/24/2016,2016,5,24, 1 ,6951,1240,1020,9211
5/24/2016,2016,5,24, 2 ,6678,1205,1006,8889
5/24/2016,2016,5,24, 3 ,6492,1167,976,8635
5/24/2016,2016,5,24, 4 ,6252,1159,968,8379
5/24/2016,2016,5,24, 5 ,6211,1162,987,8360
5/24/2016,2016,5,24, 6 ,6196,1153,1000,8349
5/24/2016,2016,5,24, 7 ,6429,1166,1009,8604
5/24/2016,2016,5,24, 8 ,7314,1349,1141,9804
5/24/2016,2016,5,24, 9 ,8182,1571,1347,11100
5/24/2016,2016,5,24, 10 ,8748,1662,1461,11871
5/24/2016,2016,5,24, 11 ,8970,1712,1523,12205
5/24/2016,2016,5,24, 12 ,8821,1699,1501,12021
5/24/2016,2016,5,24, 13 ,8792,1701,1509,12002
5/24/2016,2016,5,24, 14 ,9043,1783,1582,12408
5/24/2016,2016,5,24, 15 ,8831,1753,1565,12149
5/24/2016,2016,5,24, 16 ,8696,1730,1542,11968
5/24/2016,2016,5,24, 17 ,8359,1631,1445,11435
5/24/2016,2016,5,24, 18 ,8070,1648,1483,11201
5/24/2016,2016,5,24, 19 ,8480,1744,1516,11740
5/24/2016,2016,5,24, 20 ,8473,1700,1445,11618
5/24/2016,2016,5,24, 21 ,8372,1634,1400,11406
5/24/2016,2016,5,24, 22 ,8215,1541,1307,11063
5/24/2016,2016,5,24, 23 ,7767,1456,1211,10434
5/24/2016,2016,5,24, 24 ,7454,1386,1123,9963
5/25/2016,2016,5,25, 1 ,7042,1327,1078,9447
5/25/2016,2016,5,25, 2 ,6793,1276,1039,9108
5/25/2016,2016,5,25, 3 ,6493,1240,997,8730
5/25/2016,2016,5,25, 4 ,6363,1197,975,8535
5/25/2016,2016,5,25, 5 ,6308,1178,992,8478
5/25/2016,2016,5,25, 6 ,6197,1157,996,8350
5/25/2016,2016,5,25, 7 ,6539,1188,1002,8729
5/25/2016,2016,5,25, 8 ,7457,1363,1155,9975
5/25/2016,2016,5,25, 9 ,8221,1565,1344,11130
5/25/2016,2016,5,25, 10 ,8738,1676,1448,11862
5/25/2016,2016,5,25, 11 ,9035,1741,1472,12248
5/25/2016,2016,5,25, 12 ,8941,1692,1453,12086
5/25/2016,2016,5,25, 13 ,8934,1725,1493,12152
5/25/2016,2016,5,25, 14 ,9010,1802,1529,12341
5/25/2016,2016,5,25, 15 ,8783,1752,1505,12040
5/25/2016,2016,5,25, 16 ,8606,1699,1459,11764
5/25/2016,2016,5,25, 17 ,8335,1624,1365,11324
5/25/2016,2016,5,25, 18 ,8154,1668,1425,11247
5/25/2016,2016,5,25, 19 ,8332,1737,1465,11534
5/25/2016,2016,5,25, 20 ,8111,1672,1406,11189
5/25/2016,2016,5,25, 21 ,8028,1619,1364,11011
5/25/2016,2016,5,25, 22 ,7683,1523,1256,10462
5/25/2016,2016,5,25, 23 ,7222,1420,1130,9772
5/25/2016,2016,5,25, 24 ,6982,1313,1092,9387
5/26/2016,2016,5,26, 1 ,6708,1272,1056,9036
5/26/2016,2016,5,26, 2 ,6458,1229,1029,8716
5/26/2016,2016,5,26, 3 ,6265,1194,995,8454
5/26/2016,2016,5,26, 4 ,6151,1169,974,8294
5/26/2016,2016,5,26, 5 ,6087,1174,1000,8261
5/26/2016,2016,5,26, 6 ,6017,1172,992,8181
5/26/2016,2016,5,26, 7 ,6408,1185,996,8589
5/26/2016,2016,5,26, 8 ,7118,1339,1154,9611
5/26/2016,2016,5,26, 9 ,7977,1551,1347,10875
5/26/2016,2016,5,26, 10 ,8411,1640,1457,11508
5/26/2016,2016,5,26, 11 ,8746,1701,1503,11950
5/26/2016,2016,5,26, 12 ,8549,1652,1479,11680
5/26/2016,2016,5,26, 13 ,8578,1644,1484,11706
5/26/2016,2016,5,26, 14 ,9005,1746,1494,12245
5/26/2016,2016,5,26, 15 ,9003,1711,1444,12158
5/26/2016,2016,5,26, 16 ,8837,1688,1437,11962
5/26/2016,2016,5,26, 17 ,8323,1588,1384,11295
5/26/2016,2016,5,26, 18 ,8121,1624,1427,11172
5/26/2016,2016,5,26, 19 ,8527,1742,1480,11749
5/26/2016,2016,5,26, 20 ,8453,1700,1447,11600
5/26/2016,2016,5,26, 21 ,8372,1640,1368,11380
5/26/2016,2016,5,26, 22 ,8116,1522,1265,10903
5/26/2016,2016,5,26, 23 ,7869,1429,1164,10462
5/26/2016,2016,5,26, 24 ,7374,1343,1130,9847
5/27/2016,2016,5,27, 1 ,7065,1285,1053,9403
5/27/2016,2016,5,27, 2 ,6869,1254,1028,9151
5/27/2016,2016,5,27, 3 ,6576,1227,991,8794
5/27/2016,2016,5,27, 4 ,6396,1209,985,8590
5/27/2016,2016,5,27, 5 ,6407,1202,992,8601
5/27/2016,2016,5,27, 6 ,6246,1182,997,8425
5/27/2016,2016,5,27, 7 ,6539,1224,986,8749
5/27/2016,2016,5,27, 8 ,7446,1411,1158,10015
5/27/2016,2016,5,27, 9 ,8248,1623,1359,11230
5/27/2016,2016,5,27, 10 ,8773,1735,1450,11958
5/27/2016,2016,5,27, 11 ,9036,1771,1492,12299
5/27/2016,2016,5,27, 12 ,8914,1725,1477,12116
5/27/2016,2016,5,27, 13 ,8958,1726,1491,12175
5/27/2016,2016,5,27, 14 ,9204,1790,1496,12490
5/27/2016,2016,5,27, 15 ,9181,1766,1491,12438
5/27/2016,2016,5,27, 16 ,8931,1708,1469,12108
5/27/2016,2016,5,27, 17 ,8450,1634,1402,11486
5/27/2016,2016,5,27, 18 ,8125,1656,1408,11189
5/27/2016,2016,5,27, 19 ,8451,1756,1472,11679
5/27/2016,2016,5,27, 20 ,8437,1731,1030,11198
5/27/2016,2016,5,27, 21 ,8305,1652,999,10956
5/27/2016,2016,5,27, 22 ,8067,1549,884,10500
5/27/2016,2016,5,27, 23 ,7732,1463,821,10016
5/27/2016,2016,5,27, 24 ,7319,1392,713,9424
5/28/2016,2016,5,28, 1 ,7040,1324,1050,9414
5/28/2016,2016,5,28, 2 ,6761,1284,1023,9068
5/28/2016,2016,5,28, 3 ,6529,1249,992,8770
5/28/2016,2016,5,28, 4 ,6431,1216,969,8616
5/28/2016,2016,5,28, 5 ,6330,1208,970,8508
5/28/2016,2016,5,28, 6 ,6059,1165,939,8163
5/28/2016,2016,5,28, 7 ,6205,1172,927,8304
5/28/2016,2016,5,28, 8 ,6818,1282,1036,9136
5/28/2016,2016,5,28, 9 ,7553,1456,1172,10181
5/28/2016,2016,5,28, 10 ,7990,1559,1266,10815
5/28/2016,2016,5,28, 11 ,8247,1601,1346,11194
5/28/2016,2016,5,28, 12 ,8073,1567,1306,10946
5/28/2016,2016,5,28, 13 ,7952,1568,1313,10833
5/28/2016,2016,5,28, 14 ,8181,1562,1350,11093
5/28/2016,2016,5,28, 15 ,8090,1529,1320,10939
5/28/2016,2016,5,28, 16 ,7810,1500,1302,10612
5/28/2016,2016,5,28, 17 ,7581,1443,1267,10291
5/28/2016,2016,5,28, 18 ,7422,1532,1285,10239
5/28/2016,2016,5,28, 19 ,7893,1654,1361,10908
5/28/2016,2016,5,28, 20 ,7941,1640,1338,10919
5/28/2016,2016,5,28, 21 ,8002,1590,1334,10926
5/28/2016,2016,5,28, 22 ,7904,1501,1261,10666
5/28/2016,2016,5,28, 23 ,7521,1421,1180,10122
5/28/2016,2016,5,28, 24 ,7170,1336,1087,9593
5/29/2016,2016,5,29, 1 ,6799,1281,1000,9080
5/29/2016,2016,5,29, 2 ,6605,1240,997,8842
5/29/2016,2016,5,29, 3 ,6422,1195,971,8588
5/29/2016,2016,5,29, 4 ,6246,1170,951,8367
5/29/2016,2016,5,29, 5 ,6076,1158,951,8185
5/29/2016,2016,5,29, 6 ,5702,1098,917,7717
5/29/2016,2016,5,29, 7 ,5783,1115,928,7826
5/29/2016,2016,5,29, 8 ,6144,1184,987,8315
5/29/2016,2016,5,29, 9 ,6674,1298,1057,9029
5/29/2016,2016,5,29, 10 ,7150,1408,1066,9624
5/29/2016,2016,5,29, 11 ,7408,1431,1223,10062
5/29/2016,2016,5,29, 12 ,7260,1422,1227,9909
5/29/2016,2016,5,29, 13 ,7338,1427,1227,9992
5/29/2016,2016,5,29, 14 ,7402,1418,1257,10077
5/29/2016,2016,5,29, 15 ,7083,1382,1225,9690
5/29/2016,2016,5,29, 16 ,6843,1330,1203,9376
5/29/2016,2016,5,29, 17 ,6739,1329,1204,9272
5/29/2016,2016,5,29, 18 ,6930,1430,1313,9673
5/29/2016,2016,5,29, 19 ,7342,1588,1371,10301
5/29/2016,2016,5,29, 20 ,7459,1581,1369,10409
5/29/2016,2016,5,29, 21 ,7487,1533,1317,10337
5/29/2016,2016,5,29, 22 ,7241,1437,1227,9905
5/29/2016,2016,5,29, 23 ,6900,1369,1145,9414
5/29/2016,2016,5,29, 24 ,6682,1293,1075,9050
5/30/2016,2016,5,30, 1 ,6406,1240,1030,8676
5/30/2016,2016,5,30, 2 ,6120,1181,993,8294
5/30/2016,2016,5,30, 3 ,6011,1148,961,8120
5/30/2016,2016,5,30, 4 ,5846,1118,946,7910
5/30/2016,2016,5,30, 5 ,5838,1114,964,7916
5/30/2016,2016,5,30, 6 ,5794,1091,952,7837
5/30/2016,2016,5,30, 7 ,6190,1122,973,8285
5/30/2016,2016,5,30, 8 ,7113,1306,1140,9559
5/30/2016,2016,5,30, 9 ,7929,1531,1333,10793
5/30/2016,2016,5,30, 10 ,8393,1652,1426,11471
5/30/2016,2016,5,30, 11 ,8677,1720,1509,11906
5/30/2016,2016,5,30, 12 ,8737,1686,1483,11906
5/30/2016,2016,5,30, 13 ,8757,1693,1461,11911
5/30/2016,2016,5,30, 14 ,9195,1746,1498,12439
5/30/2016,2016,5,30, 15 ,9088,1711,1487,12286
5/30/2016,2016,5,30, 16 ,8930,1674,1450,12054
5/30/2016,2016,5,30, 17 ,8540,1592,1391,11523
5/30/2016,2016,5,30, 18 ,8120,1623,1432,11175
5/30/2016,2016,5,30, 19 ,8498,1724,1473,11695
5/30/2016,2016,5,30, 20 ,8479,1674,1440,11593
5/30/2016,2016,5,30, 21 ,8162,1612,1355,11129
5/30/2016,2016,5,30, 22 ,7964,1486,1251,10701
5/30/2016,2016,5,30, 23 ,7575,1396,1150,10121
5/30/2016,2016,5,30, 24 ,7160,1311,1095,9566
5/31/2016,2016,5,31, 1 ,6882,1248,1043,9173
5/31/2016,2016,5,31, 2 ,6728,1209,980,8917
5/31/2016,2016,5,31, 3 ,6550,1183,952,8685
5/31/2016,2016,5,31, 4 ,6330,1155,969,8454
5/31/2016,2016,5,31, 5 ,6281,1153,978,8412
5/31/2016,2016,5,31, 6 ,6187,1133,972,8292
5/31/2016,2016,5,31, 7 ,6544,1169,978,8691
5/31/2016,2016,5,31, 8 ,7418,1342,1134,9894
5/31/2016,2016,5,31, 9 ,8260,1563,1340,11163
5/31/2016,2016,5,31, 10 ,8777,1679,1458,11914
5/31/2016,2016,5,31, 11 ,9124,1748,1540,12412
5/31/2016,2016,5,31, 12 ,8919,1691,1504,12114
5/31/2016,2016,5,31, 13 ,8811,1696,1521,12028
5/31/2016,2016,5,31, 14 ,8974,1766,1557,12297
5/31/2016,2016,5,31, 15 ,8805,1716,1574,12095
5/31/2016,2016,5,31, 16 ,8526,1667,1500,11693
5/31/2016,2016,5,31, 17 ,8258,1580,1407,11245
5/31/2016,2016,5,31, 18 ,7943,1600,1466,11009
5/31/2016,2016,5,31, 19 ,8185,1702,1521,11408
5/31/2016,2016,5,31, 20 ,8144,1630,1463,11237
5/31/2016,2016,5,31, 21 ,8058,1583,1408,11049
5/31/2016,2016,5,31, 22 ,7817,1470,1297,10584
5/31/2016,2016,5,31, 23 ,7340,1378,1187,9905
5/31/2016,2016,5,31, 24 ,7005,1308,1117,9430
6/1/2016,2016,6,1, 1 ,6645,1239,1094,8978
6/1/2016,2016,6,1, 2 ,6483,1184,1060,8727
6/1/2016,2016,6,1, 3 ,6280,1147,1010,8437
6/1/2016,2016,6,1, 4 ,6108,1136,997,8241
6/1/2016,2016,6,1, 5 ,6075,1139,1011,8225
6/1/2016,2016,6,1, 6 ,5982,1114,1000,8096
6/1/2016,2016,6,1, 7 ,6226,1147,1009,8382
6/1/2016,2016,6,1, 8 ,7063,1326,1155,9544
6/1/2016,2016,6,1, 9 ,7966,1540,1345,10851
6/1/2016,2016,6,1, 10 ,8509,1636,1469,11614
6/1/2016,2016,6,1, 11 ,8863,1722,1528,12113
6/1/2016,2016,6,1, 12 ,8622,1684,1512,11818
6/1/2016,2016,6,1, 13 ,8548,1671,1534,11753
6/1/2016,2016,6,1, 14 ,8826,1742,1493,12061
6/1/2016,2016,6,1, 15 ,8793,1689,1506,11988
6/1/2016,2016,6,1, 16 ,8660,1652,1492,11804
6/1/2016,2016,6,1, 17 ,8214,1573,1408,11195
6/1/2016,2016,6,1, 18 ,7946,1572,1441,10959
6/1/2016,2016,6,1, 19 ,8281,1695,1488,11464
6/1/2016,2016,6,1, 20 ,8260,1647,1460,11367
6/1/2016,2016,6,1, 21 ,8098,1567,1407,11072
6/1/2016,2016,6,1, 22 ,7829,1455,1301,10585
6/1/2016,2016,6,1, 23 ,7459,1357,1202,10018
6/1/2016,2016,6,1, 24 ,7054,1269,1128,9451
6/2/2016,2016,6,2, 1 ,6781,1219,1080,9080
6/2/2016,2016,6,2, 2 ,6541,1187,1044,8772
6/2/2016,2016,6,2, 3 ,6402,1150,1017,8569
6/2/2016,2016,6,2, 4 ,6282,1131,1007,8420
6/2/2016,2016,6,2, 5 ,6222,1135,1020,8377
6/2/2016,2016,6,2, 6 ,6125,1116,1014,8255
6/2/2016,2016,6,2, 7 ,6427,1149,1017,8593
6/2/2016,2016,6,2, 8 ,7311,1336,1145,9792
6/2/2016,2016,6,2, 9 ,8082,1554,1344,10980
6/2/2016,2016,6,2, 10 ,8599,1631,1423,11653
6/2/2016,2016,6,2, 11 ,8994,1715,1486,12195
6/2/2016,2016,6,2, 12 ,8921,1682,1443,12046
6/2/2016,2016,6,2, 13 ,8934,1689,1435,12058
6/2/2016,2016,6,2, 14 ,9289,1744,1497,12530
6/2/2016,2016,6,2, 15 ,9116,1733,1462,12311
6/2/2016,2016,6,2, 16 ,8916,1704,1423,12043
6/2/2016,2016,6,2, 17 ,8542,1593,1356,11491
6/2/2016,2016,6,2, 18 ,8302,1584,1365,11251
6/2/2016,2016,6,2, 19 ,8391,1718,1370,11479
6/2/2016,2016,6,2, 20 ,8213,1681,1370,11264
6/2/2016,2016,6,2, 21 ,8114,1632,1261,11007
6/2/2016,2016,6,2, 22 ,7804,1532,1237,10573
6/2/2016,2016,6,2, 23 ,7469,1427,1127,10023
6/2/2016,2016,6,2, 24 ,7079,1351,1076,9506
6/3/2016,2016,6,3, 1 ,6825,1283,1052,9160
6/3/2016,2016,6,3, 2 ,6616,1233,1022,8871
6/3/2016,2016,6,3, 3 ,6394,1201,1004,8599
6/3/2016,2016,6,3, 4 ,6246,1175,1003,8424
6/3/2016,2016,6,3, 5 ,6173,1167,982,8322
6/3/2016,2016,6,3, 6 ,6098,1134,997,8229
6/3/2016,2016,6,3, 7 ,6410,1174,1010,8594
6/3/2016,2016,6,3, 8 ,7327,1377,1164,9868
6/3/2016,2016,6,3, 9 ,8200,1605,1364,11169
6/3/2016,2016,6,3, 10 ,8685,1700,1451,11836
6/3/2016,2016,6,3, 11 ,9000,1782,1443,12225
6/3/2016,2016,6,3, 12 ,8757,1717,1412,11886
6/3/2016,2016,6,3, 13 ,8915,1723,1473,12111
6/3/2016,2016,6,3, 14 ,9142,1789,1523,12454
6/3/2016,2016,6,3, 15 ,9036,1767,1503,12306
6/3/2016,2016,6,3, 16 ,8885,1711,1470,12066
6/3/2016,2016,6,3, 17 ,8409,1595,1336,11340
6/3/2016,2016,6,3, 18 ,8069,1603,1427,11099
6/3/2016,2016,6,3, 19 ,8388,1735,1488,11611
6/3/2016,2016,6,3, 20 ,8388,1708,1446,11542
6/3/2016,2016,6,3, 21 ,8336,1651,1401,11388
6/3/2016,2016,6,3, 22 ,8059,1552,1284,10895
6/3/2016,2016,6,3, 23 ,7728,1442,1196,10366
6/3/2016,2016,6,3, 24 ,7387,1367,1111,9865
6/4/2016,2016,6,4, 1 ,7087,1319,1062,9468
6/4/2016,2016,6,4, 2 ,6835,1263,1035,9133
6/4/2016,2016,6,4, 3 ,6633,1185,1005,8823
6/4/2016,2016,6,4, 4 ,6451,1186,983,8620
6/4/2016,2016,6,4, 5 ,6367,1183,996,8546
6/4/2016,2016,6,4, 6 ,6084,1145,969,8198
6/4/2016,2016,6,4, 7 ,6210,1156,938,8304
6/4/2016,2016,6,4, 8 ,6809,1275,1075,9159
6/4/2016,2016,6,4, 9 ,7465,1452,1193,10110
6/4/2016,2016,6,4, 10 ,8120,1551,1271,10942
6/4/2016,2016,6,4, 11 ,8384,1598,1323,11305
6/4/2016,2016,6,4, 12 ,8258,1561,1350,11169
6/4/2016,2016,6,4, 13 ,8248,1556,1362,11166
6/4/2016,2016,6,4, 14 ,8407,1618,1357,11382
6/4/2016,2016,6,4, 15 ,8249,1577,1318,11144
6/4/2016,2016,6,4, 16 ,8007,1528,1292,10827
6/4/2016,2016,6,4, 17 ,7633,1484,1260,10377
6/4/2016,2016,6,4, 18 ,7468,1552,1363,10383
6/4/2016,2016,6,4, 19 ,7952,1680,1416,11048
6/4/2016,2016,6,4, 20 ,8044,1670,1371,11085
6/4/2016,2016,6,4, 21 ,8016,1626,1330,10972
6/4/2016,2016,6,4, 22 ,7871,1529,1062,10462
6/4/2016,2016,6,4, 23 ,7589,1442,989,10020
6/4/2016,2016,6,4, 24 ,7225,1349,890,9464
6/5/2016,2016,6,5, 1 ,6902,1292,1042,9236
6/5/2016,2016,6,5, 2 ,6705,1247,1013,8965
6/5/2016,2016,6,5, 3 ,6500,1211,982,8693
6/5/2016,2016,6,5, 4 ,6321,1176,966,8463
6/5/2016,2016,6,5, 5 ,6089,1152,961,8202
6/5/2016,2016,6,5, 6 ,5787,1092,954,7833
6/5/2016,2016,6,5, 7 ,5875,1106,974,7955
6/5/2016,2016,6,5, 8 ,6213,1170,979,8362
6/5/2016,2016,6,5, 9 ,6661,1261,1036,8958
6/5/2016,2016,6,5, 10 ,7070,1361,1140,9571
6/5/2016,2016,6,5, 11 ,7339,1420,1193,9952
6/5/2016,2016,6,5, 12 ,7317,1422,1200,9939
6/5/2016,2016,6,5, 13 ,7401,1407,1216,10024
6/5/2016,2016,6,5, 14 ,7379,1415,1207,10001
6/5/2016,2016,6,5, 15 ,7188,1384,1202,9774
6/5/2016,2016,6,5, 16 ,6966,1345,1149,9460
6/5/2016,2016,6,5, 17 ,6867,1333,1189,9389
6/5/2016,2016,6,5, 18 ,7064,1424,1278,9766
6/5/2016,2016,6,5, 19 ,7535,1604,1334,10473
6/5/2016,2016,6,5, 20 ,7606,1583,1302,10491
6/5/2016,2016,6,5, 21 ,7558,1539,1245,10342
6/5/2016,2016,6,5, 22 ,7368,1438,1144,9950
6/5/2016,2016,6,5, 23 ,7005,1370,1076,9451
6/5/2016,2016,6,5, 24 ,6712,1236,1006,8954
6/6/2016,2016,6,6, 1 ,6500,1169,1000,8669
6/6/2016,2016,6,6, 2 ,6259,1140,967,8366
6/6/2016,2016,6,6, 3 ,6005,1111,947,8063
6/6/2016,2016,6,6, 4 ,5878,1096,910,7884
6/6/2016,2016,6,6, 5 ,5819,1101,932,7852
6/6/2016,2016,6,6, 6 ,5818,1083,933,7834
6/6/2016,2016,6,6, 7 ,6314,1122,946,8382
6/6/2016,2016,6,6, 8 ,7247,1303,1142,9692
6/6/2016,2016,6,6, 9 ,8157,1532,1290,10979
6/6/2016,2016,6,6, 10 ,8736,1641,1441,11818
6/6/2016,2016,6,6, 11 ,9049,1692,1506,12247
6/6/2016,2016,6,6, 12 ,8911,1671,1469,12051
6/6/2016,2016,6,6, 13 ,8838,1649,1495,11982
6/6/2016,2016,6,6, 14 ,9069,1730,1502,12301
6/6/2016,2016,6,6, 15 ,8973,1714,1488,12175
6/6/2016,2016,6,6, 16 ,8761,1659,1472,11892
6/6/2016,2016,6,6, 17 ,8412,1592,1420,11424
6/6/2016,2016,6,6, 18 ,8142,1610,1387,11139
6/6/2016,2016,6,6, 19 ,8382,1723,1471,11576
6/6/2016,2016,6,6, 20 ,8218,1669,1371,11258
6/6/2016,2016,6,6, 21 ,7962,1619,1318,10899
6/6/2016,2016,6,6, 22 ,7668,1499,1211,10378
6/6/2016,2016,6,6, 23 ,7319,1390,1108,9817
6/6/2016,2016,6,6, 24 ,6895,1308,1083,9286
6/7/2016,2016,6,7, 1 ,6556,1252,998,8806
6/7/2016,2016,6,7, 2 ,6375,1215,978,8568
6/7/2016,2016,6,7, 3 ,6192,1181,972,8345
6/7/2016,2016,6,7, 4 ,6064,1153,945,8162
6/7/2016,2016,6,7, 5 ,6033,1148,962,8143
6/7/2016,2016,6,7, 6 ,5972,1131,964,8067
6/7/2016,2016,6,7, 7 ,6323,1147,990,8460
6/7/2016,2016,6,7, 8 ,7123,1341,1146,9610
6/7/2016,2016,6,7, 9 ,8058,1541,1328,10927
6/7/2016,2016,6,7, 10 ,8501,1628,1430,11559
6/7/2016,2016,6,7, 11 ,8905,1700,1521,12126
6/7/2016,2016,6,7, 12 ,8779,1670,1489,11938
6/7/2016,2016,6,7, 13 ,8817,1686,1506,12009
6/7/2016,2016,6,7, 14 ,9094,1767,1552,12413
6/7/2016,2016,6,7, 15 ,8888,1753,1538,12179
6/7/2016,2016,6,7, 16 ,8750,1709,1498,11957
6/7/2016,2016,6,7, 17 ,8233,1600,1433,11266
6/7/2016,2016,6,7, 18 ,7993,1600,1428,11021
6/7/2016,2016,6,7, 19 ,8300,1743,1504,11547
6/7/2016,2016,6,7, 20 ,8211,1690,1446,11347
6/7/2016,2016,6,7, 21 ,8105,1619,1397,11121
6/7/2016,2016,6,7, 22 ,7843,1515,1296,10654
6/7/2016,2016,6,7, 23 ,7422,1406,1187,10015
6/7/2016,2016,6,7, 24 ,7074,1324,1122,9520
6/8/2016,2016,6,8, 1 ,6747,1284,1080,9111
6/8/2016,2016,6,8, 2 ,6557,1244,1056,8857
6/8/2016,2016,6,8, 3 ,6355,1202,1032,8589
6/8/2016,2016,6,8, 4 ,6166,1193,1012,8371
6/8/2016,2016,6,8, 5 ,6136,1187,1015,8338
6/8/2016,2016,6,8, 6 ,6097,1168,1000,8265
6/8/2016,2016,6,8, 7 ,6400,1194,1005,8599
6/8/2016,2016,6,8, 8 ,7277,1402,1167,9846
6/8/2016,2016,6,8, 9 ,8055,1626,1378,11059
6/8/2016,2016,6,8, 10 ,8563,1739,1470,11772
6/8/2016,2016,6,8, 11 ,8860,1786,1539,12185
6/8/2016,2016,6,8, 12 ,8677,1720,1530,11927
6/8/2016,2016,6,8, 13 ,8687,1724,1537,11948
6/8/2016,2016,6,8, 14 ,9057,1767,1585,12409
6/8/2016,2016,6,8, 15 ,8965,1752,1570,12287
6/8/2016,2016,6,8, 16 ,8846,1724,1538,12108
6/8/2016,2016,6,8, 17 ,8319,1619,1448,11386
6/8/2016,2016,6,8, 18 ,8015,1621,1484,11120
6/8/2016,2016,6,8, 19 ,8404,1734,1506,11644
6/8/2016,2016,6,8, 20 ,8323,1704,1471,11498
6/8/2016,2016,6,8, 21 ,8169,1655,1412,11236
6/8/2016,2016,6,8, 22 ,7833,1524,1298,10655
6/8/2016,2016,6,8, 23 ,7446,1420,1219,10085
6/8/2016,2016,6,8, 24 ,7131,1350,1109,9590
6/9/2016,2016,6,9, 1 ,6838,1285,1088,9211
6/9/2016,2016,6,9, 2 ,6625,1237,1067,8929
6/9/2016,2016,6,9, 3 ,6415,1212,1047,8674
6/9/2016,2016,6,9, 4 ,6321,1178,1020,8519
6/9/2016,2016,6,9, 5 ,6293,1180,1026,8499
6/9/2016,2016,6,9, 6 ,6151,1156,1003,8310
6/9/2016,2016,6,9, 7 ,6313,1190,1015,8518
6/9/2016,2016,6,9, 8 ,7258,1393,1163,9814
6/9/2016,2016,6,9, 9 ,8032,1591,1350,10973
6/9/2016,2016,6,9, 10 ,8582,1690,1480,11752
6/9/2016,2016,6,9, 11 ,8884,1757,1549,12190
6/9/2016,2016,6,9, 12 ,8643,1698,1507,11848
6/9/2016,2016,6,9, 13 ,8635,1683,1534,11852
6/9/2016,2016,6,9, 14 ,8906,1736,1575,12217
6/9/2016,2016,6,9, 15 ,8767,1739,1542,12048
6/9/2016,2016,6,9, 16 ,8608,1733,1510,11851
6/9/2016,2016,6,9, 17 ,8222,1613,1414,11249
6/9/2016,2016,6,9, 18 ,8008,1608,1449,11065
6/9/2016,2016,6,9, 19 ,8277,1741,1499,11517
6/9/2016,2016,6,9, 20 ,8210,1697,1450,11357
6/9/2016,2016,6,9, 21 ,8089,1636,1383,11108
6/9/2016,2016,6,9, 22 ,7715,1525,1281,10521
6/9/2016,2016,6,9, 23 ,7406,1420,1190,10016
6/9/2016,2016,6,9, 24 ,7003,1331,1126,9460
6/10/2016,2016,6,10, 1 ,6648,1276,1085,9009
6/10/2016,2016,6,10, 2 ,6483,1228,1055,8766
6/10/2016,2016,6,10, 3 ,6268,1192,1037,8497
6/10/2016,2016,6,10, 4 ,6133,1171,1009,8313
6/10/2016,2016,6,10, 5 ,6103,1171,1013,8287
6/10/2016,2016,6,10, 6 ,6078,1152,999,8229
6/10/2016,2016,6,10, 7 ,6438,1191,1013,8642
6/10/2016,2016,6,10, 8 ,7358,1384,1173,9915
6/10/2016,2016,6,10, 9 ,8177,1599,1356,11132
6/10/2016,2016,6,10, 10 ,8727,1705,1456,11888
6/10/2016,2016,6,10, 11 ,8949,1756,1503,12208
6/10/2016,2016,6,10, 12 ,8841,1711,1475,12027
6/10/2016,2016,6,10, 13 ,8670,1736,1503,11909
6/10/2016,2016,6,10, 14 ,9006,1783,1520,12309
6/10/2016,2016,6,10, 15 ,8859,1765,1510,12134
6/10/2016,2016,6,10, 16 ,8759,1710,1474,11943
6/10/2016,2016,6,10, 17 ,8344,1632,1421,11397
6/10/2016,2016,6,10, 18 ,8102,1613,1417,11132
6/10/2016,2016,6,10, 19 ,8423,1756,1441,11620
6/10/2016,2016,6,10, 20 ,8350,1714,1405,11469
6/10/2016,2016,6,10, 21 ,8284,1620,1343,11247
6/10/2016,2016,6,10, 22 ,8065,1502,1229,10796
6/10/2016,2016,6,10, 23 ,7674,1365,1125,10164
6/10/2016,2016,6,10, 24 ,7340,1341,1091,9772
6/11/2016,2016,6,11, 1 ,7022,1285,1042,9349
6/11/2016,2016,6,11, 2 ,6743,1225,1019,8987
6/11/2016,2016,6,11, 3 ,6587,1184,991,8762
6/11/2016,2016,6,11, 4 ,6343,1178,962,8483
6/11/2016,2016,6,11, 5 ,6289,1160,972,8421
6/11/2016,2016,6,11, 6 ,6024,1139,948,8111
6/11/2016,2016,6,11, 7 ,6190,1159,949,8298
6/11/2016,2016,6,11, 8 ,6773,1252,1075,9100
6/11/2016,2016,6,11, 9 ,7446,1409,1176,10031
6/11/2016,2016,6,11, 10 ,8009,1503,1300,10812
6/11/2016,2016,6,11, 11 ,8242,1569,1363,11174
6/11/2016,2016,6,11, 12 ,8037,1501,1347,10885
6/11/2016,2016,6,11, 13 ,8021,1520,1326,10867
6/11/2016,2016,6,11, 14 ,8258,1535,1405,11198
6/11/2016,2016,6,11, 15 ,8204,1518,1367,11089
6/11/2016,2016,6,11, 16 ,7811,1481,1316,10608
6/11/2016,2016,6,11, 17 ,7479,1423,1268,10170
6/11/2016,2016,6,11, 18 ,7464,1469,1383,10316
6/11/2016,2016,6,11, 19 ,7803,1600,1439,10842
6/11/2016,2016,6,11, 20 ,7956,1608,1428,10992
6/11/2016,2016,6,11, 21 ,7882,1576,1375,10833
6/11/2016,2016,6,11, 22 ,7713,1499,1292,10504
6/11/2016,2016,6,11, 23 ,7457,1385,1202,10044
6/11/2016,2016,6,11, 24 ,7080,1287,1108,9475
6/12/2016,2016,6,12, 1 ,6752,1220,1051,9023
6/12/2016,2016,6,12, 2 ,6513,1177,1024,8714
6/12/2016,2016,6,12, 3 ,6366,1162,1017,8545
6/12/2016,2016,6,12, 4 ,6216,1141,1005,8362
6/12/2016,2016,6,12, 5 ,6089,1159,999,8247
6/12/2016,2016,6,12, 6 ,5676,1087,922,7685
6/12/2016,2016,6,12, 7 ,5641,1090,894,7625
6/12/2016,2016,6,12, 8 ,5978,1151,957,8086
6/12/2016,2016,6,12, 9 ,6392,1229,1048,8669
6/12/2016,2016,6,12, 10 ,6798,1266,1124,9188
6/12/2016,2016,6,12, 11 ,7088,1329,1175,9592
6/12/2016,2016,6,12, 12 ,7025,1327,1175,9527
6/12/2016,2016,6,12, 13 ,7021,1306,1187,9514
6/12/2016,2016,6,12, 14 ,6987,1317,1190,9494
6/12/2016,2016,6,12, 15 ,6910,1320,1172,9402
6/12/2016,2016,6,12, 16 ,6602,1306,1144,9052
6/12/2016,2016,6,12, 17 ,6553,1297,1170,9020
6/12/2016,2016,6,12, 18 ,6744,1364,1262,9370
6/12/2016,2016,6,12, 19 ,7166,1546,1339,10051
6/12/2016,2016,6,12, 20 ,7283,1539,1326,10148
6/12/2016,2016,6,12, 21 ,7226,1454,1279,9959
6/12/2016,2016,6,12, 22 ,6908,1371,1172,9451
6/12/2016,2016,6,12, 23 ,6665,1304,1093,9062
6/12/2016,2016,6,12, 24 ,6370,1227,1087,8684
6/13/2016,2016,6,13, 1 ,6092,1167,945,8204
6/13/2016,2016,6,13, 2 ,5879,1133,917,7929
6/13/2016,2016,6,13, 3 ,5673,1097,898,7668
6/13/2016,2016,6,13, 4 ,5660,1082,855,7597
6/13/2016,2016,6,13, 5 ,5787,1143,953,7883
6/13/2016,2016,6,13, 6 ,5704,1107,950,7761
6/13/2016,2016,6,13, 7 ,6108,1095,892,8095
6/13/2016,2016,6,13, 8 ,7052,1304,1076,9432
6/13/2016,2016,6,13, 9 ,7817,1497,1246,10560
6/13/2016,2016,6,13, 10 ,8524,1597,1380,11501
6/13/2016,2016,6,13, 11 ,8788,1681,1425,11894
6/13/2016,2016,6,13, 12 ,8603,1632,1452,11687
6/13/2016,2016,6,13, 13 ,8645,1643,1432,11720
6/13/2016,2016,6,13, 14 ,9029,1711,1458,12198
6/13/2016,2016,6,13, 15 ,8904,1696,1443,12043
6/13/2016,2016,6,13, 16 ,8767,1674,1427,11868
6/13/2016,2016,6,13, 17 ,8366,1576,1367,11309
6/13/2016,2016,6,13, 18 ,7935,1579,1381,10895
6/13/2016,2016,6,13, 19 ,8360,1740,1458,11558
6/13/2016,2016,6,13, 20 ,8251,1662,1436,11349
6/13/2016,2016,6,13, 21 ,8041,1596,1351,10988
6/13/2016,2016,6,13, 22 ,7832,1473,1227,10532
6/13/2016,2016,6,13, 23 ,7413,1382,1113,9908
6/13/2016,2016,6,13, 24 ,7012,1309,1058,9379
6/14/2016,2016,6,14, 1 ,6709,1254,1021,8984
6/14/2016,2016,6,14, 2 ,6505,1212,996,8713
6/14/2016,2016,6,14, 3 ,6383,1167,967,8517
6/14/2016,2016,6,14, 4 ,6224,1148,955,8327
6/14/2016,2016,6,14, 5 ,6328,1191,1011,8530
6/14/2016,2016,6,14, 6 ,6153,1167,986,8306
6/14/2016,2016,6,14, 7 ,6378,1125,942,8445
6/14/2016,2016,6,14, 8 ,7295,1322,1122,9739
6/14/2016,2016,6,14, 9 ,8090,1551,1319,10960
6/14/2016,2016,6,14, 10 ,8771,1660,1433,11864
6/14/2016,2016,6,14, 11 ,9016,1733,1509,12258
6/14/2016,2016,6,14, 12 ,8794,1685,1469,11948
6/14/2016,2016,6,14, 13 ,8867,1688,1489,12044
6/14/2016,2016,6,14, 14 ,9218,1758,1534,12510
6/14/2016,2016,6,14, 15 ,9127,1733,1532,12392
6/14/2016,2016,6,14, 16 ,8989,1681,1468,12138
6/14/2016,2016,6,14, 17 ,8575,1593,1431,11599
6/14/2016,2016,6,14, 18 ,8138,1606,1452,11196
6/14/2016,2016,6,14, 19 ,8488,1746,1524,11758
6/14/2016,2016,6,14, 20 ,8513,1701,1505,11719
6/14/2016,2016,6,14, 21 ,8394,1641,1445,11480
6/14/2016,2016,6,14, 22 ,8189,1522,1331,11042
6/14/2016,2016,6,14, 23 ,7705,1402,1245,10352
6/14/2016,2016,6,14, 24 ,7353,1322,1070,9745
6/15/2016,2016,6,15, 1 ,7003,1281,1142,9426
6/15/2016,2016,6,15, 2 ,6824,1220,1092,9136
6/15/2016,2016,6,15, 3 ,6576,1200,1074,8850
6/15/2016,2016,6,15, 4 ,6417,1193,1037,8647
6/15/2016,2016,6,15, 5 ,6507,1225,1090,8822
6/15/2016,2016,6,15, 6 ,6302,1198,1036,8536
6/15/2016,2016,6,15, 7 ,6539,1180,965,8684
6/15/2016,2016,6,15, 8 ,7533,1366,1140,10039
6/15/2016,2016,6,15, 9 ,8337,1582,1321,11240
6/15/2016,2016,6,15, 10 ,8851,1675,1408,11934
6/15/2016,2016,6,15, 11 ,9146,1751,1486,12383
6/15/2016,2016,6,15, 12 ,9011,1719,1456,12186
6/15/2016,2016,6,15, 13 ,9098,1716,1475,12289
6/15/2016,2016,6,15, 14 ,9417,1793,1538,12748
6/15/2016,2016,6,15, 15 ,9340,1763,1505,12608
6/15/2016,2016,6,15, 16 ,9151,1736,1468,12355
6/15/2016,2016,6,15, 17 ,8743,1650,1440,11833
6/15/2016,2016,6,15, 18 ,8258,1651,1444,11353
6/15/2016,2016,6,15, 19 ,8643,1784,1534,11961
6/15/2016,2016,6,15, 20 ,8602,1688,1474,11764
6/15/2016,2016,6,15, 21 ,8492,1633,1420,11545
6/15/2016,2016,6,15, 22 ,8239,1532,1302,11073
6/15/2016,2016,6,15, 23 ,7751,1413,1231,10395
6/15/2016,2016,6,15, 24 ,7403,1342,1150,9895
6/16/2016,2016,6,16, 1 ,7111,1277,1104,9492
6/16/2016,2016,6,16, 2 ,6841,1230,1064,9135
6/16/2016,2016,6,16, 3 ,6619,1195,1049,8863
6/16/2016,2016,6,16, 4 ,6512,1184,1024,8720
6/16/2016,2016,6,16, 5 ,6541,1213,1070,8824
6/16/2016,2016,6,16, 6 ,6355,1193,1026,8574
6/16/2016,2016,6,16, 7 ,6493,1162,973,8628
6/16/2016,2016,6,16, 8 ,7463,1368,1152,9983
6/16/2016,2016,6,16, 9 ,8369,1581,1344,11294
6/16/2016,2016,6,16, 10 ,8857,1697,1427,11981
6/16/2016,2016,6,16, 11 ,9213,1743,1522,12478
6/16/2016,2016,6,16, 12 ,9023,1714,1463,12200
6/16/2016,2016,6,16, 13 ,9035,1701,1477,12213
6/16/2016,2016,6,16, 14 ,9255,1711,1514,12480
6/16/2016,2016,6,16, 15 ,9070,1700,1507,12277
6/16/2016,2016,6,16, 16 ,9004,1678,1431,12113
6/16/2016,2016,6,16, 17 ,8594,1608,1353,11555
6/16/2016,2016,6,16, 18 ,8235,1603,1389,11227
6/16/2016,2016,6,16, 19 ,8526,1736,1430,11692
6/16/2016,2016,6,16, 20 ,8556,1694,1413,11663
6/16/2016,2016,6,16, 21 ,8465,1621,1336,11422
6/16/2016,2016,6,16, 22 ,8250,1501,1272,11023
6/16/2016,2016,6,16, 23 ,7762,1391,1196,10349
6/16/2016,2016,6,16, 24 ,7427,1324,1105,9856
6/17/2016,2016,6,17, 1 ,7139,1259,1062,9460
6/17/2016,2016,6,17, 2 ,6835,1217,1034,9086
6/17/2016,2016,6,17, 3 ,6647,1181,1013,8841
6/17/2016,2016,6,17, 4 ,6518,1163,995,8676
6/17/2016,2016,6,17, 5 ,6584,1191,1047,8822
6/17/2016,2016,6,17, 6 ,6361,1158,1031,8550
6/17/2016,2016,6,17, 7 ,6607,1149,968,8724
6/17/2016,2016,6,17, 8 ,7471,1345,1158,9974
6/17/2016,2016,6,17, 9 ,8332,1562,1311,11205
6/17/2016,2016,6,17, 10 ,8859,1702,1459,12020
6/17/2016,2016,6,17, 11 ,9095,1726,1502,12323
6/17/2016,2016,6,17, 12 ,8824,1675,1473,11972
6/17/2016,2016,6,17, 13 ,8838,1692,1434,11964
6/17/2016,2016,6,17, 14 ,9070,1751,1466,12287
6/17/2016,2016,6,17, 15 ,8858,1742,1432,12032
6/17/2016,2016,6,17, 16 ,8693,1694,1424,11811
6/17/2016,2016,6,17, 17 ,8367,1609,1372,11348
6/17/2016,2016,6,17, 18 ,8124,1597,1433,11154
6/17/2016,2016,6,17, 19 ,8489,1759,1472,11720
6/17/2016,2016,6,17, 20 ,8374,1709,1412,11495
6/17/2016,2016,6,17, 21 ,8365,1650,1338,11353
6/17/2016,2016,6,17, 22 ,8160,1557,1235,10952
6/17/2016,2016,6,17, 23 ,7714,1444,1152,10310
6/17/2016,2016,6,17, 24 ,7397,1365,1069,9831
6/18/2016,2016,6,18, 1 ,7049,1303,1049,9401
6/18/2016,2016,6,18, 2 ,6847,1263,1017,9127
6/18/2016,2016,6,18, 3 ,6650,1229,993,8872
6/18/2016,2016,6,18, 4 ,6477,1201,965,8643
6/18/2016,2016,6,18, 5 ,6389,1201,960,8550
6/18/2016,2016,6,18, 6 ,6150,1168,1018,8336
6/18/2016,2016,6,18, 7 ,6396,1177,1018,8591
6/18/2016,2016,6,18, 8 ,7016,1288,1109,9413
6/18/2016,2016,6,18, 9 ,7625,1449,1207,10281
6/18/2016,2016,6,18, 10 ,8087,1551,1292,10930
6/18/2016,2016,6,18, 11 ,8421,1584,1330,11335
6/18/2016,2016,6,18, 12 ,8284,1569,1337,11190
6/18/2016,2016,6,18, 13 ,8271,1556,1333,11160
6/18/2016,2016,6,18, 14 ,8483,1592,1382,11457
6/18/2016,2016,6,18, 15 ,8347,1569,1358,11274
6/18/2016,2016,6,18, 16 ,8105,1516,1367,10988
6/18/2016,2016,6,18, 17 ,7755,1447,1326,10528
6/18/2016,2016,6,18, 18 ,7538,1503,1397,10438
6/18/2016,2016,6,18, 19 ,8021,1695,1444,11160
6/18/2016,2016,6,18, 20 ,8146,1653,1431,11230
6/18/2016,2016,6,18, 21 ,8133,1587,1373,11093
6/18/2016,2016,6,18, 22 ,7998,1520,1272,10790
6/18/2016,2016,6,18, 23 ,7694,1413,1181,10288
6/18/2016,2016,6,18, 24 ,7346,1359,1101,9806
6/19/2016,2016,6,19, 1 ,7021,1311,1061,9393
6/19/2016,2016,6,19, 2 ,6853,1269,1033,9155
6/19/2016,2016,6,19, 3 ,6609,1230,1012,8851
6/19/2016,2016,6,19, 4 ,6422,1197,984,8603
6/19/2016,2016,6,19, 5 ,6263,1178,980,8421
6/19/2016,2016,6,19, 6 ,5989,1117,980,8086
6/19/2016,2016,6,19, 7 ,5911,1103,939,7953
6/19/2016,2016,6,19, 8 ,6139,1185,991,8315
6/19/2016,2016,6,19, 9 ,6527,1283,1076,8886
6/19/2016,2016,6,19, 10 ,7067,1368,1169,9604
6/19/2016,2016,6,19, 11 ,7363,1426,1238,10027
6/19/2016,2016,6,19, 12 ,7310,1433,1220,9963
6/19/2016,2016,6,19, 13 ,7289,1439,1240,9968
6/19/2016,2016,6,19, 14 ,7431,1457,1250,10138
6/19/2016,2016,6,19, 15 ,7407,1432,1236,10075
6/19/2016,2016,6,19, 16 ,7210,1392,1208,9810
6/19/2016,2016,6,19, 17 ,7001,1348,1212,9561
6/19/2016,2016,6,19, 18 ,7062,1450,1299,9811
6/19/2016,2016,6,19, 19 ,7586,1615,1385,10586
6/19/2016,2016,6,19, 20 ,7746,1626,1350,10722
6/19/2016,2016,6,19, 21 ,7777,1588,1267,10632
6/19/2016,2016,6,19, 22 ,7603,1494,1138,10235
6/19/2016,2016,6,19, 23 ,7356,1391,1076,9823
6/19/2016,2016,6,19, 24 ,7024,1318,1030,9372
6/20/2016,2016,6,20, 1 ,6692,1265,980,8937
6/20/2016,2016,6,20, 2 ,6413,1218,948,8579
6/20/2016,2016,6,20, 3 ,6245,1204,943,8392
6/20/2016,2016,6,20, 4 ,6138,1172,934,8244
6/20/2016,2016,6,20, 5 ,6235,1208,983,8426
6/20/2016,2016,6,20, 6 ,6193,1187,985,8365
6/20/2016,2016,6,20, 7 ,6409,1152,930,8491
6/20/2016,2016,6,20, 8 ,7328,1348,1096,9772
6/20/2016,2016,6,20, 9 ,8224,1581,1314,11119
6/20/2016,2016,6,20, 10 ,8765,1714,1448,11927
6/20/2016,2016,6,20, 11 ,9038,1751,1480,12269
6/20/2016,2016,6,20, 12 ,8840,1698,1460,11998
6/20/2016,2016,6,20, 13 ,8896,1686,1460,12042
6/20/2016,2016,6,20, 14 ,9233,1745,1490,12468
6/20/2016,2016,6,20, 15 ,9126,1695,1427,12248
6/20/2016,2016,6,20, 16 ,9004,1666,1405,12075
6/20/2016,2016,6,20, 17 ,8492,1590,1382,11464
6/20/2016,2016,6,20, 18 ,8180,1641,1409,11230
6/20/2016,2016,6,20, 19 ,8430,1760,1423,11613
6/20/2016,2016,6,20, 20 ,8324,1717,1389,11430
6/20/2016,2016,6,20, 21 ,8306,1650,1322,11278
6/20/2016,2016,6,20, 22 ,8044,1537,1179,10760
6/20/2016,2016,6,20, 23 ,7569,1410,1104,10083
6/20/2016,2016,6,20, 24 ,7207,1329,981,9517
6/21/2016,2016,6,21, 1 ,6929,1275,971,9175
6/21/2016,2016,6,21, 2 ,6657,1223,938,8818
6/21/2016,2016,6,21, 3 ,6449,1173,926,8548
6/21/2016,2016,6,21, 4 ,6365,1154,910,8429
6/21/2016,2016,6,21, 5 ,6386,1188,962,8536
6/21/2016,2016,6,21, 6 ,6261,1192,993,8446
6/21/2016,2016,6,21, 7 ,6485,1151,920,8556
6/21/2016,2016,6,21, 8 ,7435,1298,1067,9800
6/21/2016,2016,6,21, 9 ,8130,1485,1185,10800
6/21/2016,2016,6,21, 10 ,8650,1572,1282,11504
6/21/2016,2016,6,21, 11 ,8965,1621,1340,11926
6/21/2016,2016,6,21, 12 ,8812,1594,1317,11723
6/21/2016,2016,6,21, 13 ,8894,1595,1317,11806
6/21/2016,2016,6,21, 14 ,9229,1659,1346,12234
6/21/2016,2016,6,21, 15 ,8968,1644,1346,11958
6/21/2016,2016,6,21, 16 ,8705,1616,1344,11665
6/21/2016,2016,6,21, 17 ,8364,1567,1369,11300
6/21/2016,2016,6,21, 18 ,8061,1584,1393,11038
6/21/2016,2016,6,21, 19 ,8496,1709,1419,11624
6/21/2016,2016,6,21, 20 ,8558,1699,1382,11639
6/21/2016,2016,6,21, 21 ,8463,1584,1286,11333
6/21/2016,2016,6,21, 22 ,8210,1450,1152,10812
6/21/2016,2016,6,21, 23 ,7706,1341,1070,10117
6/21/2016,2016,6,21, 24 ,7340,1271,1000,9611
6/22/2016,2016,6,22, 1 ,6985,1233,958,9176
6/22/2016,2016,6,22, 2 ,6799,1161,924,8884
6/22/2016,2016,6,22, 3 ,6576,1128,923,8627
6/22/2016,2016,6,22, 4 ,6415,1106,905,8426
6/22/2016,2016,6,22, 5 ,6549,1148,949,8646
6/22/2016,2016,6,22, 6 ,6343,1168,1004,8515
6/22/2016,2016,6,22, 7 ,6564,1104,947,8615
6/22/2016,2016,6,22, 8 ,7334,1282,1049,9665
6/22/2016,2016,6,22, 9 ,8140,1475,1269,10884
6/22/2016,2016,6,22, 10 ,8727,1607,1346,11680
6/22/2016,2016,6,22, 11 ,8940,1645,1404,11989
6/22/2016,2016,6,22, 12 ,8811,1611,1379,11801
6/22/2016,2016,6,22, 13 ,8844,1633,1388,11865
6/22/2016,2016,6,22, 14 ,9072,1694,1437,12203
6/22/2016,2016,6,22, 15 ,8961,1673,1391,12025
6/22/2016,2016,6,22, 16 ,8783,1651,1374,11808
6/22/2016,2016,6,22, 17 ,8396,1580,1361,11337
6/22/2016,2016,6,22, 18 ,8122,1598,1403,11123
6/22/2016,2016,6,22, 19 ,8403,1725,1452,11580
6/22/2016,2016,6,22, 20 ,8344,1665,1406,11415
6/22/2016,2016,6,22, 21 ,8237,1557,1332,11126
6/22/2016,2016,6,22, 22 ,7994,1439,1212,10645
6/22/2016,2016,6,22, 23 ,7595,1316,1115,10026
6/22/2016,2016,6,22, 24 ,7209,1252,1075,9536
6/23/2016,2016,6,23, 1 ,6867,1210,1008,9085
6/23/2016,2016,6,23, 2 ,6688,1168,985,8841
6/23/2016,2016,6,23, 3 ,6491,1147,972,8610
6/23/2016,2016,6,23, 4 ,6321,1132,955,8408
6/23/2016,2016,6,23, 5 ,6415,1180,1004,8599
6/23/2016,2016,6,23, 6 ,6306,1174,1008,8488
6/23/2016,2016,6,23, 7 ,6483,1135,951,8569
6/23/2016,2016,6,23, 8 ,7268,1328,1113,9709
6/23/2016,2016,6,23, 9 ,8138,1544,1297,10979
6/23/2016,2016,6,23, 10 ,8643,1647,1392,11682
6/23/2016,2016,6,23, 11 ,8907,1691,1452,12050
6/23/2016,2016,6,23, 12 ,8815,1648,1374,11837
6/23/2016,2016,6,23, 13 ,8803,1652,1396,11851
6/23/2016,2016,6,23, 14 ,9069,1711,1424,12204
6/23/2016,2016,6,23, 15 ,8866,1690,1343,11899
6/23/2016,2016,6,23, 16 ,8650,1667,1357,11674
6/23/2016,2016,6,23, 17 ,8305,1587,1344,11236
6/23/2016,2016,6,23, 18 ,8089,1604,1173,10866
6/23/2016,2016,6,23, 19 ,8404,1720,1334,11458
6/23/2016,2016,6,23, 20 ,8347,1685,1346,11378
6/23/2016,2016,6,23, 21 ,8246,1591,1240,11077
6/23/2016,2016,6,23, 22 ,7951,1464,1162,10577
6/23/2016,2016,6,23, 23 ,7538,1301,1091,9930
6/23/2016,2016,6,23, 24 ,7132,1223,1002,9357
6/24/2016,2016,6,24, 1 ,6863,1182,990,9035
6/24/2016,2016,6,24, 2 ,6650,1138,969,8757
6/24/2016,2016,6,24, 3 ,6475,1111,958,8544
6/24/2016,2016,6,24, 4 ,6363,1091,940,8394
6/24/2016,2016,6,24, 5 ,6444,1132,1009,8585
6/24/2016,2016,6,24, 6 ,6256,1144,995,8395
6/24/2016,2016,6,24, 7 ,6387,1126,949,8462
6/24/2016,2016,6,24, 8 ,7174,1299,1080,9553
6/24/2016,2016,6,24, 9 ,8084,1502,1252,10838
6/24/2016,2016,6,24, 10 ,8479,1603,1355,11437
6/24/2016,2016,6,24, 11 ,8737,1635,1420,11792
6/24/2016,2016,6,24, 12 ,8566,1604,1385,11555
6/24/2016,2016,6,24, 13 ,8657,1608,1396,11661
6/24/2016,2016,6,24, 14 ,8991,1685,1453,12129
6/24/2016,2016,6,24, 15 ,8964,1691,1405,12060
6/24/2016,2016,6,24, 16 ,8854,1650,1376,11880
6/24/2016,2016,6,24, 17 ,8407,1558,1356,11321
6/24/2016,2016,6,24, 18 ,8162,1568,1371,11101
6/24/2016,2016,6,24, 19 ,8424,1690,1397,11511
6/24/2016,2016,6,24, 20 ,8301,1658,1353,11312
6/24/2016,2016,6,24, 21 ,8151,1606,1322,11079
6/24/2016,2016,6,24, 22 ,7933,1480,1211,10624
6/24/2016,2016,6,24, 23 ,7560,1387,1148,10095
6/24/2016,2016,6,24, 24 ,7168,1290,1085,9543
6/25/2016,2016,6,25, 1 ,6861,1238,974,9073
6/25/2016,2016,6,25, 2 ,6712,1203,947,8862
6/25/2016,2016,6,25, 3 ,6457,1174,934,8565
6/25/2016,2016,6,25, 4 ,6338,1153,904,8395
6/25/2016,2016,6,25, 5 ,6280,1152,928,8360
6/25/2016,2016,6,25, 6 ,6070,1121,922,8113
6/25/2016,2016,6,25, 7 ,6250,1130,946,8326
6/25/2016,2016,6,25, 8 ,6884,1261,1020,9165
6/25/2016,2016,6,25, 9 ,7535,1415,1057,10007
6/25/2016,2016,6,25, 10 ,8015,1522,1147,10684
6/25/2016,2016,6,25, 11 ,8298,1558,1208,11064
6/25/2016,2016,6,25, 12 ,8250,1546,1243,11039
6/25/2016,2016,6,25, 13 ,8275,1538,1260,11073
6/25/2016,2016,6,25, 14 ,8466,1553,1307,11326
6/25/2016,2016,6,25, 15 ,8284,1534,1270,11088
6/25/2016,2016,6,25, 16 ,8059,1493,1229,10781
6/25/2016,2016,6,25, 17 ,7686,1440,1250,10376
6/25/2016,2016,6,25, 18 ,7494,1497,1318,10309
6/25/2016,2016,6,25, 19 ,7985,1593,1345,10923
6/25/2016,2016,6,25, 20 ,8084,1546,1319,10949
6/25/2016,2016,6,25, 21 ,8051,1468,1257,10776
6/25/2016,2016,6,25, 22 ,7873,1376,1155,10404
6/25/2016,2016,6,25, 23 ,7532,1273,1064,9869
6/25/2016,2016,6,25, 24 ,7184,1202,812,9198
6/26/2016,2016,6,26, 1 ,6863,1148,927,8938
6/26/2016,2016,6,26, 2 ,6677,1107,919,8703
6/26/2016,2016,6,26, 3 ,6444,1079,908,8431
6/26/2016,2016,6,26, 4 ,6265,1063,892,8220
6/26/2016,2016,6,26, 5 ,6141,1065,900,8106
6/26/2016,2016,6,26, 6 ,5845,1034,896,7775
6/26/2016,2016,6,26, 7 ,5852,1040,892,7784
6/26/2016,2016,6,26, 8 ,6185,1094,915,8194
6/26/2016,2016,6,26, 9 ,6617,1174,985,8776
6/26/2016,2016,6,26, 10 ,7083,1256,1053,9392
6/26/2016,2016,6,26, 11 ,7348,1313,1102,9763
6/26/2016,2016,6,26, 12 ,7302,1334,1106,9742
6/26/2016,2016,6,26, 13 ,7193,1329,1109,9631
6/26/2016,2016,6,26, 14 ,7087,1334,1074,9495
6/26/2016,2016,6,26, 15 ,6993,1321,1091,9405
6/26/2016,2016,6,26, 16 ,6902,1292,1079,9273
6/26/2016,2016,6,26, 17 ,6842,1306,1099,9247
6/26/2016,2016,6,26, 18 ,6908,1407,1218,9533
6/26/2016,2016,6,26, 19 ,7289,1548,1319,10156
6/26/2016,2016,6,26, 20 ,7438,1522,1298,10258
6/26/2016,2016,6,26, 21 ,7364,1452,1224,10040
6/26/2016,2016,6,26, 22 ,7040,1357,1115,9512
6/26/2016,2016,6,26, 23 ,6716,1259,1046,9021
6/26/2016,2016,6,26, 24 ,6369,1182,980,8531
6/27/2016,2016,6,27, 1 ,6985,1137,929,9051
6/27/2016,2016,6,27, 2 ,6799,1104,910,8813
6/27/2016,2016,6,27, 3 ,6576,1069,897,8542
6/27/2016,2016,6,27, 4 ,6415,1073,888,8376
6/27/2016,2016,6,27, 5 ,6549,1114,941,8604
6/27/2016,2016,6,27, 6 ,6343,1122,951,8416
6/27/2016,2016,6,27, 7 ,6094,1092,902,8088
6/27/2016,2016,6,27, 8 ,6989,1265,1060,9314
6/27/2016,2016,6,27, 9 ,7882,1463,1249,10594
6/27/2016,2016,6,27, 10 ,8463,1585,1353,11401
6/27/2016,2016,6,27, 11 ,8712,1661,1425,11798
6/27/2016,2016,6,27, 12 ,8554,1608,1346,11508
6/27/2016,2016,6,27, 13 ,8513,1620,1383,11516
6/27/2016,2016,6,27, 14 ,8686,1671,1440,11797
6/27/2016,2016,6,27, 15 ,8649,1672,1404,11725
6/27/2016,2016,6,27, 16 ,8603,1641,1383,11627
6/27/2016,2016,6,27, 17 ,8240,1586,1353,11179
6/27/2016,2016,6,27, 18 ,7976,1619,1384,10979
6/27/2016,2016,6,27, 19 ,8234,1708,1378,11320
6/27/2016,2016,6,27, 20 ,8101,1671,1349,11121
6/27/2016,2016,6,27, 21 ,7912,1586,1260,10758
6/27/2016,2016,6,27, 22 ,7271,1439,1158,9868
6/27/2016,2016,6,27, 23 ,7223,1326,1069,9618
6/27/2016,2016,6,27, 24 ,6781,1250,976,9007
6/28/2016,2016,6,28, 1 ,6513,1202,967,8682
6/28/2016,2016,6,28, 2 ,6348,1156,942,8446
6/28/2016,2016,6,28, 3 ,6164,1134,931,8229
6/28/2016,2016,6,28, 4 ,6043,1124,916,8083
6/28/2016,2016,6,28, 5 ,6180,1158,976,8314
6/28/2016,2016,6,28, 6 ,6149,1173,1012,8334
6/28/2016,2016,6,28, 7 ,6329,1129,952,8410
6/28/2016,2016,6,28, 8 ,7153,1295,1070,9518
6/28/2016,2016,6,28, 9 ,8093,1506,1221,10820
6/28/2016,2016,6,28, 10 ,8595,1604,1311,11510
6/28/2016,2016,6,28, 11 ,8935,1657,1353,11945
6/28/2016,2016,6,28, 12 ,8776,1622,1308,11706
6/28/2016,2016,6,28, 13 ,8867,1626,1328,11821
6/28/2016,2016,6,28, 14 ,9135,1678,1354,12167
6/28/2016,2016,6,28, 15 ,9071,1700,1376,12147
6/28/2016,2016,6,28, 16 ,8731,1678,1377,11786
6/28/2016,2016,6,28, 17 ,8277,1585,1340,11202
6/28/2016,2016,6,28, 18 ,8151,1606,1379,11136
6/28/2016,2016,6,28, 19 ,8380,1720,1422,11522
6/28/2016,2016,6,28, 20 ,8370,1666,1380,11416
6/28/2016,2016,6,28, 21 ,8179,1585,1271,11035
6/28/2016,2016,6,28, 22 ,7881,1460,1195,10536
6/28/2016,2016,6,28, 23 ,7447,1364,1083,9894
6/28/2016,2016,6,28, 24 ,7066,1276,1023,9365
6/29/2016,2016,6,29, 1 ,6724,1226,995,8945
6/29/2016,2016,6,29, 2 ,6551,1176,979,8706
6/29/2016,2016,6,29, 3 ,6355,1147,952,8454
6/29/2016,2016,6,29, 4 ,6201,1135,944,8280
6/29/2016,2016,6,29, 5 ,6288,1170,1006,8464
6/29/2016,2016,6,29, 6 ,6172,1168,1009,8349
6/29/2016,2016,6,29, 7 ,6408,1141,969,8518
6/29/2016,2016,6,29, 8 ,7271,1317,1090,9678
6/29/2016,2016,6,29, 9 ,8075,1521,1287,10883
6/29/2016,2016,6,29, 10 ,8583,1643,1392,11618
6/29/2016,2016,6,29, 11 ,8821,1691,1447,11959
6/29/2016,2016,6,29, 12 ,8692,1616,1411,11719
6/29/2016,2016,6,29, 13 ,8689,1624,1427,11740
6/29/2016,2016,6,29, 14 ,9024,1665,1466,12155
6/29/2016,2016,6,29, 15 ,8663,1642,1445,11750
6/29/2016,2016,6,29, 16 ,8469,1644,1411,11524
6/29/2016,2016,6,29, 17 ,8212,1563,1361,11136
6/29/2016,2016,6,29, 18 ,8042,1598,1377,11017
6/29/2016,2016,6,29, 19 ,8308,1696,1415,11419
6/29/2016,2016,6,29, 20 ,8209,1640,1367,11216
6/29/2016,2016,6,29, 21 ,8089,1581,1272,10942
6/29/2016,2016,6,29, 22 ,7699,1459,1172,10330
6/29/2016,2016,6,29, 23 ,7263,1331,1048,9642
6/29/2016,2016,6,29, 24 ,6917,1262,1016,9195
6/30/2016,2016,6,30, 1 ,6660,1207,976,8843
6/30/2016,2016,6,30, 2 ,6399,1180,958,8537
6/30/2016,2016,6,30, 3 ,6199,1148,937,8284
6/30/2016,2016,6,30, 4 ,6118,1132,920,8170
6/30/2016,2016,6,30, 5 ,6218,1175,980,8373
6/30/2016,2016,6,30, 6 ,6149,1175,987,8311
6/30/2016,2016,6,30, 7 ,6349,1141,952,8442
6/30/2016,2016,6,30, 8 ,7136,1332,1085,9553
6/30/2016,2016,6,30, 9 ,7827,1439,1289,10555
6/30/2016,2016,6,30, 10 ,8339,1620,1396,11355
6/30/2016,2016,6,30, 11 ,8632,1715,1456,11803
6/30/2016,2016,6,30, 12 ,8481,1666,1452,11599
6/30/2016,2016,6,30, 13 ,8411,1648,1446,11505
6/30/2016,2016,6,30, 14 ,8708,1660,1477,11845
6/30/2016,2016,6,30, 15 ,8545,1639,1433,11617
6/30/2016,2016,6,30, 16 ,8438,1607,1400,11445
6/30/2016,2016,6,30, 17 ,8166,1555,1318,11039
6/30/2016,2016,6,30, 18 ,7851,1570,1399,10820
6/30/2016,2016,6,30, 19 ,8237,1643,1455,11335
6/30/2016,2016,6,30, 20 ,8203,1597,1391,11191
6/30/2016,2016,6,30, 21 ,8049,1513,1313,10875
6/30/2016,2016,6,30, 22 ,7744,1387,1231,10362
6/30/2016,2016,6,30, 23 ,7364,1301,1161,9826
6/30/2016,2016,6,30, 24 ,6943,1221,1037,9201
7/1/2016,2016,7,1, 1 ,6682,1179,1013,8874
7/1/2016,2016,7,1, 2 ,6438,1151,986,8575
7/1/2016,2016,7,1, 3 ,6219,1117,943,8279
7/1/2016,2016,7,1, 4 ,6109,1110,934,8153
7/1/2016,2016,7,1, 5 ,6196,1150,985,8331
7/1/2016,2016,7,1, 6 ,6092,1155,994,8241
7/1/2016,2016,7,1, 7 ,6247,1108,945,8300
7/1/2016,2016,7,1, 8 ,7045,1260,1056,9361
7/1/2016,2016,7,1, 9 ,7925,1470,1264,10659
7/1/2016,2016,7,1, 10 ,8322,1567,1358,11247
7/1/2016,2016,7,1, 11 ,8684,1617,1401,11702
7/1/2016,2016,7,1, 12 ,8536,1569,1371,11476
7/1/2016,2016,7,1, 13 ,8562,1560,1387,11509
7/1/2016,2016,7,1, 14 ,8981,1627,1407,12015
7/1/2016,2016,7,1, 15 ,8965,1608,1381,11954
7/1/2016,2016,7,1, 16 ,8823,1573,1350,11746
7/1/2016,2016,7,1, 17 ,8390,1444,1340,11174
7/1/2016,2016,7,1, 18 ,8028,1491,1369,10888
7/1/2016,2016,7,1, 19 ,8390,1573,1393,11356
7/1/2016,2016,7,1, 20 ,8365,1526,1355,11246
7/1/2016,2016,7,1, 21 ,8150,1454,1276,10880
7/1/2016,2016,7,1, 22 ,7877,1335,1159,10371
7/1/2016,2016,7,1, 23 ,7501,1240,1075,9816
7/1/2016,2016,7,1, 24 ,7141,1176,1046,9363
7/2/2016,2016,7,2, 1 ,6870,1134,982,8986
7/2/2016,2016,7,2, 2 ,6600,1105,957,8662
7/2/2016,2016,7,2, 3 ,6381,1085,934,8400
7/2/2016,2016,7,2, 4 ,6217,1064,920,8201
7/2/2016,2016,7,2, 5 ,6121,1073,954,8148
7/2/2016,2016,7,2, 6 ,5928,1067,936,7931
7/2/2016,2016,7,2, 7 ,6089,1097,943,8129
7/2/2016,2016,7,2, 8 ,6698,1221,1062,8981
7/2/2016,2016,7,2, 9 ,7372,1403,1178,9953
7/2/2016,2016,7,2, 10 ,7850,1517,1276,10643
7/2/2016,2016,7,2, 11 ,8183,1576,1335,11094
7/2/2016,2016,7,2, 12 ,8089,1546,1283,10918
7/2/2016,2016,7,2, 13 ,8100,1537,1299,10936
7/2/2016,2016,7,2, 14 ,8320,1525,1319,11164
7/2/2016,2016,7,2, 15 ,8122,1490,1284,10896
7/2/2016,2016,7,2, 16 ,7744,1453,1227,10424
7/2/2016,2016,7,2, 17 ,7478,1445,1236,10159
7/2/2016,2016,7,2, 18 ,7404,1492,1305,10201
7/2/2016,2016,7,2, 19 ,7704,1551,1338,10593
7/2/2016,2016,7,2, 20 ,7746,1523,1315,10584
7/2/2016,2016,7,2, 21 ,7726,1440,1243,10409
7/2/2016,2016,7,2, 22 ,7453,1303,1177,9933
7/2/2016,2016,7,2, 23 ,7181,1214,1059,9454
7/2/2016,2016,7,2, 24 ,6740,1154,985,8879
7/3/2016,2016,7,3, 1 ,6490,1102,946,8538
7/3/2016,2016,7,3, 2 ,6271,1075,927,8273
7/3/2016,2016,7,3, 3 ,6106,1045,914,8065
7/3/2016,2016,7,3, 4 ,5941,1029,896,7866
7/3/2016,2016,7,3, 5 ,5841,1033,904,7778
7/3/2016,2016,7,3, 6 ,5599,1019,896,7514
7/3/2016,2016,7,3, 7 ,5584,1026,864,7474
7/3/2016,2016,7,3, 8 ,5906,1069,925,7900
7/3/2016,2016,7,3, 9 ,6317,1155,1011,8483
7/3/2016,2016,7,3, 10 ,6743,1232,1098,9073
7/3/2016,2016,7,3, 11 ,7072,1290,1137,9499
7/3/2016,2016,7,3, 12 ,7013,1306,1166,9485
7/3/2016,2016,7,3, 13 ,6924,1263,1195,9382
7/3/2016,2016,7,3, 14 ,6966,1277,1224,9467
7/3/2016,2016,7,3, 15 ,6798,1276,1214,9288
7/3/2016,2016,7,3, 16 ,6590,1277,1200,9067
7/3/2016,2016,7,3, 17 ,6500,1301,1198,8999
7/3/2016,2016,7,3, 18 ,6728,1383,1274,9385
7/3/2016,2016,7,3, 19 ,7148,1536,1393,10077
7/3/2016,2016,7,3, 20 ,7262,1496,1366,10124
7/3/2016,2016,7,3, 21 ,7190,1431,1324,9945
7/3/2016,2016,7,3, 22 ,6826,1318,1186,9330
7/3/2016,2016,7,3, 23 ,6512,1224,1138,8874
7/3/2016,2016,7,3, 24 ,6192,1147,1018,8357
7/4/2016,2016,7,4, 1 ,5920,1093,991,8004
7/4/2016,2016,7,4, 2 ,5701,1059,957,7717
7/4/2016,2016,7,4, 3 ,5548,1033,938,7519
7/4/2016,2016,7,4, 4 ,5445,1018,921,7384
7/4/2016,2016,7,4, 5 ,5670,1071,988,7729
7/4/2016,2016,7,4, 6 ,5679,1094,990,7763
7/4/2016,2016,7,4, 7 ,5986,1069,936,7991
7/4/2016,2016,7,4, 8 ,6843,1235,1095,9173
7/4/2016,2016,7,4, 9 ,7748,1438,1280,10466
7/4/2016,2016,7,4, 10 ,8334,1559,1408,11301
7/4/2016,2016,7,4, 11 ,8618,1603,1462,11683
7/4/2016,2016,7,4, 12 ,8495,1579,1415,11489
7/4/2016,2016,7,4, 13 ,8466,1573,1406,11445
7/4/2016,2016,7,4, 14 ,8840,1620,1515,11975
7/4/2016,2016,7,4, 15 ,8711,1568,1495,11774
7/4/2016,2016,7,4, 16 ,8576,1567,1474,11617
7/4/2016,2016,7,4, 17 ,8270,1523,1418,11211
7/4/2016,2016,7,4, 18 ,7934,1508,1432,10874
7/4/2016,2016,7,4, 19 ,8130,1673,1520,11323
7/4/2016,2016,7,4, 20 ,8065,1619,1394,11078
7/4/2016,2016,7,4, 21 ,7854,1514,1373,10741
7/4/2016,2016,7,4, 22 ,7587,1383,1307,10277
7/4/2016,2016,7,4, 23 ,7118,1277,1202,9597
7/4/2016,2016,7,4, 24 ,6745,1194,968,8907
7/5/2016,2016,7,5, 1 ,6420,1165,1055,8640
7/5/2016,2016,7,5, 2 ,6308,1128,1022,8458
7/5/2016,2016,7,5, 3 ,6134,1098,1004,8236
7/5/2016,2016,7,5, 4 ,6071,1082,985,8138
7/5/2016,2016,7,5, 5 ,6203,1122,1019,8344
7/5/2016,2016,7,5, 6 ,6129,1142,1029,8300
7/5/2016,2016,7,5, 7 ,6255,1103,964,8322
7/5/2016,2016,7,5, 8 ,7142,1281,1128,9551
7/5/2016,2016,7,5, 9 ,7842,1475,1320,10637
7/5/2016,2016,7,5, 10 ,8288,1536,1422,11246
7/5/2016,2016,7,5, 11 ,8576,1580,1487,11643
7/5/2016,2016,7,5, 12 ,8443,1553,1463,11459
7/5/2016,2016,7,5, 13 ,8466,1547,1418,11431
7/5/2016,2016,7,5, 14 ,8595,1631,1485,11711
7/5/2016,2016,7,5, 15 ,8432,1654,1486,11572
7/5/2016,2016,7,5, 16 ,8220,1626,1456,11302
7/5/2016,2016,7,5, 17 ,8044,1590,1413,11047
7/5/2016,2016,7,5, 18 ,7925,1543,1386,10854
7/5/2016,2016,7,5, 19 ,8077,1688,1476,11241
7/5/2016,2016,7,5, 20 ,7960,1624,1419,11003
7/5/2016,2016,7,5, 21 ,7790,1529,1356,10675
7/5/2016,2016,7,5, 22 ,7391,1406,1286,10083
7/5/2016,2016,7,5, 23 ,6990,1292,1175,9457
7/5/2016,2016,7,5, 24 ,6685,1211,1078,8974
7/6/2016,2016,7,6, 1 ,6441,1163,1038,8642
7/6/2016,2016,7,6, 2 ,6141,1137,1000,8278
7/6/2016,2016,7,6, 3 ,5980,1108,974,8062
7/6/2016,2016,7,6, 4 ,5811,1085,970,7866
7/6/2016,2016,7,6, 5 ,5820,1097,982,7899
7/6/2016,2016,7,6, 6 ,5687,1089,967,7743
7/6/2016,2016,7,6, 7 ,5836,1104,954,7894
7/6/2016,2016,7,6, 8 ,6297,1224,1053,8574
7/6/2016,2016,7,6, 9 ,6957,1361,1150,9468
7/6/2016,2016,7,6, 10 ,7392,1460,1274,10126
7/6/2016,2016,7,6, 11 ,7647,1508,1326,10481
7/6/2016,2016,7,6, 12 ,7573,1466,1336,10375
7/6/2016,2016,7,6, 13 ,7445,1449,1344,10238
7/6/2016,2016,7,6, 14 ,7696,1464,1386,10546
7/6/2016,2016,7,6, 15 ,7607,1430,1373,10410
7/6/2016,2016,7,6, 16 ,7478,1433,1332,10243
7/6/2016,2016,7,6, 17 ,7310,1426,1266,10002
7/6/2016,2016,7,6, 18 ,7223,1454,1346,10023
7/6/2016,2016,7,6, 19 ,7724,1571,1435,10730
7/6/2016,2016,7,6, 20 ,7869,1536,1399,10804
7/6/2016,2016,7,6, 21 ,7786,1481,1358,10625
7/6/2016,2016,7,6, 22 ,7442,1361,1242,10045
7/6/2016,2016,7,6, 23 ,7071,1243,1140,9454
7/6/2016,2016,7,6, 24 ,6710,1180,1063,8953
7/7/2016,2016,7,7, 1 ,6373,1134,990,8497
7/7/2016,2016,7,7, 2 ,6166,1097,985,8248
7/7/2016,2016,7,7, 3 ,5960,1072,962,7994
7/7/2016,2016,7,7, 4 ,5900,1066,958,7924
7/7/2016,2016,7,7, 5 ,6018,1106,1010,8134
7/7/2016,2016,7,7, 6 ,6001,1128,1034,8163
7/7/2016,2016,7,7, 7 ,6235,1096,983,8314
7/7/2016,2016,7,7, 8 ,7051,1265,1097,9413
7/7/2016,2016,7,7, 9 ,7853,1506,1174,10533
7/7/2016,2016,7,7, 10 ,8297,1594,1375,11266
7/7/2016,2016,7,7, 11 ,8503,1643,1431,11577
7/7/2016,2016,7,7, 12 ,8339,1612,1439,11390
7/7/2016,2016,7,7, 13 ,8278,1578,1448,11304
7/7/2016,2016,7,7, 14 ,8625,1616,1500,11741
7/7/2016,2016,7,7, 15 ,8504,1610,1480,11594
7/7/2016,2016,7,7, 16 ,8346,1585,1473,11404
7/7/2016,2016,7,7, 17 ,8047,1549,1412,11008
7/7/2016,2016,7,7, 18 ,7718,1562,1438,10718
7/7/2016,2016,7,7, 19 ,8005,1669,1533,11207
7/7/2016,2016,7,7, 20 ,7889,1629,1471,10989
7/7/2016,2016,7,7, 21 ,7774,1554,1417,10745
7/7/2016,2016,7,7, 22 ,7428,1419,1297,10144
7/7/2016,2016,7,7, 23 ,6882,1297,1180,9359
7/7/2016,2016,7,7, 24 ,6556,1224,1088,8868
7/8/2016,2016,7,8, 1 ,6294,1181,1054,8529
7/8/2016,2016,7,8, 2 ,6087,1147,1023,8257
7/8/2016,2016,7,8, 3 ,5905,1109,990,8004
7/8/2016,2016,7,8, 4 ,5878,1087,969,7934
7/8/2016,2016,7,8, 5 ,5969,1127,1016,8112
7/8/2016,2016,7,8, 6 ,5897,1155,1053,8105
7/8/2016,2016,7,8, 7 ,6000,1119,992,8111
7/8/2016,2016,7,8, 8 ,6700,1274,1152,9126
7/8/2016,2016,7,8, 9 ,7397,1477,1328,10202
7/8/2016,2016,7,8, 10 ,7897,1592,1430,10919
7/8/2016,2016,7,8, 11 ,8044,1631,1482,11157
7/8/2016,2016,7,8, 12 ,7798,1609,1461,10868
7/8/2016,2016,7,8, 13 ,7678,1592,1463,10733
7/8/2016,2016,7,8, 14 ,7868,1673,1516,11057
7/8/2016,2016,7,8, 15 ,7668,1580,1496,10744
7/8/2016,2016,7,8, 16 ,7578,1560,1445,10583
7/8/2016,2016,7,8, 17 ,7343,1493,1390,10226
7/8/2016,2016,7,8, 18 ,7224,1544,1400,10168
7/8/2016,2016,7,8, 19 ,7491,1672,1514,10677
7/8/2016,2016,7,8, 20 ,7443,1621,1465,10529
7/8/2016,2016,7,8, 21 ,7235,1562,1398,10195
7/8/2016,2016,7,8, 22 ,6922,1435,1321,9678
7/8/2016,2016,7,8, 23 ,6453,1330,1212,8995
7/8/2016,2016,7,8, 24 ,6112,1249,1111,8472
7/9/2016,2016,7,9, 1 ,5917,1189,1070,8176
7/9/2016,2016,7,9, 2 ,5672,1142,1033,7847
7/9/2016,2016,7,9, 3 ,5522,1114,1003,7639
7/9/2016,2016,7,9, 4 ,5449,1097,986,7532
7/9/2016,2016,7,9, 5 ,5449,1086,990,7525
7/9/2016,2016,7,9, 6 ,5337,1081,980,7398
7/9/2016,2016,7,9, 7 ,5516,1099,980,7595
7/9/2016,2016,7,9, 8 ,5932,1186,1076,8194
7/9/2016,2016,7,9, 9 ,6460,1329,1216,9005
7/9/2016,2016,7,9, 10 ,6868,1434,1337,9639
7/9/2016,2016,7,9, 11 ,7238,1473,1402,10113
7/9/2016,2016,7,9, 12 ,7148,1441,1370,9959
7/9/2016,2016,7,9, 13 ,7074,1434,1379,9887
7/9/2016,2016,7,9, 14 ,7187,1456,1414,10057
7/9/2016,2016,7,9, 15 ,7061,1440,1388,9889
7/9/2016,2016,7,9, 16 ,6848,1415,1345,9608
7/9/2016,2016,7,9, 17 ,6707,1380,1307,9394
7/9/2016,2016,7,9, 18 ,6708,1421,1373,9502
7/9/2016,2016,7,9, 19 ,7056,1602,1442,10100
7/9/2016,2016,7,9, 20 ,7003,1564,1389,9956
7/9/2016,2016,7,9, 21 ,6857,1505,1320,9682
7/9/2016,2016,7,9, 22 ,6543,1408,1182,9133
7/9/2016,2016,7,9, 23 ,6152,1303,1115,8570
7/9/2016,2016,7,9, 24 ,5699,1219,1047,7965
7/10/2016,2016,7,10, 1 ,5529,1173,992,7694
7/10/2016,2016,7,10, 2 ,5404,1135,980,7519
7/10/2016,2016,7,10, 3 ,5251,1112,947,7310
7/10/2016,2016,7,10, 4 ,5149,1090,932,7171
7/10/2016,2016,7,10, 5 ,5129,1086,935,7150
7/10/2016,2016,7,10, 6 ,5010,1064,923,6997
7/10/2016,2016,7,10, 7 ,5096,1090,929,7115
7/10/2016,2016,7,10, 8 ,5422,1154,972,7548
7/10/2016,2016,7,10, 9 ,5779,1237,1033,8049
7/10/2016,2016,7,10, 10 ,6286,1337,1150,8773
7/10/2016,2016,7,10, 11 ,6562,1381,1210,9153
7/10/2016,2016,7,10, 12 ,6535,1378,1224,9137
7/10/2016,2016,7,10, 13 ,6477,1397,1219,9093
7/10/2016,2016,7,10, 14 ,6486,1397,1239,9122
7/10/2016,2016,7,10, 15 ,6387,1406,1209,9002
7/10/2016,2016,7,10, 16 ,6247,1382,1202,8831
7/10/2016,2016,7,10, 17 ,6187,1345,1167,8699
7/10/2016,2016,7,10, 18 ,6369,1405,1256,9030
7/10/2016,2016,7,10, 19 ,6908,1602,1372,9882
7/10/2016,2016,7,10, 20 ,6988,1590,1314,9892
7/10/2016,2016,7,10, 21 ,6774,1535,1268,9577
7/10/2016,2016,7,10, 22 ,6336,1417,1184,8937
7/10/2016,2016,7,10, 23 ,5981,1315,1114,8410
7/10/2016,2016,7,10, 24 ,5586,1225,999,7810
7/11/2016,2016,7,11, 1 ,5401,1175,980,7556
7/11/2016,2016,7,11, 2 ,5247,1132,947,7326
7/11/2016,2016,7,11, 3 ,5134,1103,922,7159
7/11/2016,2016,7,11, 4 ,5094,1090,924,7108
7/11/2016,2016,7,11, 5 ,5303,1133,986,7422
7/11/2016,2016,7,11, 6 ,5445,1140,999,7584
7/11/2016,2016,7,11, 7 ,5723,1122,938,7783
7/11/2016,2016,7,11, 8 ,6543,1311,1106,8960
7/11/2016,2016,7,11, 9 ,7477,1547,1235,10259
7/11/2016,2016,7,11, 10 ,7984,1643,1426,11053
7/11/2016,2016,7,11, 11 ,8343,1705,1494,11542
7/11/2016,2016,7,11, 12 ,8084,1665,1457,11206
7/11/2016,2016,7,11, 13 ,7868,1664,1477,11009
7/11/2016,2016,7,11, 14 ,8055,1747,1492,11294
7/11/2016,2016,7,11, 15 ,7960,1733,1494,11187
7/11/2016,2016,7,11, 16 ,7828,1700,1442,10970
7/11/2016,2016,7,11, 17 ,7630,1614,1392,10636
7/11/2016,2016,7,11, 18 ,7454,1603,1369,10426
7/11/2016,2016,7,11, 19 ,7692,1710,1426,10828
7/11/2016,2016,7,11, 20 ,7643,1705,1366,10714
7/11/2016,2016,7,11, 21 ,7426,1641,1321,10388
7/11/2016,2016,7,11, 22 ,7034,1500,1154,9688
7/11/2016,2016,7,11, 23 ,6615,1384,1072,9071
7/11/2016,2016,7,11, 24 ,6188,1295,998,8481
7/12/2016,2016,7,12, 1 ,5886,1239,992,8117
7/12/2016,2016,7,12, 2 ,5783,1201,959,7943
7/12/2016,2016,7,12, 3 ,5632,1173,916,7721
7/12/2016,2016,7,12, 4 ,5545,1156,927,7628
7/12/2016,2016,7,12, 5 ,5703,1196,987,7886
7/12/2016,2016,7,12, 6 ,5753,1190,1012,7955
7/12/2016,2016,7,12, 7 ,5948,1158,934,8040
7/12/2016,2016,7,12, 8 ,6812,1342,1088,9242
7/12/2016,2016,7,12, 9 ,7713,1570,1255,10538
7/12/2016,2016,7,12, 10 ,8203,1673,1368,11244
7/12/2016,2016,7,12, 11 ,8507,1701,1391,11599
7/12/2016,2016,7,12, 12 ,8350,1650,1362,11362
7/12/2016,2016,7,12, 13 ,8392,1645,1360,11397
7/12/2016,2016,7,12, 14 ,8450,1716,1388,11554
7/12/2016,2016,7,12, 15 ,8468,1701,1386,11555
7/12/2016,2016,7,12, 16 ,8336,1659,1371,11366
7/12/2016,2016,7,12, 17 ,8009,1613,1336,10958
7/12/2016,2016,7,12, 18 ,7806,1614,1320,10740
7/12/2016,2016,7,12, 19 ,8091,1730,1419,11240
7/12/2016,2016,7,12, 20 ,7996,1690,1345,11031
7/12/2016,2016,7,12, 21 ,7820,1590,1276,10686
7/12/2016,2016,7,12, 22 ,7454,1474,1156,10084
7/12/2016,2016,7,12, 23 ,6989,1347,1067,9403
7/12/2016,2016,7,12, 24 ,6643,1268,1050,8961
7/13/2016,2016,7,13, 1 ,6327,1209,959,8495
7/13/2016,2016,7,13, 2 ,6108,1177,929,8214
7/13/2016,2016,7,13, 3 ,5935,1151,909,7995
7/13/2016,2016,7,13, 4 ,5823,1133,895,7851
7/13/2016,2016,7,13, 5 ,5964,1154,948,8066
7/13/2016,2016,7,13, 6 ,5918,1174,977,8069
7/13/2016,2016,7,13, 7 ,6137,1148,928,8213
7/13/2016,2016,7,13, 8 ,7045,1312,1116,9473
7/13/2016,2016,7,13, 9 ,7925,1486,1198,10609
7/13/2016,2016,7,13, 10 ,8425,1574,1394,11393
7/13/2016,2016,7,13, 11 ,8768,1627,1464,11859
7/13/2016,2016,7,13, 12 ,8587,1587,1383,11557
7/13/2016,2016,7,13, 13 ,8635,1592,1406,11633
7/13/2016,2016,7,13, 14 ,8935,1655,1451,12041
7/13/2016,2016,7,13, 15 ,8805,1647,1437,11889
7/13/2016,2016,7,13, 16 ,8537,1595,1427,11559
7/13/2016,2016,7,13, 17 ,8241,1571,1384,11196
7/13/2016,2016,7,13, 18 ,7935,1565,1390,10890
7/13/2016,2016,7,13, 19 ,8267,1693,1457,11417
7/13/2016,2016,7,13, 20 ,8277,1657,1313,11247
7/13/2016,2016,7,13, 21 ,8084,1579,1262,10925
7/13/2016,2016,7,13, 22 ,7788,1419,1149,10356
7/13/2016,2016,7,13, 23 ,7300,1309,1073,9682
7/13/2016,2016,7,13, 24 ,6921,1239,1035,9195
7/14/2016,2016,7,14, 1 ,6555,1193,995,8743
7/14/2016,2016,7,14, 2 ,6351,1159,965,8475
7/14/2016,2016,7,14, 3 ,6224,1129,918,8271
7/14/2016,2016,7,14, 4 ,6096,1113,948,8157
7/14/2016,2016,7,14, 5 ,6255,1158,1013,8426
7/14/2016,2016,7,14, 6 ,6155,1172,1006,8333
7/14/2016,2016,7,14, 7 ,6312,1139,954,8405
7/14/2016,2016,7,14, 8 ,7206,1299,1099,9604
7/14/2016,2016,7,14, 9 ,8008,1535,1288,10831
7/14/2016,2016,7,14, 10 ,8552,1625,1365,11542
7/14/2016,2016,7,14, 11 ,8819,1677,1401,11897
7/14/2016,2016,7,14, 12 ,8720,1653,1390,11763
7/14/2016,2016,7,14, 13 ,8734,1660,1392,11786
7/14/2016,2016,7,14, 14 ,8947,1737,1480,12164
7/14/2016,2016,7,14, 15 ,8777,1697,1473,11947
7/14/2016,2016,7,14, 16 ,8561,1655,1383,11599
7/14/2016,2016,7,14, 17 ,8181,1586,1329,11096
7/14/2016,2016,7,14, 18 ,7928,1588,1339,10855
7/14/2016,2016,7,14, 19 ,8204,1744,1457,11405
7/14/2016,2016,7,14, 20 ,8221,1680,1414,11315
7/14/2016,2016,7,14, 21 ,8122,1603,1354,11079
7/14/2016,2016,7,14, 22 ,7797,1471,1240,10508
7/14/2016,2016,7,14, 23 ,7410,1352,1161,9923
7/14/2016,2016,7,14, 24 ,7024,1283,973,9280
7/15/2016,2016,7,15, 1 ,6691,1223,1052,8966
7/15/2016,2016,7,15, 2 ,6498,1183,997,8678
7/15/2016,2016,7,15, 3 ,6319,1162,978,8459
7/15/2016,2016,7,15, 4 ,6216,1139,962,8317
7/15/2016,2016,7,15, 5 ,6248,1176,988,8412
7/15/2016,2016,7,15, 6 ,6150,1174,1005,8329
7/15/2016,2016,7,15, 7 ,6392,1165,928,8485
7/15/2016,2016,7,15, 8 ,7388,1348,1128,9864
7/15/2016,2016,7,15, 9 ,8180,1566,1283,11029
7/15/2016,2016,7,15, 10 ,8619,1658,1406,11683
7/15/2016,2016,7,15, 11 ,8882,1712,1468,12062
7/15/2016,2016,7,15, 12 ,8769,1685,1458,11912
7/15/2016,2016,7,15, 13 ,8851,1683,1486,12020
7/15/2016,2016,7,15, 14 ,9118,1741,1529,12388
7/15/2016,2016,7,15, 15 ,9108,1746,1501,12355
7/15/2016,2016,7,15, 16 ,8968,1709,1455,12132
7/15/2016,2016,7,15, 17 ,8576,1639,1357,11572
7/15/2016,2016,7,15, 18 ,8185,1617,1347,11149
7/15/2016,2016,7,15, 19 ,8505,1756,1447,11708
7/15/2016,2016,7,15, 20 ,8430,1719,1397,11546
7/15/2016,2016,7,15, 21 ,8319,1653,1332,11304
7/15/2016,2016,7,15, 22 ,8154,1511,1207,10872
7/15/2016,2016,7,15, 23 ,7790,1427,1122,10339
7/15/2016,2016,7,15, 24 ,7404,1334,1042,9780
7/16/2016,2016,7,16, 1 ,7035,1276,1012,9323
7/16/2016,2016,7,16, 2 ,6815,1242,981,9038
7/16/2016,2016,7,16, 3 ,6569,1217,941,8727
7/16/2016,2016,7,16, 4 ,6425,1191,945,8561
7/16/2016,2016,7,16, 5 ,6240,1190,962,8392
7/16/2016,2016,7,16, 6 ,6040,1159,957,8156
7/16/2016,2016,7,16, 7 ,6232,1177,948,8357
7/16/2016,2016,7,16, 8 ,6834,1287,1062,9183
7/16/2016,2016,7,16, 9 ,7493,1419,1206,10118
7/16/2016,2016,7,16, 10 ,8031,1483,1317,10831
7/16/2016,2016,7,16, 11 ,8310,1541,1371,11222
7/16/2016,2016,7,16, 12 ,8230,1527,1366,11123
7/16/2016,2016,7,16, 13 ,8246,1540,1359,11145
7/16/2016,2016,7,16, 14 ,8521,1611,1424,11556
7/16/2016,2016,7,16, 15 ,8360,1560,1380,11300
7/16/2016,2016,7,16, 16 ,8088,1521,1305,10914
7/16/2016,2016,7,16, 17 ,7697,1475,1263,10435
7/16/2016,2016,7,16, 18 ,7511,1509,1361,10381
7/16/2016,2016,7,16, 19 ,7936,1695,1480,11111
7/16/2016,2016,7,16, 20 ,7982,1670,1418,11070
7/16/2016,2016,7,16, 21 ,7973,1622,1369,10964
7/16/2016,2016,7,16, 22 ,7704,1527,1254,10485
7/16/2016,2016,7,16, 23 ,7410,1410,1180,10000
7/16/2016,2016,7,16, 24 ,7015,1300,1086,9401
7/17/2016,2016,7,17, 1 ,6684,1250,988,8922
7/17/2016,2016,7,17, 2 ,6489,1214,962,8665
7/17/2016,2016,7,17, 3 ,6206,1180,932,8318
7/17/2016,2016,7,17, 4 ,6059,1158,913,8130
7/17/2016,2016,7,17, 5 ,5949,1150,918,8017
7/17/2016,2016,7,17, 6 ,5694,1106,904,7704
7/17/2016,2016,7,17, 7 ,5734,1119,905,7758
7/17/2016,2016,7,17, 8 ,6072,1190,991,8253
7/17/2016,2016,7,17, 9 ,6461,1264,1080,8805
7/17/2016,2016,7,17, 10 ,6968,1344,1167,9479
7/17/2016,2016,7,17, 11 ,7240,1389,1210,9839
7/17/2016,2016,7,17, 12 ,7297,1400,1226,9923
7/17/2016,2016,7,17, 13 ,7326,1416,1247,9989
7/17/2016,2016,7,17, 14 ,7400,1445,1271,10116
7/17/2016,2016,7,17, 15 ,7356,1436,1250,10042
7/17/2016,2016,7,17, 16 ,7110,1409,1216,9735
7/17/2016,2016,7,17, 17 ,6911,1379,1201,9491
7/17/2016,2016,7,17, 18 ,6941,1460,1254,9655
7/17/2016,2016,7,17, 19 ,7574,1677,1398,10649
7/17/2016,2016,7,17, 20 ,7756,1646,1380,10782
7/17/2016,2016,7,17, 21 ,7789,1592,1321,10702
7/17/2016,2016,7,17, 22 ,7558,1477,1220,10255
7/17/2016,2016,7,17, 23 ,7275,1369,1142,9786
7/17/2016,2016,7,17, 24 ,6899,1285,1062,9246
7/18/2016,2016,7,18, 1 ,6540,1225,1007,8772
7/18/2016,2016,7,18, 2 ,6259,1173,962,8394
7/18/2016,2016,7,18, 3 ,6050,1136,937,8123
7/18/2016,2016,7,18, 4 ,5976,1115,943,8034
7/18/2016,2016,7,18, 5 ,6057,1157,974,8188
7/18/2016,2016,7,18, 6 ,6009,1177,940,8126
7/18/2016,2016,7,18, 7 ,6239,1159,887,8285
7/18/2016,2016,7,18, 8 ,7276,1347,1121,9744
7/18/2016,2016,7,18, 9 ,8148,1537,1306,10991
7/18/2016,2016,7,18, 10 ,8693,1659,1436,11788
7/18/2016,2016,7,18, 11 ,8968,1736,1503,12207
7/18/2016,2016,7,18, 12 ,8836,1661,1486,11983
7/18/2016,2016,7,18, 13 ,8861,1687,1480,12028
7/18/2016,2016,7,18, 14 ,9230,1764,1533,12527
7/18/2016,2016,7,18, 15 ,9231,1777,1516,12524
7/18/2016,2016,7,18, 16 ,9055,1696,1459,12210
7/18/2016,2016,7,18, 17 ,8578,1656,1389,11623
7/18/2016,2016,7,18, 18 ,8232,1635,1445,11312
7/18/2016,2016,7,18, 19 ,8614,1794,1489,11897
7/18/2016,2016,7,18, 20 ,8561,1754,1399,11714
7/18/2016,2016,7,18, 21 ,8441,1662,1347,11450
7/18/2016,2016,7,18, 22 ,8181,1554,1235,10970
7/18/2016,2016,7,18, 23 ,7780,1440,1145,10365
7/18/2016,2016,7,18, 24 ,7340,1343,1073,9756
7/19/2016,2016,7,19, 1 ,7077,1289,1028,9394
7/19/2016,2016,7,19, 2 ,6820,1250,999,9069
7/19/2016,2016,7,19, 3 ,6591,1222,974,8787
7/19/2016,2016,7,19, 4 ,6486,1201,966,8653
7/19/2016,2016,7,19, 5 ,6540,1228,997,8765
7/19/2016,2016,7,19, 6 ,6384,1212,1021,8617
7/19/2016,2016,7,19, 7 ,6614,1173,955,8742
7/19/2016,2016,7,19, 8 ,7485,1384,1100,9969
7/19/2016,2016,7,19, 9 ,8338,1590,1257,11185
7/19/2016,2016,7,19, 10 ,8788,1678,1388,11854
7/19/2016,2016,7,19, 11 ,9008,1752,1420,12180
7/19/2016,2016,7,19, 12 ,8875,1677,1397,11949
7/19/2016,2016,7,19, 13 ,8854,1644,1353,11851
7/19/2016,2016,7,19, 14 ,9169,1621,1420,12210
7/19/2016,2016,7,19, 15 ,9041,1587,1356,11984
7/19/2016,2016,7,19, 16 ,8860,1545,1277,11682
7/19/2016,2016,7,19, 17 ,8488,1470,1291,11249
7/19/2016,2016,7,19, 18 ,8186,1532,1356,11074
7/19/2016,2016,7,19, 19 ,8425,1614,1391,11430
7/19/2016,2016,7,19, 20 ,8378,1567,1324,11269
7/19/2016,2016,7,19, 21 ,8303,1507,1240,11050
7/19/2016,2016,7,19, 22 ,8000,1391,1113,10504
7/19/2016,2016,7,19, 23 ,7621,1288,1074,9983
7/19/2016,2016,7,19, 24 ,7209,1216,994,9419
7/20/2016,2016,7,20, 1 ,6847,1169,973,8989
7/20/2016,2016,7,20, 2 ,6655,1113,927,8695
7/20/2016,2016,7,20, 3 ,6448,1094,918,8460
7/20/2016,2016,7,20, 4 ,6324,1096,903,8323
7/20/2016,2016,7,20, 5 ,6368,1131,955,8454
7/20/2016,2016,7,20, 6 ,6295,1159,997,8451
7/20/2016,2016,7,20, 7 ,6436,1112,920,8468
7/20/2016,2016,7,20, 8 ,7269,1290,1040,9599
7/20/2016,2016,7,20, 9 ,8047,1512,1186,10745
7/20/2016,2016,7,20, 10 ,8635,1612,1356,11603
7/20/2016,2016,7,20, 11 ,8875,1637,1387,11899
7/20/2016,2016,7,20, 12 ,8800,1628,1379,11807
7/20/2016,2016,7,20, 13 ,8771,1637,1399,11807
7/20/2016,2016,7,20, 14 ,8989,1746,1433,12168
7/20/2016,2016,7,20, 15 ,8810,1715,1454,11979
7/20/2016,2016,7,20, 16 ,8689,1674,1402,11765
7/20/2016,2016,7,20, 17 ,8324,1588,1384,11296
7/20/2016,2016,7,20, 18 ,8094,1587,1386,11067
7/20/2016,2016,7,20, 19 ,8472,1741,1505,11718
7/20/2016,2016,7,20, 20 ,8453,1704,1424,11581
7/20/2016,2016,7,20, 21 ,8370,1643,1391,11404
7/20/2016,2016,7,20, 22 ,8005,1502,1274,10781
7/20/2016,2016,7,20, 23 ,7603,1386,1176,10165
7/20/2016,2016,7,20, 24 ,7261,1300,1073,9634
7/21/2016,2016,7,21, 1 ,6795,1244,1035,9074
7/21/2016,2016,7,21, 2 ,6627,1210,999,8836
7/21/2016,2016,7,21, 3 ,6385,1179,993,8557
7/21/2016,2016,7,21, 4 ,6296,1164,956,8416
7/21/2016,2016,7,21, 5 ,6340,1202,1009,8551
7/21/2016,2016,7,21, 6 ,6292,1204,1025,8521
7/21/2016,2016,7,21, 7 ,6429,1174,955,8558
7/21/2016,2016,7,21, 8 ,7335,1378,1121,9834
7/21/2016,2016,7,21, 9 ,8221,1600,1305,11126
7/21/2016,2016,7,21, 10 ,8758,1706,1396,11860
7/21/2016,2016,7,21, 11 ,9065,1767,1434,12266
7/21/2016,2016,7,21, 12 ,8971,1741,1426,12138
7/21/2016,2016,7,21, 13 ,8991,1746,1434,12171
7/21/2016,2016,7,21, 14 ,9318,1819,1516,12653
7/21/2016,2016,7,21, 15 ,9173,1800,1513,12486
7/21/2016,2016,7,21, 16 ,9010,1782,1427,12219
7/21/2016,2016,7,21, 17 ,8591,1653,1360,11604
7/21/2016,2016,7,21, 18 ,8317,1645,1382,11344
7/21/2016,2016,7,21, 19 ,8392,1812,1484,11688
7/21/2016,2016,7,21, 20 ,8300,1772,1461,11533
7/21/2016,2016,7,21, 21 ,8129,1709,1397,11235
7/21/2016,2016,7,21, 22 ,7815,1562,1293,10670
7/21/2016,2016,7,21, 23 ,7437,1448,1179,10064
7/21/2016,2016,7,21, 24 ,7023,1365,1101,9489
7/22/2016,2016,7,22, 1 ,6693,1305,1047,9045
7/22/2016,2016,7,22, 2 ,6503,1255,1038,8796
7/22/2016,2016,7,22, 3 ,6320,1229,989,8538
7/22/2016,2016,7,22, 4 ,6159,1201,987,8347
7/22/2016,2016,7,22, 5 ,6295,1229,1010,8534
7/22/2016,2016,7,22, 6 ,6133,1224,1023,8380
7/22/2016,2016,7,22, 7 ,6393,1190,979,8562
7/22/2016,2016,7,22, 8 ,7253,1362,1147,9762
7/22/2016,2016,7,22, 9 ,8180,1591,1304,11075
7/22/2016,2016,7,22, 10 ,8651,1660,1453,11764
7/22/2016,2016,7,22, 11 ,8984,1722,1513,12219
7/22/2016,2016,7,22, 12 ,8826,1726,1495,12047
7/22/2016,2016,7,22, 13 ,8862,1722,1529,12113
7/22/2016,2016,7,22, 14 ,9136,1741,1536,12413
7/22/2016,2016,7,22, 15 ,8940,1740,1533,12213
7/22/2016,2016,7,22, 16 ,8615,1703,1481,11799
7/22/2016,2016,7,22, 17 ,8232,1597,1405,11234
7/22/2016,2016,7,22, 18 ,7983,1613,1397,10993
7/22/2016,2016,7,22, 19 ,8078,1758,1474,11310
7/22/2016,2016,7,22, 20 ,7867,1722,1443,11032
7/22/2016,2016,7,22, 21 ,7750,1651,1389,10790
7/22/2016,2016,7,22, 22 ,7444,1524,1291,10259
7/22/2016,2016,7,22, 23 ,6985,1417,1200,9602
7/22/2016,2016,7,22, 24 ,6678,1323,1123,9124
7/23/2016,2016,7,23, 1 ,6412,1269,1083,8764
7/23/2016,2016,7,23, 2 ,6223,1238,1054,8515
7/23/2016,2016,7,23, 3 ,6023,1200,1020,8243
7/23/2016,2016,7,23, 4 ,5890,1185,1002,8077
7/23/2016,2016,7,23, 5 ,5839,1186,1018,8043
7/23/2016,2016,7,23, 6 ,5708,1157,994,7859
7/23/2016,2016,7,23, 7 ,5841,1182,992,8015
7/23/2016,2016,7,23, 8 ,6478,1314,1087,8879
7/23/2016,2016,7,23, 9 ,7123,1488,1168,9779
7/23/2016,2016,7,23, 10 ,7738,1577,1319,10634
7/23/2016,2016,7,23, 11 ,8066,1637,1356,11059
7/23/2016,2016,7,23, 12 ,7999,1627,1368,10994
7/23/2016,2016,7,23, 13 ,8003,1622,1390,11015
7/23/2016,2016,7,23, 14 ,8222,1659,1424,11305
7/23/2016,2016,7,23, 15 ,8014,1592,1413,11019
7/23/2016,2016,7,23, 16 ,7652,1550,1375,10577
7/23/2016,2016,7,23, 17 ,7355,1498,1286,10139
7/23/2016,2016,7,23, 18 ,7293,1554,1320,10167
7/23/2016,2016,7,23, 19 ,7708,1692,1461,10861
7/23/2016,2016,7,23, 20 ,7614,1652,1412,10678
7/23/2016,2016,7,23, 21 ,7452,1604,1379,10435
7/23/2016,2016,7,23, 22 ,7232,1508,1280,10020
7/23/2016,2016,7,23, 23 ,6855,1405,1186,9446
7/23/2016,2016,7,23, 24 ,6523,1316,1107,8946
7/24/2016,2016,7,24, 1 ,6262,1260,1062,8584
7/24/2016,2016,7,24, 2 ,6058,1220,1020,8298
7/24/2016,2016,7,24, 3 ,5930,1183,988,8101
7/24/2016,2016,7,24, 4 ,5765,1151,958,7874
7/24/2016,2016,7,24, 5 ,5613,1143,964,7720
7/24/2016,2016,7,24, 6 ,5436,1107,934,7477
7/24/2016,2016,7,24, 7 ,5484,1113,921,7518
7/24/2016,2016,7,24, 8 ,5828,1186,983,7997
7/24/2016,2016,7,24, 9 ,6275,1290,1065,8630
7/24/2016,2016,7,24, 10 ,6791,1385,1164,9340
7/24/2016,2016,7,24, 11 ,7097,1460,1216,9773
7/24/2016,2016,7,24, 12 ,7075,1451,1254,9780
7/24/2016,2016,7,24, 13 ,7123,1462,1254,9839
7/24/2016,2016,7,24, 14 ,7140,1480,1286,9906
7/24/2016,2016,7,24, 15 ,6957,1455,1251,9663
7/24/2016,2016,7,24, 16 ,6773,1436,1196,9405
7/24/2016,2016,7,24, 17 ,6730,1389,1212,9331
7/24/2016,2016,7,24, 18 ,6888,1466,1281,9635
7/24/2016,2016,7,24, 19 ,7272,1629,1423,10324
7/24/2016,2016,7,24, 20 ,7322,1620,1375,10317
7/24/2016,2016,7,24, 21 ,7225,1563,1359,10147
7/24/2016,2016,7,24, 22 ,6956,1465,1330,9751
7/24/2016,2016,7,24, 23 ,6602,1358,1236,9196
7/24/2016,2016,7,24, 24 ,6304,1271,1115,8690
7/25/2016,2016,7,25, 1 ,5964,1216,1038,8218
7/25/2016,2016,7,25, 2 ,5696,1169,996,7861
7/25/2016,2016,7,25, 3 ,5550,1148,982,7680
7/25/2016,2016,7,25, 4 ,5489,1129,960,7578
7/25/2016,2016,7,25, 5 ,5712,1163,989,7864
7/25/2016,2016,7,25, 6 ,5759,1169,1026,7954
7/25/2016,2016,7,25, 7 ,6009,1144,954,8107
7/25/2016,2016,7,25, 8 ,6926,1328,1118,9372
7/25/2016,2016,7,25, 9 ,7812,1561,1303,10676
7/25/2016,2016,7,25, 10 ,8385,1665,1454,11504
7/25/2016,2016,7,25, 11 ,8773,1753,1521,12047
7/25/2016,2016,7,25, 12 ,8644,1734,1501,11879
7/25/2016,2016,7,25, 13 ,8747,1735,1484,11966
7/25/2016,2016,7,25, 14 ,9051,1808,1501,12360
7/25/2016,2016,7,25, 15 ,9022,1768,1464,12254
7/25/2016,2016,7,25, 16 ,8946,1757,1457,12160
7/25/2016,2016,7,25, 17 ,8619,1681,1425,11725
7/25/2016,2016,7,25, 18 ,8153,1651,1442,11246
7/25/2016,2016,7,25, 19 ,8450,1796,1501,11747
7/25/2016,2016,7,25, 20 ,8379,1758,1439,11576
7/25/2016,2016,7,25, 21 ,8329,1687,1373,11389
7/25/2016,2016,7,25, 22 ,8002,1548,1258,10808
7/25/2016,2016,7,25, 23 ,7548,1427,1134,10109
7/25/2016,2016,7,25, 24 ,7150,1344,1101,9595
7/26/2016,2016,7,26, 1 ,6806,1286,1032,9124
7/26/2016,2016,7,26, 2 ,6555,1251,1007,8813
7/26/2016,2016,7,26, 3 ,6380,1213,983,8576
7/26/2016,2016,7,26, 4 ,6210,1184,973,8367
7/26/2016,2016,7,26, 5 ,6326,1221,1035,8582
7/26/2016,2016,7,26, 6 ,6253,1224,1044,8521
7/26/2016,2016,7,26, 7 ,6354,1194,987,8535
7/26/2016,2016,7,26, 8 ,7303,1391,1190,9884
7/26/2016,2016,7,26, 9 ,8171,1601,1305,11077
7/26/2016,2016,7,26, 10 ,8769,1709,1419,11897
7/26/2016,2016,7,26, 11 ,8993,1770,1478,12241
7/26/2016,2016,7,26, 12 ,8857,1732,1468,12057
7/26/2016,2016,7,26, 13 ,8915,1734,1484,12133
7/26/2016,2016,7,26, 14 ,9295,1785,1523,12603
7/26/2016,2016,7,26, 15 ,9203,1767,1519,12489
7/26/2016,2016,7,26, 16 ,8950,1718,1463,12131
7/26/2016,2016,7,26, 17 ,8374,1631,1398,11403
7/26/2016,2016,7,26, 18 ,8058,1614,1421,11093
7/26/2016,2016,7,26, 19 ,8381,1774,1473,11628
7/26/2016,2016,7,26, 20 ,8360,1723,1386,11469
7/26/2016,2016,7,26, 21 ,8340,1667,1349,11356
7/26/2016,2016,7,26, 22 ,7967,1537,1228,10732
7/26/2016,2016,7,26, 23 ,7580,1405,1147,10132
7/26/2016,2016,7,26, 24 ,7162,1320,1091,9573
7/27/2016,2016,7,27, 1 ,6849,1278,1030,9157
7/27/2016,2016,7,27, 2 ,6678,1233,996,8907
7/27/2016,2016,7,27, 3 ,6470,1200,971,8641
7/27/2016,2016,7,27, 4 ,6351,1180,958,8489
7/27/2016,2016,7,27, 5 ,6460,1223,1007,8690
7/27/2016,2016,7,27, 6 ,6321,1227,1018,8566
7/27/2016,2016,7,27, 7 ,6516,1202,955,8673
7/27/2016,2016,7,27, 8 ,7280,1393,1100,9773
7/27/2016,2016,7,27, 9 ,8160,1620,1281,11061
7/27/2016,2016,7,27, 10 ,8613,1720,1407,11740
7/27/2016,2016,7,27, 11 ,8928,1773,1466,12167
7/27/2016,2016,7,27, 12 ,8903,1735,1439,12077
7/27/2016,2016,7,27, 13 ,8993,1730,1448,12171
7/27/2016,2016,7,27, 14 ,9328,1826,1521,12675
7/27/2016,2016,7,27, 15 ,9240,1809,1511,12560
7/27/2016,2016,7,27, 16 ,9047,1709,1474,12230
7/27/2016,2016,7,27, 17 ,8557,1619,1423,11599
7/27/2016,2016,7,27, 18 ,8172,1628,1436,11236
7/27/2016,2016,7,27, 19 ,8463,1780,1504,11747
7/27/2016,2016,7,27, 20 ,8465,1741,1442,11648
7/27/2016,2016,7,27, 21 ,8394,1645,1372,11411
7/27/2016,2016,7,27, 22 ,8036,1527,1235,10798
7/27/2016,2016,7,27, 23 ,7628,1421,1161,10210
7/27/2016,2016,7,27, 24 ,7241,1335,1081,9657
7/28/2016,2016,7,28, 1 ,6931,1285,1021,9237
7/28/2016,2016,7,28, 2 ,6687,1185,1000,8872
7/28/2016,2016,7,28, 3 ,6478,1162,964,8604
7/28/2016,2016,7,28, 4 ,6399,1156,954,8509
7/28/2016,2016,7,28, 5 ,6485,1184,1017,8686
7/28/2016,2016,7,28, 6 ,6355,1191,1059,8605
7/28/2016,2016,7,28, 7 ,6494,1169,994,8657
7/28/2016,2016,7,28, 8 ,7364,1327,1118,9809
7/28/2016,2016,7,28, 9 ,8179,1519,1271,10969
7/28/2016,2016,7,28, 10 ,8626,1616,1373,11615
7/28/2016,2016,7,28, 11 ,8896,1686,1390,11972
7/28/2016,2016,7,28, 12 ,8757,1648,1355,11760
7/28/2016,2016,7,28, 13 ,8789,1661,1376,11826
7/28/2016,2016,7,28, 14 ,9087,1741,1430,12258
7/28/2016,2016,7,28, 15 ,9000,1720,1428,12148
7/28/2016,2016,7,28, 16 ,8798,1673,1389,11860
7/28/2016,2016,7,28, 17 ,8388,1607,1357,11352
7/28/2016,2016,7,28, 18 ,8126,1581,1414,11121
7/28/2016,2016,7,28, 19 ,8499,1730,1437,11666
7/28/2016,2016,7,28, 20 ,8555,1704,1365,11624
7/28/2016,2016,7,28, 21 ,8412,1629,1304,11345
7/28/2016,2016,7,28, 22 ,8165,1487,1190,10842
7/28/2016,2016,7,28, 23 ,7777,1373,1093,10243
7/28/2016,2016,7,28, 24 ,7350,1300,1027,9677
7/29/2016,2016,7,29, 1 ,6974,1244,978,9196
7/29/2016,2016,7,29, 2 ,6806,1211,962,8979
7/29/2016,2016,7,29, 3 ,6527,1180,926,8633
7/29/2016,2016,7,29, 4 ,6403,1146,941,8490
7/29/2016,2016,7,29, 5 ,6481,1165,975,8621
7/29/2016,2016,7,29, 6 ,6348,1205,1032,8585
7/29/2016,2016,7,29, 7 ,6516,1177,986,8679
7/29/2016,2016,7,29, 8 ,7373,1277,1090,9740
7/29/2016,2016,7,29, 9 ,8094,1442,1234,10770
7/29/2016,2016,7,29, 10 ,8617,1518,1308,11443
7/29/2016,2016,7,29, 11 ,8902,1536,1367,11805
7/29/2016,2016,7,29, 12 ,8829,1505,1348,11682
7/29/2016,2016,7,29, 13 ,8729,1495,1354,11578
7/29/2016,2016,7,29, 14 ,8921,1558,1396,11875
7/29/2016,2016,7,29, 15 ,8686,1520,1372,11578
7/29/2016,2016,7,29, 16 ,8361,1540,1328,11229
7/29/2016,2016,7,29, 17 ,8159,1487,1321,10967
7/29/2016,2016,7,29, 18 ,7955,1538,1333,10826
7/29/2016,2016,7,29, 19 ,8211,1595,1389,11195
7/29/2016,2016,7,29, 20 ,8150,1526,1323,10999
7/29/2016,2016,7,29, 21 ,8135,1455,1270,10860
7/29/2016,2016,7,29, 22 ,7806,1333,1163,10302
7/29/2016,2016,7,29, 23 ,7410,1247,1091,9748
7/29/2016,2016,7,29, 24 ,7067,1186,978,9231
7/30/2016,2016,7,30, 1 ,6778,1144,970,8892
7/30/2016,2016,7,30, 2 ,6521,1102,950,8573
7/30/2016,2016,7,30, 3 ,6358,1076,906,8340
7/30/2016,2016,7,30, 4 ,6246,1073,899,8218
7/30/2016,2016,7,30, 5 ,6182,1080,926,8188
7/30/2016,2016,7,30, 6 ,6017,1094,942,8053
7/30/2016,2016,7,30, 7 ,6073,1103,941,8117
7/30/2016,2016,7,30, 8 ,6536,1195,1024,8755
7/30/2016,2016,7,30, 9 ,7160,1351,1149,9660
7/30/2016,2016,7,30, 10 ,7715,1446,1263,10424
7/30/2016,2016,7,30, 11 ,7949,1506,1293,10748
7/30/2016,2016,7,30, 12 ,7795,1476,1277,10548
7/30/2016,2016,7,30, 13 ,7675,1479,1273,10427
7/30/2016,2016,7,30, 14 ,7828,1537,1308,10673
7/30/2016,2016,7,30, 15 ,7725,1506,1276,10507
7/30/2016,2016,7,30, 16 ,7625,1457,1250,10332
7/30/2016,2016,7,30, 17 ,7471,1411,1246,10128
7/30/2016,2016,7,30, 18 ,7420,1463,1328,10211
7/30/2016,2016,7,30, 19 ,7855,1595,1374,10824
7/30/2016,2016,7,30, 20 ,7835,1545,1326,10706
7/30/2016,2016,7,30, 21 ,7782,1475,1263,10520
7/30/2016,2016,7,30, 22 ,7542,1364,1163,10069
7/30/2016,2016,7,30, 23 ,7244,1264,1064,9572
7/30/2016,2016,7,30, 24 ,6862,1174,982,9018
7/31/2016,2016,7,31, 1 ,6573,1124,939,8636
7/31/2016,2016,7,31, 2 ,6391,1114,912,8417
7/31/2016,2016,7,31, 3 ,6228,1089,889,8206
7/31/2016,2016,7,31, 4 ,6050,1074,875,7999
7/31/2016,2016,7,31, 5 ,5866,1071,894,7831
7/31/2016,2016,7,31, 6 ,5661,1038,894,7593
7/31/2016,2016,7,31, 7 ,5699,1057,896,7652
7/31/2016,2016,7,31, 8 ,5893,1124,946,7963
7/31/2016,2016,7,31, 9 ,6262,1199,1000,8461
7/31/2016,2016,7,31, 10 ,6634,1269,1075,8978
7/31/2016,2016,7,31, 11 ,6882,1301,1157,9340
7/31/2016,2016,7,31, 12 ,6851,1287,1144,9282
7/31/2016,2016,7,31, 13 ,6752,1314,1114,9180
7/31/2016,2016,7,31, 14 ,6702,1306,1126,9134
7/31/2016,2016,7,31, 15 ,6536,1279,1114,8929
7/31/2016,2016,7,31, 16 ,6373,1267,1110,8750
7/31/2016,2016,7,31, 17 ,6409,1264,1128,8801
7/31/2016,2016,7,31, 18 ,6578,1377,1261,9216
7/31/2016,2016,7,31, 19 ,7000,1523,1326,9849
7/31/2016,2016,7,31, 20 ,7037,1490,1283,9810
7/31/2016,2016,7,31, 21 ,6924,1430,1235,9589
7/31/2016,2016,7,31, 22 ,6604,1320,1123,9047
7/31/2016,2016,7,31, 23 ,6322,1230,1067,8619
7/31/2016,2016,7,31, 24 ,5930,1158,988,8076
8/1/2016,2016,8,1, 1 ,5688,1115,920,7723
8/1/2016,2016,8,1, 2 ,5529,1081,898,7508
8/1/2016,2016,8,1, 3 ,5373,1046,878,7297
8/1/2016,2016,8,1, 4 ,5366,1046,871,7283
8/1/2016,2016,8,1, 5 ,5522,1083,932,7537
8/1/2016,2016,8,1, 6 ,5703,1125,973,7801
8/1/2016,2016,8,1, 7 ,5942,1093,910,7945
8/1/2016,2016,8,1, 8 ,6760,1234,1032,9026
8/1/2016,2016,8,1, 9 ,7554,1447,1170,10171
8/1/2016,2016,8,1, 10 ,8111,1576,1329,11016
8/1/2016,2016,8,1, 11 ,8358,1605,1423,11386
8/1/2016,2016,8,1, 12 ,8251,1595,1404,11250
8/1/2016,2016,8,1, 13 ,8267,1595,1406,11268
8/1/2016,2016,8,1, 14 ,8559,1646,1447,11652
8/1/2016,2016,8,1, 15 ,8384,1637,1424,11445
8/1/2016,2016,8,1, 16 ,8233,1620,1399,11252
8/1/2016,2016,8,1, 17 ,8049,1540,1358,10947
8/1/2016,2016,8,1, 18 ,7815,1593,1392,10800
8/1/2016,2016,8,1, 19 ,8030,1691,1448,11169
8/1/2016,2016,8,1, 20 ,7968,1623,1416,11007
8/1/2016,2016,8,1, 21 ,7830,1555,1336,10721
8/1/2016,2016,8,1, 22 ,7422,1424,1230,10076
8/1/2016,2016,8,1, 23 ,7033,1328,1113,9474
8/1/2016,2016,8,1, 24 ,6661,1240,1046,8947
8/2/2016,2016,8,2, 1 ,6391,1193,986,8570
8/2/2016,2016,8,2, 2 ,6241,1163,965,8369
8/2/2016,2016,8,2, 3 ,6031,1123,935,8089
8/2/2016,2016,8,2, 4 ,5936,1112,923,7971
8/2/2016,2016,8,2, 5 ,6102,1151,975,8228
8/2/2016,2016,8,2, 6 ,6128,1175,997,8300
8/2/2016,2016,8,2, 7 ,6239,1146,938,8323
8/2/2016,2016,8,2, 8 ,7128,1312,1099,9539
8/2/2016,2016,8,2, 9 ,7908,1545,1282,10735
8/2/2016,2016,8,2, 10 ,8359,1612,1472,11443
8/2/2016,2016,8,2, 11 ,8625,1680,1538,11843
8/2/2016,2016,8,2, 12 ,8495,1657,1482,11634
8/2/2016,2016,8,2, 13 ,8474,1656,1509,11639
8/2/2016,2016,8,2, 14 ,8645,1731,1582,11958
8/2/2016,2016,8,2, 15 ,8482,1715,1551,11748
8/2/2016,2016,8,2, 16 ,8283,1689,1518,11490
8/2/2016,2016,8,2, 17 ,8007,1598,1434,11039
8/2/2016,2016,8,2, 18 ,7841,1629,1421,10891
8/2/2016,2016,8,2, 19 ,8148,1766,1535,11449
8/2/2016,2016,8,2, 20 ,8028,1709,1503,11240
8/2/2016,2016,8,2, 21 ,7914,1633,1421,10968
8/2/2016,2016,8,2, 22 ,7578,1508,1393,10479
8/2/2016,2016,8,2, 23 ,7103,1383,1247,9733
8/2/2016,2016,8,2, 24 ,6729,1299,1166,9194
8/3/2016,2016,8,3, 1 ,6365,1228,1013,8606
8/3/2016,2016,8,3, 2 ,6187,1192,988,8367
8/3/2016,2016,8,3, 3 ,6054,1151,959,8164
8/3/2016,2016,8,3, 4 ,5990,1133,942,8065
8/3/2016,2016,8,3, 5 ,6080,1156,1001,8237
8/3/2016,2016,8,3, 6 ,6074,1170,1050,8294
8/3/2016,2016,8,3, 7 ,6261,1139,979,8379
8/3/2016,2016,8,3, 8 ,7160,1317,1096,9573
8/3/2016,2016,8,3, 9 ,8001,1528,1246,10775
8/3/2016,2016,8,3, 10 ,8559,1618,1371,11548
8/3/2016,2016,8,3, 11 ,8985,1685,1427,12097
8/3/2016,2016,8,3, 12 ,8578,1635,1400,11613
8/3/2016,2016,8,3, 13 ,8705,1624,1197,11526
8/3/2016,2016,8,3, 14 ,9070,1702,1307,12079
8/3/2016,2016,8,3, 15 ,9019,1677,1445,12141
8/3/2016,2016,8,3, 16 ,8846,1631,1418,11895
8/3/2016,2016,8,3, 17 ,8443,1574,1383,11400
8/3/2016,2016,8,3, 18 ,8190,1584,1430,11204
8/3/2016,2016,8,3, 19 ,8511,1722,1511,11744
8/3/2016,2016,8,3, 20 ,8477,1673,1443,11593
8/3/2016,2016,8,3, 21 ,8410,1592,1387,11389
8/3/2016,2016,8,3, 22 ,7970,1447,1222,10639
8/3/2016,2016,8,3, 23 ,7513,1346,1155,10014
8/3/2016,2016,8,3, 24 ,7112,1257,1063,9432
8/4/2016,2016,8,4, 1 ,6767,1194,1014,8975
8/4/2016,2016,8,4, 2 ,6563,1158,993,8714
8/4/2016,2016,8,4, 3 ,6366,1129,968,8463
8/4/2016,2016,8,4, 4 ,6266,1113,921,8300
8/4/2016,2016,8,4, 5 ,6347,1152,988,8487
8/4/2016,2016,8,4, 6 ,6272,1173,1051,8496
8/4/2016,2016,8,4, 7 ,6452,1139,980,8571
8/4/2016,2016,8,4, 8 ,7355,1308,1143,9806
8/4/2016,2016,8,4, 9 ,8149,1541,1273,10963
8/4/2016,2016,8,4, 10 ,8590,1631,1372,11593
8/4/2016,2016,8,4, 11 ,9028,1734,1425,12187
8/4/2016,2016,8,4, 12 ,8878,1688,1413,11979
8/4/2016,2016,8,4, 13 ,8938,1701,1421,12060
8/4/2016,2016,8,4, 14 ,9108,1727,1467,12302
8/4/2016,2016,8,4, 15 ,9130,1690,1458,12278
8/4/2016,2016,8,4, 16 ,8913,1657,1437,12007
8/4/2016,2016,8,4, 17 ,8571,1598,1392,11561
8/4/2016,2016,8,4, 18 ,8264,1634,1454,11352
8/4/2016,2016,8,4, 19 ,8529,1754,1487,11770
8/4/2016,2016,8,4, 20 ,8536,1691,1412,11639
8/4/2016,2016,8,4, 21 ,8420,1593,1307,11320
8/4/2016,2016,8,4, 22 ,8102,1466,1199,10767
8/4/2016,2016,8,4, 23 ,7630,1373,1060,10063
8/4/2016,2016,8,4, 24 ,7243,1297,995,9535
8/5/2016,2016,8,5, 1 ,6925,1233,969,9127
8/5/2016,2016,8,5, 2 ,6728,1199,973,8900
8/5/2016,2016,8,5, 3 ,6496,1165,952,8613
8/5/2016,2016,8,5, 4 ,6398,1153,954,8505
8/5/2016,2016,8,5, 5 ,6444,1183,998,8625
8/5/2016,2016,8,5, 6 ,6379,1195,1039,8613
8/5/2016,2016,8,5, 7 ,6499,1154,989,8642
8/5/2016,2016,8,5, 8 ,7354,1313,1084,9751
8/5/2016,2016,8,5, 9 ,8205,1533,1253,10991
8/5/2016,2016,8,5, 10 ,8651,1634,1375,11660
8/5/2016,2016,8,5, 11 ,8764,1702,1437,11903
8/5/2016,2016,8,5, 12 ,8512,1641,1409,11562
8/5/2016,2016,8,5, 13 ,8619,1673,1402,11694
8/5/2016,2016,8,5, 14 ,8671,1697,1454,11822
8/5/2016,2016,8,5, 15 ,8639,1628,1436,11703
8/5/2016,2016,8,5, 16 ,8571,1582,1407,11560
8/5/2016,2016,8,5, 17 ,8262,1526,1332,11120
8/5/2016,2016,8,5, 18 ,8109,1568,1360,11037
8/5/2016,2016,8,5, 19 ,8263,1643,1397,11303
8/5/2016,2016,8,5, 20 ,8079,1587,1365,11031
8/5/2016,2016,8,5, 21 ,7938,1525,1313,10776
8/5/2016,2016,8,5, 22 ,7652,1389,1209,10250
8/5/2016,2016,8,5, 23 ,7240,1291,1102,9633
8/5/2016,2016,8,5, 24 ,6867,1230,1021,9118
8/6/2016,2016,8,6, 1 ,6593,1175,973,8741
8/6/2016,2016,8,6, 2 ,6490,1161,935,8586
8/6/2016,2016,8,6, 3 ,6272,1140,919,8331
8/6/2016,2016,8,6, 4 ,6141,1104,911,8156
8/6/2016,2016,8,6, 5 ,6070,1113,929,8112
8/6/2016,2016,8,6, 6 ,5907,1099,949,7955
8/6/2016,2016,8,6, 7 ,6089,1099,935,8123
8/6/2016,2016,8,6, 8 ,6651,1205,985,8841
8/6/2016,2016,8,6, 9 ,7233,1339,1120,9692
8/6/2016,2016,8,6, 10 ,7840,1428,1235,10503
8/6/2016,2016,8,6, 11 ,8154,1489,1332,10975
8/6/2016,2016,8,6, 12 ,8025,1453,1321,10799
8/6/2016,2016,8,6, 13 ,8045,1442,1274,10761
8/6/2016,2016,8,6, 14 ,8207,1472,1324,11003
8/6/2016,2016,8,6, 15 ,8031,1450,1301,10782
8/6/2016,2016,8,6, 16 ,7877,1403,1205,10485
8/6/2016,2016,8,6, 17 ,7503,1380,1213,10096
8/6/2016,2016,8,6, 18 ,7489,1470,1314,10273
8/6/2016,2016,8,6, 19 ,7763,1553,1374,10690
8/6/2016,2016,8,6, 20 ,7742,1517,1345,10604
8/6/2016,2016,8,6, 21 ,7692,1445,1198,10335
8/6/2016,2016,8,6, 22 ,7422,1334,1177,9933
8/6/2016,2016,8,6, 23 ,7107,1234,1091,9432
8/6/2016,2016,8,6, 24 ,6741,1155,1049,8945
8/7/2016,2016,8,7, 1 ,6471,1112,954,8537
8/7/2016,2016,8,7, 2 ,6274,1080,929,8283
8/7/2016,2016,8,7, 3 ,6053,1058,903,8014
8/7/2016,2016,8,7, 4 ,5900,1042,879,7821
8/7/2016,2016,8,7, 5 ,5788,1037,892,7717
8/7/2016,2016,8,7, 6 ,5552,1021,884,7457
8/7/2016,2016,8,7, 7 ,5553,1028,865,7446
8/7/2016,2016,8,7, 8 ,5847,1094,906,7847
8/7/2016,2016,8,7, 9 ,6171,1184,979,8334
8/7/2016,2016,8,7, 10 ,6646,1265,1066,8977
8/7/2016,2016,8,7, 11 ,6934,1306,1137,9377
8/7/2016,2016,8,7, 12 ,6921,1284,1131,9336
8/7/2016,2016,8,7, 13 ,6929,1291,1131,9351
8/7/2016,2016,8,7, 14 ,7023,1286,1131,9440
8/7/2016,2016,8,7, 15 ,6931,1273,1135,9339
8/7/2016,2016,8,7, 16 ,6697,1238,1101,9036
8/7/2016,2016,8,7, 17 ,6624,1226,1108,8958
8/7/2016,2016,8,7, 18 ,6712,1320,1210,9242
8/7/2016,2016,8,7, 19 ,7318,1471,1342,10131
8/7/2016,2016,8,7, 20 ,7416,1435,1335,10186
8/7/2016,2016,8,7, 21 ,7415,1377,1284,10076
8/7/2016,2016,8,7, 22 ,7166,1290,1183,9639
8/7/2016,2016,8,7, 23 ,6784,1211,1074,9069
8/7/2016,2016,8,7, 24 ,6427,1134,1021,8582
8/8/2016,2016,8,8, 1 ,6118,1088,1015,8221
8/8/2016,2016,8,8, 2 ,5873,1069,995,7937
8/8/2016,2016,8,8, 3 ,5697,1042,959,7698
8/8/2016,2016,8,8, 4 ,5637,1041,950,7628
8/8/2016,2016,8,8, 5 ,5820,1082,1014,7916
8/8/2016,2016,8,8, 6 ,5914,1124,1056,8094
8/8/2016,2016,8,8, 7 ,6086,1068,973,8127
8/8/2016,2016,8,8, 8 ,6863,1235,1149,9247
8/8/2016,2016,8,8, 9 ,7643,1464,1299,10406
8/8/2016,2016,8,8, 10 ,8143,1572,1393,11108
8/8/2016,2016,8,8, 11 ,8381,1634,1457,11472
8/8/2016,2016,8,8, 12 ,8217,1594,1390,11201
8/8/2016,2016,8,8, 13 ,8063,1584,1399,11046
8/8/2016,2016,8,8, 14 ,8296,1663,1458,11417
8/8/2016,2016,8,8, 15 ,8130,1653,1446,11229
8/8/2016,2016,8,8, 16 ,8006,1635,1417,11058
8/8/2016,2016,8,8, 17 ,7762,1551,1367,10680
8/8/2016,2016,8,8, 18 ,7661,1593,1398,10652
8/8/2016,2016,8,8, 19 ,8001,1702,1505,11208
8/8/2016,2016,8,8, 20 ,7818,1633,1465,10916
8/8/2016,2016,8,8, 21 ,7635,1564,1382,10581
8/8/2016,2016,8,8, 22 ,7174,1426,1264,9864
8/8/2016,2016,8,8, 23 ,6726,1319,1177,9222
8/8/2016,2016,8,8, 24 ,6377,1227,1078,8682
8/9/2016,2016,8,9, 1 ,6164,1165,1013,8342
8/9/2016,2016,8,9, 2 ,5973,1134,979,8086
8/9/2016,2016,8,9, 3 ,5832,1120,951,7903
8/9/2016,2016,8,9, 4 ,5738,1103,932,7773
8/9/2016,2016,8,9, 5 ,5910,1126,986,8022
8/9/2016,2016,8,9, 6 ,6028,1161,1023,8212
8/9/2016,2016,8,9, 7 ,6207,1137,958,8302
8/9/2016,2016,8,9, 8 ,6914,1276,1108,9298
8/9/2016,2016,8,9, 9 ,7636,1472,1288,10396
8/9/2016,2016,8,9, 10 ,8003,1594,1461,11058
8/9/2016,2016,8,9, 11 ,8163,1649,1498,11310
8/9/2016,2016,8,9, 12 ,7858,1606,1478,10942
8/9/2016,2016,8,9, 13 ,7736,1610,1468,10814
8/9/2016,2016,8,9, 14 ,7968,1649,1534,11151
8/9/2016,2016,8,9, 15 ,7852,1646,1528,11026
8/9/2016,2016,8,9, 16 ,7809,1634,1494,10937
8/9/2016,2016,8,9, 17 ,7621,1584,1405,10610
8/9/2016,2016,8,9, 18 ,7585,1616,1445,10646
8/9/2016,2016,8,9, 19 ,7825,1721,1543,11089
8/9/2016,2016,8,9, 20 ,7513,1656,1492,10661
8/9/2016,2016,8,9, 21 ,7263,1588,1426,10277
8/9/2016,2016,8,9, 22 ,6830,1426,1311,9567
8/9/2016,2016,8,9, 23 ,6442,1336,1193,8971
8/9/2016,2016,8,9, 24 ,6086,1259,1109,8454
8/10/2016,2016,8,10, 1 ,5848,1200,1063,8111
8/10/2016,2016,8,10, 2 ,5699,1170,1025,7894
8/10/2016,2016,8,10, 3 ,5627,1147,995,7769
8/10/2016,2016,8,10, 4 ,5577,1134,980,7691
8/10/2016,2016,8,10, 5 ,5708,1175,1018,7901
8/10/2016,2016,8,10, 6 ,5779,1187,1046,8012
8/10/2016,2016,8,10, 7 ,5960,1159,973,8092
8/10/2016,2016,8,10, 8 ,6676,1310,1129,9115
8/10/2016,2016,8,10, 9 ,7418,1532,1346,10296
8/10/2016,2016,8,10, 10 ,7887,1616,1384,10887
8/10/2016,2016,8,10, 11 ,8067,1665,1488,11220
8/10/2016,2016,8,10, 12 ,7903,1592,1452,10947
8/10/2016,2016,8,10, 13 ,7786,1611,1464,10861
8/10/2016,2016,8,10, 14 ,8016,1704,1531,11251
8/10/2016,2016,8,10, 15 ,7937,1617,1502,11056
8/10/2016,2016,8,10, 16 ,7812,1643,1471,10926
8/10/2016,2016,8,10, 17 ,7647,1572,1418,10637
8/10/2016,2016,8,10, 18 ,7519,1596,1465,10580
8/10/2016,2016,8,10, 19 ,7797,1742,1489,11028
8/10/2016,2016,8,10, 20 ,7684,1661,1480,10825
8/10/2016,2016,8,10, 21 ,7422,1606,1419,10447
8/10/2016,2016,8,10, 22 ,6967,1462,1302,9731
8/10/2016,2016,8,10, 23 ,6617,1369,1206,9192
8/10/2016,2016,8,10, 24 ,6217,1266,1109,8592
8/11/2016,2016,8,11, 1 ,5982,1203,1066,8251
8/11/2016,2016,8,11, 2 ,5760,1174,1037,7971
8/11/2016,2016,8,11, 3 ,5654,1160,1000,7814
8/11/2016,2016,8,11, 4 ,5671,1136,990,7797
8/11/2016,2016,8,11, 5 ,5819,1157,1033,8009
8/11/2016,2016,8,11, 6 ,5924,1188,1062,8174
8/11/2016,2016,8,11, 7 ,6046,1144,987,8177
8/11/2016,2016,8,11, 8 ,6891,1314,1134,9339
8/11/2016,2016,8,11, 9 ,7717,1507,1327,10551
8/11/2016,2016,8,11, 10 ,8118,1622,1433,11173
8/11/2016,2016,8,11, 11 ,8419,1685,1493,11597
8/11/2016,2016,8,11, 12 ,8216,1621,1457,11294
8/11/2016,2016,8,11, 13 ,8106,1630,1452,11188
8/11/2016,2016,8,11, 14 ,8354,1702,1515,11571
8/11/2016,2016,8,11, 15 ,8209,1697,1515,11421
8/11/2016,2016,8,11, 16 ,8112,1674,1469,11255
8/11/2016,2016,8,11, 17 ,7831,1581,1407,10819
8/11/2016,2016,8,11, 18 ,7749,1600,1450,10799
8/11/2016,2016,8,11, 19 ,7950,1758,1516,11224
8/11/2016,2016,8,11, 20 ,7859,1681,1455,10995
8/11/2016,2016,8,11, 21 ,7709,1633,1418,10760
8/11/2016,2016,8,11, 22 ,7226,1482,1318,10026
8/11/2016,2016,8,11, 23 ,6788,1379,1199,9366
8/11/2016,2016,8,11, 24 ,6408,1287,1083,8778
8/12/2016,2016,8,12, 1 ,6163,1245,1054,8462
8/12/2016,2016,8,12, 2 ,5992,1210,1023,8225
8/12/2016,2016,8,12, 3 ,5888,1167,998,8053
8/12/2016,2016,8,12, 4 ,5836,1156,978,7970
8/12/2016,2016,8,12, 5 ,5993,1180,1006,8179
8/12/2016,2016,8,12, 6 ,6060,1205,1034,8299
8/12/2016,2016,8,12, 7 ,6194,1160,971,8325
8/12/2016,2016,8,12, 8 ,6933,1323,1124,9380
8/12/2016,2016,8,12, 9 ,7683,1529,1288,10500
8/12/2016,2016,8,12, 10 ,8122,1623,1381,11126
8/12/2016,2016,8,12, 11 ,8266,1687,1462,11415
8/12/2016,2016,8,12, 12 ,8011,1607,1474,11092
8/12/2016,2016,8,12, 13 ,7882,1593,1477,10952
8/12/2016,2016,8,12, 14 ,8113,1643,1528,11284
8/12/2016,2016,8,12, 15 ,8059,1620,1494,11173
8/12/2016,2016,8,12, 16 ,7988,1602,1458,11048
8/12/2016,2016,8,12, 17 ,7784,1528,1386,10698
8/12/2016,2016,8,12, 18 ,7674,1571,1431,10676
8/12/2016,2016,8,12, 19 ,7715,1687,1510,10912
8/12/2016,2016,8,12, 20 ,7488,1614,1464,10566
8/12/2016,2016,8,12, 21 ,7315,1532,1417,10264
8/12/2016,2016,8,12, 22 ,6928,1417,1309,9654
8/12/2016,2016,8,12, 23 ,6469,1330,1212,9011
8/12/2016,2016,8,12, 24 ,6140,1252,1133,8525
8/13/2016,2016,8,13, 1 ,5832,1198,1082,8112
8/13/2016,2016,8,13, 2 ,5768,1159,1047,7974
8/13/2016,2016,8,13, 3 ,5613,1135,1009,7757
8/13/2016,2016,8,13, 4 ,5497,1109,995,7601
8/13/2016,2016,8,13, 5 ,5547,1108,1016,7671
8/13/2016,2016,8,13, 6 ,5592,1105,990,7687
8/13/2016,2016,8,13, 7 ,5781,1113,980,7874
8/13/2016,2016,8,13, 8 ,6250,1223,1107,8580
8/13/2016,2016,8,13, 9 ,6837,1345,1223,9405
8/13/2016,2016,8,13, 10 ,7213,1444,1354,10011
8/13/2016,2016,8,13, 11 ,7444,1520,1388,10352
8/13/2016,2016,8,13, 12 ,7237,1483,1382,10102
8/13/2016,2016,8,13, 13 ,7037,1475,1386,9898
8/13/2016,2016,8,13, 14 ,7002,1463,1446,9911
8/13/2016,2016,8,13, 15 ,6819,1430,1420,9669
8/13/2016,2016,8,13, 16 ,6716,1424,1357,9497
8/13/2016,2016,8,13, 17 ,6557,1381,1338,9276
8/13/2016,2016,8,13, 18 ,6625,1454,1384,9463
8/13/2016,2016,8,13, 19 ,6992,1581,1480,10053
8/13/2016,2016,8,13, 20 ,6926,1548,1464,9938
8/13/2016,2016,8,13, 21 ,6775,1496,1416,9687
8/13/2016,2016,8,13, 22 ,6495,1425,1353,9273
8/13/2016,2016,8,13, 23 ,6107,1311,1224,8642
8/13/2016,2016,8,13, 24 ,5691,1224,1069,7984
8/14/2016,2016,8,14, 1 ,5468,1177,1083,7728
8/14/2016,2016,8,14, 2 ,5371,1140,1044,7555
8/14/2016,2016,8,14, 3 ,5284,1108,1010,7402
8/14/2016,2016,8,14, 4 ,5174,1083,989,7246
8/14/2016,2016,8,14, 5 ,5166,1083,994,7243
8/14/2016,2016,8,14, 6 ,5139,1045,977,7161
8/14/2016,2016,8,14, 7 ,5222,1069,913,7204
8/14/2016,2016,8,14, 8 ,5389,1125,986,7500
8/14/2016,2016,8,14, 9 ,5830,1221,1080,8131
8/14/2016,2016,8,14, 10 ,6304,1299,1177,8780
8/14/2016,2016,8,14, 11 ,6457,1349,1233,9039
8/14/2016,2016,8,14, 12 ,6334,1336,1239,8909
8/14/2016,2016,8,14, 13 ,6349,1360,1246,8955
8/14/2016,2016,8,14, 14 ,6277,1356,1244,8877
8/14/2016,2016,8,14, 15 ,6272,1353,1212,8837
8/14/2016,2016,8,14, 16 ,6225,1322,1206,8753
8/14/2016,2016,8,14, 17 ,6177,1292,1205,8674
8/14/2016,2016,8,14, 18 ,6507,1421,1295,9223
8/14/2016,2016,8,14, 19 ,6952,1585,1323,9860
8/14/2016,2016,8,14, 20 ,6991,1540,1406,9937
8/14/2016,2016,8,14, 21 ,6888,1477,1363,9728
8/14/2016,2016,8,14, 22 ,6575,1377,1272,9224
8/14/2016,2016,8,14, 23 ,6173,1286,1165,8624
8/14/2016,2016,8,14, 24 ,5874,1201,1082,8157
8/15/2016,2016,8,15, 1 ,5590,1156,1041,7787
8/15/2016,2016,8,15, 2 ,5412,1114,1003,7529
8/15/2016,2016,8,15, 3 ,5350,1084,906,7340
8/15/2016,2016,8,15, 4 ,5254,1075,933,7262
8/15/2016,2016,8,15, 5 ,5449,1105,951,7505
8/15/2016,2016,8,15, 6 ,5696,1140,1040,7876
8/15/2016,2016,8,15, 7 ,6000,1097,967,8064
8/15/2016,2016,8,15, 8 ,6760,1279,1121,9160
8/15/2016,2016,8,15, 9 ,7545,1506,1328,10379
8/15/2016,2016,8,15, 10 ,8097,1611,1445,11153
8/15/2016,2016,8,15, 11 ,8338,1665,1498,11501
8/15/2016,2016,8,15, 12 ,8282,1635,1489,11406
8/15/2016,2016,8,15, 13 ,8243,1625,1486,11354
8/15/2016,2016,8,15, 14 ,8473,1693,1551,11717
8/15/2016,2016,8,15, 15 ,8377,1668,1534,11579
8/15/2016,2016,8,15, 16 ,8259,1649,1492,11400
8/15/2016,2016,8,15, 17 ,8012,1566,1413,10991
8/15/2016,2016,8,15, 18 ,7911,1627,1468,11006
8/15/2016,2016,8,15, 19 ,7962,1721,1485,11168
8/15/2016,2016,8,15, 20 ,7779,1676,1441,10896
8/15/2016,2016,8,15, 21 ,7595,1616,1424,10635
8/15/2016,2016,8,15, 22 ,7216,1495,1291,10002
8/15/2016,2016,8,15, 23 ,6853,1387,1196,9436
8/15/2016,2016,8,15, 24 ,6419,1297,1113,8829
8/16/2016,2016,8,16, 1 ,6215,1260,1067,8542
8/16/2016,2016,8,16, 2 ,6073,1219,1023,8315
8/16/2016,2016,8,16, 3 ,5907,1196,989,8092
8/16/2016,2016,8,16, 4 ,5908,1180,991,8079
8/16/2016,2016,8,16, 5 ,6085,1209,1029,8323
8/16/2016,2016,8,16, 6 ,6209,1227,1047,8483
8/16/2016,2016,8,16, 7 ,6336,1168,971,8475
8/16/2016,2016,8,16, 8 ,7039,1339,1130,9508
8/16/2016,2016,8,16, 9 ,7819,1549,1304,10672
8/16/2016,2016,8,16, 10 ,8209,1642,1332,11183
8/16/2016,2016,8,16, 11 ,8469,1683,1428,11580
8/16/2016,2016,8,16, 12 ,8325,1660,1399,11384
8/16/2016,2016,8,16, 13 ,8206,1655,1423,11284
8/16/2016,2016,8,16, 14 ,8442,1736,1494,11672
8/16/2016,2016,8,16, 15 ,8295,1716,1474,11485
8/16/2016,2016,8,16, 16 ,8264,1691,1444,11399
8/16/2016,2016,8,16, 17 ,8012,1606,1428,11046
8/16/2016,2016,8,16, 18 ,7961,1648,1485,11094
8/16/2016,2016,8,16, 19 ,7925,1780,1531,11236
8/16/2016,2016,8,16, 20 ,7735,1711,1468,10914
8/16/2016,2016,8,16, 21 ,7572,1623,1418,10613
8/16/2016,2016,8,16, 22 ,7176,1514,1316,10006
8/16/2016,2016,8,16, 23 ,6735,1409,1217,9361
8/16/2016,2016,8,16, 24 ,6365,1327,1132,8824
8/17/2016,2016,8,17, 1 ,6102,1272,1065,8439
8/17/2016,2016,8,17, 2 ,5971,1239,1051,8261
8/17/2016,2016,8,17, 3 ,5856,1202,1024,8082
8/17/2016,2016,8,17, 4 ,5785,1183,1011,7979
8/17/2016,2016,8,17, 5 ,5941,1208,1051,8200
8/17/2016,2016,8,17, 6 ,6084,1222,1067,8373
8/17/2016,2016,8,17, 7 ,6155,1176,992,8323
8/17/2016,2016,8,17, 8 ,6982,1359,1151,9492
8/17/2016,2016,8,17, 9 ,7793,1570,1372,10735
8/17/2016,2016,8,17, 10 ,8267,1693,1468,11428
8/17/2016,2016,8,17, 11 ,8516,1734,1529,11779
8/17/2016,2016,8,17, 12 ,8366,1691,1502,11559
8/17/2016,2016,8,17, 13 ,8350,1714,1522,11586
8/17/2016,2016,8,17, 14 ,8584,1768,1577,11929
8/17/2016,2016,8,17, 15 ,8502,1755,1550,11807
8/17/2016,2016,8,17, 16 ,8408,1697,1507,11612
8/17/2016,2016,8,17, 17 ,8123,1623,1408,11154
8/17/2016,2016,8,17, 18 ,7914,1646,1434,10994
8/17/2016,2016,8,17, 19 ,8166,1779,1539,11484
8/17/2016,2016,8,17, 20 ,7995,1736,1454,11185
8/17/2016,2016,8,17, 21 ,7779,1671,1428,10878
8/17/2016,2016,8,17, 22 ,7460,1533,1302,10295
8/17/2016,2016,8,17, 23 ,7075,1427,1217,9719
8/17/2016,2016,8,17, 24 ,6636,1342,1111,9089
8/18/2016,2016,8,18, 1 ,6310,1275,1067,8652
8/18/2016,2016,8,18, 2 ,6197,1235,1027,8459
8/18/2016,2016,8,18, 3 ,6045,1206,999,8250
8/18/2016,2016,8,18, 4 ,6021,1189,989,8199
8/18/2016,2016,8,18, 5 ,6131,1222,1002,8355
8/18/2016,2016,8,18, 6 ,6206,1231,1066,8503
8/18/2016,2016,8,18, 7 ,6331,1184,981,8496
8/18/2016,2016,8,18, 8 ,7164,1365,1148,9677
8/18/2016,2016,8,18, 9 ,8000,1582,1349,10931
8/18/2016,2016,8,18, 10 ,8489,1690,1470,11649
8/18/2016,2016,8,18, 11 ,8820,1766,1525,12111
8/18/2016,2016,8,18, 12 ,8606,1731,1515,11852
8/18/2016,2016,8,18, 13 ,8645,1708,1529,11882
8/18/2016,2016,8,18, 14 ,8903,1784,1583,12270
8/18/2016,2016,8,18, 15 ,8735,1785,1569,12089
8/18/2016,2016,8,18, 16 ,8589,1744,1525,11858
8/18/2016,2016,8,18, 17 ,8266,1652,1452,11370
8/18/2016,2016,8,18, 18 ,8079,1687,1503,11269
8/18/2016,2016,8,18, 19 ,8314,1790,1567,11671
8/18/2016,2016,8,18, 20 ,8202,1748,1512,11462
8/18/2016,2016,8,18, 21 ,8040,1668,1465,11173
8/18/2016,2016,8,18, 22 ,7702,1520,1304,10526
8/18/2016,2016,8,18, 23 ,7309,1457,1226,9992
8/18/2016,2016,8,18, 24 ,6827,1353,1152,9332
8/19/2016,2016,8,19, 1 ,6602,1305,1103,9010
8/19/2016,2016,8,19, 2 ,6415,1253,1067,8735
8/19/2016,2016,8,19, 3 ,6277,1219,1039,8535
8/19/2016,2016,8,19, 4 ,6122,1200,1022,8344
8/19/2016,2016,8,19, 5 ,6217,1227,1051,8495
8/19/2016,2016,8,19, 6 ,6219,1210,1057,8486
8/19/2016,2016,8,19, 7 ,6343,1178,993,8514
8/19/2016,2016,8,19, 8 ,7152,1359,1111,9622
8/19/2016,2016,8,19, 9 ,7783,1612,1305,10700
8/19/2016,2016,8,19, 10 ,8345,1690,1453,11488
8/19/2016,2016,8,19, 11 ,8648,1745,1498,11891
8/19/2016,2016,8,19, 12 ,8490,1691,1483,11664
8/19/2016,2016,8,19, 13 ,8488,1711,1499,11698
8/19/2016,2016,8,19, 14 ,8765,1769,1540,12074
8/19/2016,2016,8,19, 15 ,8673,1750,1528,11951
8/19/2016,2016,8,19, 16 ,8507,1688,1499,11694
8/19/2016,2016,8,19, 17 ,8112,1631,1419,11162
8/19/2016,2016,8,19, 18 ,8041,1658,1483,11182
8/19/2016,2016,8,19, 19 ,8305,1770,1538,11613
8/19/2016,2016,8,19, 20 ,8192,1713,1490,11395
8/19/2016,2016,8,19, 21 ,8001,1599,1437,11037
8/19/2016,2016,8,19, 22 ,7706,1523,1337,10566
8/19/2016,2016,8,19, 23 ,7268,1443,1247,9958
8/19/2016,2016,8,19, 24 ,6888,1358,1157,9403
8/20/2016,2016,8,20, 1 ,6556,1306,1093,8955
8/20/2016,2016,8,20, 2 ,6409,1272,1071,8752
8/20/2016,2016,8,20, 3 ,6226,1227,1041,8494
8/20/2016,2016,8,20, 4 ,6119,1193,1027,8339
8/20/2016,2016,8,20, 5 ,6075,1194,1027,8296
8/20/2016,2016,8,20, 6 ,5983,1167,948,8098
8/20/2016,2016,8,20, 7 ,6114,1177,943,8234
8/20/2016,2016,8,20, 8 ,6632,1269,1083,8984
8/20/2016,2016,8,20, 9 ,7264,1410,1232,9906
8/20/2016,2016,8,20, 10 ,7734,1503,1338,10575
8/20/2016,2016,8,20, 11 ,8032,1545,1384,10961
8/20/2016,2016,8,20, 12 ,7849,1491,1372,10712
8/20/2016,2016,8,20, 13 ,7740,1496,1378,10614
8/20/2016,2016,8,20, 14 ,7760,1529,1422,10711
8/20/2016,2016,8,20, 15 ,7555,1518,1386,10459
8/20/2016,2016,8,20, 16 ,7374,1479,1336,10189
8/20/2016,2016,8,20, 17 ,7281,1468,1317,10066
8/20/2016,2016,8,20, 18 ,7361,1568,1416,10345
8/20/2016,2016,8,20, 19 ,7547,1598,1467,10612
8/20/2016,2016,8,20, 20 ,7413,1542,1444,10399
8/20/2016,2016,8,20, 21 ,7279,1480,1396,10155
8/20/2016,2016,8,20, 22 ,7060,1349,1303,9712
8/20/2016,2016,8,20, 23 ,6599,1224,1201,9024
8/20/2016,2016,8,20, 24 ,6260,1159,1114,8533
8/21/2016,2016,8,21, 1 ,5978,1108,1063,8149
8/21/2016,2016,8,21, 2 ,5867,1076,1033,7976
8/21/2016,2016,8,21, 3 ,5697,1047,1014,7758
8/21/2016,2016,8,21, 4 ,5590,1037,985,7612
8/21/2016,2016,8,21, 5 ,5519,1040,983,7542
8/21/2016,2016,8,21, 6 ,5351,1016,946,7313
8/21/2016,2016,8,21, 7 ,5376,1026,950,7352
8/21/2016,2016,8,21, 8 ,5690,1077,992,7759
8/21/2016,2016,8,21, 9 ,6106,1172,1042,8320
8/21/2016,2016,8,21, 10 ,6459,1248,1135,8842
8/21/2016,2016,8,21, 11 ,6810,1302,1164,9276
8/21/2016,2016,8,21, 12 ,6768,1295,1184,9247
8/21/2016,2016,8,21, 13 ,6786,1300,1157,9243
8/21/2016,2016,8,21, 14 ,6861,1288,1160,9309
8/21/2016,2016,8,21, 15 ,6836,1284,1144,9264
8/21/2016,2016,8,21, 16 ,6665,1254,1135,9054
8/21/2016,2016,8,21, 17 ,6623,1272,1157,9052
8/21/2016,2016,8,21, 18 ,6826,1397,1306,9529
8/21/2016,2016,8,21, 19 ,7301,1492,1365,10158
8/21/2016,2016,8,21, 20 ,7308,1448,1316,10072
8/21/2016,2016,8,21, 21 ,7185,1334,1260,9779
8/21/2016,2016,8,21, 22 ,6820,1238,1163,9221
8/21/2016,2016,8,21, 23 ,6477,1166,1077,8720
8/21/2016,2016,8,21, 24 ,6089,1090,1116,8295
8/22/2016,2016,8,22, 1 ,5787,1086,978,7851
8/22/2016,2016,8,22, 2 ,5629,1058,994,7681
8/22/2016,2016,8,22, 3 ,5417,1030,969,7416
8/22/2016,2016,8,22, 4 ,5425,1031,951,7407
8/22/2016,2016,8,22, 5 ,5577,1079,987,7643
8/22/2016,2016,8,22, 6 ,5747,1115,1022,7884
8/22/2016,2016,8,22, 7 ,6018,1085,974,8077
8/22/2016,2016,8,22, 8 ,6892,1244,1117,9253
8/22/2016,2016,8,22, 9 ,7847,1468,1272,10587
8/22/2016,2016,8,22, 10 ,8358,1587,1394,11339
8/22/2016,2016,8,22, 11 ,8702,1642,1475,11819
8/22/2016,2016,8,22, 12 ,8552,1601,1419,11572
8/22/2016,2016,8,22, 13 ,8557,1581,1458,11596
8/22/2016,2016,8,22, 14 ,8819,1645,1500,11964
8/22/2016,2016,8,22, 15 ,8698,1611,1439,11748
8/22/2016,2016,8,22, 16 ,8546,1597,1449,11592
8/22/2016,2016,8,22, 17 ,8157,1523,1385,11065
8/22/2016,2016,8,22, 18 ,7970,1576,1453,10999
8/22/2016,2016,8,22, 19 ,8264,1655,1500,11419
8/22/2016,2016,8,22, 20 ,8153,1607,1468,11228
8/22/2016,2016,8,22, 21 ,8009,1533,1407,10949
8/22/2016,2016,8,22, 22 ,7587,1411,1273,10271
8/22/2016,2016,8,22, 23 ,7177,1304,1222,9703
8/22/2016,2016,8,22, 24 ,6740,1217,1099,9056
8/23/2016,2016,8,23, 1 ,6427,1166,1032,8625
8/23/2016,2016,8,23, 2 ,6251,1122,1020,8393
8/23/2016,2016,8,23, 3 ,6087,1111,985,8183
8/23/2016,2016,8,23, 4 ,6000,1106,986,8092
8/23/2016,2016,8,23, 5 ,6116,1140,1039,8295
8/23/2016,2016,8,23, 6 ,6211,1161,1063,8435
8/23/2016,2016,8,23, 7 ,6316,1113,990,8419
8/23/2016,2016,8,23, 8 ,7077,1302,1150,9529
8/23/2016,2016,8,23, 9 ,7909,1501,1310,10720
8/23/2016,2016,8,23, 10 ,8322,1611,1422,11355
8/23/2016,2016,8,23, 11 ,8712,1658,1429,11799
8/23/2016,2016,8,23, 12 ,8520,1605,1432,11557
8/23/2016,2016,8,23, 13 ,8564,1597,1347,11508
8/23/2016,2016,8,23, 14 ,8806,1687,1515,12008
8/23/2016,2016,8,23, 15 ,8719,1641,1494,11854
8/23/2016,2016,8,23, 16 ,8494,1593,1424,11511
8/23/2016,2016,8,23, 17 ,8166,1496,1371,11033
8/23/2016,2016,8,23, 18 ,7973,1576,1489,11038
8/23/2016,2016,8,23, 19 ,8350,1690,1544,11584
8/23/2016,2016,8,23, 20 ,8218,1630,1500,11348
8/23/2016,2016,8,23, 21 ,8044,1552,1429,11025
8/23/2016,2016,8,23, 22 ,7610,1413,1272,10295
8/23/2016,2016,8,23, 23 ,7192,1296,1180,9668
8/23/2016,2016,8,23, 24 ,6796,1220,1105,9121
8/24/2016,2016,8,24, 1 ,6493,1176,1065,8734
8/24/2016,2016,8,24, 2 ,6334,1136,1026,8496
8/24/2016,2016,8,24, 3 ,6157,1113,995,8265
8/24/2016,2016,8,24, 4 ,6054,1102,989,8145
8/24/2016,2016,8,24, 5 ,6173,1136,1039,8348
8/24/2016,2016,8,24, 6 ,6219,1095,1065,8379
8/24/2016,2016,8,24, 7 ,6344,1054,1011,8409
8/24/2016,2016,8,24, 8 ,7183,1249,1158,9590
8/24/2016,2016,8,24, 9 ,8007,1481,1343,10831
8/24/2016,2016,8,24, 10 ,8494,1585,1476,11555
8/24/2016,2016,8,24, 11 ,8805,1652,1519,11976
8/24/2016,2016,8,24, 12 ,8590,1559,1505,11654
8/24/2016,2016,8,24, 13 ,8628,1578,1531,11737
8/24/2016,2016,8,24, 14 ,8897,1641,1580,12118
8/24/2016,2016,8,24, 15 ,8817,1644,1565,12026
8/24/2016,2016,8,24, 16 ,8677,1622,1528,11827
8/24/2016,2016,8,24, 17 ,8351,1523,1463,11337
8/24/2016,2016,8,24, 18 ,8064,1543,1488,11095
8/24/2016,2016,8,24, 19 ,8414,1678,1563,11655
8/24/2016,2016,8,24, 20 ,8319,1624,1485,11428
8/24/2016,2016,8,24, 21 ,8200,1625,1427,11252
8/24/2016,2016,8,24, 22 ,7773,1511,1336,10620
8/24/2016,2016,8,24, 23 ,7394,1398,1235,10027
8/24/2016,2016,8,24, 24 ,6923,1304,1165,9392
8/25/2016,2016,8,25, 1 ,6564,1255,1082,8901
8/25/2016,2016,8,25, 2 ,6389,1216,1078,8683
8/25/2016,2016,8,25, 3 ,6236,1183,1034,8453
8/25/2016,2016,8,25, 4 ,6166,1169,1028,8363
8/25/2016,2016,8,25, 5 ,6271,1191,1071,8533
8/25/2016,2016,8,25, 6 ,6311,1200,1077,8588
8/25/2016,2016,8,25, 7 ,6410,1168,1000,8578
8/25/2016,2016,8,25, 8 ,7169,1345,1152,9666
8/25/2016,2016,8,25, 9 ,7942,1563,1332,10837
8/25/2016,2016,8,25, 10 ,8516,1689,1450,11655
8/25/2016,2016,8,25, 11 ,8654,1734,1503,11891
8/25/2016,2016,8,25, 12 ,8489,1689,1495,11673
8/25/2016,2016,8,25, 13 ,8433,1684,1484,11601
8/25/2016,2016,8,25, 14 ,8657,1762,1510,11929
8/25/2016,2016,8,25, 15 ,8571,1745,1481,11797
8/25/2016,2016,8,25, 16 ,8422,1677,1428,11527
8/25/2016,2016,8,25, 17 ,8203,1594,1421,11218
8/25/2016,2016,8,25, 18 ,8007,1647,1487,11141
8/25/2016,2016,8,25, 19 ,8320,1749,1510,11579
8/25/2016,2016,8,25, 20 ,8190,1709,1477,11376
8/25/2016,2016,8,25, 21 ,7990,1640,1415,11045
8/25/2016,2016,8,25, 22 ,7556,1502,1284,10342
8/25/2016,2016,8,25, 23 ,7161,1397,1190,9748
8/25/2016,2016,8,25, 24 ,6710,1323,1123,9156
8/26/2016,2016,8,26, 1 ,6482,1279,1081,8842
8/26/2016,2016,8,26, 2 ,6243,1230,1052,8525
8/26/2016,2016,8,26, 3 ,6127,1200,1032,8359
8/26/2016,2016,8,26, 4 ,6020,1176,1007,8203
8/26/2016,2016,8,26, 5 ,6164,1215,1046,8425
8/26/2016,2016,8,26, 6 ,6153,1198,1087,8438
8/26/2016,2016,8,26, 7 ,6300,1171,1016,8487
8/26/2016,2016,8,26, 8 ,7090,1345,1169,9604
8/26/2016,2016,8,26, 9 ,7853,1566,1351,10770
8/26/2016,2016,8,26, 10 ,8365,1680,1486,11531
8/26/2016,2016,8,26, 11 ,8613,1748,1517,11878
8/26/2016,2016,8,26, 12 ,8395,1690,1513,11598
8/26/2016,2016,8,26, 13 ,8429,1691,1550,11670
8/26/2016,2016,8,26, 14 ,8705,1776,1591,12072
8/26/2016,2016,8,26, 15 ,8594,1744,1556,11894
8/26/2016,2016,8,26, 16 ,8359,1709,1515,11583
8/26/2016,2016,8,26, 17 ,7968,1612,1437,11017
8/26/2016,2016,8,26, 18 ,7803,1660,1479,10942
8/26/2016,2016,8,26, 19 ,8079,1744,1531,11354
8/26/2016,2016,8,26, 20 ,7897,1689,1479,11065
8/26/2016,2016,8,26, 21 ,7747,1640,1413,10800
8/26/2016,2016,8,26, 22 ,7438,1524,1339,10301
8/26/2016,2016,8,26, 23 ,7068,1419,1211,9698
8/26/2016,2016,8,26, 24 ,6711,1326,1201,9238
8/27/2016,2016,8,27, 1 ,6389,1277,1069,8735
8/27/2016,2016,8,27, 2 ,6173,1247,1049,8469
8/27/2016,2016,8,27, 3 ,6056,1205,1012,8273
8/27/2016,2016,8,27, 4 ,5864,1188,1003,8055
8/27/2016,2016,8,27, 5 ,5880,1195,1020,8095
8/27/2016,2016,8,27, 6 ,5805,1178,1018,8001
8/27/2016,2016,8,27, 7 ,5900,1185,1007,8092
8/27/2016,2016,8,27, 8 ,6407,1288,1094,8789
8/27/2016,2016,8,27, 9 ,7017,1421,1241,9679
8/27/2016,2016,8,27, 10 ,7541,1492,1341,10374
8/27/2016,2016,8,27, 11 ,7837,1569,1404,10810
8/27/2016,2016,8,27, 12 ,7695,1541,1414,10650
8/27/2016,2016,8,27, 13 ,7669,1530,1434,10633
8/27/2016,2016,8,27, 14 ,7879,1556,1463,10898
8/27/2016,2016,8,27, 15 ,7687,1518,1407,10612
8/27/2016,2016,8,27, 16 ,7509,1481,1374,10364
8/27/2016,2016,8,27, 17 ,7208,1440,1325,9973
8/27/2016,2016,8,27, 18 ,7296,1560,1449,10305
8/27/2016,2016,8,27, 19 ,7670,1655,1473,10798
8/27/2016,2016,8,27, 20 ,7536,1607,1429,10572
8/27/2016,2016,8,27, 21 ,7456,1553,1347,10356
8/27/2016,2016,8,27, 22 ,7209,1457,1248,9914
8/27/2016,2016,8,27, 23 ,6826,1348,1153,9327
8/27/2016,2016,8,27, 24 ,6447,1269,1075,8791
8/28/2016,2016,8,28, 1 ,6184,1215,1026,8425
8/28/2016,2016,8,28, 2 ,6000,1183,1002,8185
8/28/2016,2016,8,28, 3 ,5868,1143,978,7989
8/28/2016,2016,8,28, 4 ,5689,1124,961,7774
8/28/2016,2016,8,28, 5 ,5569,1119,965,7653
8/28/2016,2016,8,28, 6 ,5466,1085,948,7499
8/28/2016,2016,8,28, 7 ,5451,1086,969,7506
8/28/2016,2016,8,28, 8 ,5722,1145,989,7856
8/28/2016,2016,8,28, 9 ,6119,1247,1065,8431
8/28/2016,2016,8,28, 10 ,6538,1328,1149,9015
8/28/2016,2016,8,28, 11 ,6787,1382,1215,9384
8/28/2016,2016,8,28, 12 ,6668,1387,1212,9267
8/28/2016,2016,8,28, 13 ,6652,1380,1224,9256
8/28/2016,2016,8,28, 14 ,6518,1388,1235,9141
8/28/2016,2016,8,28, 15 ,6379,1369,1210,8958
8/28/2016,2016,8,28, 16 ,6339,1333,1185,8857
8/28/2016,2016,8,28, 17 ,6304,1320,1185,8809
8/28/2016,2016,8,28, 18 ,6586,1460,1318,9364
8/28/2016,2016,8,28, 19 ,6982,1528,1370,9880
8/28/2016,2016,8,28, 20 ,7007,1543,1348,9898
8/28/2016,2016,8,28, 21 ,6875,1484,1276,9635
8/28/2016,2016,8,28, 22 ,6615,1382,1157,9154
8/28/2016,2016,8,28, 23 ,6257,1303,1078,8638
8/28/2016,2016,8,28, 24 ,5926,1181,1017,8124
8/29/2016,2016,8,29, 1 ,5686,1145,911,7742
8/29/2016,2016,8,29, 2 ,5508,1117,938,7563
8/29/2016,2016,8,29, 3 ,5300,1096,911,7307
8/29/2016,2016,8,29, 4 ,5199,1065,893,7157
8/29/2016,2016,8,29, 5 ,5245,1073,910,7228
8/29/2016,2016,8,29, 6 ,5129,1059,923,7111
8/29/2016,2016,8,29, 7 ,5298,1076,928,7302
8/29/2016,2016,8,29, 8 ,5811,1149,1021,7981
8/29/2016,2016,8,29, 9 ,6290,1268,1143,8701
8/29/2016,2016,8,29, 10 ,6695,1371,1260,9326
8/29/2016,2016,8,29, 11 ,6923,1438,1326,9687
8/29/2016,2016,8,29, 12 ,6782,1427,1297,9506
8/29/2016,2016,8,29, 13 ,6797,1377,1335,9509
8/29/2016,2016,8,29, 14 ,6942,1464,1374,9780
8/29/2016,2016,8,29, 15 ,6884,1436,1358,9678
8/29/2016,2016,8,29, 16 ,6775,1419,1339,9533
8/29/2016,2016,8,29, 17 ,6649,1380,1301,9330
8/29/2016,2016,8,29, 18 ,6914,1460,1417,9791
8/29/2016,2016,8,29, 19 ,7442,1608,1461,10511
8/29/2016,2016,8,29, 20 ,7378,1586,1430,10394
8/29/2016,2016,8,29, 21 ,7305,1537,1381,10223
8/29/2016,2016,8,29, 22 ,6942,1421,1246,9609
8/29/2016,2016,8,29, 23 ,6563,1345,1172,9080
8/29/2016,2016,8,29, 24 ,6197,1258,1097,8552
8/30/2016,2016,8,30, 1 ,5857,1187,1050,8094
8/30/2016,2016,8,30, 2 ,5698,1172,1024,7894
8/30/2016,2016,8,30, 3 ,5569,1139,989,7697
8/30/2016,2016,8,30, 4 ,5464,1118,969,7551
8/30/2016,2016,8,30, 5 ,5663,1144,1034,7841
8/30/2016,2016,8,30, 6 ,5808,1161,1060,8029
8/30/2016,2016,8,30, 7 ,5982,1124,997,8103
8/30/2016,2016,8,30, 8 ,6804,1294,1173,9271
8/30/2016,2016,8,30, 9 ,7642,1540,1365,10547
8/30/2016,2016,8,30, 10 ,8097,1641,1480,11218
8/30/2016,2016,8,30, 11 ,8376,1737,1531,11644
8/30/2016,2016,8,30, 12 ,8247,1689,1510,11446
8/30/2016,2016,8,30, 13 ,8333,1698,1506,11537
8/30/2016,2016,8,30, 14 ,8647,1764,1593,12004
8/30/2016,2016,8,30, 15 ,8613,1735,1579,11927
8/30/2016,2016,8,30, 16 ,8429,1688,1536,11653
8/30/2016,2016,8,30, 17 ,8075,1600,1461,11136
8/30/2016,2016,8,30, 18 ,7966,1669,1529,11164
8/30/2016,2016,8,30, 19 ,8239,1773,1564,11576
8/30/2016,2016,8,30, 20 ,8092,1724,1520,11336
8/30/2016,2016,8,30, 21 ,7950,1644,1457,11051
8/30/2016,2016,8,30, 22 ,7583,1508,1320,10411
8/30/2016,2016,8,30, 23 ,7112,1404,1222,9738
8/30/2016,2016,8,30, 24 ,6681,1317,1145,9143
8/31/2016,2016,8,31, 1 ,6500,1262,1103,8865
8/31/2016,2016,8,31, 2 ,6200,1213,1064,8477
8/31/2016,2016,8,31, 3 ,6017,1184,1033,8234
8/31/2016,2016,8,31, 4 ,5930,1161,1013,8104
8/31/2016,2016,8,31, 5 ,6045,1183,1055,8283
8/31/2016,2016,8,31, 6 ,6140,1181,1047,8368
8/31/2016,2016,8,31, 7 ,6204,1151,992,8347
8/31/2016,2016,8,31, 8 ,7041,1333,1181,9555
8/31/2016,2016,8,31, 9 ,7797,1567,1368,10732
8/31/2016,2016,8,31, 10 ,8314,1669,1490,11473
8/31/2016,2016,8,31, 11 ,8679,1742,1545,11966
8/31/2016,2016,8,31, 12 ,8488,1699,1528,11715
8/31/2016,2016,8,31, 13 ,8492,1713,1543,11748
8/31/2016,2016,8,31, 14 ,8765,1784,1583,12132
8/31/2016,2016,8,31, 15 ,8659,1740,1562,11961
8/31/2016,2016,8,31, 16 ,8460,1706,1484,11650
8/31/2016,2016,8,31, 17 ,8131,1632,1452,11215
8/31/2016,2016,8,31, 18 ,7964,1674,1510,11148
8/31/2016,2016,8,31, 19 ,8230,1775,1563,11568
8/31/2016,2016,8,31, 20 ,8077,1730,1521,11328
8/31/2016,2016,8,31, 21 ,7913,1660,1442,11015
8/31/2016,2016,8,31, 22 ,7643,1523,1305,10471
8/31/2016,2016,8,31, 23 ,7155,1427,1225,9807
8/31/2016,2016,8,31, 24 ,6748,1331,1147,9226
9/1/2016,2016,9,1, 1 ,6456,1262,1085,8803
9/1/2016,2016,9,1, 2 ,6195,1228,1047,8470
9/1/2016,2016,9,1, 3 ,6037,1194,1020,8251
9/1/2016,2016,9,1, 4 ,5993,1177,1012,8182
9/1/2016,2016,9,1, 5 ,6126,1190,1043,8359
9/1/2016,2016,9,1, 6 ,6161,1196,1066,8423
9/1/2016,2016,9,1, 7 ,6306,1162,988,8456
9/1/2016,2016,9,1, 8 ,7032,1346,1184,9562
9/1/2016,2016,9,1, 9 ,7801,1593,1350,10744
9/1/2016,2016,9,1, 10 ,8254,1686,1454,11394
9/1/2016,2016,9,1, 11 ,8532,1744,1526,11802
9/1/2016,2016,9,1, 12 ,8336,1726,1498,11560
9/1/2016,2016,9,1, 13 ,8319,1729,1509,11557
9/1/2016,2016,9,1, 14 ,8586,1811,1579,11976
9/1/2016,2016,9,1, 15 ,8508,1765,1525,11798
9/1/2016,2016,9,1, 16 ,8281,1729,1486,11496
9/1/2016,2016,9,1, 17 ,7951,1620,1434,11005
9/1/2016,2016,9,1, 18 ,7856,1703,1502,11061
9/1/2016,2016,9,1, 19 ,8145,1788,1515,11448
9/1/2016,2016,9,1, 20 ,7973,1710,1483,11166
9/1/2016,2016,9,1, 21 ,7863,1657,1410,10930
9/1/2016,2016,9,1, 22 ,7549,1514,1274,10337
9/1/2016,2016,9,1, 23 ,7078,1426,1174,9678
9/1/2016,2016,9,1, 24 ,6703,1345,1088,9136
9/2/2016,2016,9,2, 1 ,6440,1280,1063,8783
9/2/2016,2016,9,2, 2 ,6282,1231,1023,8536
9/2/2016,2016,9,2, 3 ,6022,1196,992,8210
9/2/2016,2016,9,2, 4 ,5915,1167,980,8062
9/2/2016,2016,9,2, 5 ,6077,1194,1018,8289
9/2/2016,2016,9,2, 6 ,6067,1195,1051,8313
9/2/2016,2016,9,2, 7 ,6209,1173,991,8373
9/2/2016,2016,9,2, 8 ,7024,1360,1139,9523
9/2/2016,2016,9,2, 9 ,7952,1592,1345,10889
9/2/2016,2016,9,2, 10 ,8512,1689,1465,11666
9/2/2016,2016,9,2, 11 ,8704,1777,1525,12006
9/2/2016,2016,9,2, 12 ,8588,1733,1490,11811
9/2/2016,2016,9,2, 13 ,8477,1751,1515,11743
9/2/2016,2016,9,2, 14 ,8867,1801,1586,12254
9/2/2016,2016,9,2, 15 ,8822,1791,1573,12186
9/2/2016,2016,9,2, 16 ,8610,1743,1540,11893
9/2/2016,2016,9,2, 17 ,8210,1657,1450,11317
9/2/2016,2016,9,2, 18 ,7972,1691,1493,11156
9/2/2016,2016,9,2, 19 ,8350,1781,1532,11663
9/2/2016,2016,9,2, 20 ,8184,1726,1480,11390
9/2/2016,2016,9,2, 21 ,8071,1676,1411,11158
9/2/2016,2016,9,2, 22 ,7789,1549,1299,10637
9/2/2016,2016,9,2, 23 ,7404,1436,1220,10060
9/2/2016,2016,9,2, 24 ,6771,1346,1126,9243
9/3/2016,2016,9,3, 1 ,6724,1292,1081,9097
9/3/2016,2016,9,3, 2 ,6492,1250,1041,8783
9/3/2016,2016,9,3, 3 ,6261,1222,999,8482
9/3/2016,2016,9,3, 4 ,6075,1186,941,8202
9/3/2016,2016,9,3, 5 ,6080,1187,953,8220
9/3/2016,2016,9,3, 6 ,5991,1157,989,8137
9/3/2016,2016,9,3, 7 ,6120,1170,982,8272
9/3/2016,2016,9,3, 8 ,6633,1299,1080,9012
9/3/2016,2016,9,3, 9 ,7300,1490,1214,10004
9/3/2016,2016,9,3, 10 ,7709,1577,1269,10555
9/3/2016,2016,9,3, 11 ,8093,1650,1372,11115
9/3/2016,2016,9,3, 12 ,7977,1626,1350,10953
9/3/2016,2016,9,3, 13 ,7977,1623,1354,10954
9/3/2016,2016,9,3, 14 ,8133,1664,1423,11220
9/3/2016,2016,9,3, 15 ,8045,1592,1435,11072
9/3/2016,2016,9,3, 16 ,7815,1576,1400,10791
9/3/2016,2016,9,3, 17 ,7463,1502,1346,10311
9/3/2016,2016,9,3, 18 ,7471,1588,1463,10522
9/3/2016,2016,9,3, 19 ,7873,1687,1481,11041
9/3/2016,2016,9,3, 20 ,7875,1655,1445,10975
9/3/2016,2016,9,3, 21 ,7676,1580,1345,10601
9/3/2016,2016,9,3, 22 ,7751,1485,1292,10528
9/3/2016,2016,9,3, 23 ,7370,1357,1173,9900
9/3/2016,2016,9,3, 24 ,6874,1284,1090,9248
9/4/2016,2016,9,4, 1 ,6602,1228,1026,8856
9/4/2016,2016,9,4, 2 ,6374,1194,1007,8575
9/4/2016,2016,9,4, 3 ,6108,1153,944,8205
9/4/2016,2016,9,4, 4 ,6111,1132,942,8185
9/4/2016,2016,9,4, 5 ,5962,1124,939,8025
9/4/2016,2016,9,4, 6 ,5792,1086,964,7842
9/4/2016,2016,9,4, 7 ,5751,1088,931,7770
9/4/2016,2016,9,4, 8 ,6063,1156,982,8201
9/4/2016,2016,9,4, 9 ,6501,1256,1074,8831
9/4/2016,2016,9,4, 10 ,6825,1357,1119,9301
9/4/2016,2016,9,4, 11 ,7015,1396,1169,9580
9/4/2016,2016,9,4, 12 ,6644,1407,1246,9297
9/4/2016,2016,9,4, 13 ,6577,1419,1249,9245
9/4/2016,2016,9,4, 14 ,6514,1422,1248,9184
9/4/2016,2016,9,4, 15 ,6402,1396,1220,9018
9/4/2016,2016,9,4, 16 ,6340,1364,1192,8896
9/4/2016,2016,9,4, 17 ,6326,1348,1179,8853
9/4/2016,2016,9,4, 18 ,6667,1529,1330,9526
9/4/2016,2016,9,4, 19 ,7144,1616,1374,10134
9/4/2016,2016,9,4, 20 ,7063,1564,1327,9954
9/4/2016,2016,9,4, 21 ,6998,1487,1276,9761
9/4/2016,2016,9,4, 22 ,6711,1378,1172,9261
9/4/2016,2016,9,4, 23 ,6290,1292,1104,8686
9/4/2016,2016,9,4, 24 ,6044,1218,1093,8355
9/5/2016,2016,9,5, 1 ,5779,1163,994,7936
9/5/2016,2016,9,5, 2 ,5591,1132,959,7682
9/5/2016,2016,9,5, 3 ,5435,1109,925,7469
9/5/2016,2016,9,5, 4 ,5449,1098,922,7469
9/5/2016,2016,9,5, 5 ,5478,1130,963,7571
9/5/2016,2016,9,5, 6 ,5820,1151,987,7958
9/5/2016,2016,9,5, 7 ,5997,1084,946,8027
9/5/2016,2016,9,5, 8 ,6876,1306,1102,9284
9/5/2016,2016,9,5, 9 ,7719,1562,1311,10592
9/5/2016,2016,9,5, 10 ,8302,1659,1436,11397
9/5/2016,2016,9,5, 11 ,8626,1744,1502,11872
9/5/2016,2016,9,5, 12 ,8501,1707,1493,11701
9/5/2016,2016,9,5, 13 ,8516,1720,1483,11719
9/5/2016,2016,9,5, 14 ,8825,1807,1551,12183
9/5/2016,2016,9,5, 15 ,8694,1758,1501,11953
9/5/2016,2016,9,5, 16 ,8475,1700,1458,11633
9/5/2016,2016,9,5, 17 ,8295,1637,1409,11341
9/5/2016,2016,9,5, 18 ,8110,1704,1490,11304
9/5/2016,2016,9,5, 19 ,8321,1758,1514,11593
9/5/2016,2016,9,5, 20 ,8151,1695,1445,11291
9/5/2016,2016,9,5, 21 ,8028,1619,1360,11007
9/5/2016,2016,9,5, 22 ,7617,1497,1210,10324
9/5/2016,2016,9,5, 23 ,7182,1372,1103,9657
9/5/2016,2016,9,5, 24 ,6723,1264,1031,9018
9/6/2016,2016,9,6, 1 ,6424,1232,1014,8670
9/6/2016,2016,9,6, 2 ,6253,1201,980,8434
9/6/2016,2016,9,6, 3 ,6059,1155,956,8170
9/6/2016,2016,9,6, 4 ,5929,1144,948,8021
9/6/2016,2016,9,6, 5 ,6075,1173,961,8209
9/6/2016,2016,9,6, 6 ,6113,1199,1038,8350
9/6/2016,2016,9,6, 7 ,6262,1168,968,8398
9/6/2016,2016,9,6, 8 ,7134,1338,1131,9603
9/6/2016,2016,9,6, 9 ,7942,1556,1337,10835
9/6/2016,2016,9,6, 10 ,8465,1666,1436,11567
9/6/2016,2016,9,6, 11 ,8798,1720,1512,12030
9/6/2016,2016,9,6, 12 ,8652,1701,1458,11811
9/6/2016,2016,9,6, 13 ,7626,1682,1471,10779
9/6/2016,2016,9,6, 14 ,8477,1756,1525,11758
9/6/2016,2016,9,6, 15 ,8371,1719,1514,11604
9/6/2016,2016,9,6, 16 ,8441,1705,1462,11608
9/6/2016,2016,9,6, 17 ,8144,1617,1392,11153
9/6/2016,2016,9,6, 18 ,8152,1717,1469,11338
9/6/2016,2016,9,6, 19 ,8381,1743,1496,11620
9/6/2016,2016,9,6, 20 ,8345,1706,1392,11443
9/6/2016,2016,9,6, 21 ,8179,1611,1316,11106
9/6/2016,2016,9,6, 22 ,7767,1480,1199,10446
9/6/2016,2016,9,6, 23 ,7340,1353,1129,9822
9/6/2016,2016,9,6, 24 ,6978,1270,1032,9280
9/7/2016,2016,9,7, 1 ,6661,1220,982,8863
9/7/2016,2016,9,7, 2 ,6436,1183,932,8551
9/7/2016,2016,9,7, 3 ,6254,1148,914,8316
9/7/2016,2016,9,7, 4 ,6116,1137,909,8162
9/7/2016,2016,9,7, 5 ,6250,1163,974,8387
9/7/2016,2016,9,7, 6 ,6237,1187,1020,8444
9/7/2016,2016,9,7, 7 ,6353,1157,950,8460
9/7/2016,2016,9,7, 8 ,7215,1333,1062,9610
9/7/2016,2016,9,7, 9 ,7944,1567,1242,10753
9/7/2016,2016,9,7, 10 ,8388,1688,1354,11430
9/7/2016,2016,9,7, 11 ,8792,1774,1388,11954
9/7/2016,2016,9,7, 12 ,8643,1700,1361,11704
9/7/2016,2016,9,7, 13 ,8708,1684,1394,11786
9/7/2016,2016,9,7, 14 ,9049,1748,1452,12249
9/7/2016,2016,9,7, 15 ,8963,1700,1445,12108
9/7/2016,2016,9,7, 16 ,8711,1655,1415,11781
9/7/2016,2016,9,7, 17 ,8394,1641,1386,11421
9/7/2016,2016,9,7, 18 ,8297,1707,1456,11460
9/7/2016,2016,9,7, 19 ,8466,1673,1424,11563
9/7/2016,2016,9,7, 20 ,8243,1613,1367,11223
9/7/2016,2016,9,7, 21 ,8071,1527,1265,10863
9/7/2016,2016,9,7, 22 ,7652,1388,1168,10208
9/7/2016,2016,9,7, 23 ,7262,1292,1005,9559
9/7/2016,2016,9,7, 24 ,6889,1224,991,9104
9/8/2016,2016,9,8, 1 ,6559,1181,980,8720
9/8/2016,2016,9,8, 2 ,6399,1143,947,8489
9/8/2016,2016,9,8, 3 ,6227,1121,919,8267
9/8/2016,2016,9,8, 4 ,6123,1107,906,8136
9/8/2016,2016,9,8, 5 ,6216,1154,945,8315
9/8/2016,2016,9,8, 6 ,6176,1186,996,8358
9/8/2016,2016,9,8, 7 ,6299,1141,937,8377
9/8/2016,2016,9,8, 8 ,7089,1285,1070,9444
9/8/2016,2016,9,8, 9 ,7941,1490,1261,10692
9/8/2016,2016,9,8, 10 ,8452,1602,1348,11402
9/8/2016,2016,9,8, 11 ,8772,1632,1408,11812
9/8/2016,2016,9,8, 12 ,8620,1571,1369,11560
9/8/2016,2016,9,8, 13 ,8716,1543,1364,11623
9/8/2016,2016,9,8, 14 ,8911,1596,1407,11914
9/8/2016,2016,9,8, 15 ,8797,1577,1381,11755
9/8/2016,2016,9,8, 16 ,8600,1565,1359,11524
9/8/2016,2016,9,8, 17 ,8241,1532,1319,11092
9/8/2016,2016,9,8, 18 ,8090,1636,1430,11156
9/8/2016,2016,9,8, 19 ,8373,1649,1413,11435
9/8/2016,2016,9,8, 20 ,8134,1593,1356,11083
9/8/2016,2016,9,8, 21 ,7918,1487,1292,10697
9/8/2016,2016,9,8, 22 ,7513,1354,1196,10063
9/8/2016,2016,9,8, 23 ,7132,1269,1078,9479
9/8/2016,2016,9,8, 24 ,6805,1188,1007,9000
9/9/2016,2016,9,9, 1 ,6549,1152,967,8668
9/9/2016,2016,9,9, 2 ,6279,1113,933,8325
9/9/2016,2016,9,9, 3 ,6076,1081,915,8072
9/9/2016,2016,9,9, 4 ,6013,1079,909,8001
9/9/2016,2016,9,9, 5 ,6082,1102,965,8149
9/9/2016,2016,9,9, 6 ,6063,1133,1040,8236
9/9/2016,2016,9,9, 7 ,6200,1109,951,8260
9/9/2016,2016,9,9, 8 ,6962,1231,1084,9277
9/9/2016,2016,9,9, 9 ,7790,1422,1271,10483
9/9/2016,2016,9,9, 10 ,8341,1490,1390,11221
9/9/2016,2016,9,9, 11 ,8669,1601,1440,11710
9/9/2016,2016,9,9, 12 ,8460,1567,1396,11423
9/9/2016,2016,9,9, 13 ,8483,1533,1415,11431
9/9/2016,2016,9,9, 14 ,8847,1538,1499,11884
9/9/2016,2016,9,9, 15 ,8748,1571,1469,11788
9/9/2016,2016,9,9, 16 ,8559,1519,1440,11518
9/9/2016,2016,9,9, 17 ,8163,1492,1380,11035
9/9/2016,2016,9,9, 18 ,8095,1577,1478,11150
9/9/2016,2016,9,9, 19 ,8252,1605,1468,11325
9/9/2016,2016,9,9, 20 ,8138,1565,1416,11119
9/9/2016,2016,9,9, 21 ,8063,1471,1344,10878
9/9/2016,2016,9,9, 22 ,7658,1359,1216,10233
9/9/2016,2016,9,9, 23 ,7258,1264,1134,9656
9/9/2016,2016,9,9, 24 ,6896,1198,1063,9157
9/10/2016,2016,9,10, 1 ,6516,1152,1018,8686
9/10/2016,2016,9,10, 2 ,6320,1073,981,8374
9/10/2016,2016,9,10, 3 ,6152,1062,962,8176
9/10/2016,2016,9,10, 4 ,6042,1059,944,8045
9/10/2016,2016,9,10, 5 ,5982,1085,957,8024
9/10/2016,2016,9,10, 6 ,5888,1089,979,7956
9/10/2016,2016,9,10, 7 ,6004,1104,972,8080
9/10/2016,2016,9,10, 8 ,6647,1223,1070,8940
9/10/2016,2016,9,10, 9 ,7404,1378,1229,10011
9/10/2016,2016,9,10, 10 ,7885,1469,1312,10666
9/10/2016,2016,9,10, 11 ,8225,1537,1385,11147
9/10/2016,2016,9,10, 12 ,8076,1503,1377,10956
9/10/2016,2016,9,10, 13 ,8079,1509,1371,10959
9/10/2016,2016,9,10, 14 ,8325,1541,1378,11244
9/10/2016,2016,9,10, 15 ,8129,1506,1341,10976
9/10/2016,2016,9,10, 16 ,7937,1476,1305,10718
9/10/2016,2016,9,10, 17 ,7594,1459,1305,10358
9/10/2016,2016,9,10, 18 ,7637,1579,1426,10642
9/10/2016,2016,9,10, 19 ,8050,1626,1405,11081
9/10/2016,2016,9,10, 20 ,7957,1573,1351,10881
9/10/2016,2016,9,10, 21 ,7892,1492,1266,10650
9/10/2016,2016,9,10, 22 ,7618,1383,1175,10176
9/10/2016,2016,9,10, 23 ,7211,1287,1071,9569
9/10/2016,2016,9,10, 24 ,6745,1217,994,8956
9/11/2016,2016,9,11, 1 ,6434,1165,957,8556
9/11/2016,2016,9,11, 2 ,6286,1117,943,8346
9/11/2016,2016,9,11, 3 ,6088,1088,917,8093
9/11/2016,2016,9,11, 4 ,5912,1076,891,7879
9/11/2016,2016,9,11, 5 ,5827,1073,898,7798
9/11/2016,2016,9,11, 6 ,5541,1056,903,7500
9/11/2016,2016,9,11, 7 ,5597,1074,903,7574
9/11/2016,2016,9,11, 8 ,5961,1120,942,8023
9/11/2016,2016,9,11, 9 ,6371,1213,1011,8595
9/11/2016,2016,9,11, 10 ,6848,1289,1094,9231
9/11/2016,2016,9,11, 11 ,7155,1369,1165,9689
9/11/2016,2016,9,11, 12 ,7133,1337,1177,9647
9/11/2016,2016,9,11, 13 ,7113,1377,1173,9663
9/11/2016,2016,9,11, 14 ,7155,1369,1220,9744
9/11/2016,2016,9,11, 15 ,7148,1357,1201,9706
9/11/2016,2016,9,11, 16 ,7042,1325,1166,9533
9/11/2016,2016,9,11, 17 ,6856,1308,1163,9327
9/11/2016,2016,9,11, 18 ,6995,1468,1317,9780
9/11/2016,2016,9,11, 19 ,7491,1573,1352,10416
9/11/2016,2016,9,11, 20 ,7578,1522,1313,10413
9/11/2016,2016,9,11, 21 ,7545,1458,1276,10279
9/11/2016,2016,9,11, 22 ,7262,1363,1179,9804
9/11/2016,2016,9,11, 23 ,6978,1252,1087,9317
9/11/2016,2016,9,11, 24 ,6666,1174,1013,8853
9/12/2016,2016,9,12, 1 ,6390,1120,968,8478
9/12/2016,2016,9,12, 2 ,6111,1082,921,8114
9/12/2016,2016,9,12, 3 ,5914,1054,897,7865
9/12/2016,2016,9,12, 4 ,5777,1032,888,7697
9/12/2016,2016,9,12, 5 ,5755,1041,907,7703
9/12/2016,2016,9,12, 6 ,5607,1040,895,7542
9/12/2016,2016,9,12, 7 ,5735,1052,874,7661
9/12/2016,2016,9,12, 8 ,6239,1156,977,8372
9/12/2016,2016,9,12, 9 ,6757,1277,1106,9140
9/12/2016,2016,9,12, 10 ,7213,1399,1160,9772
9/12/2016,2016,9,12, 11 ,7619,1499,1267,10385
9/12/2016,2016,9,12, 12 ,7562,1441,1249,10252
9/12/2016,2016,9,12, 13 ,7616,1443,1261,10320
9/12/2016,2016,9,12, 14 ,7676,1434,1297,10407
9/12/2016,2016,9,12, 15 ,7461,1420,1279,10160
9/12/2016,2016,9,12, 16 ,7190,1404,1262,9856
9/12/2016,2016,9,12, 17 ,7043,1403,1256,9702
9/12/2016,2016,9,12, 18 ,7241,1566,1392,10199
9/12/2016,2016,9,12, 19 ,7641,1594,1359,10594
9/12/2016,2016,9,12, 20 ,7558,1563,1353,10474
9/12/2016,2016,9,12, 21 ,7496,1459,1296,10251
9/12/2016,2016,9,12, 22 ,7087,1328,1166,9581
9/12/2016,2016,9,12, 23 ,6795,1181,1059,9035
9/12/2016,2016,9,12, 24 ,6388,1105,979,8472
9/13/2016,2016,9,13, 1 ,6125,1138,964,8227
9/13/2016,2016,9,13, 2 ,5888,1102,922,7912
9/13/2016,2016,9,13, 3 ,5765,1081,902,7748
9/13/2016,2016,9,13, 4 ,5699,1074,911,7684
9/13/2016,2016,9,13, 5 ,5860,1132,975,7967
9/13/2016,2016,9,13, 6 ,5932,1156,1024,8112
9/13/2016,2016,9,13, 7 ,6145,1131,948,8224
9/13/2016,2016,9,13, 8 ,6999,1324,1095,9418
9/13/2016,2016,9,13, 9 ,7906,1554,1308,10768
9/13/2016,2016,9,13, 10 ,8402,1658,1402,11462
9/13/2016,2016,9,13, 11 ,8688,1724,1477,11889
9/13/2016,2016,9,13, 12 ,8493,1724,1460,11677
9/13/2016,2016,9,13, 13 ,8427,1677,1453,11557
9/13/2016,2016,9,13, 14 ,8701,1707,1479,11887
9/13/2016,2016,9,13, 15 ,8531,1720,1475,11726
9/13/2016,2016,9,13, 16 ,8392,1654,1463,11509
9/13/2016,2016,9,13, 17 ,8123,1592,1414,11129
9/13/2016,2016,9,13, 18 ,8070,1705,1441,11216
9/13/2016,2016,9,13, 19 ,8229,1713,1453,11395
9/13/2016,2016,9,13, 20 ,8034,1640,1399,11073
9/13/2016,2016,9,13, 21 ,7884,1563,1326,10773
9/13/2016,2016,9,13, 22 ,7551,1431,1206,10188
9/13/2016,2016,9,13, 23 ,7152,1333,1120,9605
9/13/2016,2016,9,13, 24 ,6774,1249,1053,9076
9/14/2016,2016,9,14, 1 ,6457,1197,1016,8670
9/14/2016,2016,9,14, 2 ,6260,1144,987,8391
9/14/2016,2016,9,14, 3 ,6137,1127,967,8231
9/14/2016,2016,9,14, 4 ,6093,1123,954,8170
9/14/2016,2016,9,14, 5 ,6201,1136,1001,8338
9/14/2016,2016,9,14, 6 ,6264,1177,1041,8482
9/14/2016,2016,9,14, 7 ,6419,1140,983,8542
9/14/2016,2016,9,14, 8 ,7111,1309,1095,9515
9/14/2016,2016,9,14, 9 ,8022,1544,1271,10837
9/14/2016,2016,9,14, 10 ,8404,1652,1387,11443
9/14/2016,2016,9,14, 11 ,8623,1723,1456,11802
9/14/2016,2016,9,14, 12 ,8237,1667,1436,11340
9/14/2016,2016,9,14, 13 ,8239,1681,1463,11383
9/14/2016,2016,9,14, 14 ,8553,1749,1503,11805
9/14/2016,2016,9,14, 15 ,8486,1717,1489,11692
9/14/2016,2016,9,14, 16 ,8284,1684,1455,11423
9/14/2016,2016,9,14, 17 ,7992,1600,1400,10992
9/14/2016,2016,9,14, 18 ,8053,1723,1480,11256
9/14/2016,2016,9,14, 19 ,8097,1749,1474,11320
9/14/2016,2016,9,14, 20 ,7985,1678,1431,11094
9/14/2016,2016,9,14, 21 ,7810,1603,1400,10813
9/14/2016,2016,9,14, 22 ,7384,1472,1262,10118
9/14/2016,2016,9,14, 23 ,6981,1365,1157,9503
9/14/2016,2016,9,14, 24 ,6579,1287,1138,9004
9/15/2016,2016,9,15, 1 ,6318,1232,1028,8578
9/15/2016,2016,9,15, 2 ,6175,1189,998,8362
9/15/2016,2016,9,15, 3 ,6027,1172,976,8175
9/15/2016,2016,9,15, 4 ,5975,1155,964,8094
9/15/2016,2016,9,15, 5 ,6085,1198,1012,8295
9/15/2016,2016,9,15, 6 ,6139,1214,1053,8406
9/15/2016,2016,9,15, 7 ,6274,1174,1006,8454
9/15/2016,2016,9,15, 8 ,7135,1356,1167,9658
9/15/2016,2016,9,15, 9 ,7932,1577,1262,10771
9/15/2016,2016,9,15, 10 ,8381,1688,1439,11508
9/15/2016,2016,9,15, 11 ,8697,1745,1498,11940
9/15/2016,2016,9,15, 12 ,8482,1703,1249,11434
9/15/2016,2016,9,15, 13 ,8444,1714,1439,11597
9/15/2016,2016,9,15, 14 ,8819,1788,1534,12141
9/15/2016,2016,9,15, 15 ,8695,1734,1528,11957
9/15/2016,2016,9,15, 16 ,8522,1669,1466,11657
9/15/2016,2016,9,15, 17 ,8160,1599,1428,11187
9/15/2016,2016,9,15, 18 ,8138,1734,1534,11406
9/15/2016,2016,9,15, 19 ,8346,1745,1534,11625
9/15/2016,2016,9,15, 20 ,8181,1683,1476,11340
9/15/2016,2016,9,15, 21 ,8016,1602,1426,11044
9/15/2016,2016,9,15, 22 ,7664,1459,1310,10433
9/15/2016,2016,9,15, 23 ,7262,1361,1153,9776
9/15/2016,2016,9,15, 24 ,6860,1278,1139,9277
9/16/2016,2016,9,16, 1 ,6572,1226,1065,8863
9/16/2016,2016,9,16, 2 ,6351,1188,1027,8566
9/16/2016,2016,9,16, 3 ,6230,1160,997,8387
9/16/2016,2016,9,16, 4 ,6109,1146,990,8245
9/16/2016,2016,9,16, 5 ,6205,1181,1041,8427
9/16/2016,2016,9,16, 6 ,6207,1205,1059,8471
9/16/2016,2016,9,16, 7 ,6274,1171,1022,8467
9/16/2016,2016,9,16, 8 ,7164,1340,1150,9654
9/16/2016,2016,9,16, 9 ,8031,1567,1303,10901
9/16/2016,2016,9,16, 10 ,8434,1666,1421,11521
9/16/2016,2016,9,16, 11 ,8744,1750,1480,11974
9/16/2016,2016,9,16, 12 ,8550,1703,1451,11704
9/16/2016,2016,9,16, 13 ,8575,1715,1470,11760
9/16/2016,2016,9,16, 14 ,8947,1777,1528,12252
9/16/2016,2016,9,16, 15 ,8803,1732,1482,12017
9/16/2016,2016,9,16, 16 ,8609,1697,1445,11751
9/16/2016,2016,9,16, 17 ,8205,1607,1404,11216
9/16/2016,2016,9,16, 18 ,8224,1737,1510,11471
9/16/2016,2016,9,16, 19 ,8350,1737,1513,11600
9/16/2016,2016,9,16, 20 ,8287,1654,1472,11413
9/16/2016,2016,9,16, 21 ,8149,1612,1391,11152
9/16/2016,2016,9,16, 22 ,7774,1472,1250,10496
9/16/2016,2016,9,16, 23 ,7395,1389,1191,9975
9/16/2016,2016,9,16, 24 ,7040,1279,1084,9403
9/17/2016,2016,9,17, 1 ,6669,1247,1038,8954
9/17/2016,2016,9,17, 2 ,6501,1210,1003,8714
9/17/2016,2016,9,17, 3 ,6278,1181,978,8437
9/17/2016,2016,9,17, 4 ,6124,1144,961,8229
9/17/2016,2016,9,17, 5 ,6014,1170,975,8159
9/17/2016,2016,9,17, 6 ,5977,1175,970,8122
9/17/2016,2016,9,17, 7 ,6099,1167,973,8239
9/17/2016,2016,9,17, 8 ,6780,1262,1077,9119
9/17/2016,2016,9,17, 9 ,7424,1429,1261,10114
9/17/2016,2016,9,17, 10 ,7983,1537,1336,10856
9/17/2016,2016,9,17, 11 ,8227,1582,1410,11219
9/17/2016,2016,9,17, 12 ,8005,1540,1358,10903
9/17/2016,2016,9,17, 13 ,7937,1547,1366,10850
9/17/2016,2016,9,17, 14 ,8135,1594,1409,11138
9/17/2016,2016,9,17, 15 ,7966,1551,1393,10910
9/17/2016,2016,9,17, 16 ,7724,1532,1383,10639
9/17/2016,2016,9,17, 17 ,7477,1473,1314,10264
9/17/2016,2016,9,17, 18 ,7671,1655,1467,10793
9/17/2016,2016,9,17, 19 ,7943,1691,1467,11101
9/17/2016,2016,9,17, 20 ,7917,1668,1437,11022
9/17/2016,2016,9,17, 21 ,7825,1602,1367,10794
9/17/2016,2016,9,17, 22 ,7550,1487,1229,10266
9/17/2016,2016,9,17, 23 ,7142,1374,1113,9629
9/17/2016,2016,9,17, 24 ,6764,1286,1036,9086
9/18/2016,2016,9,18, 1 ,6426,1224,1019,8669
9/18/2016,2016,9,18, 2 ,6289,1192,989,8470
9/18/2016,2016,9,18, 3 ,6098,1160,970,8228
9/18/2016,2016,9,18, 4 ,5916,1131,949,7996
9/18/2016,2016,9,18, 5 ,5821,1117,958,7896
9/18/2016,2016,9,18, 6 ,5692,1073,962,7727
9/18/2016,2016,9,18, 7 ,5734,1098,921,7753
9/18/2016,2016,9,18, 8 ,5921,1171,973,8065
9/18/2016,2016,9,18, 9 ,6344,1268,1099,8711
9/18/2016,2016,9,18, 10 ,6843,1367,1172,9382
9/18/2016,2016,9,18, 11 ,7066,1420,1226,9712
9/18/2016,2016,9,18, 12 ,7076,1421,1231,9728
9/18/2016,2016,9,18, 13 ,7083,1428,1240,9751
9/18/2016,2016,9,18, 14 ,7197,1432,1230,9859
9/18/2016,2016,9,18, 15 ,7117,1419,1234,9770
9/18/2016,2016,9,18, 16 ,6913,1374,1125,9412
9/18/2016,2016,9,18, 17 ,6789,1376,1167,9332
9/18/2016,2016,9,18, 18 ,7148,1546,1357,10051
9/18/2016,2016,9,18, 19 ,7598,1590,1295,10483
9/18/2016,2016,9,18, 20 ,7666,1572,1253,10491
9/18/2016,2016,9,18, 21 ,7545,1507,1209,10261
9/18/2016,2016,9,18, 22 ,7204,1393,1127,9724
9/18/2016,2016,9,18, 23 ,6888,1287,1054,9229
9/18/2016,2016,9,18, 24 ,6536,1217,980,8733
9/19/2016,2016,9,19, 1 ,6206,1166,940,8312
9/19/2016,2016,9,19, 2 ,5936,1132,919,7987
9/19/2016,2016,9,19, 3 ,5807,1101,887,7795
9/19/2016,2016,9,19, 4 ,5781,1093,889,7763
9/19/2016,2016,9,19, 5 ,5916,1128,945,7989
9/19/2016,2016,9,19, 6 ,6060,1165,995,8220
9/19/2016,2016,9,19, 7 ,6151,1134,932,8217
9/19/2016,2016,9,19, 8 ,7088,1281,1084,9453
9/19/2016,2016,9,19, 9 ,7955,1472,1253,10680
9/19/2016,2016,9,19, 10 ,8530,1585,1380,11495
9/19/2016,2016,9,19, 11 ,8855,1655,1445,11955
9/19/2016,2016,9,19, 12 ,8705,1608,1429,11742
9/19/2016,2016,9,19, 13 ,8616,1614,1402,11632
9/19/2016,2016,9,19, 14 ,8872,1695,1480,12047
9/19/2016,2016,9,19, 15 ,8680,1666,1467,11813
9/19/2016,2016,9,19, 16 ,8483,1619,1434,11536
9/19/2016,2016,9,19, 17 ,8223,1564,1450,11237
9/19/2016,2016,9,19, 18 ,8255,1689,1528,11472
9/19/2016,2016,9,19, 19 ,8282,1695,1471,11448
9/19/2016,2016,9,19, 20 ,8108,1627,1405,11140
9/19/2016,2016,9,19, 21 ,7755,1540,1338,10633
9/19/2016,2016,9,19, 22 ,7325,1430,1215,9970
9/19/2016,2016,9,19, 23 ,6935,1326,1111,9372
9/19/2016,2016,9,19, 24 ,6575,1241,1048,8864
9/20/2016,2016,9,20, 1 ,6314,1194,969,8477
9/20/2016,2016,9,20, 2 ,6158,1162,940,8260
9/20/2016,2016,9,20, 3 ,5995,1133,915,8043
9/20/2016,2016,9,20, 4 ,5941,1119,928,7988
9/20/2016,2016,9,20, 5 ,6092,1147,975,8214
9/20/2016,2016,9,20, 6 ,6152,1157,1044,8353
9/20/2016,2016,9,20, 7 ,6322,1108,973,8403
9/20/2016,2016,9,20, 8 ,7095,1243,1094,9432
9/20/2016,2016,9,20, 9 ,7842,1430,1248,10520
9/20/2016,2016,9,20, 10 ,8346,1518,1362,11226
9/20/2016,2016,9,20, 11 ,8584,1568,1444,11596
9/20/2016,2016,9,20, 12 ,8342,1524,1418,11284
9/20/2016,2016,9,20, 13 ,8230,1526,1413,11169
9/20/2016,2016,9,20, 14 ,8530,1622,1484,11636
9/20/2016,2016,9,20, 15 ,8453,1604,1477,11534
9/20/2016,2016,9,20, 16 ,8313,1590,1435,11338
9/20/2016,2016,9,20, 17 ,8067,1534,1345,10946
9/20/2016,2016,9,20, 18 ,8136,1657,1505,11298
9/20/2016,2016,9,20, 19 ,8136,1653,1474,11263
9/20/2016,2016,9,20, 20 ,8109,1594,1431,11134
9/20/2016,2016,9,20, 21 ,7802,1487,1362,10651
9/20/2016,2016,9,20, 22 ,7517,1344,1220,10081
9/20/2016,2016,9,20, 23 ,7115,1247,1128,9490
9/20/2016,2016,9,20, 24 ,6673,1171,1050,8894
9/21/2016,2016,9,21, 1 ,6385,1111,1007,8503
9/21/2016,2016,9,21, 2 ,6223,1077,978,8278
9/21/2016,2016,9,21, 3 ,6053,1054,953,8060
9/21/2016,2016,9,21, 4 ,5981,1049,944,7974
9/21/2016,2016,9,21, 5 ,6139,1084,1004,8227
9/21/2016,2016,9,21, 6 ,6149,1108,1029,8286
9/21/2016,2016,9,21, 7 ,6289,1101,966,8356
9/21/2016,2016,9,21, 8 ,7151,1224,1155,9530
9/21/2016,2016,9,21, 9 ,7881,1450,1347,10678
9/21/2016,2016,9,21, 10 ,8394,1562,1454,11410
9/21/2016,2016,9,21, 11 ,8673,1634,1502,11809
9/21/2016,2016,9,21, 12 ,8359,1596,1486,11441
9/21/2016,2016,9,21, 13 ,8248,1609,1478,11335
9/21/2016,2016,9,21, 14 ,8458,1692,1548,11698
9/21/2016,2016,9,21, 15 ,8430,1677,1524,11631
9/21/2016,2016,9,21, 16 ,8309,1630,1501,11440
9/21/2016,2016,9,21, 17 ,8064,1565,1443,11072
9/21/2016,2016,9,21, 18 ,8164,1725,1556,11445
9/21/2016,2016,9,21, 19 ,8238,1732,1556,11526
9/21/2016,2016,9,21, 20 ,8120,1683,1499,11302
9/21/2016,2016,9,21, 21 ,7915,1589,1407,10911
9/21/2016,2016,9,21, 22 ,7518,1443,1247,10208
9/21/2016,2016,9,21, 23 ,7099,1344,1179,9622
9/21/2016,2016,9,21, 24 ,6706,1257,1097,9060
9/22/2016,2016,9,22, 1 ,6376,1201,1054,8631
9/22/2016,2016,9,22, 2 ,6175,1165,1024,8364
9/22/2016,2016,9,22, 3 ,6027,1126,986,8139
9/22/2016,2016,9,22, 4 ,5944,1122,985,8051
9/22/2016,2016,9,22, 5 ,6152,1168,1039,8359
9/22/2016,2016,9,22, 6 ,6161,1192,1054,8407
9/22/2016,2016,9,22, 7 ,6295,1152,997,8444
9/22/2016,2016,9,22, 8 ,7052,1328,1156,9536
9/22/2016,2016,9,22, 9 ,7792,1532,1367,10691
9/22/2016,2016,9,22, 10 ,8255,1657,1497,11409
9/22/2016,2016,9,22, 11 ,8581,1710,1540,11831
9/22/2016,2016,9,22, 12 ,8413,1675,1522,11610
9/22/2016,2016,9,22, 13 ,8445,1707,1532,11684
9/22/2016,2016,9,22, 14 ,8699,1769,1584,12052
9/22/2016,2016,9,22, 15 ,8564,1683,1533,11780
9/22/2016,2016,9,22, 16 ,8434,1548,1495,11477
9/22/2016,2016,9,22, 17 ,8143,1619,1410,11172
9/22/2016,2016,9,22, 18 ,8220,1714,1537,11471
9/22/2016,2016,9,22, 19 ,8313,1706,1482,11501
9/22/2016,2016,9,22, 20 ,8193,1659,1406,11258
9/22/2016,2016,9,22, 21 ,7991,1574,1359,10924
9/22/2016,2016,9,22, 22 ,7586,1452,1258,10296
9/22/2016,2016,9,22, 23 ,7199,1350,1144,9693
9/22/2016,2016,9,22, 24 ,6810,1261,1065,9136
9/23/2016,2016,9,23, 1 ,6476,1198,1012,8686
9/23/2016,2016,9,23, 2 ,6238,1150,978,8366
9/23/2016,2016,9,23, 3 ,6102,1125,954,8181
9/23/2016,2016,9,23, 4 ,6028,1124,946,8098
9/23/2016,2016,9,23, 5 ,6131,1153,993,8277
9/23/2016,2016,9,23, 6 ,6141,1189,999,8329
9/23/2016,2016,9,23, 7 ,6303,1154,964,8421
9/23/2016,2016,9,23, 8 ,7157,1323,1117,9597
9/23/2016,2016,9,23, 9 ,7958,1553,1354,10865
9/23/2016,2016,9,23, 10 ,8453,1714,1438,11605
9/23/2016,2016,9,23, 11 ,8779,1746,1521,12046
9/23/2016,2016,9,23, 12 ,8525,1702,1497,11724
9/23/2016,2016,9,23, 13 ,8527,1709,1510,11746
9/23/2016,2016,9,23, 14 ,8882,1728,1560,12170
9/23/2016,2016,9,23, 15 ,8715,1699,1552,11966
9/23/2016,2016,9,23, 16 ,8335,1618,1500,11453
9/23/2016,2016,9,23, 17 ,8007,1578,1443,11028
9/23/2016,2016,9,23, 18 ,7989,1683,1538,11210
9/23/2016,2016,9,23, 19 ,8067,1692,1490,11249
9/23/2016,2016,9,23, 20 ,8020,1645,1449,11114
9/23/2016,2016,9,23, 21 ,7877,1564,1306,10747
9/23/2016,2016,9,23, 22 ,7505,1438,1203,10146
9/23/2016,2016,9,23, 23 ,7119,1338,1107,9564
9/23/2016,2016,9,23, 24 ,6685,1264,1041,8990
9/24/2016,2016,9,24, 1 ,6380,1213,1017,8610
9/24/2016,2016,9,24, 2 ,6186,1172,982,8340
9/24/2016,2016,9,24, 3 ,5999,1139,953,8091
9/24/2016,2016,9,24, 4 ,5929,1126,939,7994
9/24/2016,2016,9,24, 5 ,5871,1131,951,7953
9/24/2016,2016,9,24, 6 ,5743,1135,968,7846
9/24/2016,2016,9,24, 7 ,5882,1141,950,7973
9/24/2016,2016,9,24, 8 ,6549,1215,1047,8811
9/24/2016,2016,9,24, 9 ,7302,1349,1179,9830
9/24/2016,2016,9,24, 10 ,7778,1457,1301,10536
9/24/2016,2016,9,24, 11 ,8093,1531,1356,10980
9/24/2016,2016,9,24, 12 ,7967,1483,1368,10818
9/24/2016,2016,9,24, 13 ,7961,1495,1395,10851
9/24/2016,2016,9,24, 14 ,8098,1537,1427,11062
9/24/2016,2016,9,24, 15 ,7774,1499,1407,10680
9/24/2016,2016,9,24, 16 ,7576,1448,1361,10385
9/24/2016,2016,9,24, 17 ,7320,1433,1339,10092
9/24/2016,2016,9,24, 18 ,7602,1609,1466,10677
9/24/2016,2016,9,24, 19 ,7821,1591,1465,10877
9/24/2016,2016,9,24, 20 ,7795,1555,1442,10792
9/24/2016,2016,9,24, 21 ,7777,1494,1386,10657
9/24/2016,2016,9,24, 22 ,7465,1372,1276,10113
9/24/2016,2016,9,24, 23 ,7027,1271,1117,9415
9/24/2016,2016,9,24, 24 ,6707,1207,1052,8966
9/25/2016,2016,9,25, 1 ,6440,1152,1020,8612
9/25/2016,2016,9,25, 2 ,6202,1117,976,8295
9/25/2016,2016,9,25, 3 ,6038,1093,945,8076
9/25/2016,2016,9,25, 4 ,5895,1071,925,7891
9/25/2016,2016,9,25, 5 ,5792,1079,942,7813
9/25/2016,2016,9,25, 6 ,5608,1066,918,7592
9/25/2016,2016,9,25, 7 ,5616,1058,943,7617
9/25/2016,2016,9,25, 8 ,5892,1128,962,7982
9/25/2016,2016,9,25, 9 ,6343,1230,1052,8625
9/25/2016,2016,9,25, 10 ,6770,1305,1141,9216
9/25/2016,2016,9,25, 11 ,7115,1361,1209,9685
9/25/2016,2016,9,25, 12 ,7037,1326,1202,9565
9/25/2016,2016,9,25, 13 ,7109,1357,1195,9661
9/25/2016,2016,9,25, 14 ,7169,1346,1217,9732
9/25/2016,2016,9,25, 15 ,7068,1336,1194,9598
9/25/2016,2016,9,25, 16 ,6888,1310,1178,9376
9/25/2016,2016,9,25, 17 ,6646,1314,1184,9144
9/25/2016,2016,9,25, 18 ,6965,1475,1393,9833
9/25/2016,2016,9,25, 19 ,7338,1505,1401,10244
9/25/2016,2016,9,25, 20 ,7334,1468,1349,10151
9/25/2016,2016,9,25, 21 ,7158,1398,1308,9864
9/25/2016,2016,9,25, 22 ,6824,1288,1183,9295
9/25/2016,2016,9,25, 23 ,6431,1203,1097,8731
9/25/2016,2016,9,25, 24 ,6144,1134,1018,8296
9/26/2016,2016,9,26, 1 ,5869,1079,984,7932
9/26/2016,2016,9,26, 2 ,5629,1045,952,7626
9/26/2016,2016,9,26, 3 ,5557,1017,927,7501
9/26/2016,2016,9,26, 4 ,5531,1002,921,7454
9/26/2016,2016,9,26, 5 ,5718,1053,970,7741
9/26/2016,2016,9,26, 6 ,5842,1118,1001,7961
9/26/2016,2016,9,26, 7 ,6068,1067,937,8072
9/26/2016,2016,9,26, 8 ,6981,1236,1112,9329
9/26/2016,2016,9,26, 9 ,7810,1496,1312,10618
9/26/2016,2016,9,26, 10 ,8460,1612,1453,11525
9/26/2016,2016,9,26, 11 ,8739,1680,1477,11896
9/26/2016,2016,9,26, 12 ,8622,1631,1464,11717
9/26/2016,2016,9,26, 13 ,8623,1642,1463,11728
9/26/2016,2016,9,26, 14 ,8953,1698,1518,12169
9/26/2016,2016,9,26, 15 ,8830,1640,1494,11964
9/26/2016,2016,9,26, 16 ,8621,1641,1469,11731
9/26/2016,2016,9,26, 17 ,8258,1572,1421,11251
9/26/2016,2016,9,26, 18 ,8286,1667,1538,11491
9/26/2016,2016,9,26, 19 ,8394,1668,1483,11545
9/26/2016,2016,9,26, 20 ,8303,1595,1456,11354
9/26/2016,2016,9,26, 21 ,8100,1525,1357,10982
9/26/2016,2016,9,26, 22 ,7734,1390,1240,10364
9/26/2016,2016,9,26, 23 ,7301,1262,1148,9711
9/26/2016,2016,9,26, 24 ,6914,1215,1078,9207
9/27/2016,2016,9,27, 1 ,6601,1140,1029,8770
9/27/2016,2016,9,27, 2 ,6354,1116,996,8466
9/27/2016,2016,9,27, 3 ,6153,1072,969,8194
9/27/2016,2016,9,27, 4 ,6095,1071,967,8133
9/27/2016,2016,9,27, 5 ,6234,1133,1012,8379
9/27/2016,2016,9,27, 6 ,6249,1166,1038,8453
9/27/2016,2016,9,27, 7 ,6374,1124,975,8473
9/27/2016,2016,9,27, 8 ,7155,1289,1166,9610
9/27/2016,2016,9,27, 9 ,8025,1492,1308,10825
9/27/2016,2016,9,27, 10 ,8456,1595,1489,11540
9/27/2016,2016,9,27, 11 ,8664,1662,1541,11867
9/27/2016,2016,9,27, 12 ,8391,1626,1520,11537
9/27/2016,2016,9,27, 13 ,8360,1620,1524,11504
9/27/2016,2016,9,27, 14 ,8773,1697,1585,12055
9/27/2016,2016,9,27, 15 ,8512,1680,1538,11730
9/27/2016,2016,9,27, 16 ,8353,1643,1476,11472
9/27/2016,2016,9,27, 17 ,8074,1587,1430,11091
9/27/2016,2016,9,27, 18 ,8107,1722,1527,11356
9/27/2016,2016,9,27, 19 ,8116,1656,1487,11259
9/27/2016,2016,9,27, 20 ,7996,1635,1426,11057
9/27/2016,2016,9,27, 21 ,7734,1534,1348,10616
9/27/2016,2016,9,27, 22 ,7326,1388,1202,9916
9/27/2016,2016,9,27, 23 ,6954,1287,1121,9362
9/27/2016,2016,9,27, 24 ,6493,1202,1139,8834
9/28/2016,2016,9,28, 1 ,6261,1155,1027,8443
9/28/2016,2016,9,28, 2 ,6083,1126,996,8205
9/28/2016,2016,9,28, 3 ,5943,1108,971,8022
9/28/2016,2016,9,28, 4 ,5870,1089,982,7941
9/28/2016,2016,9,28, 5 ,5999,1136,1027,8162
9/28/2016,2016,9,28, 6 ,6123,1146,1064,8333
9/28/2016,2016,9,28, 7 ,6175,1123,992,8290
9/28/2016,2016,9,28, 8 ,6867,1259,1116,9242
9/28/2016,2016,9,28, 9 ,7671,1449,1317,10437
9/28/2016,2016,9,28, 10 ,8055,1563,1459,11077
9/28/2016,2016,9,28, 11 ,8262,1608,1514,11384
9/28/2016,2016,9,28, 12 ,7998,1563,1489,11050
9/28/2016,2016,9,28, 13 ,7870,1581,1504,10955
9/28/2016,2016,9,28, 14 ,8090,1652,1566,11308
9/28/2016,2016,9,28, 15 ,7931,1651,1537,11119
9/28/2016,2016,9,28, 16 ,7846,1609,1471,10926
9/28/2016,2016,9,28, 17 ,7760,1577,1444,10781
9/28/2016,2016,9,28, 18 ,7887,1702,1561,11150
9/28/2016,2016,9,28, 19 ,7916,1653,1542,11111
9/28/2016,2016,9,28, 20 ,7753,1592,1469,10814
9/28/2016,2016,9,28, 21 ,7502,1440,1406,10348
9/28/2016,2016,9,28, 22 ,7131,1295,1340,9766
9/28/2016,2016,9,28, 23 ,6715,1207,1278,9200
9/28/2016,2016,9,28, 24 ,6338,1127,1101,8566
9/29/2016,2016,9,29, 1 ,6081,1083,1054,8218
9/29/2016,2016,9,29, 2 ,5911,1052,1021,7984
9/29/2016,2016,9,29, 3 ,5801,1046,981,7828
9/29/2016,2016,9,29, 4 ,5742,1050,967,7759
9/29/2016,2016,9,29, 5 ,5876,1096,1017,7989
9/29/2016,2016,9,29, 6 ,5952,1144,1050,8146
9/29/2016,2016,9,29, 7 ,6092,1106,993,8191
9/29/2016,2016,9,29, 8 ,6687,1266,1120,9073
9/29/2016,2016,9,29, 9 ,7461,1474,1289,10224
9/29/2016,2016,9,29, 10 ,7828,1589,1375,10792
9/29/2016,2016,9,29, 11 ,8044,1657,1437,11138
9/29/2016,2016,9,29, 12 ,7886,1615,1408,10909
9/29/2016,2016,9,29, 13 ,7831,1630,1399,10860
9/29/2016,2016,9,29, 14 ,8147,1672,1456,11275
9/29/2016,2016,9,29, 15 ,8012,1615,1459,11086
9/29/2016,2016,9,29, 16 ,7943,1577,1436,10956
9/29/2016,2016,9,29, 17 ,7779,1556,1414,10749
9/29/2016,2016,9,29, 18 ,7983,1677,1526,11186
9/29/2016,2016,9,29, 19 ,7932,1634,1516,11082
9/29/2016,2016,9,29, 20 ,7735,1578,1471,10784
9/29/2016,2016,9,29, 21 ,7434,1490,1391,10315
9/29/2016,2016,9,29, 22 ,7083,1344,1245,9672
9/29/2016,2016,9,29, 23 ,6610,1255,1151,9016
9/29/2016,2016,9,29, 24 ,6293,1186,1096,8575
9/30/2016,2016,9,30, 1 ,5996,1135,1044,8175
9/30/2016,2016,9,30, 2 ,5883,1100,1012,7995
9/30/2016,2016,9,30, 3 ,5736,1062,1009,7807
9/30/2016,2016,9,30, 4 ,5665,1057,978,7700
9/30/2016,2016,9,30, 5 ,5763,1097,1037,7897
9/30/2016,2016,9,30, 6 ,5885,1126,1059,8070
9/30/2016,2016,9,30, 7 ,6070,1099,1016,8185
9/30/2016,2016,9,30, 8 ,6867,1248,1172,9287
9/30/2016,2016,9,30, 9 ,7670,1502,1324,10496
9/30/2016,2016,9,30, 10 ,8099,1610,1424,11133
9/30/2016,2016,9,30, 11 ,8391,1703,1506,11600
9/30/2016,2016,9,30, 12 ,8167,1643,1474,11284
9/30/2016,2016,9,30, 13 ,8099,1642,1488,11229
9/30/2016,2016,9,30, 14 ,8301,1711,1526,11538
9/30/2016,2016,9,30, 15 ,8068,1665,1484,11217
9/30/2016,2016,9,30, 16 ,7937,1640,1479,11056
9/30/2016,2016,9,30, 17 ,7748,1571,1406,10725
9/30/2016,2016,9,30, 18 ,7978,1716,1554,11248
9/30/2016,2016,9,30, 19 ,7937,1695,1507,11139
9/30/2016,2016,9,30, 20 ,7732,1623,1454,10809
9/30/2016,2016,9,30, 21 ,7551,1548,1375,10474
9/30/2016,2016,9,30, 22 ,7148,1395,1252,9795
9/30/2016,2016,9,30, 23 ,6739,1306,1144,9189
9/30/2016,2016,9,30, 24 ,6311,1233,1074,8618
10/1/2016,2016,10,1, 1 ,6021,1180,1035,8236
10/1/2016,2016,10,1, 2 ,5811,1140,1009,7960
10/1/2016,2016,10,1, 3 ,5677,1114,974,7765
10/1/2016,2016,10,1, 4 ,5570,1089,960,7619
10/1/2016,2016,10,1, 5 ,5528,1105,966,7599
10/1/2016,2016,10,1, 6 ,5533,1111,971,7615
10/1/2016,2016,10,1, 7 ,5687,1124,972,7783
10/1/2016,2016,10,1, 8 ,6286,1249,1048,8583
10/1/2016,2016,10,1, 9 ,6912,1425,1187,9524
10/1/2016,2016,10,1, 10 ,7452,1532,1311,10295
10/1/2016,2016,10,1, 11 ,7833,1604,1373,10810
10/1/2016,2016,10,1, 12 ,7696,1565,1350,10611
10/1/2016,2016,10,1, 13 ,7665,1593,1373,10631
10/1/2016,2016,10,1, 14 ,7911,1612,1410,10933
10/1/2016,2016,10,1, 15 ,7822,1562,1373,10757
10/1/2016,2016,10,1, 16 ,7569,1532,1289,10390
10/1/2016,2016,10,1, 17 ,7182,1451,1319,9952
10/1/2016,2016,10,1, 18 ,7528,1626,1461,10615
10/1/2016,2016,10,1, 19 ,7759,1598,1429,10786
10/1/2016,2016,10,1, 20 ,7691,1583,1377,10651
10/1/2016,2016,10,1, 21 ,7614,1500,1308,10422
10/1/2016,2016,10,1, 22 ,7306,1390,1232,9928
10/1/2016,2016,10,1, 23 ,6898,1276,1124,9298
10/1/2016,2016,10,1, 24 ,6495,1169,1049,8713
10/2/2016,2016,10,2, 1 ,6259,1207,1007,8473
10/2/2016,2016,10,2, 2 ,6025,1161,966,8152
10/2/2016,2016,10,2, 3 ,5830,1135,940,7905
10/2/2016,2016,10,2, 4 ,5743,1100,932,7775
10/2/2016,2016,10,2, 5 ,5602,1104,944,7650
10/2/2016,2016,10,2, 6 ,5397,1062,942,7401
10/2/2016,2016,10,2, 7 ,5458,1054,935,7447
10/2/2016,2016,10,2, 8 ,5855,1120,961,7936
10/2/2016,2016,10,2, 9 ,6296,1217,1013,8526
10/2/2016,2016,10,2, 10 ,6705,1300,1105,9110
10/2/2016,2016,10,2, 11 ,6952,1342,1141,9435
10/2/2016,2016,10,2, 12 ,7022,1346,1138,9506
10/2/2016,2016,10,2, 13 ,6972,1349,1172,9493
10/2/2016,2016,10,2, 14 ,7020,1382,1207,9609
10/2/2016,2016,10,2, 15 ,6924,1353,1194,9471
10/2/2016,2016,10,2, 16 ,6754,1322,1167,9243
10/2/2016,2016,10,2, 17 ,6678,1328,1195,9201
10/2/2016,2016,10,2, 18 ,7135,1567,1416,10118
10/2/2016,2016,10,2, 19 ,7480,1587,1410,10477
10/2/2016,2016,10,2, 20 ,7510,1565,1364,10439
10/2/2016,2016,10,2, 21 ,7347,1495,1291,10133
10/2/2016,2016,10,2, 22 ,7054,1361,1194,9609
10/2/2016,2016,10,2, 23 ,6651,1281,1110,9042
10/2/2016,2016,10,2, 24 ,6332,1205,1033,8570
10/3/2016,2016,10,3, 1 ,6095,1152,985,8232
10/3/2016,2016,10,3, 2 ,5864,1107,951,7922
10/3/2016,2016,10,3, 3 ,5651,1073,925,7649
10/3/2016,2016,10,3, 4 ,5580,1075,916,7571
10/3/2016,2016,10,3, 5 ,5751,1115,944,7810
10/3/2016,2016,10,3, 6 ,5901,1140,973,8014
10/3/2016,2016,10,3, 7 ,6068,1121,958,8147
10/3/2016,2016,10,3, 8 ,6853,1291,1060,9204
10/3/2016,2016,10,3, 9 ,7796,1499,1293,10588
10/3/2016,2016,10,3, 10 ,8322,1604,1389,11315
10/3/2016,2016,10,3, 11 ,8591,1653,1432,11676
10/3/2016,2016,10,3, 12 ,8450,1628,1342,11420
10/3/2016,2016,10,3, 13 ,8460,1626,1391,11477
10/3/2016,2016,10,3, 14 ,8689,1672,1419,11780
10/3/2016,2016,10,3, 15 ,8571,1657,1418,11646
10/3/2016,2016,10,3, 16 ,8406,1614,1345,11365
10/3/2016,2016,10,3, 17 ,8113,1547,1323,10983
10/3/2016,2016,10,3, 18 ,8276,1691,1474,11441
10/3/2016,2016,10,3, 19 ,8206,1679,1443,11328
10/3/2016,2016,10,3, 20 ,8127,1654,1394,11175
10/3/2016,2016,10,3, 21 ,7865,1569,1315,10749
10/3/2016,2016,10,3, 22 ,7461,1431,1199,10091
10/3/2016,2016,10,3, 23 ,7077,1333,1119,9529
10/3/2016,2016,10,3, 24 ,6665,1245,1047,8957
10/4/2016,2016,10,4, 1 ,6360,1211,993,8564
10/4/2016,2016,10,4, 2 ,6144,1172,964,8280
10/4/2016,2016,10,4, 3 ,5978,1149,936,8063
10/4/2016,2016,10,4, 4 ,5927,1139,937,8003
10/4/2016,2016,10,4, 5 ,6048,1177,981,8206
10/4/2016,2016,10,4, 6 ,6084,1198,988,8270
10/4/2016,2016,10,4, 7 ,6190,1157,926,8273
10/4/2016,2016,10,4, 8 ,6988,1302,1110,9400
10/4/2016,2016,10,4, 9 ,7808,1500,1295,10603
10/4/2016,2016,10,4, 10 ,8229,1550,1377,11156
10/4/2016,2016,10,4, 11 ,8483,1604,1459,11546
10/4/2016,2016,10,4, 12 ,8385,1553,1422,11360
10/4/2016,2016,10,4, 13 ,8391,1513,1421,11325
10/4/2016,2016,10,4, 14 ,8628,1585,1437,11650
10/4/2016,2016,10,4, 15 ,8409,1572,1418,11399
10/4/2016,2016,10,4, 16 ,8168,1535,1426,11129
10/4/2016,2016,10,4, 17 ,7987,1495,1379,10861
10/4/2016,2016,10,4, 18 ,8108,1661,1489,11258
10/4/2016,2016,10,4, 19 ,8043,1630,1429,11102
10/4/2016,2016,10,4, 20 ,7923,1513,1373,10809
10/4/2016,2016,10,4, 21 ,7655,1446,1310,10411
10/4/2016,2016,10,4, 22 ,7260,1322,1189,9771
10/4/2016,2016,10,4, 23 ,6747,1230,1092,9069
10/4/2016,2016,10,4, 24 ,6352,1162,1004,8518
10/5/2016,2016,10,5, 1 ,6053,1138,970,8161
10/5/2016,2016,10,5, 2 ,5885,1107,936,7928
10/5/2016,2016,10,5, 3 ,5717,1082,928,7727
10/5/2016,2016,10,5, 4 ,5538,1069,920,7527
10/5/2016,2016,10,5, 5 ,5772,1105,973,7850
10/5/2016,2016,10,5, 6 ,5927,1138,1016,8081
10/5/2016,2016,10,5, 7 ,6053,1111,951,8115
10/5/2016,2016,10,5, 8 ,6714,1265,1105,9084
10/5/2016,2016,10,5, 9 ,7574,1469,1296,10339
10/5/2016,2016,10,5, 10 ,8165,1564,1415,11144
10/5/2016,2016,10,5, 11 ,8425,1616,1462,11503
10/5/2016,2016,10,5, 12 ,8215,1566,1439,11220
10/5/2016,2016,10,5, 13 ,8193,1552,1442,11187
10/5/2016,2016,10,5, 14 ,8471,1608,1479,11558
10/5/2016,2016,10,5, 15 ,8329,1575,1456,11360
10/5/2016,2016,10,5, 16 ,8107,1519,1425,11051
10/5/2016,2016,10,5, 17 ,7921,1488,1402,10811
10/5/2016,2016,10,5, 18 ,8084,1642,1510,11236
10/5/2016,2016,10,5, 19 ,8087,1633,1455,11175
10/5/2016,2016,10,5, 20 ,7963,1544,1397,10904
10/5/2016,2016,10,5, 21 ,7704,1415,1275,10394
10/5/2016,2016,10,5, 22 ,7274,1301,1159,9734
10/5/2016,2016,10,5, 23 ,6825,1222,1085,9132
10/5/2016,2016,10,5, 24 ,6495,1151,986,8632
10/6/2016,2016,10,6, 1 ,6181,1139,961,8281
10/6/2016,2016,10,6, 2 ,5945,1066,949,7960
10/6/2016,2016,10,6, 3 ,5792,1040,935,7767
10/6/2016,2016,10,6, 4 ,5737,1040,928,7705
10/6/2016,2016,10,6, 5 ,5934,1103,978,8015
10/6/2016,2016,10,6, 6 ,5984,1128,1024,8136
10/6/2016,2016,10,6, 7 ,6131,1101,963,8195
10/6/2016,2016,10,6, 8 ,6952,1243,1115,9310
10/6/2016,2016,10,6, 9 ,7760,1457,1323,10540
10/6/2016,2016,10,6, 10 ,8208,1576,1452,11236
10/6/2016,2016,10,6, 11 ,8438,1651,1514,11603
10/6/2016,2016,10,6, 12 ,8338,1596,1459,11393
10/6/2016,2016,10,6, 13 ,8246,1598,1485,11329
10/6/2016,2016,10,6, 14 ,8577,1676,1573,11826
10/6/2016,2016,10,6, 15 ,8436,1663,1505,11604
10/6/2016,2016,10,6, 16 ,8276,1619,1476,11371
10/6/2016,2016,10,6, 17 ,8024,1534,1426,10984
10/6/2016,2016,10,6, 18 ,8207,1697,1556,11460
10/6/2016,2016,10,6, 19 ,8063,1672,1476,11211
10/6/2016,2016,10,6, 20 ,7961,1620,1384,10965
10/6/2016,2016,10,6, 21 ,7673,1509,1300,10482
10/6/2016,2016,10,6, 22 ,7239,1369,1186,9794
10/6/2016,2016,10,6, 23 ,6868,1273,1090,9231
10/6/2016,2016,10,6, 24 ,6462,1190,1018,8670
10/7/2016,2016,10,7, 1 ,6092,1146,1024,8262
10/7/2016,2016,10,7, 2 ,5922,1118,981,8021
10/7/2016,2016,10,7, 3 ,5818,1095,964,7877
10/7/2016,2016,10,7, 4 ,5752,1085,960,7797
10/7/2016,2016,10,7, 5 ,5873,1121,1002,7996
10/7/2016,2016,10,7, 6 ,6007,1155,1041,8203
10/7/2016,2016,10,7, 7 ,6149,1125,1007,8281
10/7/2016,2016,10,7, 8 ,6899,1286,1143,9328
10/7/2016,2016,10,7, 9 ,7661,1523,1191,10375
10/7/2016,2016,10,7, 10 ,8161,1647,1452,11260
10/7/2016,2016,10,7, 11 ,8369,1707,1513,11589
10/7/2016,2016,10,7, 12 ,8121,1667,1471,11259
10/7/2016,2016,10,7, 13 ,8006,1673,1475,11154
10/7/2016,2016,10,7, 14 ,8256,1720,1561,11537
10/7/2016,2016,10,7, 15 ,8152,1679,1535,11366
10/7/2016,2016,10,7, 16 ,8034,1635,1491,11160
10/7/2016,2016,10,7, 17 ,7867,1569,1430,10866
10/7/2016,2016,10,7, 18 ,8010,1716,1549,11275
10/7/2016,2016,10,7, 19 ,7924,1704,1495,11123
10/7/2016,2016,10,7, 20 ,7818,1654,1442,10914
10/7/2016,2016,10,7, 21 ,7620,1571,1373,10564
10/7/2016,2016,10,7, 22 ,7296,1456,1278,10030
10/7/2016,2016,10,7, 23 ,6921,1334,1095,9350
10/7/2016,2016,10,7, 24 ,6534,1260,1046,8840
10/8/2016,2016,10,8, 1 ,6255,1205,1032,8492
10/8/2016,2016,10,8, 2 ,6029,1164,1013,8206
10/8/2016,2016,10,8, 3 ,5837,1135,983,7955
10/8/2016,2016,10,8, 4 ,5772,1116,956,7844
10/8/2016,2016,10,8, 5 ,5744,1123,985,7852
10/8/2016,2016,10,8, 6 ,5787,1120,981,7888
10/8/2016,2016,10,8, 7 ,5923,1129,1004,8056
10/8/2016,2016,10,8, 8 ,6439,1240,1099,8778
10/8/2016,2016,10,8, 9 ,7054,1384,1230,9668
10/8/2016,2016,10,8, 10 ,7508,1520,1381,10409
10/8/2016,2016,10,8, 11 ,7829,1596,1440,10865
10/8/2016,2016,10,8, 12 ,7693,1551,1396,10640
10/8/2016,2016,10,8, 13 ,7553,1547,1405,10505
10/8/2016,2016,10,8, 14 ,7732,1591,1453,10776
10/8/2016,2016,10,8, 15 ,7547,1549,1429,10525
10/8/2016,2016,10,8, 16 ,7347,1516,1396,10259
10/8/2016,2016,10,8, 17 ,7234,1495,1263,9992
10/8/2016,2016,10,8, 18 ,7577,1690,1523,10790
10/8/2016,2016,10,8, 19 ,7626,1673,1482,10781
10/8/2016,2016,10,8, 20 ,7511,1607,1434,10552
10/8/2016,2016,10,8, 21 ,7389,1527,1369,10285
10/8/2016,2016,10,8, 22 ,7102,1402,1257,9761
10/8/2016,2016,10,8, 23 ,6723,1331,1164,9218
10/8/2016,2016,10,8, 24 ,6329,1239,1080,8648
10/9/2016,2016,10,9, 1 ,6064,1185,1044,8293
10/9/2016,2016,10,9, 2 ,5860,1155,1002,8017
10/9/2016,2016,10,9, 3 ,5749,1122,981,7852
10/9/2016,2016,10,9, 4 ,5677,1097,958,7732
10/9/2016,2016,10,9, 5 ,5592,1104,961,7657
10/9/2016,2016,10,9, 6 ,5457,1067,952,7476
10/9/2016,2016,10,9, 7 ,5490,1081,938,7509
10/9/2016,2016,10,9, 8 ,5789,1139,997,7925
10/9/2016,2016,10,9, 9 ,6171,1240,1092,8503
10/9/2016,2016,10,9, 10 ,6592,1319,1205,9116
10/9/2016,2016,10,9, 11 ,6897,1383,1255,9535
10/9/2016,2016,10,9, 12 ,6827,1383,1260,9470
10/9/2016,2016,10,9, 13 ,6801,1420,1229,9450
10/9/2016,2016,10,9, 14 ,6870,1408,1216,9494
10/9/2016,2016,10,9, 15 ,6818,1383,1313,9514
10/9/2016,2016,10,9, 16 ,6665,1341,1225,9231
10/9/2016,2016,10,9, 17 ,6578,1359,1216,9153
10/9/2016,2016,10,9, 18 ,7215,1589,1423,10227
10/9/2016,2016,10,9, 19 ,7446,1599,1350,10395
10/9/2016,2016,10,9, 20 ,7410,1572,1314,10296
10/9/2016,2016,10,9, 21 ,7214,1499,1254,9967
10/9/2016,2016,10,9, 22 ,6977,1379,1146,9502
10/9/2016,2016,10,9, 23 ,6660,1274,1067,9001
10/9/2016,2016,10,9, 24 ,6254,1189,987,8430
10/10/2016,2016,10,10, 1 ,6006,1161,938,8105
10/10/2016,2016,10,10, 2 ,5779,1118,919,7816
10/10/2016,2016,10,10, 3 ,5628,1092,888,7608
10/10/2016,2016,10,10, 4 ,5528,1080,888,7496
10/10/2016,2016,10,10, 5 ,5703,1124,944,7771
10/10/2016,2016,10,10, 6 ,5846,1147,972,7965
10/10/2016,2016,10,10, 7 ,6087,1128,922,8137
10/10/2016,2016,10,10, 8 ,6948,1321,1073,9342
10/10/2016,2016,10,10, 9 ,7893,1555,1310,10758
10/10/2016,2016,10,10, 10 ,8385,1656,1447,11488
10/10/2016,2016,10,10, 11 ,8584,1709,1525,11818
10/10/2016,2016,10,10, 12 ,8350,1683,1483,11516
10/10/2016,2016,10,10, 13 ,8282,1696,1472,11450
10/10/2016,2016,10,10, 14 ,8539,1721,1539,11799
10/10/2016,2016,10,10, 15 ,8409,1710,1524,11643
10/10/2016,2016,10,10, 16 ,8267,1694,1495,11456
10/10/2016,2016,10,10, 17 ,8091,1611,1440,11142
10/10/2016,2016,10,10, 18 ,8304,1743,1568,11615
10/10/2016,2016,10,10, 19 ,8167,1695,1502,11364
10/10/2016,2016,10,10, 20 ,8055,1648,1448,11151
10/10/2016,2016,10,10, 21 ,7846,1558,1358,10762
10/10/2016,2016,10,10, 22 ,7363,1425,1234,10022
10/10/2016,2016,10,10, 23 ,6883,1324,1123,9330
10/10/2016,2016,10,10, 24 ,6464,1241,1022,8727
10/11/2016,2016,10,11, 1 ,6194,1181,1002,8377
10/11/2016,2016,10,11, 2 ,6006,1149,967,8122
10/11/2016,2016,10,11, 3 ,5822,1122,908,7852
10/11/2016,2016,10,11, 4 ,5777,1104,936,7817
10/11/2016,2016,10,11, 5 ,5915,1150,978,8043
10/11/2016,2016,10,11, 6 ,5989,1175,1020,8184
10/11/2016,2016,10,11, 7 ,6075,1133,953,8161
10/11/2016,2016,10,11, 8 ,6878,1310,1111,9299
10/11/2016,2016,10,11, 9 ,7718,1532,1310,10560
10/11/2016,2016,10,11, 10 ,8290,1632,1414,11336
10/11/2016,2016,10,11, 11 ,8570,1703,1469,11742
10/11/2016,2016,10,11, 12 ,8412,1662,1433,11507
10/11/2016,2016,10,11, 13 ,8407,1665,1455,11527
10/11/2016,2016,10,11, 14 ,8750,1705,1492,11947
10/11/2016,2016,10,11, 15 ,8571,1623,1437,11631
10/11/2016,2016,10,11, 16 ,8316,1604,1398,11318
10/11/2016,2016,10,11, 17 ,8044,1574,1414,11032
10/11/2016,2016,10,11, 18 ,8166,1728,1498,11392
10/11/2016,2016,10,11, 19 ,7955,1692,1443,11090
10/11/2016,2016,10,11, 20 ,7854,1623,1394,10871
10/11/2016,2016,10,11, 21 ,7531,1519,1299,10349
10/11/2016,2016,10,11, 22 ,7220,1381,1163,9764
10/11/2016,2016,10,11, 23 ,6808,1287,1061,9156
10/11/2016,2016,10,11, 24 ,6399,1211,1027,8637
10/12/2016,2016,10,12, 1 ,6140,1166,991,8297
10/12/2016,2016,10,12, 2 ,5972,1132,967,8071
10/12/2016,2016,10,12, 3 ,5874,1117,938,7929
10/12/2016,2016,10,12, 4 ,5790,1105,942,7837
10/12/2016,2016,10,12, 5 ,5939,1144,994,8077
10/12/2016,2016,10,12, 6 ,6026,1182,1037,8245
10/12/2016,2016,10,12, 7 ,6144,1140,977,8261
10/12/2016,2016,10,12, 8 ,7069,1302,1085,9456
10/12/2016,2016,10,12, 9 ,7807,1508,1257,10572
10/12/2016,2016,10,12, 10 ,8305,1594,1375,11274
10/12/2016,2016,10,12, 11 ,8494,1653,1417,11564
10/12/2016,2016,10,12, 12 ,8318,1615,1387,11320
10/12/2016,2016,10,12, 13 ,8262,1597,1382,11241
10/12/2016,2016,10,12, 14 ,8434,1627,1384,11445
10/12/2016,2016,10,12, 15 ,8190,1618,1363,11171
10/12/2016,2016,10,12, 16 ,8077,1593,1353,11023
10/12/2016,2016,10,12, 17 ,7899,1581,1355,10835
10/12/2016,2016,10,12, 18 ,8130,1727,1464,11321
10/12/2016,2016,10,12, 19 ,8009,1677,1428,11114
10/12/2016,2016,10,12, 20 ,7893,1631,1376,10900
10/12/2016,2016,10,12, 21 ,7637,1540,1293,10470
10/12/2016,2016,10,12, 22 ,7266,1397,1149,9812
10/12/2016,2016,10,12, 23 ,6795,1295,1079,9169
10/12/2016,2016,10,12, 24 ,6376,1215,1007,8598
10/13/2016,2016,10,13, 1 ,6194,1171,972,8337
10/13/2016,2016,10,13, 2 ,5969,1139,938,8046
10/13/2016,2016,10,13, 3 ,5842,1108,914,7864
10/13/2016,2016,10,13, 4 ,5745,1093,925,7763
10/13/2016,2016,10,13, 5 ,5965,1127,983,8075
10/13/2016,2016,10,13, 6 ,5996,1161,1029,8186
10/13/2016,2016,10,13, 7 ,6129,1136,963,8228
10/13/2016,2016,10,13, 8 ,6938,1293,1102,9333
10/13/2016,2016,10,13, 9 ,7722,1507,1293,10522
10/13/2016,2016,10,13, 10 ,8248,1582,1400,11230
10/13/2016,2016,10,13, 11 ,8487,1670,1451,11608
10/13/2016,2016,10,13, 12 ,8233,1628,1411,11272
10/13/2016,2016,10,13, 13 ,8160,1621,1445,11226
10/13/2016,2016,10,13, 14 ,8427,1701,1491,11619
10/13/2016,2016,10,13, 15 ,8294,1661,1470,11425
10/13/2016,2016,10,13, 16 ,8172,1611,1438,11221
10/13/2016,2016,10,13, 17 ,7925,1571,1392,10888
10/13/2016,2016,10,13, 18 ,8173,1734,1536,11443
10/13/2016,2016,10,13, 19 ,8035,1705,1495,11235
10/13/2016,2016,10,13, 20 ,7848,1645,1441,10934
10/13/2016,2016,10,13, 21 ,7593,1553,1362,10508
10/13/2016,2016,10,13, 22 ,7100,1410,1232,9742
10/13/2016,2016,10,13, 23 ,6754,1297,1134,9185
10/13/2016,2016,10,13, 24 ,6343,1234,1068,8645
10/14/2016,2016,10,14, 1 ,6126,1191,1015,8332
10/14/2016,2016,10,14, 2 ,5972,1153,987,8112
10/14/2016,2016,10,14, 3 ,5766,1125,950,7841
10/14/2016,2016,10,14, 4 ,5735,1113,939,7787
10/14/2016,2016,10,14, 5 ,5831,1149,984,7964
10/14/2016,2016,10,14, 6 ,5938,1193,1020,8151
10/14/2016,2016,10,14, 7 ,6021,1163,960,8144
10/14/2016,2016,10,14, 8 ,6827,1310,1108,9245
10/14/2016,2016,10,14, 9 ,7564,1519,1307,10390
10/14/2016,2016,10,14, 10 ,8108,1591,1416,11115
10/14/2016,2016,10,14, 11 ,8360,1636,1496,11492
10/14/2016,2016,10,14, 12 ,8173,1563,1448,11184
10/14/2016,2016,10,14, 13 ,8135,1543,1456,11134
10/14/2016,2016,10,14, 14 ,8494,1603,1507,11604
10/14/2016,2016,10,14, 15 ,8356,1558,1482,11396
10/14/2016,2016,10,14, 16 ,8185,1547,1446,11178
10/14/2016,2016,10,14, 17 ,7955,1533,1391,10879
10/14/2016,2016,10,14, 18 ,8223,1677,1525,11425
10/14/2016,2016,10,14, 19 ,8084,1634,1467,11185
10/14/2016,2016,10,14, 20 ,7986,1565,1384,10935
10/14/2016,2016,10,14, 21 ,7808,1413,1362,10583
10/14/2016,2016,10,14, 22 ,7539,1323,1243,10105
10/14/2016,2016,10,14, 23 ,7173,1238,1165,9576
10/14/2016,2016,10,14, 24 ,6745,1183,1084,9012
10/15/2016,2016,10,15, 1 ,6469,1136,1036,8641
10/15/2016,2016,10,15, 2 ,6254,1114,996,8364
10/15/2016,2016,10,15, 3 ,6056,1099,974,8129
10/15/2016,2016,10,15, 4 ,5933,1075,972,7980
10/15/2016,2016,10,15, 5 ,5922,1098,972,7992
10/15/2016,2016,10,15, 6 ,5970,1124,975,8069
10/15/2016,2016,10,15, 7 ,6063,1126,979,8168
10/15/2016,2016,10,15, 8 ,6546,1220,1081,8847
10/15/2016,2016,10,15, 9 ,7115,1388,1201,9704
10/15/2016,2016,10,15, 10 ,7473,1476,1302,10251
10/15/2016,2016,10,15, 11 ,7765,1514,1363,10642
10/15/2016,2016,10,15, 12 ,7587,1489,1324,10400
10/15/2016,2016,10,15, 13 ,7384,1477,1288,10149
10/15/2016,2016,10,15, 14 ,7554,1528,1348,10430
10/15/2016,2016,10,15, 15 ,7364,1489,1319,10172
10/15/2016,2016,10,15, 16 ,7250,1464,1292,10006
10/15/2016,2016,10,15, 17 ,7262,1461,1260,9983
10/15/2016,2016,10,15, 18 ,7565,1636,1451,10652
10/15/2016,2016,10,15, 19 ,7462,1605,1423,10490
10/15/2016,2016,10,15, 20 ,7317,1548,1287,10152
10/15/2016,2016,10,15, 21 ,7170,1492,1339,10001
10/15/2016,2016,10,15, 22 ,6915,1371,1211,9497
10/15/2016,2016,10,15, 23 ,6619,1268,1144,9031
10/15/2016,2016,10,15, 24 ,6230,1195,1022,8447
10/16/2016,2016,10,16, 1 ,5800,1142,1014,7956
10/16/2016,2016,10,16, 2 ,5620,1119,963,7702
10/16/2016,2016,10,16, 3 ,5411,1093,954,7458
10/16/2016,2016,10,16, 4 ,5218,1075,937,7230
10/16/2016,2016,10,16, 5 ,5112,1067,948,7127
10/16/2016,2016,10,16, 6 ,5009,1059,913,6981
10/16/2016,2016,10,16, 7 ,4961,1068,909,6938
10/16/2016,2016,10,16, 8 ,5151,1128,964,7243
10/16/2016,2016,10,16, 9 ,5128,1204,1035,7367
10/16/2016,2016,10,16, 10 ,5864,1269,1133,8266
10/16/2016,2016,10,16, 11 ,6022,1312,1190,8524
10/16/2016,2016,10,16, 12 ,5950,1315,1200,8465
10/16/2016,2016,10,16, 13 ,5998,1290,1200,8488
10/16/2016,2016,10,16, 14 ,6054,1290,1197,8541
10/16/2016,2016,10,16, 15 ,6039,1271,1178,8488
10/16/2016,2016,10,16, 16 ,6020,1247,1164,8431
10/16/2016,2016,10,16, 17 ,6134,1293,1173,8600
10/16/2016,2016,10,16, 18 ,6768,1536,1407,9711
10/16/2016,2016,10,16, 19 ,6802,1533,1398,9733
10/16/2016,2016,10,16, 20 ,6774,1495,1364,9633
10/16/2016,2016,10,16, 21 ,6672,1412,1303,9387
10/16/2016,2016,10,16, 22 ,6302,1305,1206,8813
10/16/2016,2016,10,16, 23 ,6030,1217,1112,8359
10/16/2016,2016,10,16, 24 ,5766,1156,1039,7961
10/17/2016,2016,10,17, 1 ,5476,1099,989,7564
10/17/2016,2016,10,17, 2 ,5308,1064,954,7326
10/17/2016,2016,10,17, 3 ,5170,1034,929,7133
10/17/2016,2016,10,17, 4 ,5055,1035,918,7008
10/17/2016,2016,10,17, 5 ,5275,1081,976,7332
10/17/2016,2016,10,17, 6 ,5495,1130,1011,7636
10/17/2016,2016,10,17, 7 ,5813,1113,956,7882
10/17/2016,2016,10,17, 8 ,6631,1300,1121,9052
10/17/2016,2016,10,17, 9 ,7480,1527,1342,10349
10/17/2016,2016,10,17, 10 ,8039,1646,1434,11119
10/17/2016,2016,10,17, 11 ,8360,1724,1534,11618
10/17/2016,2016,10,17, 12 ,8226,1672,1523,11421
10/17/2016,2016,10,17, 13 ,8216,1677,1526,11419
10/17/2016,2016,10,17, 14 ,8396,1745,1571,11712
10/17/2016,2016,10,17, 15 ,8236,1722,1559,11517
10/17/2016,2016,10,17, 16 ,8097,1656,1510,11263
10/17/2016,2016,10,17, 17 ,7902,1609,1469,10980
10/17/2016,2016,10,17, 18 ,8194,1767,1577,11538
10/17/2016,2016,10,17, 19 ,8023,1739,1545,11307
10/17/2016,2016,10,17, 20 ,7819,1688,1482,10989
10/17/2016,2016,10,17, 21 ,7649,1597,1414,10660
10/17/2016,2016,10,17, 22 ,7200,1440,1270,9910
10/17/2016,2016,10,17, 23 ,6773,1327,1177,9277
10/17/2016,2016,10,17, 24 ,6452,1218,1107,8777
10/18/2016,2016,10,18, 1 ,6151,1217,1066,8434
10/18/2016,2016,10,18, 2 ,5993,1183,1032,8208
10/18/2016,2016,10,18, 3 ,5825,1148,1008,7981
10/18/2016,2016,10,18, 4 ,5777,1138,996,7911
10/18/2016,2016,10,18, 5 ,5900,1177,1063,8140
10/18/2016,2016,10,18, 6 ,6031,1197,1091,8319
10/18/2016,2016,10,18, 7 ,6114,1171,1004,8289
10/18/2016,2016,10,18, 8 ,7001,1366,1183,9550
10/18/2016,2016,10,18, 9 ,7804,1615,1425,10844
10/18/2016,2016,10,18, 10 ,8408,1709,1493,11610
10/18/2016,2016,10,18, 11 ,8623,1751,1555,11929
10/18/2016,2016,10,18, 12 ,8474,1711,1509,11694
10/18/2016,2016,10,18, 13 ,8494,1719,1558,11771
10/18/2016,2016,10,18, 14 ,8832,1797,1563,12192
10/18/2016,2016,10,18, 15 ,8698,1766,1555,12019
10/18/2016,2016,10,18, 16 ,8517,1715,1530,11762
10/18/2016,2016,10,18, 17 ,8187,1619,1487,11293
10/18/2016,2016,10,18, 18 ,8428,1792,1570,11790
10/18/2016,2016,10,18, 19 ,8313,1751,1536,11600
10/18/2016,2016,10,18, 20 ,8240,1708,1484,11432
10/18/2016,2016,10,18, 21 ,8016,1648,1381,11045
10/18/2016,2016,10,18, 22 ,7615,1503,1245,10363
10/18/2016,2016,10,18, 23 ,7217,1402,1162,9781
10/18/2016,2016,10,18, 24 ,6760,1329,1096,9185
10/19/2016,2016,10,19, 1 ,6491,1267,1056,8814
10/19/2016,2016,10,19, 2 ,6276,1239,1028,8543
10/19/2016,2016,10,19, 3 ,6128,1193,994,8315
10/19/2016,2016,10,19, 4 ,6048,1186,993,8227
10/19/2016,2016,10,19, 5 ,6177,1219,1039,8435
10/19/2016,2016,10,19, 6 ,6243,1218,1056,8517
10/19/2016,2016,10,19, 7 ,6299,1193,969,8461
10/19/2016,2016,10,19, 8 ,7090,1348,1150,9588
10/19/2016,2016,10,19, 9 ,7841,1565,1333,10739
10/19/2016,2016,10,19, 10 ,8397,1656,1390,11443
10/19/2016,2016,10,19, 11 ,8562,1715,1479,11756
10/19/2016,2016,10,19, 12 ,8265,1688,1450,11403
10/19/2016,2016,10,19, 13 ,8192,1677,1490,11359
10/19/2016,2016,10,19, 14 ,8426,1743,1501,11670
10/19/2016,2016,10,19, 15 ,8224,1721,1491,11436
10/19/2016,2016,10,19, 16 ,8178,1695,1468,11341
10/19/2016,2016,10,19, 17 ,7989,1629,1447,11065
10/19/2016,2016,10,19, 18 ,8234,1803,1556,11593
10/19/2016,2016,10,19, 19 ,7964,1765,1490,11219
10/19/2016,2016,10,19, 20 ,7874,1717,1465,11056
10/19/2016,2016,10,19, 21 ,7554,1634,1379,10567
10/19/2016,2016,10,19, 22 ,7225,1509,1233,9967
10/19/2016,2016,10,19, 23 ,6819,1398,1146,9363
10/19/2016,2016,10,19, 24 ,6434,1303,1068,8805
10/20/2016,2016,10,20, 1 ,6125,1257,1024,8406
10/20/2016,2016,10,20, 2 ,5910,1212,997,8119
10/20/2016,2016,10,20, 3 ,5777,1204,975,7956
10/20/2016,2016,10,20, 4 ,5695,1183,975,7853
10/20/2016,2016,10,20, 5 ,5708,1230,1029,7967
10/20/2016,2016,10,20, 6 ,5765,1261,1070,8096
10/20/2016,2016,10,20, 7 ,6047,1230,1012,8289
10/20/2016,2016,10,20, 8 ,6707,1391,1186,9284
10/20/2016,2016,10,20, 9 ,7390,1589,1360,10339
10/20/2016,2016,10,20, 10 ,7711,1705,1496,10912
10/20/2016,2016,10,20, 11 ,7959,1751,1546,11256
10/20/2016,2016,10,20, 12 ,7803,1695,1513,11011
10/20/2016,2016,10,20, 13 ,7747,1712,1528,10987
10/20/2016,2016,10,20, 14 ,7947,1761,1582,11290
10/20/2016,2016,10,20, 15 ,7854,1716,1557,11127
10/20/2016,2016,10,20, 16 ,7731,1695,1537,10963
10/20/2016,2016,10,20, 17 ,7634,1627,1486,10747
10/20/2016,2016,10,20, 18 ,7857,1802,1603,11262
10/20/2016,2016,10,20, 19 ,7681,1757,1504,10942
10/20/2016,2016,10,20, 20 ,7499,1706,1429,10634
10/20/2016,2016,10,20, 21 ,7383,1629,1354,10366
10/20/2016,2016,10,20, 22 ,7055,1501,1188,9744
10/20/2016,2016,10,20, 23 ,6677,1385,1089,9151
10/20/2016,2016,10,20, 24 ,6332,1276,1060,8668
10/21/2016,2016,10,21, 1 ,6044,1237,1028,8309
10/21/2016,2016,10,21, 2 ,5892,1214,1001,8107
10/21/2016,2016,10,21, 3 ,5805,1174,967,7946
10/21/2016,2016,10,21, 4 ,5659,1165,950,7774
10/21/2016,2016,10,21, 5 ,5808,1192,1007,8007
10/21/2016,2016,10,21, 6 ,5892,1212,1040,8144
10/21/2016,2016,10,21, 7 ,6040,1189,971,8200
10/21/2016,2016,10,21, 8 ,6868,1355,1087,9310
10/21/2016,2016,10,21, 9 ,7691,1543,1329,10563
10/21/2016,2016,10,21, 10 ,8248,1647,1449,11344
10/21/2016,2016,10,21, 11 ,8428,1688,1493,11609
10/21/2016,2016,10,21, 12 ,8253,1658,1462,11373
10/21/2016,2016,10,21, 13 ,8305,1671,1467,11443
10/21/2016,2016,10,21, 14 ,8616,1720,1523,11859
10/21/2016,2016,10,21, 15 ,8422,1689,1511,11622
10/21/2016,2016,10,21, 16 ,8315,1639,1500,11454
10/21/2016,2016,10,21, 17 ,7943,1599,1465,11007
10/21/2016,2016,10,21, 18 ,8164,1794,1527,11485
10/21/2016,2016,10,21, 19 ,8023,1732,1465,11220
10/21/2016,2016,10,21, 20 ,7920,1681,1425,11026
10/21/2016,2016,10,21, 21 ,7760,1599,1355,10714
10/21/2016,2016,10,21, 22 ,7446,1464,1221,10131
10/21/2016,2016,10,21, 23 ,7099,1379,1123,9601
10/21/2016,2016,10,21, 24 ,6690,1293,1063,9046
10/22/2016,2016,10,22, 1 ,6471,1237,1031,8739
10/22/2016,2016,10,22, 2 ,6236,1206,998,8440
10/22/2016,2016,10,22, 3 ,6039,1177,966,8182
10/22/2016,2016,10,22, 4 ,5911,1156,953,8020
10/22/2016,2016,10,22, 5 ,5861,1168,970,7999
10/22/2016,2016,10,22, 6 ,5801,1164,967,7932
10/22/2016,2016,10,22, 7 ,5950,1172,991,8113
10/22/2016,2016,10,22, 8 ,6556,1283,1081,8920
10/22/2016,2016,10,22, 9 ,7238,1445,1235,9918
10/22/2016,2016,10,22, 10 ,7788,1552,1300,10640
10/22/2016,2016,10,22, 11 ,8135,1633,1404,11172
10/22/2016,2016,10,22, 12 ,8019,1621,1397,11037
10/22/2016,2016,10,22, 13 ,7987,1617,1402,11006
10/22/2016,2016,10,22, 14 ,8136,1645,1450,11231
10/22/2016,2016,10,22, 15 ,7996,1636,1424,11056
10/22/2016,2016,10,22, 16 ,7743,1568,1368,10679
10/22/2016,2016,10,22, 17 ,7449,1533,1348,10330
10/22/2016,2016,10,22, 18 ,7891,1731,1502,11124
10/22/2016,2016,10,22, 19 ,7866,1702,1472,11040
10/22/2016,2016,10,22, 20 ,7756,1666,1416,10838
10/22/2016,2016,10,22, 21 ,7732,1574,1360,10666
10/22/2016,2016,10,22, 22 ,7480,1494,1264,10238
10/22/2016,2016,10,22, 23 ,7156,1368,1164,9688
10/22/2016,2016,10,22, 24 ,6718,1294,1067,9079
10/23/2016,2016,10,23, 1 ,6427,1242,1038,8707
10/23/2016,2016,10,23, 2 ,6244,1211,1004,8459
10/23/2016,2016,10,23, 3 ,6129,1178,974,8281
10/23/2016,2016,10,23, 4 ,5955,1156,961,8072
10/23/2016,2016,10,23, 5 ,5888,1158,964,8010
10/23/2016,2016,10,23, 6 ,5643,1127,958,7728
10/23/2016,2016,10,23, 7 ,5680,1135,952,7767
10/23/2016,2016,10,23, 8 ,6001,1194,1001,8196
10/23/2016,2016,10,23, 9 ,6414,1287,1083,8784
10/23/2016,2016,10,23, 10 ,6916,1376,1174,9466
10/23/2016,2016,10,23, 11 ,7201,1443,1205,9849
10/23/2016,2016,10,23, 12 ,7136,1445,1245,9826
10/23/2016,2016,10,23, 13 ,7219,1442,1259,9920
10/23/2016,2016,10,23, 14 ,7275,1456,1281,10012
10/23/2016,2016,10,23, 15 ,7190,1432,1253,9875
10/23/2016,2016,10,23, 16 ,7006,1384,1206,9596
10/23/2016,2016,10,23, 17 ,6818,1404,1213,9435
10/23/2016,2016,10,23, 18 ,7362,1627,1413,10402
10/23/2016,2016,10,23, 19 ,7521,1629,1403,10553
10/23/2016,2016,10,23, 20 ,7551,1599,1358,10508
10/23/2016,2016,10,23, 21 ,7449,1519,1303,10271
10/23/2016,2016,10,23, 22 ,7239,1411,1199,9849
10/23/2016,2016,10,23, 23 ,6882,1320,1113,9315
10/23/2016,2016,10,23, 24 ,6471,1245,1047,8763
10/24/2016,2016,10,24, 1 ,6242,1188,996,8426
10/24/2016,2016,10,24, 2 ,5975,1143,962,8080
10/24/2016,2016,10,24, 3 ,5824,1125,935,7884
10/24/2016,2016,10,24, 4 ,5701,1102,922,7725
10/24/2016,2016,10,24, 5 ,5753,1126,936,7815
10/24/2016,2016,10,24, 6 ,5815,1140,969,7924
10/24/2016,2016,10,24, 7 ,6129,1173,987,8289
10/24/2016,2016,10,24, 8 ,7017,1328,1165,9510
10/24/2016,2016,10,24, 9 ,7935,1563,1388,10886
10/24/2016,2016,10,24, 10 ,8476,1653,1522,11651
10/24/2016,2016,10,24, 11 ,8778,1722,1586,12086
10/24/2016,2016,10,24, 12 ,8661,1702,1573,11936
10/24/2016,2016,10,24, 13 ,8678,1695,1579,11952
10/24/2016,2016,10,24, 14 ,8935,1759,1627,12321
10/24/2016,2016,10,24, 15 ,8763,1737,1623,12123
10/24/2016,2016,10,24, 16 ,8607,1718,1556,11881
10/24/2016,2016,10,24, 17 ,8284,1644,1502,11430
10/24/2016,2016,10,24, 18 ,8458,1791,1638,11887
10/24/2016,2016,10,24, 19 ,8321,1758,1553,11632
10/24/2016,2016,10,24, 20 ,8202,1699,1520,11421
10/24/2016,2016,10,24, 21 ,7985,1621,1463,11069
10/24/2016,2016,10,24, 22 ,7646,1476,1332,10454
10/24/2016,2016,10,24, 23 ,7242,1388,1232,9862
10/24/2016,2016,10,24, 24 ,6863,1297,1166,9326
10/25/2016,2016,10,25, 1 ,6502,1264,1090,8856
10/25/2016,2016,10,25, 2 ,6309,1223,1051,8583
10/25/2016,2016,10,25, 3 ,6089,1188,1019,8296
10/25/2016,2016,10,25, 4 ,6003,1170,1008,8181
10/25/2016,2016,10,25, 5 ,5990,1191,1030,8211
10/25/2016,2016,10,25, 6 ,5974,1190,1041,8205
10/25/2016,2016,10,25, 7 ,6204,1197,1050,8451
10/25/2016,2016,10,25, 8 ,7077,1383,1225,9685
10/25/2016,2016,10,25, 9 ,7862,1614,1404,10880
10/25/2016,2016,10,25, 10 ,8351,1724,1538,11613
10/25/2016,2016,10,25, 11 ,8685,1779,1615,12079
10/25/2016,2016,10,25, 12 ,8546,1755,1586,11887
10/25/2016,2016,10,25, 13 ,8553,1764,1596,11913
10/25/2016,2016,10,25, 14 ,8905,1780,1628,12313
10/25/2016,2016,10,25, 15 ,8786,1765,1556,12107
10/25/2016,2016,10,25, 16 ,8612,1735,1540,11887
10/25/2016,2016,10,25, 17 ,8205,1650,1488,11343
10/25/2016,2016,10,25, 18 ,8480,1823,1530,11833
10/25/2016,2016,10,25, 19 ,8332,1785,1525,11642
10/25/2016,2016,10,25, 20 ,8160,1718,1474,11352
10/25/2016,2016,10,25, 21 ,7935,1640,1374,10949
10/25/2016,2016,10,25, 22 ,7692,1508,1277,10477
10/25/2016,2016,10,25, 23 ,7266,1409,1200,9875
10/25/2016,2016,10,25, 24 ,6899,1333,1117,9349
10/26/2016,2016,10,26, 1 ,6584,1268,1037,8889
10/26/2016,2016,10,26, 2 ,6407,1235,1021,8663
10/26/2016,2016,10,26, 3 ,6211,1204,994,8409
10/26/2016,2016,10,26, 4 ,6132,1187,979,8298
10/26/2016,2016,10,26, 5 ,6136,1200,1018,8354
10/26/2016,2016,10,26, 6 ,6131,1198,1009,8338
10/26/2016,2016,10,26, 7 ,6400,1208,1022,8630
10/26/2016,2016,10,26, 8 ,7119,1357,1178,9654
10/26/2016,2016,10,26, 9 ,7950,1572,1371,10893
10/26/2016,2016,10,26, 10 ,8388,1696,1481,11565
10/26/2016,2016,10,26, 11 ,8690,1740,1538,11968
10/26/2016,2016,10,26, 12 ,8489,1697,1513,11699
10/26/2016,2016,10,26, 13 ,8434,1720,1496,11650
10/26/2016,2016,10,26, 14 ,8649,1789,1527,11965
10/26/2016,2016,10,26, 15 ,8579,1770,1473,11822
10/26/2016,2016,10,26, 16 ,8482,1729,1460,11671
10/26/2016,2016,10,26, 17 ,8093,1652,1441,11186
10/26/2016,2016,10,26, 18 ,8363,1816,1530,11709
10/26/2016,2016,10,26, 19 ,8232,1772,1435,11439
10/26/2016,2016,10,26, 20 ,8077,1719,1446,11242
10/26/2016,2016,10,26, 21 ,7862,1629,1335,10826
10/26/2016,2016,10,26, 22 ,7591,1503,1231,10325
10/26/2016,2016,10,26, 23 ,7154,1407,1110,9671
10/26/2016,2016,10,26, 24 ,6785,1320,1017,9122
10/27/2016,2016,10,27, 1 ,6461,1267,1016,8744
10/27/2016,2016,10,27, 2 ,6279,1232,987,8498
10/27/2016,2016,10,27, 3 ,6119,1196,965,8280
10/27/2016,2016,10,27, 4 ,6067,1171,957,8195
10/27/2016,2016,10,27, 5 ,6040,1189,978,8207
10/27/2016,2016,10,27, 6 ,6038,1197,1020,8255
10/27/2016,2016,10,27, 7 ,6317,1194,1014,8525
10/27/2016,2016,10,27, 8 ,7091,1339,1164,9594
10/27/2016,2016,10,27, 9 ,7889,1538,1316,10743
10/27/2016,2016,10,27, 10 ,8388,1560,1418,11366
10/27/2016,2016,10,27, 11 ,8659,1624,1493,11776
10/27/2016,2016,10,27, 12 ,8448,1581,1459,11488
10/27/2016,2016,10,27, 13 ,8429,1573,1479,11481
10/27/2016,2016,10,27, 14 ,8760,1633,1518,11911
10/27/2016,2016,10,27, 15 ,8599,1633,1448,11680
10/27/2016,2016,10,27, 16 ,8442,1628,1464,11534
10/27/2016,2016,10,27, 17 ,8147,1590,1442,11179
10/27/2016,2016,10,27, 18 ,8355,1748,1534,11637
10/27/2016,2016,10,27, 19 ,8233,1677,1480,11390
10/27/2016,2016,10,27, 20 ,8082,1643,1445,11170
10/27/2016,2016,10,27, 21 ,7918,1562,1343,10823
10/27/2016,2016,10,27, 22 ,7539,1423,1222,10184
10/27/2016,2016,10,27, 23 ,7198,1330,1142,9670
10/27/2016,2016,10,27, 24 ,6730,1263,1087,9080
10/28/2016,2016,10,28, 1 ,6526,1201,1028,8755
10/28/2016,2016,10,28, 2 ,6356,1179,1000,8535
10/28/2016,2016,10,28, 3 ,6210,1148,981,8339
10/28/2016,2016,10,28, 4 ,5993,1141,975,8109
10/28/2016,2016,10,28, 5 ,6004,1155,996,8155
10/28/2016,2016,10,28, 6 ,6042,1174,1023,8239
10/28/2016,2016,10,28, 7 ,6269,1169,1024,8462
10/28/2016,2016,10,28, 8 ,7128,1338,1151,9617
10/28/2016,2016,10,28, 9 ,7947,1549,1357,10853
10/28/2016,2016,10,28, 10 ,8418,1637,1463,11518
10/28/2016,2016,10,28, 11 ,8663,1696,1505,11864
10/28/2016,2016,10,28, 12 ,8491,1625,1472,11588
10/28/2016,2016,10,28, 13 ,8470,1665,1469,11604
10/28/2016,2016,10,28, 14 ,8812,1723,1522,12057
10/28/2016,2016,10,28, 15 ,8654,1696,1501,11851
10/28/2016,2016,10,28, 16 ,8471,1651,1397,11519
10/28/2016,2016,10,28, 17 ,8073,1598,1444,11115
10/28/2016,2016,10,28, 18 ,8348,1767,1538,11653
10/28/2016,2016,10,28, 19 ,8215,1725,1472,11412
10/28/2016,2016,10,28, 20 ,8094,1675,1414,11183
10/28/2016,2016,10,28, 21 ,7935,1584,1321,10840
10/28/2016,2016,10,28, 22 ,7714,1461,1214,10389
10/28/2016,2016,10,28, 23 ,7261,1350,1146,9757
10/28/2016,2016,10,28, 24 ,6890,1286,1091,9267
10/29/2016,2016,10,29, 1 ,6580,1231,1027,8838
10/29/2016,2016,10,29, 2 ,6416,1194,1000,8610
10/29/2016,2016,10,29, 3 ,6209,1166,973,8348
10/29/2016,2016,10,29, 4 ,6032,1145,965,8142
10/29/2016,2016,10,29, 5 ,6066,1148,978,8192
10/29/2016,2016,10,29, 6 ,5855,1142,988,7985
10/29/2016,2016,10,29, 7 ,6001,1159,1008,8168
10/29/2016,2016,10,29, 8 ,6521,1266,1098,8885
10/29/2016,2016,10,29, 9 ,7151,1426,1271,9848
10/29/2016,2016,10,29, 10 ,7608,1507,1340,10455
10/29/2016,2016,10,29, 11 ,7904,1576,1401,10881
10/29/2016,2016,10,29, 12 ,7791,1524,1367,10682
10/29/2016,2016,10,29, 13 ,7755,1496,1363,10614
10/29/2016,2016,10,29, 14 ,7985,1553,1409,10947
10/29/2016,2016,10,29, 15 ,7792,1517,1374,10683
10/29/2016,2016,10,29, 16 ,7566,1449,1338,10353
10/29/2016,2016,10,29, 17 ,7276,1479,1296,10051
10/29/2016,2016,10,29, 18 ,7698,1680,1438,10816
10/29/2016,2016,10,29, 19 ,7720,1645,1420,10785
10/29/2016,2016,10,29, 20 ,7583,1588,1345,10516
10/29/2016,2016,10,29, 21 ,7583,1526,1302,10411
10/29/2016,2016,10,29, 22 ,7351,1421,1195,9967
10/29/2016,2016,10,29, 23 ,7013,1292,1105,9410
10/29/2016,2016,10,29, 24 ,6554,1198,1008,8760
10/30/2016,2016,10,30, 1 ,6360,1147,976,8483
10/30/2016,2016,10,30, 2 ,6151,1109,951,8211
10/30/2016,2016,10,30, 3 ,5980,1084,927,7991
10/30/2016,2016,10,30, 4 ,5782,1055,909,7746
10/30/2016,2016,10,30, 5 ,5703,1065,931,7699
10/30/2016,2016,10,30, 6 ,5505,1054,934,7493
10/30/2016,2016,10,30, 7 ,5438,1069,934,7441
10/30/2016,2016,10,30, 8 ,5818,1102,988,7908
10/30/2016,2016,10,30, 9 ,6288,1184,1069,8541
10/30/2016,2016,10,30, 10 ,6740,1253,1163,9156
10/30/2016,2016,10,30, 11 ,6930,1291,1230,9451
10/30/2016,2016,10,30, 12 ,6880,1300,1220,9400
10/30/2016,2016,10,30, 13 ,6915,1312,1224,9451
10/30/2016,2016,10,30, 14 ,7005,1317,1235,9557
10/30/2016,2016,10,30, 15 ,6867,1305,1216,9388
10/30/2016,2016,10,30, 16 ,6645,1289,1182,9116
10/30/2016,2016,10,30, 17 ,6579,1306,1232,9117
10/30/2016,2016,10,30, 18 ,7201,1536,1376,10113
10/30/2016,2016,10,30, 19 ,7198,1518,1333,10049
10/30/2016,2016,10,30, 20 ,7226,1490,1290,10006
10/30/2016,2016,10,30, 21 ,7007,1420,1212,9639
10/30/2016,2016,10,30, 22 ,6843,1320,1137,9300
10/30/2016,2016,10,30, 23 ,6527,1245,1065,8837
10/30/2016,2016,10,30, 24 ,6205,1171,997,8373
10/31/2016,2016,10,31, 1 ,5950,1131,952,8033
10/31/2016,2016,10,31, 2 ,5700,1096,933,7729
10/31/2016,2016,10,31, 3 ,5528,1072,896,7496
10/31/2016,2016,10,31, 4 ,5368,1049,892,7309
10/31/2016,2016,10,31, 5 ,5268,1055,910,7233
10/31/2016,2016,10,31, 6 ,5169,1051,916,7136
10/31/2016,2016,10,31, 7 ,5223,1067,922,7212
10/31/2016,2016,10,31, 8 ,5516,1134,999,7649
10/31/2016,2016,10,31, 9 ,5958,1238,1108,8304
10/31/2016,2016,10,31, 10 ,6418,1316,1220,8954
10/31/2016,2016,10,31, 11 ,6766,1374,1290,9430
10/31/2016,2016,10,31, 12 ,6682,1353,1264,9299
10/31/2016,2016,10,31, 13 ,6759,1345,1238,9342
10/31/2016,2016,10,31, 14 ,6795,1374,1294,9463
10/31/2016,2016,10,31, 15 ,6728,1329,1269,9326
10/31/2016,2016,10,31, 16 ,6543,1310,1241,9094
10/31/2016,2016,10,31, 17 ,6303,1336,1269,8908
10/31/2016,2016,10,31, 18 ,6844,1533,1394,9771
10/31/2016,2016,10,31, 19 ,6858,1503,1336,9697
10/31/2016,2016,10,31, 20 ,6884,1471,1275,9630
10/31/2016,2016,10,31, 21 ,6760,1371,1195,9326
10/31/2016,2016,10,31, 22 ,6524,1263,1082,8869
10/31/2016,2016,10,31, 23 ,6167,1183,992,8342
10/31/2016,2016,10,31, 24 ,5896,1101,943,7940
11/1/2016,2016,11,1, 1 ,5638,1065,905,7608
11/1/2016,2016,11,1, 2 ,5403,1034,888,7325
11/1/2016,2016,11,1, 3 ,5207,1002,867,7076
11/1/2016,2016,11,1, 4 ,5102,985,857,6944
11/1/2016,2016,11,1, 5 ,5017,996,877,6890
11/1/2016,2016,11,1, 6 ,4826,991,887,6704
11/1/2016,2016,11,1, 7 ,4727,985,887,6599
11/1/2016,2016,11,1, 8 ,4840,1026,910,6776
11/1/2016,2016,11,1, 9 ,4995,1080,970,7045
11/1/2016,2016,11,1, 10 ,5170,1121,1035,7326
11/1/2016,2016,11,1, 11 ,5571,1181,1090,7842
11/1/2016,2016,11,1, 12 ,5744,1206,1102,8052
11/1/2016,2016,11,1, 13 ,5759,1227,1094,8080
11/1/2016,2016,11,1, 14 ,5773,1228,1078,8079
11/1/2016,2016,11,1, 15 ,5695,1219,1072,7986
11/1/2016,2016,11,1, 16 ,5490,1183,1060,7733
11/1/2016,2016,11,1, 17 ,5395,1215,1110,7720
11/1/2016,2016,11,1, 18 ,6070,1407,1273,8750
11/1/2016,2016,11,1, 19 ,6207,1408,1231,8846
11/1/2016,2016,11,1, 20 ,6266,1375,1202,8843
11/1/2016,2016,11,1, 21 ,6238,1335,1146,8719
11/1/2016,2016,11,1, 22 ,6024,1234,1034,8292
11/1/2016,2016,11,1, 23 ,5687,1168,970,7825
11/1/2016,2016,11,1, 24 ,5437,1087,932,7456
11/2/2016,2016,11,2, 1 ,5199,1069,873,7141
11/2/2016,2016,11,2, 2 ,5061,1039,852,6952
11/2/2016,2016,11,2, 3 ,4919,1019,829,6767
11/2/2016,2016,11,2, 4 ,4831,1006,827,6664
11/2/2016,2016,11,2, 5 ,4898,1034,864,6796
11/2/2016,2016,11,2, 6 ,5067,1052,882,7001
11/2/2016,2016,11,2, 7 ,5420,1062,898,7380
11/2/2016,2016,11,2, 8 ,6283,1179,1007,8469
11/2/2016,2016,11,2, 9 ,7161,1346,1175,9682
11/2/2016,2016,11,2, 10 ,7618,1447,1253,10318
11/2/2016,2016,11,2, 11 ,7798,1482,1325,10605
11/2/2016,2016,11,2, 12 ,7590,1503,1334,10427
11/2/2016,2016,11,2, 13 ,7425,1506,1330,10261
11/2/2016,2016,11,2, 14 ,7734,1534,1352,10620
11/2/2016,2016,11,2, 15 ,7644,1501,1324,10469
11/2/2016,2016,11,2, 16 ,7572,1470,1311,10353
11/2/2016,2016,11,2, 17 ,7372,1460,1286,10118
11/2/2016,2016,11,2, 18 ,7717,1644,1428,10789
11/2/2016,2016,11,2, 19 ,7469,1612,1363,10444
11/2/2016,2016,11,2, 20 ,7363,1542,1300,10205
11/2/2016,2016,11,2, 21 ,7148,1468,1216,9832
11/2/2016,2016,11,2, 22 ,6825,1340,1100,9265
11/2/2016,2016,11,2, 23 ,6368,1257,1031,8656
11/2/2016,2016,11,2, 24 ,5984,1194,933,8111
11/3/2016,2016,11,3, 1 ,5788,1131,906,7825
11/3/2016,2016,11,3, 2 ,5671,1073,885,7629
11/3/2016,2016,11,3, 3 ,5525,1064,894,7483
11/3/2016,2016,11,3, 4 ,5450,1051,887,7388
11/3/2016,2016,11,3, 5 ,5587,1083,940,7610
11/3/2016,2016,11,3, 6 ,5696,1129,999,7824
11/3/2016,2016,11,3, 7 ,5863,1114,959,7936
11/3/2016,2016,11,3, 8 ,6675,1214,1093,8982
11/3/2016,2016,11,3, 9 ,7417,1405,1272,10094
11/3/2016,2016,11,3, 10 ,7972,1513,1387,10872
11/3/2016,2016,11,3, 11 ,8169,1582,1445,11196
11/3/2016,2016,11,3, 12 ,8049,1552,1431,11032
11/3/2016,2016,11,3, 13 ,7969,1538,1428,10935
11/3/2016,2016,11,3, 14 ,8260,1591,1470,11321
11/3/2016,2016,11,3, 15 ,8153,1566,1449,11168
11/3/2016,2016,11,3, 16 ,8013,1544,1453,11010
11/3/2016,2016,11,3, 17 ,7835,1548,1443,10826
11/3/2016,2016,11,3, 18 ,8141,1691,1539,11371
11/3/2016,2016,11,3, 19 ,7880,1636,1433,10949
11/3/2016,2016,11,3, 20 ,7689,1555,1367,10611
11/3/2016,2016,11,3, 21 ,7491,1457,1325,10273
11/3/2016,2016,11,3, 22 ,7108,1334,1190,9632
11/3/2016,2016,11,3, 23 ,6739,1243,1107,9089
11/3/2016,2016,11,3, 24 ,6348,1168,1004,8520
11/4/2016,2016,11,4, 1 ,6115,1109,986,8210
11/4/2016,2016,11,4, 2 ,5936,1072,964,7972
11/4/2016,2016,11,4, 3 ,5761,1055,946,7762
11/4/2016,2016,11,4, 4 ,5643,1033,949,7625
11/4/2016,2016,11,4, 5 ,5808,1063,974,7845
11/4/2016,2016,11,4, 6 ,5912,1112,1021,8045
11/4/2016,2016,11,4, 7 ,6032,1096,983,8111
11/4/2016,2016,11,4, 8 ,6753,1215,1140,9108
11/4/2016,2016,11,4, 9 ,7461,1411,1280,10152
11/4/2016,2016,11,4, 10 ,7842,1493,1397,10732
11/4/2016,2016,11,4, 11 ,8012,1543,1449,11004
11/4/2016,2016,11,4, 12 ,7738,1494,1382,10614
11/4/2016,2016,11,4, 13 ,7670,1461,1362,10493
11/4/2016,2016,11,4, 14 ,7905,1494,1441,10840
11/4/2016,2016,11,4, 15 ,7879,1475,1372,10726
11/4/2016,2016,11,4, 16 ,7794,1468,1336,10598
11/4/2016,2016,11,4, 17 ,7620,1490,1350,10460
11/4/2016,2016,11,4, 18 ,7967,1606,1501,11074
11/4/2016,2016,11,4, 19 ,7724,1533,1421,10678
11/4/2016,2016,11,4, 20 ,7550,1472,1359,10381
11/4/2016,2016,11,4, 21 ,7339,1385,1288,10012
11/4/2016,2016,11,4, 22 ,6952,1259,1170,9381
11/4/2016,2016,11,4, 23 ,6566,1176,1107,8849
11/4/2016,2016,11,4, 24 ,6206,1108,1030,8344
11/5/2016,2016,11,5, 1 ,5929,1064,989,7982
11/5/2016,2016,11,5, 2 ,5808,1032,952,7792
11/5/2016,2016,11,5, 3 ,5630,1022,932,7584
11/5/2016,2016,11,5, 4 ,5516,1012,920,7448
11/5/2016,2016,11,5, 5 ,5510,1038,945,7493
11/5/2016,2016,11,5, 6 ,5488,1050,964,7502
11/5/2016,2016,11,5, 7 ,5656,1064,978,7698
11/5/2016,2016,11,5, 8 ,6245,1159,1062,8466
11/5/2016,2016,11,5, 9 ,6927,1314,1187,9428
11/5/2016,2016,11,5, 10 ,7484,1393,1265,10142
11/5/2016,2016,11,5, 11 ,7778,1456,1330,10564
11/5/2016,2016,11,5, 12 ,7655,1429,1309,10393
11/5/2016,2016,11,5, 13 ,7654,1437,1311,10402
11/5/2016,2016,11,5, 14 ,7875,1487,1346,10708
11/5/2016,2016,11,5, 15 ,7808,1473,1315,10596
11/5/2016,2016,11,5, 16 ,7550,1454,1332,10336
11/5/2016,2016,11,5, 17 ,7259,1427,1372,10058
11/5/2016,2016,11,5, 18 ,7753,1619,1480,10852
11/5/2016,2016,11,5, 19 ,7725,1581,1373,10679
11/5/2016,2016,11,5, 20 ,7625,1521,1307,10453
11/5/2016,2016,11,5, 21 ,7579,1433,1247,10259
11/5/2016,2016,11,5, 22 ,7292,1322,1155,9769
11/5/2016,2016,11,5, 23 ,6867,1226,1032,9125
11/5/2016,2016,11,5, 24 ,6503,1151,935,8589
11/6/2016,2016,11,6, 1 ,6193,1113,936,8242
11/6/2016,2016,11,6, 2 ,5949,1071,823,7843
11/6/2016,2016,11,6, 3 ,5782,1049,813,7644
11/6/2016,2016,11,6, 4 ,5594,1031,772,7397
11/6/2016,2016,11,6, 5 ,5522,1037,850,7409
11/6/2016,2016,11,6, 6 ,5395,1026,867,7288
11/6/2016,2016,11,6, 7 ,5368,1046,878,7292
11/6/2016,2016,11,6, 8 ,5738,1099,936,7773
11/6/2016,2016,11,6, 9 ,6123,1191,1010,8324
11/6/2016,2016,11,6, 10 ,6686,1302,1114,9102
11/6/2016,2016,11,6, 11 ,6951,1355,1174,9480
11/6/2016,2016,11,6, 12 ,6943,1368,1187,9498
11/6/2016,2016,11,6, 13 ,6943,1346,1170,9459
11/6/2016,2016,11,6, 14 ,7024,1358,1174,9556
11/6/2016,2016,11,6, 15 ,6853,1306,1128,9287
11/6/2016,2016,11,6, 16 ,6579,1261,1109,8949
11/6/2016,2016,11,6, 17 ,6451,1293,1184,8928
11/6/2016,2016,11,6, 18 ,7143,1527,1365,10035
11/6/2016,2016,11,6, 19 ,7168,1506,1334,10008
11/6/2016,2016,11,6, 20 ,7139,1457,1296,9892
11/6/2016,2016,11,6, 21 ,7033,1375,1218,9626
11/6/2016,2016,11,6, 22 ,6744,1267,1123,9134
11/6/2016,2016,11,6, 23 ,6433,1187,1042,8662
11/6/2016,2016,11,6, 24 ,6017,1101,967,8085
11/7/2016,2016,11,7, 1 ,5826,1049,930,7805
11/7/2016,2016,11,7, 2 ,5546,1015,900,7461
11/7/2016,2016,11,7, 3 ,5413,992,876,7281
11/7/2016,2016,11,7, 4 ,5356,987,877,7220
11/7/2016,2016,11,7, 5 ,5516,1027,938,7481
11/7/2016,2016,11,7, 6 ,5668,1079,993,7740
11/7/2016,2016,11,7, 7 ,5802,1036,937,7775
11/7/2016,2016,11,7, 8 ,6766,1210,1099,9075
11/7/2016,2016,11,7, 9 ,7589,1427,1286,10302
11/7/2016,2016,11,7, 10 ,8094,1555,1418,11067
11/7/2016,2016,11,7, 11 ,8330,1601,1456,11387
11/7/2016,2016,11,7, 12 ,8163,1561,1450,11174
11/7/2016,2016,11,7, 13 ,8143,1559,1413,11115
11/7/2016,2016,11,7, 14 ,8441,1608,1516,11565
11/7/2016,2016,11,7, 15 ,8323,1589,1498,11410
11/7/2016,2016,11,7, 16 ,8169,1548,1475,11192
11/7/2016,2016,11,7, 17 ,7884,1508,1452,10844
11/7/2016,2016,11,7, 18 ,8175,1685,1579,11439
11/7/2016,2016,11,7, 19 ,7911,1634,1504,11049
11/7/2016,2016,11,7, 20 ,7806,1568,1456,10830
11/7/2016,2016,11,7, 21 ,7559,1483,1374,10416
11/7/2016,2016,11,7, 22 ,7210,1339,1233,9782
11/7/2016,2016,11,7, 23 ,6782,1238,1138,9158
11/7/2016,2016,11,7, 24 ,6336,1162,1045,8543
11/8/2016,2016,11,8, 1 ,6045,1115,1017,8177
11/8/2016,2016,11,8, 2 ,5859,1082,991,7932
11/8/2016,2016,11,8, 3 ,5673,1062,953,7688
11/8/2016,2016,11,8, 4 ,5636,1048,949,7633
11/8/2016,2016,11,8, 5 ,5771,1099,1015,7885
11/8/2016,2016,11,8, 6 ,5882,1134,1040,8056
11/8/2016,2016,11,8, 7 ,5955,1102,970,8027
11/8/2016,2016,11,8, 8 ,6824,1254,1129,9207
11/8/2016,2016,11,8, 9 ,7568,1450,1328,10346
11/8/2016,2016,11,8, 10 ,8053,1528,1425,11006
11/8/2016,2016,11,8, 11 ,8350,1601,1494,11445
11/8/2016,2016,11,8, 12 ,8136,1529,1450,11115
11/8/2016,2016,11,8, 13 ,8174,1562,1497,11233
11/8/2016,2016,11,8, 14 ,8507,1634,1521,11662
11/8/2016,2016,11,8, 15 ,8307,1622,1497,11426
11/8/2016,2016,11,8, 16 ,8123,1579,1469,11171
11/8/2016,2016,11,8, 17 ,7811,1530,1435,10776
11/8/2016,2016,11,8, 18 ,8108,1721,1557,11386
11/8/2016,2016,11,8, 19 ,7921,1655,1487,11063
11/8/2016,2016,11,8, 20 ,7745,1589,1459,10793
11/8/2016,2016,11,8, 21 ,7444,1499,1370,10313
11/8/2016,2016,11,8, 22 ,7040,1358,1223,9621
11/8/2016,2016,11,8, 23 ,6589,1259,1112,8960
11/8/2016,2016,11,8, 24 ,6185,1143,1055,8383
11/9/2016,2016,11,9, 1 ,5919,1128,1016,8063
11/9/2016,2016,11,9, 2 ,5739,1085,993,7817
11/9/2016,2016,11,9, 3 ,5598,1068,954,7620
11/9/2016,2016,11,9, 4 ,5514,1063,959,7536
11/9/2016,2016,11,9, 5 ,5671,1088,1013,7772
11/9/2016,2016,11,9, 6 ,5744,1160,1050,7954
11/9/2016,2016,11,9, 7 ,5935,1130,980,8045
11/9/2016,2016,11,9, 8 ,6660,1258,1135,9053
11/9/2016,2016,11,9, 9 ,7421,1463,1320,10204
11/9/2016,2016,11,9, 10 ,7912,1565,1433,10910
11/9/2016,2016,11,9, 11 ,8166,1626,1484,11276
11/9/2016,2016,11,9, 12 ,7954,1581,1457,10992
11/9/2016,2016,11,9, 13 ,7940,1625,1464,11029
11/9/2016,2016,11,9, 14 ,8272,1675,1524,11471
11/9/2016,2016,11,9, 15 ,8177,1648,1481,11306
11/9/2016,2016,11,9, 16 ,7969,1621,1450,11040
11/9/2016,2016,11,9, 17 ,7672,1557,1422,10651
11/9/2016,2016,11,9, 18 ,8068,1743,1566,11377
11/9/2016,2016,11,9, 19 ,7863,1682,1510,11055
11/9/2016,2016,11,9, 20 ,7674,1621,1461,10756
11/9/2016,2016,11,9, 21 ,7435,1536,1366,10337
11/9/2016,2016,11,9, 22 ,7021,1383,1207,9611
11/9/2016,2016,11,9, 23 ,6559,1289,1140,8988
11/9/2016,2016,11,9, 24 ,6177,1208,1063,8448
11/10/2016,2016,11,10, 1 ,5947,1176,1022,8145
11/10/2016,2016,11,10, 2 ,5763,1137,983,7883
11/10/2016,2016,11,10, 3 ,5607,1110,958,7675
11/10/2016,2016,11,10, 4 ,5515,1100,954,7569
11/10/2016,2016,11,10, 5 ,5718,1128,1015,7861
11/10/2016,2016,11,10, 6 ,5848,1167,1052,8067
11/10/2016,2016,11,10, 7 ,5887,1127,993,8007
11/10/2016,2016,11,10, 8 ,6653,1300,1142,9095
11/10/2016,2016,11,10, 9 ,7353,1507,1333,10193
11/10/2016,2016,11,10, 10 ,7892,1625,1471,10988
11/10/2016,2016,11,10, 11 ,8171,1697,1497,11365
11/10/2016,2016,11,10, 12 ,7977,1641,1476,11094
11/10/2016,2016,11,10, 13 ,7945,1637,1454,11036
11/10/2016,2016,11,10, 14 ,8252,1700,1527,11479
11/10/2016,2016,11,10, 15 ,8150,1687,1511,11348
11/10/2016,2016,11,10, 16 ,8004,1656,1479,11139
11/10/2016,2016,11,10, 17 ,7753,1583,1444,10780
11/10/2016,2016,11,10, 18 ,8195,1763,1608,11566
11/10/2016,2016,11,10, 19 ,8016,1710,1522,11248
11/10/2016,2016,11,10, 20 ,7786,1644,1473,10903
11/10/2016,2016,11,10, 21 ,7672,1545,1404,10621
11/10/2016,2016,11,10, 22 ,7211,1400,1251,9862
11/10/2016,2016,11,10, 23 ,6832,1304,1167,9303
11/10/2016,2016,11,10, 24 ,6410,1217,1072,8699
11/11/2016,2016,11,11, 1 ,6127,1163,1038,8328
11/11/2016,2016,11,11, 2 ,5982,1129,1007,8118
11/11/2016,2016,11,11, 3 ,5795,1104,973,7872
11/11/2016,2016,11,11, 4 ,5710,1090,971,7771
11/11/2016,2016,11,11, 5 ,5831,1129,1020,7980
11/11/2016,2016,11,11, 6 ,5935,1167,1054,8156
11/11/2016,2016,11,11, 7 ,6054,1128,987,8169
11/11/2016,2016,11,11, 8 ,6868,1288,1114,9270
11/11/2016,2016,11,11, 9 ,7611,1517,1351,10479
11/11/2016,2016,11,11, 10 ,8091,1621,1475,11187
11/11/2016,2016,11,11, 11 ,8253,1709,1533,11495
11/11/2016,2016,11,11, 12 ,8021,1661,1489,11171
11/11/2016,2016,11,11, 13 ,7954,1630,1501,11085
11/11/2016,2016,11,11, 14 ,8224,1719,1564,11507
11/11/2016,2016,11,11, 15 ,8126,1676,1553,11355
11/11/2016,2016,11,11, 16 ,7948,1641,1504,11093
11/11/2016,2016,11,11, 17 ,7805,1574,1475,10854
11/11/2016,2016,11,11, 18 ,8095,1757,1609,11461
11/11/2016,2016,11,11, 19 ,7849,1690,1521,11060
11/11/2016,2016,11,11, 20 ,7669,1639,1467,10775
11/11/2016,2016,11,11, 21 ,7505,1549,1380,10434
11/11/2016,2016,11,11, 22 ,7171,1414,1264,9849
11/11/2016,2016,11,11, 23 ,6791,1316,1182,9289
11/11/2016,2016,11,11, 24 ,6396,1230,1063,8689
11/12/2016,2016,11,12, 1 ,6113,1187,1056,8356
11/12/2016,2016,11,12, 2 ,5959,1154,1030,8143
11/12/2016,2016,11,12, 3 ,5788,1128,1001,7917
11/12/2016,2016,11,12, 4 ,5680,1128,991,7799
11/12/2016,2016,11,12, 5 ,5690,1142,977,7809
11/12/2016,2016,11,12, 6 ,5694,1145,1018,7857
11/12/2016,2016,11,12, 7 ,5804,1164,1011,7979
11/12/2016,2016,11,12, 8 ,6349,1257,1091,8697
11/12/2016,2016,11,12, 9 ,7023,1430,1240,9693
11/12/2016,2016,11,12, 10 ,7460,1522,1358,10340
11/12/2016,2016,11,12, 11 ,7743,1577,1382,10702
11/12/2016,2016,11,12, 12 ,7582,1544,1386,10512
11/12/2016,2016,11,12, 13 ,7529,1554,1396,10479
11/12/2016,2016,11,12, 14 ,7767,1581,1499,10847
11/12/2016,2016,11,12, 15 ,7604,1556,1413,10573
11/12/2016,2016,11,12, 16 ,7403,1518,1378,10299
11/12/2016,2016,11,12, 17 ,7193,1506,1366,10065
11/12/2016,2016,11,12, 18 ,7728,1685,1523,10936
11/12/2016,2016,11,12, 19 ,7659,1641,1484,10784
11/12/2016,2016,11,12, 20 ,7536,1589,1461,10586
11/12/2016,2016,11,12, 21 ,7442,1496,1403,10341
11/12/2016,2016,11,12, 22 ,7123,1371,1305,9799
11/12/2016,2016,11,12, 23 ,6744,1314,1236,9294
11/12/2016,2016,11,12, 24 ,6392,1230,1097,8719
11/13/2016,2016,11,13, 1 ,6140,1193,1042,8375
11/13/2016,2016,11,13, 2 ,5927,1151,1014,8092
11/13/2016,2016,11,13, 3 ,5785,1125,982,7892
11/13/2016,2016,11,13, 4 ,5642,1101,969,7712
11/13/2016,2016,11,13, 5 ,5556,1099,971,7626
11/13/2016,2016,11,13, 6 ,5403,1085,966,7454
11/13/2016,2016,11,13, 7 ,5418,1112,947,7477
11/13/2016,2016,11,13, 8 ,5601,1144,992,7737
11/13/2016,2016,11,13, 9 ,5992,1212,1067,8271
11/13/2016,2016,11,13, 10 ,6430,1305,1140,8875
11/13/2016,2016,11,13, 11 ,6751,1361,1203,9315
11/13/2016,2016,11,13, 12 ,6617,1368,1208,9193
11/13/2016,2016,11,13, 13 ,6711,1375,1190,9276
11/13/2016,2016,11,13, 14 ,6738,1354,1207,9299
11/13/2016,2016,11,13, 15 ,6638,1342,1180,9160
11/13/2016,2016,11,13, 16 ,6483,1340,1160,8983
11/13/2016,2016,11,13, 17 ,6400,1352,1194,8946
11/13/2016,2016,11,13, 18 ,7122,1637,1384,10143
11/13/2016,2016,11,13, 19 ,7050,1593,1372,10015
11/13/2016,2016,11,13, 20 ,7063,1556,1349,9968
11/13/2016,2016,11,13, 21 ,6893,1472,1266,9631
11/13/2016,2016,11,13, 22 ,6556,1364,1143,9063
11/13/2016,2016,11,13, 23 ,6254,1285,1069,8608
11/13/2016,2016,11,13, 24 ,5918,1214,999,8131
11/14/2016,2016,11,14, 1 ,5693,1171,960,7824
11/14/2016,2016,11,14, 2 ,5513,1140,932,7585
11/14/2016,2016,11,14, 3 ,5428,1110,905,7443
11/14/2016,2016,11,14, 4 ,5337,1102,906,7345
11/14/2016,2016,11,14, 5 ,5530,1154,971,7655
11/14/2016,2016,11,14, 6 ,5700,1194,1005,7899
11/14/2016,2016,11,14, 7 ,5894,1161,943,7998
11/14/2016,2016,11,14, 8 ,6883,1329,1123,9335
11/14/2016,2016,11,14, 9 ,7565,1563,1338,10466
11/14/2016,2016,11,14, 10 ,8118,1652,1464,11234
11/14/2016,2016,11,14, 11 ,8601,1724,1539,11864
11/14/2016,2016,11,14, 12 ,8384,1694,1520,11598
11/14/2016,2016,11,14, 13 ,8167,1671,1527,11365
11/14/2016,2016,11,14, 14 ,8571,1737,1572,11880
11/14/2016,2016,11,14, 15 ,8521,1730,1564,11815
11/14/2016,2016,11,14, 16 ,8344,1690,1540,11574
11/14/2016,2016,11,14, 17 ,7982,1642,1472,11096
11/14/2016,2016,11,14, 18 ,8301,1805,1612,11718
11/14/2016,2016,11,14, 19 ,8129,1736,1556,11421
11/14/2016,2016,11,14, 20 ,7949,1685,1512,11146
11/14/2016,2016,11,14, 21 ,7764,1583,1416,10763
11/14/2016,2016,11,14, 22 ,7339,1448,1284,10071
11/14/2016,2016,11,14, 23 ,6906,1335,1185,9426
11/14/2016,2016,11,14, 24 ,6488,1257,1101,8846
11/15/2016,2016,11,15, 1 ,6221,1218,1062,8501
11/15/2016,2016,11,15, 2 ,6061,1187,1020,8268
11/15/2016,2016,11,15, 3 ,5930,1139,995,8064
11/15/2016,2016,11,15, 4 ,5843,1128,988,7959
11/15/2016,2016,11,15, 5 ,5997,1172,1043,8212
11/15/2016,2016,11,15, 6 ,6129,1208,1070,8407
11/15/2016,2016,11,15, 7 ,6199,1153,1008,8360
11/15/2016,2016,11,15, 8 ,6955,1335,1176,9466
11/15/2016,2016,11,15, 9 ,7677,1566,1382,10625
11/15/2016,2016,11,15, 10 ,8029,1674,1503,11206
11/15/2016,2016,11,15, 11 ,8239,1738,1579,11556
11/15/2016,2016,11,15, 12 ,7957,1706,1540,11203
11/15/2016,2016,11,15, 13 ,7820,1698,1549,11067
11/15/2016,2016,11,15, 14 ,7969,1774,1581,11324
11/15/2016,2016,11,15, 15 ,7905,1749,1570,11224
11/15/2016,2016,11,15, 16 ,7771,1719,1543,11033
11/15/2016,2016,11,15, 17 ,7640,1666,1524,10830
11/15/2016,2016,11,15, 18 ,8021,1820,1619,11460
11/15/2016,2016,11,15, 19 ,7820,1770,1524,11114
11/15/2016,2016,11,15, 20 ,5488,1707,1482,8677
11/15/2016,2016,11,15, 21 ,7025,1614,1416,10055
11/15/2016,2016,11,15, 22 ,6781,1488,1274,9543
11/15/2016,2016,11,15, 23 ,6449,1365,1163,8977
11/15/2016,2016,11,15, 24 ,6131,1287,1107,8525
11/16/2016,2016,11,16, 1 ,5910,1235,1063,8208
11/16/2016,2016,11,16, 2 ,5753,1202,1044,7999
11/16/2016,2016,11,16, 3 ,5651,1164,1010,7825
11/16/2016,2016,11,16, 4 ,5551,1156,998,7705
11/16/2016,2016,11,16, 5 ,5777,1189,1049,8015
11/16/2016,2016,11,16, 6 ,5921,1209,1067,8197
11/16/2016,2016,11,16, 7 ,6098,1177,1026,8301
11/16/2016,2016,11,16, 8 ,6746,1342,1179,9267
11/16/2016,2016,11,16, 9 ,7418,1560,1390,10368
11/16/2016,2016,11,16, 10 ,8058,1691,1462,11211
11/16/2016,2016,11,16, 11 ,8425,1763,1549,11737
11/16/2016,2016,11,16, 12 ,8242,1698,1561,11501
11/16/2016,2016,11,16, 13 ,8287,1712,1550,11549
11/16/2016,2016,11,16, 14 ,8608,1793,1592,11993
11/16/2016,2016,11,16, 15 ,8399,1752,1579,11730
11/16/2016,2016,11,16, 16 ,8261,1712,1533,11506
11/16/2016,2016,11,16, 17 ,8073,1659,1499,11231
11/16/2016,2016,11,16, 18 ,8400,1826,1618,11844
11/16/2016,2016,11,16, 19 ,8147,1778,1502,11427
11/16/2016,2016,11,16, 20 ,7979,1721,1485,11185
11/16/2016,2016,11,16, 21 ,7699,1637,1420,10756
11/16/2016,2016,11,16, 22 ,7354,1486,1288,10128
11/16/2016,2016,11,16, 23 ,6910,1390,1190,9490
11/16/2016,2016,11,16, 24 ,6497,1310,1118,8925
11/17/2016,2016,11,17, 1 ,6185,1259,1065,8509
11/17/2016,2016,11,17, 2 ,5990,1215,1034,8239
11/17/2016,2016,11,17, 3 ,5830,1179,1005,8014
11/17/2016,2016,11,17, 4 ,5819,1171,1006,7996
11/17/2016,2016,11,17, 5 ,5915,1217,1059,8191
11/17/2016,2016,11,17, 6 ,6054,1237,1091,8382
11/17/2016,2016,11,17, 7 ,6139,1199,1025,8363
11/17/2016,2016,11,17, 8 ,6971,1330,1138,9439
11/17/2016,2016,11,17, 9 ,7817,1489,1332,10638
11/17/2016,2016,11,17, 10 ,8248,1572,1463,11283
11/17/2016,2016,11,17, 11 ,8594,1631,1471,11696
11/17/2016,2016,11,17, 12 ,8410,1565,1476,11451
11/17/2016,2016,11,17, 13 ,8429,1557,1460,11446
11/17/2016,2016,11,17, 14 ,8732,1599,1510,11841
11/17/2016,2016,11,17, 15 ,8643,1580,1480,11703
11/17/2016,2016,11,17, 16 ,8428,1579,1464,11471
11/17/2016,2016,11,17, 17 ,8169,1569,1488,11226
11/17/2016,2016,11,17, 18 ,8452,1739,1570,11761
11/17/2016,2016,11,17, 19 ,8266,1683,1520,11469
11/17/2016,2016,11,17, 20 ,8085,1616,1433,11134
11/17/2016,2016,11,17, 21 ,7903,1531,1356,10790
11/17/2016,2016,11,17, 22 ,7583,1382,1221,10186
11/17/2016,2016,11,17, 23 ,7165,1281,1142,9588
11/17/2016,2016,11,17, 24 ,6790,1226,1066,9082
11/18/2016,2016,11,18, 1 ,6496,1182,1031,8709
11/18/2016,2016,11,18, 2 ,6254,1158,998,8410
11/18/2016,2016,11,18, 3 ,6149,1142,979,8270
11/18/2016,2016,11,18, 4 ,6028,1121,975,8124
11/18/2016,2016,11,18, 5 ,6123,1174,1022,8319
11/18/2016,2016,11,18, 6 ,6224,1201,1065,8490
11/18/2016,2016,11,18, 7 ,6300,1161,1010,8471
11/18/2016,2016,11,18, 8 ,7107,1285,1149,9541
11/18/2016,2016,11,18, 9 ,7881,1502,1322,10705
11/18/2016,2016,11,18, 10 ,8267,1596,1372,11235
11/18/2016,2016,11,18, 11 ,8594,1661,1446,11701
11/18/2016,2016,11,18, 12 ,8376,1618,1394,11388
11/18/2016,2016,11,18, 13 ,8347,1598,1381,11326
11/18/2016,2016,11,18, 14 ,8688,1691,1443,11822
11/18/2016,2016,11,18, 15 ,8524,1644,1431,11599
11/18/2016,2016,11,18, 16 ,8403,1619,1439,11461
11/18/2016,2016,11,18, 17 ,8160,1580,1453,11193
11/18/2016,2016,11,18, 18 ,8468,1745,1509,11722
11/18/2016,2016,11,18, 19 ,8213,1696,1462,11371
11/18/2016,2016,11,18, 20 ,8124,1652,1323,11099
11/18/2016,2016,11,18, 21 ,7934,1564,1260,10758
11/18/2016,2016,11,18, 22 ,7622,1437,1170,10229
11/18/2016,2016,11,18, 23 ,7195,1320,1114,9629
11/18/2016,2016,11,18, 24 ,6843,1250,963,9056
11/19/2016,2016,11,19, 1 ,6472,1191,1003,8666
11/19/2016,2016,11,19, 2 ,6280,1155,985,8420
11/19/2016,2016,11,19, 3 ,6031,1140,955,8126
11/19/2016,2016,11,19, 4 ,5898,1128,951,7977
11/19/2016,2016,11,19, 5 ,5857,1137,974,7968
11/19/2016,2016,11,19, 6 ,5866,1155,1015,8036
11/19/2016,2016,11,19, 7 ,6027,1144,1002,8173
11/19/2016,2016,11,19, 8 ,6469,1220,1108,8797
11/19/2016,2016,11,19, 9 ,7108,1396,1219,9723
11/19/2016,2016,11,19, 10 ,7587,1475,1321,10383
11/19/2016,2016,11,19, 11 ,7833,1559,1394,10786
11/19/2016,2016,11,19, 12 ,7675,1528,1374,10577
11/19/2016,2016,11,19, 13 ,7614,1550,1402,10566
11/19/2016,2016,11,19, 14 ,7738,1544,1439,10721
11/19/2016,2016,11,19, 15 ,7579,1527,1412,10518
11/19/2016,2016,11,19, 16 ,7396,1496,1386,10278
11/19/2016,2016,11,19, 17 ,7352,1499,1393,10244
11/19/2016,2016,11,19, 18 ,7731,1708,1524,10963
11/19/2016,2016,11,19, 19 ,7574,1659,1460,10693
11/19/2016,2016,11,19, 20 ,7539,1619,1412,10570
11/19/2016,2016,11,19, 21 ,7412,1561,1357,10330
11/19/2016,2016,11,19, 22 ,7160,1453,1238,9851
11/19/2016,2016,11,19, 23 ,6752,1338,1164,9254
11/19/2016,2016,11,19, 24 ,6346,1259,1073,8678
11/20/2016,2016,11,20, 1 ,6070,1202,1027,8299
11/20/2016,2016,11,20, 2 ,5924,1180,990,8094
11/20/2016,2016,11,20, 3 ,5793,1136,962,7891
11/20/2016,2016,11,20, 4 ,5624,1119,939,7682
11/20/2016,2016,11,20, 5 ,5586,1115,948,7649
11/20/2016,2016,11,20, 6 ,5478,1089,946,7513
11/20/2016,2016,11,20, 7 ,5499,1094,870,7463
11/20/2016,2016,11,20, 8 ,5821,1173,895,7889
11/20/2016,2016,11,20, 9 ,6251,1262,1013,8526
11/20/2016,2016,11,20, 10 ,6708,1336,1090,9134
11/20/2016,2016,11,20, 11 ,6950,1404,1128,9482
11/20/2016,2016,11,20, 12 ,6947,1382,1147,9476
11/20/2016,2016,11,20, 13 ,6971,1377,1144,9492
11/20/2016,2016,11,20, 14 ,7028,1371,1153,9552
11/20/2016,2016,11,20, 15 ,6908,1367,1130,9405
11/20/2016,2016,11,20, 16 ,6706,1311,1102,9119
11/20/2016,2016,11,20, 17 ,6611,1343,1098,9052
11/20/2016,2016,11,20, 18 ,7355,1618,1300,10273
11/20/2016,2016,11,20, 19 ,7392,1590,1343,10325
11/20/2016,2016,11,20, 20 ,7438,1550,1316,10304
11/20/2016,2016,11,20, 21 ,7285,1470,1259,10014
11/20/2016,2016,11,20, 22 ,6968,1357,1129,9454
11/20/2016,2016,11,20, 23 ,6554,1253,1072,8879
11/20/2016,2016,11,20, 24 ,6181,1180,995,8356
11/21/2016,2016,11,21, 1 ,5902,1135,959,7996
11/21/2016,2016,11,21, 2 ,5686,1101,918,7705
11/21/2016,2016,11,21, 3 ,5480,1077,894,7451
11/21/2016,2016,11,21, 4 ,5461,1074,892,7427
11/21/2016,2016,11,21, 5 ,5591,1118,945,7654
11/21/2016,2016,11,21, 6 ,5736,1177,1003,7916
11/21/2016,2016,11,21, 7 ,5895,1140,947,7982
11/21/2016,2016,11,21, 8 ,6873,1291,1128,9292
11/21/2016,2016,11,21, 9 ,7791,1513,1323,10627
11/21/2016,2016,11,21, 10 ,8302,1617,1463,11382
11/21/2016,2016,11,21, 11 ,8640,1678,1513,11831
11/21/2016,2016,11,21, 12 ,8512,1611,1524,11647
11/21/2016,2016,11,21, 13 ,8514,1594,1521,11629
11/21/2016,2016,11,21, 14 ,8860,1680,1571,12111
11/21/2016,2016,11,21, 15 ,8672,1668,1567,11907
11/21/2016,2016,11,21, 16 ,8470,1618,1513,11601
11/21/2016,2016,11,21, 17 ,8118,1564,1479,11161
11/21/2016,2016,11,21, 18 ,8505,1755,1603,11863
11/21/2016,2016,11,21, 19 ,8280,1742,1498,11520
11/21/2016,2016,11,21, 20 ,8080,1684,1529,11293
11/21/2016,2016,11,21, 21 ,7861,1586,1445,10892
11/21/2016,2016,11,21, 22 ,7470,1433,1319,10222
11/21/2016,2016,11,21, 23 ,7010,1336,1208,9554
11/21/2016,2016,11,21, 24 ,6588,1262,1140,8990
11/22/2016,2016,11,22, 1 ,6261,1220,1079,8560
11/22/2016,2016,11,22, 2 ,6064,1172,1043,8279
11/22/2016,2016,11,22, 3 ,5841,1159,1016,8016
11/22/2016,2016,11,22, 4 ,5726,1138,1017,7881
11/22/2016,2016,11,22, 5 ,5922,1182,1064,8168
11/22/2016,2016,11,22, 6 ,6001,1228,1096,8325
11/22/2016,2016,11,22, 7 ,6057,1170,1028,8255
11/22/2016,2016,11,22, 8 ,6803,1337,1189,9329
11/22/2016,2016,11,22, 9 ,7690,1559,1382,10631
11/22/2016,2016,11,22, 10 ,8161,1669,1511,11341
11/22/2016,2016,11,22, 11 ,8499,1721,1564,11784
11/22/2016,2016,11,22, 12 ,8328,1683,1547,11558
11/22/2016,2016,11,22, 13 ,8365,1688,1535,11588
11/22/2016,2016,11,22, 14 ,8727,1771,1610,12108
11/22/2016,2016,11,22, 15 ,8541,1745,1592,11878
11/22/2016,2016,11,22, 16 ,8323,1710,1535,11568
11/22/2016,2016,11,22, 17 ,8113,1645,1492,11250
11/22/2016,2016,11,22, 18 ,8366,1838,1625,11829
11/22/2016,2016,11,22, 19 ,8170,1780,1564,11514
11/22/2016,2016,11,22, 20 ,7982,1730,1523,11235
11/22/2016,2016,11,22, 21 ,7782,1631,1441,10854
11/22/2016,2016,11,22, 22 ,7352,1489,1293,10134
11/22/2016,2016,11,22, 23 ,6892,1378,1184,9454
11/22/2016,2016,11,22, 24 ,6544,1298,1140,8982
11/23/2016,2016,11,23, 1 ,6234,1245,1076,8555
11/23/2016,2016,11,23, 2 ,5990,1209,1049,8248
11/23/2016,2016,11,23, 3 ,5866,1189,1022,8077
11/23/2016,2016,11,23, 4 ,5783,1181,1026,7990
11/23/2016,2016,11,23, 5 ,5977,1234,1077,8288
11/23/2016,2016,11,23, 6 ,6059,1262,1110,8431
11/23/2016,2016,11,23, 7 ,6121,1234,1026,8381
11/23/2016,2016,11,23, 8 ,6959,1367,1160,9486
11/23/2016,2016,11,23, 9 ,7813,1566,1349,10728
11/23/2016,2016,11,23, 10 ,8336,1669,1491,11496
11/23/2016,2016,11,23, 11 ,8611,1736,1534,11881
11/23/2016,2016,11,23, 12 ,8449,1689,1475,11613
11/23/2016,2016,11,23, 13 ,8429,1703,1455,11587
11/23/2016,2016,11,23, 14 ,8767,1767,1490,12024
11/23/2016,2016,11,23, 15 ,8515,1733,1467,11715
11/23/2016,2016,11,23, 16 ,8334,1687,1451,11472
11/23/2016,2016,11,23, 17 ,7921,1652,1455,11028
11/23/2016,2016,11,23, 18 ,8312,1800,1526,11638
11/23/2016,2016,11,23, 19 ,8136,1752,1493,11381
11/23/2016,2016,11,23, 20 ,8013,1690,1437,11140
11/23/2016,2016,11,23, 21 ,7723,1601,1319,10643
11/23/2016,2016,11,23, 22 ,7292,1480,1197,9969
11/23/2016,2016,11,23, 23 ,6911,1346,1142,9399
11/23/2016,2016,11,23, 24 ,6498,1264,1118,8880
11/24/2016,2016,11,24, 1 ,6206,1219,1020,8445
11/24/2016,2016,11,24, 2 ,6025,1187,982,8194
11/24/2016,2016,11,24, 3 ,5893,1165,961,8019
11/24/2016,2016,11,24, 4 ,5790,1152,962,7904
11/24/2016,2016,11,24, 5 ,5905,1189,1019,8113
11/24/2016,2016,11,24, 6 ,6057,1235,1081,8373
11/24/2016,2016,11,24, 7 ,6097,1192,1020,8309
11/24/2016,2016,11,24, 8 ,6818,1296,1125,9239
11/24/2016,2016,11,24, 9 ,7574,1501,1294,10369
11/24/2016,2016,11,24, 10 ,7998,1587,1405,10990
11/24/2016,2016,11,24, 11 ,8257,1622,1452,11331
11/24/2016,2016,11,24, 12 ,8093,1561,1420,11074
11/24/2016,2016,11,24, 13 ,7977,1541,1388,10906
11/24/2016,2016,11,24, 14 ,8280,1603,1427,11310
11/24/2016,2016,11,24, 15 ,8149,1589,1397,11135
11/24/2016,2016,11,24, 16 ,7986,1573,1401,10960
11/24/2016,2016,11,24, 17 ,7806,1581,1409,10796
11/24/2016,2016,11,24, 18 ,8118,1694,1542,11354
11/24/2016,2016,11,24, 19 ,7963,1605,1482,11050
11/24/2016,2016,11,24, 20 ,7797,1507,1482,10786
11/24/2016,2016,11,24, 21 ,7494,1391,1339,10224
11/24/2016,2016,11,24, 22 ,7121,1257,1219,9597
11/24/2016,2016,11,24, 23 ,6743,1204,1118,9065
11/24/2016,2016,11,24, 24 ,6295,1078,1026,8399
11/25/2016,2016,11,25, 1 ,6064,1053,992,8109
11/25/2016,2016,11,25, 2 ,5874,993,964,7831
11/25/2016,2016,11,25, 3 ,5709,977,943,7629
11/25/2016,2016,11,25, 4 ,5672,994,946,7612
11/25/2016,2016,11,25, 5 ,5771,1038,1001,7810
11/25/2016,2016,11,25, 6 ,5943,1072,1052,8067
11/25/2016,2016,11,25, 7 ,6072,1097,1008,8177
11/25/2016,2016,11,25, 8 ,6761,1200,1144,9105
11/25/2016,2016,11,25, 9 ,7373,1358,1316,10047
11/25/2016,2016,11,25, 10 ,7726,1479,1463,10668
11/25/2016,2016,11,25, 11 ,7928,1516,1530,10974
11/25/2016,2016,11,25, 12 ,7605,1495,1508,10608
11/25/2016,2016,11,25, 13 ,7450,1452,1511,10413
11/25/2016,2016,11,25, 14 ,7661,1505,1568,10734
11/25/2016,2016,11,25, 15 ,7504,1509,1433,10446
11/25/2016,2016,11,25, 16 ,7449,1501,1510,10460
11/25/2016,2016,11,25, 17 ,7392,1477,1454,10323
11/25/2016,2016,11,25, 18 ,7720,1638,1595,10953
11/25/2016,2016,11,25, 19 ,7563,1585,1552,10700
11/25/2016,2016,11,25, 20 ,7400,1539,1504,10443
11/25/2016,2016,11,25, 21 ,7095,1450,1420,9965
11/25/2016,2016,11,25, 22 ,6776,1328,1305,9409
11/25/2016,2016,11,25, 23 ,6326,1237,1165,8728
11/25/2016,2016,11,25, 24 ,5966,1171,1084,8221
11/26/2016,2016,11,26, 1 ,5715,1123,1062,7900
11/26/2016,2016,11,26, 2 ,5530,1093,1020,7643
11/26/2016,2016,11,26, 3 ,5389,1062,993,7444
11/26/2016,2016,11,26, 4 ,5316,1059,980,7355
11/26/2016,2016,11,26, 5 ,5393,1072,999,7464
11/26/2016,2016,11,26, 6 ,5425,1080,1024,7529
11/26/2016,2016,11,26, 7 ,5608,1091,1020,7719
11/26/2016,2016,11,26, 8 ,6136,1203,1083,8422
11/26/2016,2016,11,26, 9 ,6699,1382,1235,9316
11/26/2016,2016,11,26, 10 ,7066,1518,1353,9937
11/26/2016,2016,11,26, 11 ,7293,1586,1420,10299
11/26/2016,2016,11,26, 12 ,7087,1558,1410,10055
11/26/2016,2016,11,26, 13 ,7054,1536,1326,9916
11/26/2016,2016,11,26, 14 ,7187,1567,1462,10216
11/26/2016,2016,11,26, 15 ,7109,1547,1434,10090
11/26/2016,2016,11,26, 16 ,7027,1507,1397,9931
11/26/2016,2016,11,26, 17 ,7055,1511,1397,9963
11/26/2016,2016,11,26, 18 ,7495,1669,1512,10676
11/26/2016,2016,11,26, 19 ,7370,1601,1487,10458
11/26/2016,2016,11,26, 20 ,7236,1558,1428,10222
11/26/2016,2016,11,26, 21 ,7054,1487,1362,9903
11/26/2016,2016,11,26, 22 ,6804,1405,1276,9485
11/26/2016,2016,11,26, 23 ,6372,1277,1165,8814
11/26/2016,2016,11,26, 24 ,6044,1205,1080,8329
11/27/2016,2016,11,27, 1 ,5732,1156,1023,7911
11/27/2016,2016,11,27, 2 ,5535,1124,1000,7659
11/27/2016,2016,11,27, 3 ,5463,1096,960,7519
11/27/2016,2016,11,27, 4 ,5368,1081,944,7393
11/27/2016,2016,11,27, 5 ,5360,1080,958,7398
11/27/2016,2016,11,27, 6 ,5258,1079,957,7294
11/27/2016,2016,11,27, 7 ,5320,1079,952,7351
11/27/2016,2016,11,27, 8 ,5628,1118,1012,7758
11/27/2016,2016,11,27, 9 ,5998,1216,1092,8306
11/27/2016,2016,11,27, 10 ,6496,1289,1193,8978
11/27/2016,2016,11,27, 11 ,6807,1344,1268,9419
11/27/2016,2016,11,27, 12 ,6774,1348,1259,9381
11/27/2016,2016,11,27, 13 ,6797,1347,1275,9419
11/27/2016,2016,11,27, 14 ,6809,1384,1290,9483
11/27/2016,2016,11,27, 15 ,6717,1391,1271,9379
11/27/2016,2016,11,27, 16 ,6651,1335,1250,9236
11/27/2016,2016,11,27, 17 ,6625,1365,1294,9284
11/27/2016,2016,11,27, 18 ,7385,1646,1488,10519
11/27/2016,2016,11,27, 19 ,7338,1620,1455,10413
11/27/2016,2016,11,27, 20 ,7389,1580,1422,10391
11/27/2016,2016,11,27, 21 ,7247,1506,1352,10105
11/27/2016,2016,11,27, 22 ,6920,1390,1213,9523
11/27/2016,2016,11,27, 23 ,6534,1271,1133,8938
11/27/2016,2016,11,27, 24 ,6126,1195,1076,8397
11/28/2016,2016,11,28, 1 ,5851,1142,1014,8007
11/28/2016,2016,11,28, 2 ,5594,1102,988,7684
11/28/2016,2016,11,28, 3 ,5433,1074,964,7471
11/28/2016,2016,11,28, 4 ,5431,1069,961,7461
11/28/2016,2016,11,28, 5 ,5578,1110,1012,7700
11/28/2016,2016,11,28, 6 ,5785,1156,1055,7996
11/28/2016,2016,11,28, 7 ,5879,1105,984,7968
11/28/2016,2016,11,28, 8 ,6773,1288,1157,9218
11/28/2016,2016,11,28, 9 ,7639,1522,1378,10539
11/28/2016,2016,11,28, 10 ,8198,1638,1505,11341
11/28/2016,2016,11,28, 11 ,8509,1730,1594,11833
11/28/2016,2016,11,28, 12 ,8339,1664,1574,11577
11/28/2016,2016,11,28, 13 ,8369,1668,1584,11621
11/28/2016,2016,11,28, 14 ,8677,1727,1607,12011
11/28/2016,2016,11,28, 15 ,8572,1738,1589,11899
11/28/2016,2016,11,28, 16 ,8394,1729,1555,11678
11/28/2016,2016,11,28, 17 ,8085,1649,1522,11256
11/28/2016,2016,11,28, 18 ,8374,1800,1606,11780
11/28/2016,2016,11,28, 19 ,8142,1761,1596,11499
11/28/2016,2016,11,28, 20 ,7976,1698,1533,11207
11/28/2016,2016,11,28, 21 ,7754,1602,1450,10806
11/28/2016,2016,11,28, 22 ,7459,1477,1319,10255
11/28/2016,2016,11,28, 23 ,7007,1382,1189,9578
11/28/2016,2016,11,28, 24 ,6528,1294,1159,8981
11/29/2016,2016,11,29, 1 ,6230,1251,1114,8595
11/29/2016,2016,11,29, 2 ,6043,1209,1080,8332
11/29/2016,2016,11,29, 3 ,5872,1185,1055,8112
11/29/2016,2016,11,29, 4 ,5815,1172,1041,8028
11/29/2016,2016,11,29, 5 ,5965,1196,1096,8257
11/29/2016,2016,11,29, 6 ,6104,1248,1137,8489
11/29/2016,2016,11,29, 7 ,5879,1185,1068,8132
11/29/2016,2016,11,29, 8 ,6880,1344,1187,9411
11/29/2016,2016,11,29, 9 ,7687,1557,1343,10587
11/29/2016,2016,11,29, 10 ,8169,1634,1497,11300
11/29/2016,2016,11,29, 11 ,8373,1724,1528,11625
11/29/2016,2016,11,29, 12 ,8209,1670,1487,11366
11/29/2016,2016,11,29, 13 ,8233,1659,1463,11355
11/29/2016,2016,11,29, 14 ,8470,1712,1499,11681
11/29/2016,2016,11,29, 15 ,8357,1666,1386,11409
11/29/2016,2016,11,29, 16 ,8149,1618,1388,11155
11/29/2016,2016,11,29, 17 ,7866,1610,1407,10883
11/29/2016,2016,11,29, 18 ,8231,1709,1488,11428
11/29/2016,2016,11,29, 19 ,7994,1620,1478,11092
11/29/2016,2016,11,29, 20 ,7789,1556,1435,10780
11/29/2016,2016,11,29, 21 ,7567,1486,1376,10429
11/29/2016,2016,11,29, 22 ,7266,1373,1234,9873
11/29/2016,2016,11,29, 23 ,6894,1282,1131,9307
11/29/2016,2016,11,29, 24 ,6438,1216,1034,8688
11/30/2016,2016,11,30, 1 ,6135,1170,990,8295
11/30/2016,2016,11,30, 2 ,5979,1139,979,8097
11/30/2016,2016,11,30, 3 ,5761,1109,954,7824
11/30/2016,2016,11,30, 4 ,5632,1090,945,7667
11/30/2016,2016,11,30, 5 ,5625,1101,965,7691
11/30/2016,2016,11,30, 6 ,5582,1131,983,7696
11/30/2016,2016,11,30, 7 ,5572,1139,996,7707
11/30/2016,2016,11,30, 8 ,5940,1224,1071,8235
11/30/2016,2016,11,30, 9 ,6458,1367,1169,8994
11/30/2016,2016,11,30, 10 ,6947,1448,1303,9698
11/30/2016,2016,11,30, 11 ,7343,1514,1360,10217
11/30/2016,2016,11,30, 12 ,7230,1478,1358,10066
11/30/2016,2016,11,30, 13 ,7211,1492,1339,10042
11/30/2016,2016,11,30, 14 ,7341,1510,1384,10235
11/30/2016,2016,11,30, 15 ,7245,1484,1366,10095
11/30/2016,2016,11,30, 16 ,7074,1465,1337,9876
11/30/2016,2016,11,30, 17 ,6883,1476,1340,9699
11/30/2016,2016,11,30, 18 ,7536,1634,1537,10707
11/30/2016,2016,11,30, 19 ,7545,1593,1503,10641
11/30/2016,2016,11,30, 20 ,7521,1546,1465,10532
11/30/2016,2016,11,30, 21 ,7353,1472,1400,10225
11/30/2016,2016,11,30, 22 ,7005,1329,1271,9605
11/30/2016,2016,11,30, 23 ,6651,1236,1151,9038
11/30/2016,2016,11,30, 24 ,6207,1173,1088,8468
12/1/2016,2016,12,1, 1 ,5929,1130,1041,8100
12/1/2016,2016,12,1, 2 ,5727,1100,1000,7827
12/1/2016,2016,12,1, 3 ,5556,1077,974,7607
12/1/2016,2016,12,1, 4 ,5495,1071,978,7544
12/1/2016,2016,12,1, 5 ,5644,1105,1035,7784
12/1/2016,2016,12,1, 6 ,5820,1173,1076,8069
12/1/2016,2016,12,1, 7 ,5878,1132,1014,8024
12/1/2016,2016,12,1, 8 ,6735,1266,1157,9158
12/1/2016,2016,12,1, 9 ,7617,1486,1371,10474
12/1/2016,2016,12,1, 10 ,8030,1604,1515,11149
12/1/2016,2016,12,1, 11 ,8327,1675,1535,11537
12/1/2016,2016,12,1, 12 ,8153,1634,1528,11315
12/1/2016,2016,12,1, 13 ,8134,1610,1533,11277
12/1/2016,2016,12,1, 14 ,8369,1649,1592,11610
12/1/2016,2016,12,1, 15 ,8323,1625,1552,11500
12/1/2016,2016,12,1, 16 ,8226,1628,1534,11388
12/1/2016,2016,12,1, 17 ,7947,1560,1502,11009
12/1/2016,2016,12,1, 18 ,8262,1751,1595,11608
12/1/2016,2016,12,1, 19 ,8097,1690,1523,11310
12/1/2016,2016,12,1, 20 ,7928,1629,1471,11028
12/1/2016,2016,12,1, 21 ,7745,1551,1408,10704
12/1/2016,2016,12,1, 22 ,7380,1414,1224,10018
12/1/2016,2016,12,1, 23 ,6931,1306,1145,9382
12/1/2016,2016,12,1, 24 ,6455,1228,1084,8767
12/2/2016,2016,12,2, 1 ,6198,1180,1027,8405
12/2/2016,2016,12,2, 2 ,5921,1138,995,8054
12/2/2016,2016,12,2, 3 ,5833,1112,973,7918
12/2/2016,2016,12,2, 4 ,5739,1108,974,7821
12/2/2016,2016,12,2, 5 ,5849,1158,1029,8036
12/2/2016,2016,12,2, 6 ,5984,1192,1044,8220
12/2/2016,2016,12,2, 7 ,6006,1169,1027,8202
12/2/2016,2016,12,2, 8 ,6847,1321,1149,9317
12/2/2016,2016,12,2, 9 ,7651,1539,1319,10509
12/2/2016,2016,12,2, 10 ,8082,1661,1440,11183
12/2/2016,2016,12,2, 11 ,8245,1706,1480,11431
12/2/2016,2016,12,2, 12 ,8028,1669,1450,11147
12/2/2016,2016,12,2, 13 ,7946,1678,1444,11068
12/2/2016,2016,12,2, 14 ,8178,1741,1490,11409
12/2/2016,2016,12,2, 15 ,8164,1702,1515,11381
12/2/2016,2016,12,2, 16 ,8045,1651,1477,11173
12/2/2016,2016,12,2, 17 ,7773,1614,1414,10801
12/2/2016,2016,12,2, 18 ,8181,1796,1586,11563
12/2/2016,2016,12,2, 19 ,8000,1735,1555,11290
12/2/2016,2016,12,2, 20 ,7816,1682,1506,11004
12/2/2016,2016,12,2, 21 ,7596,1606,1437,10639
12/2/2016,2016,12,2, 22 ,7253,1480,1273,10006
12/2/2016,2016,12,2, 23 ,6767,1375,1178,9320
12/2/2016,2016,12,2, 24 ,6396,1292,1092,8780
12/3/2016,2016,12,3, 1 ,6105,1242,1043,8390
12/3/2016,2016,12,3, 2 ,5867,1204,1034,8105
12/3/2016,2016,12,3, 3 ,5691,1180,997,7868
12/3/2016,2016,12,3, 4 ,5583,1160,1002,7745
12/3/2016,2016,12,3, 5 ,5601,1175,1026,7802
12/3/2016,2016,12,3, 6 ,5629,1189,1020,7838
12/3/2016,2016,12,3, 7 ,5738,1175,1007,7920
12/3/2016,2016,12,3, 8 ,6272,1281,1087,8640
12/3/2016,2016,12,3, 9 ,6862,1422,1221,9505
12/3/2016,2016,12,3, 10 ,7288,1499,1302,10089
12/3/2016,2016,12,3, 11 ,7666,1567,1373,10606
12/3/2016,2016,12,3, 12 ,7504,1527,1362,10393
12/3/2016,2016,12,3, 13 ,7487,1512,1355,10354
12/3/2016,2016,12,3, 14 ,7636,1543,1381,10560
12/3/2016,2016,12,3, 15 ,7471,1537,1354,10362
12/3/2016,2016,12,3, 16 ,7251,1494,1297,10042
12/3/2016,2016,12,3, 17 ,7130,1481,1321,9932
12/3/2016,2016,12,3, 18 ,7725,1668,1461,10854
12/3/2016,2016,12,3, 19 ,7647,1625,1402,10674
12/3/2016,2016,12,3, 20 ,7504,1585,1400,10489
12/3/2016,2016,12,3, 21 ,7483,1541,1299,10323
12/3/2016,2016,12,3, 22 ,7181,1446,1226,9853
12/3/2016,2016,12,3, 23 ,6785,1343,1143,9271
12/3/2016,2016,12,3, 24 ,6402,1223,1047,8672
12/4/2016,2016,12,4, 1 ,6053,1193,994,8240
12/4/2016,2016,12,4, 2 ,5818,1161,971,7950
12/4/2016,2016,12,4, 3 ,5641,1144,948,7733
12/4/2016,2016,12,4, 4 ,5603,1123,927,7653
12/4/2016,2016,12,4, 5 ,5527,1129,946,7602
12/4/2016,2016,12,4, 6 ,5370,1132,947,7449
12/4/2016,2016,12,4, 7 ,5338,1121,941,7400
12/4/2016,2016,12,4, 8 ,5642,1152,957,7751
12/4/2016,2016,12,4, 9 ,6064,1235,1005,8304
12/4/2016,2016,12,4, 10 ,6465,1304,1050,8819
12/4/2016,2016,12,4, 11 ,6749,1357,1088,9194
12/4/2016,2016,12,4, 12 ,6698,1353,1104,9155
12/4/2016,2016,12,4, 13 ,6741,1364,1086,9191
12/4/2016,2016,12,4, 14 ,6761,1344,1084,9189
12/4/2016,2016,12,4, 15 ,6616,1346,1088,9050
12/4/2016,2016,12,4, 16 ,6421,1335,1118,8874
12/4/2016,2016,12,4, 17 ,6521,1354,1150,9025
12/4/2016,2016,12,4, 18 ,7162,1615,1384,10161
12/4/2016,2016,12,4, 19 ,7245,1612,1319,10176
12/4/2016,2016,12,4, 20 ,7237,1579,1271,10087
12/4/2016,2016,12,4, 21 ,7200,1517,1240,9957
12/4/2016,2016,12,4, 22 ,6854,1410,1115,9379
12/4/2016,2016,12,4, 23 ,6437,1293,1038,8768
12/4/2016,2016,12,4, 24 ,6116,1240,985,8341
12/5/2016,2016,12,5, 1 ,5803,1183,925,7911
12/5/2016,2016,12,5, 2 ,5577,1154,892,7623
12/5/2016,2016,12,5, 3 ,5450,1110,877,7437
12/5/2016,2016,12,5, 4 ,5370,1104,881,7355
12/5/2016,2016,12,5, 5 ,5578,1147,941,7666
12/5/2016,2016,12,5, 6 ,5746,1202,1011,7959
12/5/2016,2016,12,5, 7 ,5925,1153,961,8039
12/5/2016,2016,12,5, 8 ,6691,1290,1083,9064
12/5/2016,2016,12,5, 9 ,7584,1532,1261,10377
12/5/2016,2016,12,5, 10 ,8191,1648,1387,11226
12/5/2016,2016,12,5, 11 ,8528,1740,1417,11685
12/5/2016,2016,12,5, 12 ,8379,1700,1420,11499
12/5/2016,2016,12,5, 13 ,8289,1676,1450,11415
12/5/2016,2016,12,5, 14 ,8545,1735,1490,11770
12/5/2016,2016,12,5, 15 ,8437,1719,1471,11627
12/5/2016,2016,12,5, 16 ,8258,1684,1457,11399
12/5/2016,2016,12,5, 17 ,8020,1617,1437,11074
12/5/2016,2016,12,5, 18 ,8419,1820,1572,11811
12/5/2016,2016,12,5, 19 ,8205,1776,1472,11453
12/5/2016,2016,12,5, 20 ,8075,1727,1449,11251
12/5/2016,2016,12,5, 21 ,7844,1628,1381,10853
12/5/2016,2016,12,5, 22 ,7401,1481,1242,10124
12/5/2016,2016,12,5, 23 ,6902,1362,1149,9413
12/5/2016,2016,12,5, 24 ,6471,1293,1067,8831
12/6/2016,2016,12,6, 1 ,6105,1235,1026,8366
12/6/2016,2016,12,6, 2 ,5955,1201,987,8143
12/6/2016,2016,12,6, 3 ,5763,1171,962,7896
12/6/2016,2016,12,6, 4 ,5732,1161,948,7841
12/6/2016,2016,12,6, 5 ,5982,1205,1012,8199
12/6/2016,2016,12,6, 6 ,5958,1248,1073,8279
12/6/2016,2016,12,6, 7 ,5985,1193,1009,8187
12/6/2016,2016,12,6, 8 ,6812,1350,1130,9292
12/6/2016,2016,12,6, 9 ,7631,1591,1332,10554
12/6/2016,2016,12,6, 10 ,8028,1659,1439,11126
12/6/2016,2016,12,6, 11 ,8386,1706,1494,11586
12/6/2016,2016,12,6, 12 ,8139,1721,1473,11333
12/6/2016,2016,12,6, 13 ,8174,1696,1446,11316
12/6/2016,2016,12,6, 14 ,8456,1777,1486,11719
12/6/2016,2016,12,6, 15 ,8372,1762,1495,11629
12/6/2016,2016,12,6, 16 ,8236,1728,1476,11440
12/6/2016,2016,12,6, 17 ,7898,1654,1399,10951
12/6/2016,2016,12,6, 18 ,8251,1814,1585,11650
12/6/2016,2016,12,6, 19 ,8129,1780,1496,11405
12/6/2016,2016,12,6, 20 ,7976,1716,1470,11162
12/6/2016,2016,12,6, 21 ,7824,1637,1404,10865
12/6/2016,2016,12,6, 22 ,7406,1479,1289,10174
12/6/2016,2016,12,6, 23 ,6990,1385,1179,9554
12/6/2016,2016,12,6, 24 ,6544,1301,1093,8938
12/7/2016,2016,12,7, 1 ,6200,1241,1056,8497
12/7/2016,2016,12,7, 2 ,6034,1200,1020,8254
12/7/2016,2016,12,7, 3 ,5851,1173,1003,8027
12/7/2016,2016,12,7, 4 ,5820,1162,996,7978
12/7/2016,2016,12,7, 5 ,5970,1192,1041,8203
12/7/2016,2016,12,7, 6 ,6122,1242,1096,8460
12/7/2016,2016,12,7, 7 ,6118,1201,1021,8340
12/7/2016,2016,12,7, 8 ,6826,1345,1149,9320
12/7/2016,2016,12,7, 9 ,7584,1545,1345,10474
12/7/2016,2016,12,7, 10 ,8037,1655,1469,11161
12/7/2016,2016,12,7, 11 ,8321,1721,1542,11584
12/7/2016,2016,12,7, 12 ,8123,1674,1503,11300
12/7/2016,2016,12,7, 13 ,8031,1662,1490,11183
12/7/2016,2016,12,7, 14 ,8264,1733,1551,11548
12/7/2016,2016,12,7, 15 ,8154,1709,1508,11371
12/7/2016,2016,12,7, 16 ,8037,1659,1459,11155
12/7/2016,2016,12,7, 17 ,7882,1641,1470,10993
12/7/2016,2016,12,7, 18 ,8324,1817,1598,11739
12/7/2016,2016,12,7, 19 ,8072,1751,1557,11380
12/7/2016,2016,12,7, 20 ,7918,1714,1495,11127
12/7/2016,2016,12,7, 21 ,7792,1624,1421,10837
12/7/2016,2016,12,7, 22 ,7358,1467,1269,10094
12/7/2016,2016,12,7, 23 ,6865,1366,1152,9383
12/7/2016,2016,12,7, 24 ,6401,1289,1086,8776
12/8/2016,2016,12,8, 1 ,6051,1236,1026,8313
12/8/2016,2016,12,8, 2 ,5866,1191,998,8055
12/8/2016,2016,12,8, 3 ,5729,1163,986,7878
12/8/2016,2016,12,8, 4 ,5625,1151,962,7738
12/8/2016,2016,12,8, 5 ,5803,1172,1007,7982
12/8/2016,2016,12,8, 6 ,5896,1219,1072,8187
12/8/2016,2016,12,8, 7 ,5996,1191,976,8163
12/8/2016,2016,12,8, 8 ,6615,1307,1119,9041
12/8/2016,2016,12,8, 9 ,7364,1500,1284,10148
12/8/2016,2016,12,8, 10 ,7857,1605,1410,10872
12/8/2016,2016,12,8, 11 ,8158,1695,1498,11351
12/8/2016,2016,12,8, 12 ,8006,1649,1464,11119
12/8/2016,2016,12,8, 13 ,8028,1650,1444,11122
12/8/2016,2016,12,8, 14 ,8322,1699,1494,11515
12/8/2016,2016,12,8, 15 ,8271,1661,1481,11413
12/8/2016,2016,12,8, 16 ,8135,1621,1471,11227
12/8/2016,2016,12,8, 17 ,7844,1602,1431,10877
12/8/2016,2016,12,8, 18 ,8284,1760,1542,11586
12/8/2016,2016,12,8, 19 ,8075,1719,1497,11291
12/8/2016,2016,12,8, 20 ,7871,1660,1446,10977
12/8/2016,2016,12,8, 21 ,7819,1559,1371,10749
12/8/2016,2016,12,8, 22 ,7391,1424,1233,10048
12/8/2016,2016,12,8, 23 ,6888,1315,1116,9319
12/8/2016,2016,12,8, 24 ,6456,1249,1047,8752
12/9/2016,2016,12,9, 1 ,6206,1191,1008,8405
12/9/2016,2016,12,9, 2 ,5995,1150,976,8121
12/9/2016,2016,12,9, 3 ,5824,1126,950,7900
12/9/2016,2016,12,9, 4 ,5754,1117,943,7814
12/9/2016,2016,12,9, 5 ,5865,1147,994,8006
12/9/2016,2016,12,9, 6 ,6058,1192,1051,8301
12/9/2016,2016,12,9, 7 ,6121,1160,985,8266
12/9/2016,2016,12,9, 8 ,6828,1309,1142,9279
12/9/2016,2016,12,9, 9 ,7653,1538,1318,10509
12/9/2016,2016,12,9, 10 ,8042,1647,1451,11140
12/9/2016,2016,12,9, 11 ,8326,1709,1510,11545
12/9/2016,2016,12,9, 12 ,8132,1674,1463,11269
12/9/2016,2016,12,9, 13 ,8075,1669,1472,11216
12/9/2016,2016,12,9, 14 ,8404,1727,1524,11655
12/9/2016,2016,12,9, 15 ,8272,1699,1521,11492
12/9/2016,2016,12,9, 16 ,8115,1671,1483,11269
12/9/2016,2016,12,9, 17 ,7847,1621,1429,10897
12/9/2016,2016,12,9, 18 ,8218,1796,1584,11598
12/9/2016,2016,12,9, 19 ,8023,1763,1549,11335
12/9/2016,2016,12,9, 20 ,7885,1706,1459,11050
12/9/2016,2016,12,9, 21 ,7703,1638,1405,10746
12/9/2016,2016,12,9, 22 ,7346,1488,1295,10129
12/9/2016,2016,12,9, 23 ,6986,1391,1188,9565
12/9/2016,2016,12,9, 24 ,6528,1302,1038,8868
12/10/2016,2016,12,10, 1 ,6207,1249,1037,8493
12/10/2016,2016,12,10, 2 ,6047,1209,1005,8261
12/10/2016,2016,12,10, 3 ,5873,1183,970,8026
12/10/2016,2016,12,10, 4 ,5743,1160,951,7854
12/10/2016,2016,12,10, 5 ,5742,1168,972,7882
12/10/2016,2016,12,10, 6 ,5744,1175,974,7893
12/10/2016,2016,12,10, 7 ,5760,1174,973,7907
12/10/2016,2016,12,10, 8 ,6296,1267,1080,8643
12/10/2016,2016,12,10, 9 ,7002,1405,1202,9609
12/10/2016,2016,12,10, 10 ,7420,1495,1324,10239
12/10/2016,2016,12,10, 11 ,7722,1572,1399,10693
12/10/2016,2016,12,10, 12 ,7569,1545,1382,10496
12/10/2016,2016,12,10, 13 ,7533,1540,1382,10455
12/10/2016,2016,12,10, 14 ,7763,1594,1430,10787
12/10/2016,2016,12,10, 15 ,7625,1564,1398,10587
12/10/2016,2016,12,10, 16 ,7437,1528,1367,10332
12/10/2016,2016,12,10, 17 ,7216,1497,1317,10030
12/10/2016,2016,12,10, 18 ,7761,1724,1490,10975
12/10/2016,2016,12,10, 19 ,7660,1698,1488,10846
12/10/2016,2016,12,10, 20 ,7592,1659,1455,10706
12/10/2016,2016,12,10, 21 ,7514,1576,1406,10496
12/10/2016,2016,12,10, 22 ,7267,1478,1283,10028
12/10/2016,2016,12,10, 23 ,6905,1359,1155,9419
12/10/2016,2016,12,10, 24 ,6488,1285,1090,8863
12/11/2016,2016,12,11, 1 ,6170,1216,1027,8413
12/11/2016,2016,12,11, 2 ,5977,1180,992,8149
12/11/2016,2016,12,11, 3 ,5734,1147,969,7850
12/11/2016,2016,12,11, 4 ,5594,1127,941,7662
12/11/2016,2016,12,11, 5 ,5581,1126,945,7652
12/11/2016,2016,12,11, 6 ,5455,1110,941,7506
12/11/2016,2016,12,11, 7 ,5498,1114,931,7543
12/11/2016,2016,12,11, 8 ,5734,1174,988,7896
12/11/2016,2016,12,11, 9 ,6126,1267,1082,8475
12/11/2016,2016,12,11, 10 ,6502,1342,1173,9017
12/11/2016,2016,12,11, 11 ,6803,1412,1224,9439
12/11/2016,2016,12,11, 12 ,6730,1410,1243,9383
12/11/2016,2016,12,11, 13 ,6683,1413,1249,9345
12/11/2016,2016,12,11, 14 ,6695,1433,1266,9394
12/11/2016,2016,12,11, 15 ,6647,1414,1246,9307
12/11/2016,2016,12,11, 16 ,6538,1386,1224,9148
12/11/2016,2016,12,11, 17 ,6460,1397,1223,9080
12/11/2016,2016,12,11, 18 ,7135,1653,1424,10212
12/11/2016,2016,12,11, 19 ,7188,1648,1438,10274
12/11/2016,2016,12,11, 20 ,7188,1622,1427,10237
12/11/2016,2016,12,11, 21 ,7132,1546,1371,10049
12/11/2016,2016,12,11, 22 ,6819,1417,1203,9439
12/11/2016,2016,12,11, 23 ,6439,1317,1136,8892
12/11/2016,2016,12,11, 24 ,6050,1252,1072,8374
12/12/2016,2016,12,12, 1 ,5774,1189,1018,7981
12/12/2016,2016,12,12, 2 ,5542,1141,976,7659
12/12/2016,2016,12,12, 3 ,5457,1109,958,7524
12/12/2016,2016,12,12, 4 ,5409,1099,948,7456
12/12/2016,2016,12,12, 5 ,5608,1135,986,7729
12/12/2016,2016,12,12, 6 ,5783,1189,909,7881
12/12/2016,2016,12,12, 7 ,5943,1157,868,7968
12/12/2016,2016,12,12, 8 ,6695,1303,1009,9007
12/12/2016,2016,12,12, 9 ,7577,1540,1099,10216
12/12/2016,2016,12,12, 10 ,8086,1671,1443,11200
12/12/2016,2016,12,12, 11 ,8342,1741,1508,11591
12/12/2016,2016,12,12, 12 ,8214,1696,1498,11408
12/12/2016,2016,12,12, 13 ,8196,1700,1538,11434
12/12/2016,2016,12,12, 14 ,8501,1764,1561,11826
12/12/2016,2016,12,12, 15 ,8405,1762,1566,11733
12/12/2016,2016,12,12, 16 ,8215,1693,1539,11447
12/12/2016,2016,12,12, 17 ,8045,1669,1498,11212
12/12/2016,2016,12,12, 18 ,8390,1838,1621,11849
12/12/2016,2016,12,12, 19 ,8252,1780,1549,11581
12/12/2016,2016,12,12, 20 ,8055,1735,1309,11099
12/12/2016,2016,12,12, 21 ,7900,1633,1370,10903
12/12/2016,2016,12,12, 22 ,7537,1490,1206,10233
12/12/2016,2016,12,12, 23 ,6968,1388,1119,9475
12/12/2016,2016,12,12, 24 ,6480,1283,1063,8826
12/13/2016,2016,12,13, 1 ,6184,1229,971,8384
12/13/2016,2016,12,13, 2 ,5987,1174,962,8123
12/13/2016,2016,12,13, 3 ,5828,1146,938,7912
12/13/2016,2016,12,13, 4 ,5782,1139,973,7894
12/13/2016,2016,12,13, 5 ,5897,1168,1025,8090
12/13/2016,2016,12,13, 6 ,6127,1218,1028,8373
12/13/2016,2016,12,13, 7 ,6198,1166,991,8355
12/13/2016,2016,12,13, 8 ,6857,1309,1130,9296
12/13/2016,2016,12,13, 9 ,7570,1538,1356,10464
12/13/2016,2016,12,13, 10 ,7906,1643,1455,11004
12/13/2016,2016,12,13, 11 ,8154,1705,1523,11382
12/13/2016,2016,12,13, 12 ,7948,1665,1494,11107
12/13/2016,2016,12,13, 13 ,7921,1663,1478,11062
12/13/2016,2016,12,13, 14 ,8178,1684,1533,11395
12/13/2016,2016,12,13, 15 ,8060,1672,1493,11225
12/13/2016,2016,12,13, 16 ,7964,1622,1467,11053
12/13/2016,2016,12,13, 17 ,7883,1636,1461,10980
12/13/2016,2016,12,13, 18 ,8260,1757,1559,11576
12/13/2016,2016,12,13, 19 ,8150,1717,1537,11404
12/13/2016,2016,12,13, 20 ,7940,1652,1252,10844
12/13/2016,2016,12,13, 21 ,7773,1559,1209,10541
12/13/2016,2016,12,13, 22 ,7328,1416,1051,9795
12/13/2016,2016,12,13, 23 ,6866,1301,934,9101
12/13/2016,2016,12,13, 24 ,6505,1224,881,8610
12/14/2016,2016,12,14, 1 ,6170,1169,1039,8378
12/14/2016,2016,12,14, 2 ,5971,1131,1005,8107
12/14/2016,2016,12,14, 3 ,5857,1096,977,7930
12/14/2016,2016,12,14, 4 ,5791,1088,972,7851
12/14/2016,2016,12,14, 5 ,5932,1133,1027,8092
12/14/2016,2016,12,14, 6 ,6137,1184,1092,8413
12/14/2016,2016,12,14, 7 ,6218,1156,1010,8384
12/14/2016,2016,12,14, 8 ,6846,1288,1131,9265
12/14/2016,2016,12,14, 9 ,7583,1490,1303,10376
12/14/2016,2016,12,14, 10 ,8078,1596,1403,11077
12/14/2016,2016,12,14, 11 ,8295,1660,1451,11406
12/14/2016,2016,12,14, 12 ,8081,1633,1434,11148
12/14/2016,2016,12,14, 13 ,8109,1641,1413,11163
12/14/2016,2016,12,14, 14 ,8378,1713,1469,11560
12/14/2016,2016,12,14, 15 ,8252,1679,1446,11377
12/14/2016,2016,12,14, 16 ,8161,1666,1416,11243
12/14/2016,2016,12,14, 17 ,8013,1624,1428,11065
12/14/2016,2016,12,14, 18 ,8413,1790,1505,11708
12/14/2016,2016,12,14, 19 ,8174,1741,1477,11392
12/14/2016,2016,12,14, 20 ,7970,1677,1428,11075
12/14/2016,2016,12,14, 21 ,7847,1588,1350,10785
12/14/2016,2016,12,14, 22 ,7382,1446,1273,10101
12/14/2016,2016,12,14, 23 ,6912,1331,1116,9359
12/14/2016,2016,12,14, 24 ,6575,1262,1015,8852
12/15/2016,2016,12,15, 1 ,6272,1199,994,8465
12/15/2016,2016,12,15, 2 ,5973,1163,962,8098
12/15/2016,2016,12,15, 3 ,5836,1135,924,7895
12/15/2016,2016,12,15, 4 ,5746,1125,926,7797
12/15/2016,2016,12,15, 5 ,5962,1165,989,8116
12/15/2016,2016,12,15, 6 ,6111,1211,1057,8379
12/15/2016,2016,12,15, 7 ,6176,1167,991,8334
12/15/2016,2016,12,15, 8 ,6778,1306,1093,9177
12/15/2016,2016,12,15, 9 ,7550,1526,1313,10389
12/15/2016,2016,12,15, 10 ,7958,1637,1413,11008
12/15/2016,2016,12,15, 11 ,8158,1719,1466,11343
12/15/2016,2016,12,15, 12 ,7862,1667,1445,10974
12/15/2016,2016,12,15, 13 ,7873,1681,1431,10985
12/15/2016,2016,12,15, 14 ,8035,1754,1498,11287
12/15/2016,2016,12,15, 15 ,7947,1712,1493,11152
12/15/2016,2016,12,15, 16 ,7881,1673,1479,11033
12/15/2016,2016,12,15, 17 ,7728,1621,1452,10801
12/15/2016,2016,12,15, 18 ,8170,1815,1584,11569
12/15/2016,2016,12,15, 19 ,7996,1776,1517,11289
12/15/2016,2016,12,15, 20 ,7772,1732,1463,10967
12/15/2016,2016,12,15, 21 ,7648,1626,1411,10685
12/15/2016,2016,12,15, 22 ,7176,1487,1248,9911
12/15/2016,2016,12,15, 23 ,6776,1368,1143,9287
12/15/2016,2016,12,15, 24 ,6320,1290,1058,8668
12/16/2016,2016,12,16, 1 ,6021,1234,1001,8256
12/16/2016,2016,12,16, 2 ,5834,1195,979,8008
12/16/2016,2016,12,16, 3 ,5759,1174,971,7904
12/16/2016,2016,12,16, 4 ,5715,1159,967,7841
12/16/2016,2016,12,16, 5 ,5766,1178,999,7943
12/16/2016,2016,12,16, 6 ,6012,1218,1008,8238
12/16/2016,2016,12,16, 7 ,6139,1197,1023,8359
12/16/2016,2016,12,16, 8 ,6651,1308,1106,9065
12/16/2016,2016,12,16, 9 ,7288,1505,1281,10074
12/16/2016,2016,12,16, 10 ,7694,1589,1363,10646
12/16/2016,2016,12,16, 11 ,7953,1666,1370,10989
12/16/2016,2016,12,16, 12 ,7732,1620,1364,10716
12/16/2016,2016,12,16, 13 ,7680,1612,1377,10669
12/16/2016,2016,12,16, 14 ,7860,1668,1421,10949
12/16/2016,2016,12,16, 15 ,7741,1633,1402,10776
12/16/2016,2016,12,16, 16 ,7648,1593,1401,10642
12/16/2016,2016,12,16, 17 ,7465,1585,1392,10442
12/16/2016,2016,12,16, 18 ,7839,1709,1526,11074
12/16/2016,2016,12,16, 19 ,7637,1648,1457,10742
12/16/2016,2016,12,16, 20 ,7459,1589,1435,10483
12/16/2016,2016,12,16, 21 ,7269,1506,1369,10144
12/16/2016,2016,12,16, 22 ,6873,1376,1248,9497
12/16/2016,2016,12,16, 23 ,6540,1281,1139,8960
12/16/2016,2016,12,16, 24 ,6093,1194,1051,8338
12/17/2016,2016,12,17, 1 ,5770,1128,983,7881
12/17/2016,2016,12,17, 2 ,5578,1107,963,7648
12/17/2016,2016,12,17, 3 ,5408,1064,942,7414
12/17/2016,2016,12,17, 4 ,5392,1066,842,7300
12/17/2016,2016,12,17, 5 ,5383,1068,927,7378
12/17/2016,2016,12,17, 6 ,5459,1082,986,7527
12/17/2016,2016,12,17, 7 ,5562,1101,984,7647
12/17/2016,2016,12,17, 8 ,5938,1201,1059,8198
12/17/2016,2016,12,17, 9 ,6445,1322,1180,8947
12/17/2016,2016,12,17, 10 ,6861,1432,1292,9585
12/17/2016,2016,12,17, 11 ,7083,1471,1346,9900
12/17/2016,2016,12,17, 12 ,6899,1438,1300,9637
12/17/2016,2016,12,17, 13 ,6814,1441,1284,9539
12/17/2016,2016,12,17, 14 ,6951,1489,1297,9737
12/17/2016,2016,12,17, 15 ,6799,1453,1271,9523
12/17/2016,2016,12,17, 16 ,6665,1415,1263,9343
12/17/2016,2016,12,17, 17 ,6635,1417,1277,9329
12/17/2016,2016,12,17, 18 ,7226,1586,1439,10251
12/17/2016,2016,12,17, 19 ,7092,1607,1380,10079
12/17/2016,2016,12,17, 20 ,7032,1576,1344,9952
12/17/2016,2016,12,17, 21 ,6883,1518,1284,9685
12/17/2016,2016,12,17, 22 ,6618,1409,1194,9221
12/17/2016,2016,12,17, 23 ,6226,1327,1118,8671
12/17/2016,2016,12,17, 24 ,5916,1225,1021,8162
12/18/2016,2016,12,18, 1 ,5553,1079,957,7589
12/18/2016,2016,12,18, 2 ,5399,1105,931,7435
12/18/2016,2016,12,18, 3 ,5264,1088,915,7267
12/18/2016,2016,12,18, 4 ,5167,1082,902,7151
12/18/2016,2016,12,18, 5 ,5078,1076,905,7059
12/18/2016,2016,12,18, 6 ,5147,1068,924,7139
12/18/2016,2016,12,18, 7 ,5147,1090,900,7137
12/18/2016,2016,12,18, 8 ,5424,1135,957,7516
12/18/2016,2016,12,18, 9 ,5723,1229,1015,7967
12/18/2016,2016,12,18, 10 ,6072,1299,1113,8484
12/18/2016,2016,12,18, 11 ,6260,1366,1148,8774
12/18/2016,2016,12,18, 12 ,6189,1346,1131,8666
12/18/2016,2016,12,18, 13 ,6150,1337,1133,8620
12/18/2016,2016,12,18, 14 ,6113,1360,1152,8625
12/18/2016,2016,12,18, 15 ,6080,1335,1145,8560
12/18/2016,2016,12,18, 16 ,6035,1312,1133,8480
12/18/2016,2016,12,18, 17 ,6068,1313,1161,8542
12/18/2016,2016,12,18, 18 ,6837,1553,1365,9755
12/18/2016,2016,12,18, 19 ,6832,1566,1353,9751
12/18/2016,2016,12,18, 20 ,6812,1523,1346,9681
12/18/2016,2016,12,18, 21 ,6598,1460,1277,9335
12/18/2016,2016,12,18, 22 ,6322,1359,1164,8845
12/18/2016,2016,12,18, 23 ,5996,1253,1069,8318
12/18/2016,2016,12,18, 24 ,5646,1166,1009,7821
12/19/2016,2016,12,19, 1 ,5334,1117,950,7401
12/19/2016,2016,12,19, 2 ,5172,1090,925,7187
12/19/2016,2016,12,19, 3 ,5037,1081,907,7025
12/19/2016,2016,12,19, 4 ,5016,1063,906,6985
12/19/2016,2016,12,19, 5 ,5134,1076,924,7134
12/19/2016,2016,12,19, 6 ,5450,1140,982,7572
12/19/2016,2016,12,19, 7 ,5672,1138,969,7779
12/19/2016,2016,12,19, 8 ,6336,1257,1077,8670
12/19/2016,2016,12,19, 9 ,7023,1446,1267,9736
12/19/2016,2016,12,19, 10 ,7515,1548,1382,10445
12/19/2016,2016,12,19, 11 ,7862,1607,1463,10932
12/19/2016,2016,12,19, 12 ,7774,1556,1448,10778
12/19/2016,2016,12,19, 13 ,7779,1542,1435,10756
12/19/2016,2016,12,19, 14 ,8027,1591,1506,11124
12/19/2016,2016,12,19, 15 ,7958,1591,1500,11049
12/19/2016,2016,12,19, 16 ,7843,1581,1473,10897
12/19/2016,2016,12,19, 17 ,7568,1539,1437,10544
12/19/2016,2016,12,19, 18 ,7988,1724,1575,11287
12/19/2016,2016,12,19, 19 ,7795,1700,1530,11025
12/19/2016,2016,12,19, 20 ,7581,1645,1477,10703
12/19/2016,2016,12,19, 21 ,7426,1562,1395,10383
12/19/2016,2016,12,19, 22 ,7036,1429,1231,9696
12/19/2016,2016,12,19, 23 ,6599,1317,1135,9051
12/19/2016,2016,12,19, 24 ,6160,1237,1094,8491
12/20/2016,2016,12,20, 1 ,5872,1182,1014,8068
12/20/2016,2016,12,20, 2 ,5704,1144,988,7836
12/20/2016,2016,12,20, 3 ,5559,1122,969,7650
12/20/2016,2016,12,20, 4 ,5518,1115,974,7607
12/20/2016,2016,12,20, 5 ,5584,1130,1010,7724
12/20/2016,2016,12,20, 6 ,5713,1168,1044,7925
12/20/2016,2016,12,20, 7 ,5863,1172,1009,8044
12/20/2016,2016,12,20, 8 ,6560,1298,1121,8979
12/20/2016,2016,12,20, 9 ,7318,1500,1318,10136
12/20/2016,2016,12,20, 10 ,7831,1596,1428,10855
12/20/2016,2016,12,20, 11 ,8212,1655,1489,11356
12/20/2016,2016,12,20, 12 ,8053,1626,1479,11158
12/20/2016,2016,12,20, 13 ,8040,1642,1471,11153
12/20/2016,2016,12,20, 14 ,8350,1695,1537,11582
12/20/2016,2016,12,20, 15 ,8267,1661,1520,11448
12/20/2016,2016,12,20, 16 ,8105,1628,1504,11237
12/20/2016,2016,12,20, 17 ,7763,1580,1445,10788
12/20/2016,2016,12,20, 18 ,8214,1775,1621,11610
12/20/2016,2016,12,20, 19 ,7975,1733,1567,11275
12/20/2016,2016,12,20, 20 ,7816,1706,1519,11041
12/20/2016,2016,12,20, 21 ,7707,1616,1434,10757
12/20/2016,2016,12,20, 22 ,7236,1477,1310,10023
12/20/2016,2016,12,20, 23 ,6685,1346,1184,9215
12/20/2016,2016,12,20, 24 ,6289,1272,1097,8658
12/21/2016,2016,12,21, 1 ,6069,1202,1050,8321
12/21/2016,2016,12,21, 2 ,5931,1179,1017,8127
12/21/2016,2016,12,21, 3 ,5639,1160,991,7790
12/21/2016,2016,12,21, 4 ,5613,1149,984,7746
12/21/2016,2016,12,21, 5 ,5618,1154,993,7765
12/21/2016,2016,12,21, 6 ,5721,1181,1023,7925
12/21/2016,2016,12,21, 7 ,5841,1186,1011,8038
12/21/2016,2016,12,21, 8 ,6593,1316,1132,9041
12/21/2016,2016,12,21, 9 ,7441,1505,1311,10257
12/21/2016,2016,12,21, 10 ,7871,1596,1426,10893
12/21/2016,2016,12,21, 11 ,8278,1682,1499,11459
12/21/2016,2016,12,21, 12 ,8099,1630,1491,11220
12/21/2016,2016,12,21, 13 ,8057,1646,1490,11193
12/21/2016,2016,12,21, 14 ,8281,1696,1525,11502
12/21/2016,2016,12,21, 15 ,8209,1663,1502,11374
12/21/2016,2016,12,21, 16 ,7958,1636,1458,11052
12/21/2016,2016,12,21, 17 ,7628,1584,1446,10658
12/21/2016,2016,12,21, 18 ,8057,1758,1564,11379
12/21/2016,2016,12,21, 19 ,7916,1740,1536,11192
12/21/2016,2016,12,21, 20 ,7686,1705,1475,10866
12/21/2016,2016,12,21, 21 ,7527,1610,1399,10536
12/21/2016,2016,12,21, 22 ,7197,1483,1256,9936
12/21/2016,2016,12,21, 23 ,6725,1374,1163,9262
12/21/2016,2016,12,21, 24 ,6333,1304,1070,8707
12/22/2016,2016,12,22, 1 ,5936,1234,1028,8198
12/22/2016,2016,12,22, 2 ,5742,1201,1000,7943
12/22/2016,2016,12,22, 3 ,5636,1181,980,7797
12/22/2016,2016,12,22, 4 ,5508,1163,974,7645
12/22/2016,2016,12,22, 5 ,5489,1168,985,7642
12/22/2016,2016,12,22, 6 ,5577,1187,1026,7790
12/22/2016,2016,12,22, 7 ,5750,1198,1025,7973
12/22/2016,2016,12,22, 8 ,6343,1337,1147,8827
12/22/2016,2016,12,22, 9 ,7169,1524,1304,9997
12/22/2016,2016,12,22, 10 ,7590,1634,1395,10619
12/22/2016,2016,12,22, 11 ,7935,1688,1454,11077
12/22/2016,2016,12,22, 12 ,7892,1655,1410,10957
12/22/2016,2016,12,22, 13 ,7850,1656,1434,10940
12/22/2016,2016,12,22, 14 ,8117,1689,1482,11288
12/22/2016,2016,12,22, 15 ,8095,1689,1463,11247
12/22/2016,2016,12,22, 16 ,7887,1673,1441,11001
12/22/2016,2016,12,22, 17 ,7550,1607,1404,10561
12/22/2016,2016,12,22, 18 ,7929,1791,1543,11263
12/22/2016,2016,12,22, 19 ,7836,1778,1510,11124
12/22/2016,2016,12,22, 20 ,7565,1723,1448,10736
12/22/2016,2016,12,22, 21 ,7389,1630,1376,10395
12/22/2016,2016,12,22, 22 ,7027,1476,1173,9676
12/22/2016,2016,12,22, 23 ,6717,1404,1171,9292
12/22/2016,2016,12,22, 24 ,6296,1315,1037,8648
12/23/2016,2016,12,23, 1 ,5941,1260,1033,8234
12/23/2016,2016,12,23, 2 ,5714,1224,1013,7951
12/23/2016,2016,12,23, 3 ,5542,1191,992,7725
12/23/2016,2016,12,23, 4 ,5391,1173,990,7554
12/23/2016,2016,12,23, 5 ,5426,1182,993,7601
12/23/2016,2016,12,23, 6 ,5501,1200,1036,7737
12/23/2016,2016,12,23, 7 ,5646,1211,1031,7888
12/23/2016,2016,12,23, 8 ,6192,1296,1111,8599
12/23/2016,2016,12,23, 9 ,6801,1470,1252,9523
12/23/2016,2016,12,23, 10 ,7280,1561,1347,10188
12/23/2016,2016,12,23, 11 ,7578,1600,1400,10578
12/23/2016,2016,12,23, 12 ,7419,1561,1386,10366
12/23/2016,2016,12,23, 13 ,7333,1546,1379,10258
12/23/2016,2016,12,23, 14 ,7505,1589,1420,10514
12/23/2016,2016,12,23, 15 ,7341,1556,1420,10317
12/23/2016,2016,12,23, 16 ,7127,1549,1393,10069
12/23/2016,2016,12,23, 17 ,6845,1522,1371,9738
12/23/2016,2016,12,23, 18 ,7203,1692,1451,10346
12/23/2016,2016,12,23, 19 ,7183,1682,1465,10330
12/23/2016,2016,12,23, 20 ,7035,1643,1375,10053
12/23/2016,2016,12,23, 21 ,6900,1575,1371,9846
12/23/2016,2016,12,23, 22 ,6581,1464,1270,9315
12/23/2016,2016,12,23, 23 ,6193,1353,1201,8747
12/23/2016,2016,12,23, 24 ,5836,1266,1067,8169
12/24/2016,2016,12,24, 1 ,5527,1213,1014,7754
12/24/2016,2016,12,24, 2 ,5327,1161,992,7480
12/24/2016,2016,12,24, 3 ,5184,1129,973,7286
12/24/2016,2016,12,24, 4 ,5040,1114,955,7109
12/24/2016,2016,12,24, 5 ,4987,1119,959,7065
12/24/2016,2016,12,24, 6 ,4947,1121,976,7044
12/24/2016,2016,12,24, 7 ,4846,1100,973,6919
12/24/2016,2016,12,24, 8 ,5010,1172,1024,7206
12/24/2016,2016,12,24, 9 ,5497,1279,1126,7902
12/24/2016,2016,12,24, 10 ,5756,1341,1199,8296
12/24/2016,2016,12,24, 11 ,6046,1380,1255,8681
12/24/2016,2016,12,24, 12 ,6015,1376,1278,8669
12/24/2016,2016,12,24, 13 ,5980,1377,1286,8643
12/24/2016,2016,12,24, 14 ,5957,1367,1294,8618
12/24/2016,2016,12,24, 15 ,5845,1352,1273,8470
12/24/2016,2016,12,24, 16 ,5745,1324,1225,8294
12/24/2016,2016,12,24, 17 ,5660,1374,1216,8250
12/24/2016,2016,12,24, 18 ,6274,1594,1394,9262
12/24/2016,2016,12,24, 19 ,6273,1567,1382,9222
12/24/2016,2016,12,24, 20 ,5927,1485,1317,8729
12/24/2016,2016,12,24, 21 ,5706,1417,1235,8358
12/24/2016,2016,12,24, 22 ,5478,1340,1108,7926
12/24/2016,2016,12,24, 23 ,5308,1300,1048,7656
12/24/2016,2016,12,24, 24 ,5095,1253,1044,7392
12/25/2016,2016,12,25, 1 ,4965,1203,1068,7236
12/25/2016,2016,12,25, 2 ,4797,1155,1007,6959
12/25/2016,2016,12,25, 3 ,4676,1112,963,6751
12/25/2016,2016,12,25, 4 ,4542,1088,936,6566
12/25/2016,2016,12,25, 5 ,4475,1072,924,6471
12/25/2016,2016,12,25, 6 ,4482,1052,894,6428
12/25/2016,2016,12,25, 7 ,4347,1046,890,6283
12/25/2016,2016,12,25, 8 ,4389,1069,916,6374
12/25/2016,2016,12,25, 9 ,4480,1119,951,6550
12/25/2016,2016,12,25, 10 ,4754,1167,1025,6946
12/25/2016,2016,12,25, 11 ,5019,1218,1082,7319
12/25/2016,2016,12,25, 12 ,5142,1251,1103,7496
12/25/2016,2016,12,25, 13 ,5148,1251,1112,7511
12/25/2016,2016,12,25, 14 ,5152,1265,1136,7553
12/25/2016,2016,12,25, 15 ,5087,1242,1127,7456
12/25/2016,2016,12,25, 16 ,5003,1223,1098,7324
12/25/2016,2016,12,25, 17 ,5097,1261,1126,7484
12/25/2016,2016,12,25, 18 ,5713,1483,1286,8482
12/25/2016,2016,12,25, 19 ,5817,1511,1302,8630
12/25/2016,2016,12,25, 20 ,5762,1481,1288,8531
12/25/2016,2016,12,25, 21 ,5657,1405,1239,8301
12/25/2016,2016,12,25, 22 ,5492,1318,1115,7925
12/25/2016,2016,12,25, 23 ,5188,1250,1053,7491
12/25/2016,2016,12,25, 24 ,4998,1180,1001,7179
12/26/2016,2016,12,26, 1 ,4844,1125,955,6924
12/26/2016,2016,12,26, 2 ,4623,1092,918,6633
12/26/2016,2016,12,26, 3 ,4478,1068,896,6442
12/26/2016,2016,12,26, 4 ,4335,1056,876,6267
12/26/2016,2016,12,26, 5 ,4313,1068,888,6269
12/26/2016,2016,12,26, 6 ,4361,1081,918,6360
12/26/2016,2016,12,26, 7 ,4452,1090,924,6466
12/26/2016,2016,12,26, 8 ,4523,1158,1026,6707
12/26/2016,2016,12,26, 9 ,4835,1281,1168,7284
12/26/2016,2016,12,26, 10 ,4978,1378,1237,7593
12/26/2016,2016,12,26, 11 ,5379,1461,1349,8189
12/26/2016,2016,12,26, 12 ,5446,1480,1349,8275
12/26/2016,2016,12,26, 13 ,5428,1491,1337,8256
12/26/2016,2016,12,26, 14 ,5560,1523,1383,8466
12/26/2016,2016,12,26, 15 ,5580,1504,1362,8446
12/26/2016,2016,12,26, 16 ,5575,1474,1337,8386
12/26/2016,2016,12,26, 17 ,5731,1445,1332,8508
12/26/2016,2016,12,26, 18 ,6387,1698,1494,9579
12/26/2016,2016,12,26, 19 ,6437,1700,1488,9625
12/26/2016,2016,12,26, 20 ,6371,1663,1452,9486
12/26/2016,2016,12,26, 21 ,6160,1599,1401,9160
12/26/2016,2016,12,26, 22 ,5877,1476,1269,8622
12/26/2016,2016,12,26, 23 ,5533,1373,1185,8091
12/26/2016,2016,12,26, 24 ,5315,1286,1105,7706
12/27/2016,2016,12,27, 1 ,5053,1231,1061,7345
12/27/2016,2016,12,27, 2 ,4835,1191,1034,7060
12/27/2016,2016,12,27, 3 ,4752,1159,995,6906
12/27/2016,2016,12,27, 4 ,4686,1145,981,6812
12/27/2016,2016,12,27, 5 ,4707,1146,991,6844
12/27/2016,2016,12,27, 6 ,4919,1164,1022,7105
12/27/2016,2016,12,27, 7 ,5117,1174,1020,7311
12/27/2016,2016,12,27, 8 ,5891,1289,1136,8316
12/27/2016,2016,12,27, 9 ,6587,1481,1307,9375
12/27/2016,2016,12,27, 10 ,7184,1602,1438,10224
12/27/2016,2016,12,27, 11 ,7569,1681,1503,10753
12/27/2016,2016,12,27, 12 ,7494,1653,1521,10668
12/27/2016,2016,12,27, 13 ,7476,1648,1524,10648
12/27/2016,2016,12,27, 14 ,7709,1674,1583,10966
12/27/2016,2016,12,27, 15 ,7654,1698,1560,10912
12/27/2016,2016,12,27, 16 ,7529,1669,1537,10735
12/27/2016,2016,12,27, 17 ,7236,1614,1493,10343
12/27/2016,2016,12,27, 18 ,7519,1776,1589,10884
12/27/2016,2016,12,27, 19 ,7471,1748,1558,10777
12/27/2016,2016,12,27, 20 ,7306,1692,1475,10473
12/27/2016,2016,12,27, 21 ,7194,1615,1416,10225
12/27/2016,2016,12,27, 22 ,6992,1472,1276,9740
12/27/2016,2016,12,27, 23 ,6534,1362,1195,9091
12/27/2016,2016,12,27, 24 ,6173,1295,1109,8577
12/28/2016,2016,12,28, 1 ,5887,1247,1069,8203
12/28/2016,2016,12,28, 2 ,5704,1192,1025,7921
12/28/2016,2016,12,28, 3 ,5462,1155,997,7614
12/28/2016,2016,12,28, 4 ,5375,1139,978,7492
12/28/2016,2016,12,28, 5 ,5337,1145,989,7471
12/28/2016,2016,12,28, 6 ,5492,1167,1013,7672
12/28/2016,2016,12,28, 7 ,5563,1183,970,7716
12/28/2016,2016,12,28, 8 ,5108,1315,1086,7509
12/28/2016,2016,12,28, 9 ,6831,1518,1324,9673
12/28/2016,2016,12,28, 10 ,7344,1616,1423,10383
12/28/2016,2016,12,28, 11 ,7645,1707,1496,10848
12/28/2016,2016,12,28, 12 ,7537,1678,1497,10712
12/28/2016,2016,12,28, 13 ,7528,1671,1525,10724
12/28/2016,2016,12,28, 14 ,7727,1740,1576,11043
12/28/2016,2016,12,28, 15 ,7624,1729,1549,10902
12/28/2016,2016,12,28, 16 ,7485,1688,1512,10685
12/28/2016,2016,12,28, 17 ,7200,1600,1460,10260
12/28/2016,2016,12,28, 18 ,7430,1797,1590,10817
12/28/2016,2016,12,28, 19 ,7383,1785,1580,10748
12/28/2016,2016,12,28, 20 ,7229,1719,1529,10477
12/28/2016,2016,12,28, 21 ,7085,1660,1468,10213
12/28/2016,2016,12,28, 22 ,6845,1518,1317,9680
12/28/2016,2016,12,28, 23 ,6412,1411,1228,9051
12/28/2016,2016,12,28, 24 ,6088,1334,1137,8559
12/29/2016,2016,12,29, 1 ,5786,1263,1101,8150
12/29/2016,2016,12,29, 2 ,5513,1226,1067,7806
12/29/2016,2016,12,29, 3 ,5397,1202,1032,7631
12/29/2016,2016,12,29, 4 ,5279,1174,1012,7465
12/29/2016,2016,12,29, 5 ,5306,1173,1016,7495
12/29/2016,2016,12,29, 6 ,5403,1177,1037,7617
12/29/2016,2016,12,29, 7 ,5511,1174,1026,7711
12/29/2016,2016,12,29, 8 ,5958,1299,1130,8387
12/29/2016,2016,12,29, 9 ,6703,1505,1312,9520
12/29/2016,2016,12,29, 10 ,7176,1589,1376,10141
12/29/2016,2016,12,29, 11 ,7479,1643,1491,10613
12/29/2016,2016,12,29, 12 ,7399,1635,1484,10518
12/29/2016,2016,12,29, 13 ,7374,1627,1485,10486
12/29/2016,2016,12,29, 14 ,7547,1676,1537,10760
12/29/2016,2016,12,29, 15 ,7464,1656,1539,10659
12/29/2016,2016,12,29, 16 ,7263,1628,1503,10394
12/29/2016,2016,12,29, 17 ,6922,1541,1440,9903
12/29/2016,2016,12,29, 18 ,7182,1732,1582,10496
12/29/2016,2016,12,29, 19 ,7103,1724,1565,10392
12/29/2016,2016,12,29, 20 ,6949,1660,1504,10113
12/29/2016,2016,12,29, 21 ,6905,1596,1432,9933
12/29/2016,2016,12,29, 22 ,6583,1480,1329,9392
12/29/2016,2016,12,29, 23 ,6219,1362,1228,8809
12/29/2016,2016,12,29, 24 ,5876,1297,1137,8310
12/30/2016,2016,12,30, 1 ,5570,1230,1091,7891
12/30/2016,2016,12,30, 2 ,5413,1192,1050,7655
12/30/2016,2016,12,30, 3 ,5258,1160,1016,7434
12/30/2016,2016,12,30, 4 ,5101,1136,1001,7238
12/30/2016,2016,12,30, 5 ,5047,1133,1005,7185
12/30/2016,2016,12,30, 6 ,5026,1137,1007,7170
12/30/2016,2016,12,30, 7 ,4916,1121,999,7036
12/30/2016,2016,12,30, 8 ,5192,1179,1055,7426
12/30/2016,2016,12,30, 9 ,5491,1314,1151,7956
12/30/2016,2016,12,30, 10 ,5991,1393,1255,8639
12/30/2016,2016,12,30, 11 ,6276,1461,1331,9068
12/30/2016,2016,12,30, 12 ,6296,1452,1324,9072
12/30/2016,2016,12,30, 13 ,6284,1456,1295,9035
12/30/2016,2016,12,30, 14 ,6383,1464,1302,9149
12/30/2016,2016,12,30, 15 ,6304,1448,1324,9076
12/30/2016,2016,12,30, 16 ,6098,1421,1291,8810
12/30/2016,2016,12,30, 17 ,5881,1396,1281,8558
12/30/2016,2016,12,30, 18 ,6475,1616,1422,9513
12/30/2016,2016,12,30, 19 ,6570,1645,1423,9638
12/30/2016,2016,12,30, 20 ,6604,1603,1388,9595
12/30/2016,2016,12,30, 21 ,6442,1532,1329,9303
12/30/2016,2016,12,30, 22 ,6179,1408,1213,8800
12/30/2016,2016,12,30, 23 ,5788,1296,1119,8203
12/30/2016,2016,12,30, 24 ,5466,1237,1039,7742
12/31/2016,2016,12,31, 1 ,5163,1182,1000,7345
12/31/2016,2016,12,31, 2 ,4978,1147,958,7083
12/31/2016,2016,12,31, 3 ,4778,1114,929,6821
12/31/2016,2016,12,31, 4 ,4720,1085,917,6722
12/31/2016,2016,12,31, 5 ,4670,1094,911,6675
12/31/2016,2016,12,31, 6 ,4636,1094,929,6659
12/31/2016,2016,12,31, 7 ,4579,1083,919,6581
12/31/2016,2016,12,31, 8 ,4687,1151,970,6808
12/31/2016,2016,12,31, 9 ,5143,1254,1025,7422
12/31/2016,2016,12,31, 10 ,5397,1311,1123,7831
12/31/2016,2016,12,31, 11 ,5570,1356,1132,8058
12/31/2016,2016,12,31, 12 ,5597,1366,1139,8102
12/31/2016,2016,12,31, 13 ,5578,1359,1135,8072
12/31/2016,2016,12,31, 14 ,5586,1367,1154,8107
12/31/2016,2016,12,31, 15 ,5500,1370,1128,7998
12/31/2016,2016,12,31, 16 ,5373,1349,1119,7841
12/31/2016,2016,12,31, 17 ,5390,1347,1163,7900
12/31/2016,2016,12,31, 18 ,5897,1557,1302,8756
12/31/2016,2016,12,31, 19 ,5931,1593,1254,8778
12/31/2016,2016,12,31, 20 ,5664,1536,1234,8434
12/31/2016,2016,12,31, 21 ,5475,1491,1220,8186
12/31/2016,2016,12,31, 22 ,5314,1432,1150,7896
12/31/2016,2016,12,31, 23 ,5251,1429,1108,7788
12/31/2016,2016,12,31, 24 ,5154,1430,1129,7713
1/1/2017,2017,1,1, 1 ,5064,1371,1072,7507
1/1/2017,2017,1,1, 2 ,4807,1246,965,7018
1/1/2017,2017,1,1, 3 ,4609,1170,901,6680
1/1/2017,2017,1,1, 4 ,4457,1135,868,6460
1/1/2017,2017,1,1, 5 ,4332,1102,842,6276
1/1/2017,2017,1,1, 6 ,4268,1052,828,6148
1/1/2017,2017,1,1, 7 ,4091,1006,815,5912
1/1/2017,2017,1,1, 8 ,4107,1020,825,5952
1/1/2017,2017,1,1, 9 ,4270,1033,836,6139
1/1/2017,2017,1,1, 10 ,4431,1062,850,6343
1/1/2017,2017,1,1, 11 ,4681,1111,878,6670
1/1/2017,2017,1,1, 12 ,4874,1130,905,6909
1/1/2017,2017,1,1, 13 ,4845,1140,911,6896
1/1/2017,2017,1,1, 14 ,4853,1131,913,6897
1/1/2017,2017,1,1, 15 ,4838,1128,904,6870
1/1/2017,2017,1,1, 16 ,4760,1132,909,6801
1/1/2017,2017,1,1, 17 ,4734,1168,957,6859
1/1/2017,2017,1,1, 18 ,5226,1388,1159,7773
1/1/2017,2017,1,1, 19 ,5466,1401,1160,8027
1/1/2017,2017,1,1, 20 ,5405,1356,1124,7885
1/1/2017,2017,1,1, 21 ,5318,1288,1063,7669
1/1/2017,2017,1,1, 22 ,5091,1207,976,7274
1/1/2017,2017,1,1, 23 ,4897,1147,921,6965
1/1/2017,2017,1,1, 24 ,4704,1097,868,6669
1/2/2017,2017,1,2, 1 ,4467,1059,831,6357
1/2/2017,2017,1,2, 2 ,4263,1034,812,6109
1/2/2017,2017,1,2, 3 ,4172,1007,795,5974
1/2/2017,2017,1,2, 4 ,4077,998,782,5857
1/2/2017,2017,1,2, 5 ,4082,1007,796,5885
1/2/2017,2017,1,2, 6 ,4192,1019,822,6033
1/2/2017,2017,1,2, 7 ,4226,1027,841,6094
1/2/2017,2017,1,2, 8 ,4540,1069,898,6507
1/2/2017,2017,1,2, 9 ,5015,1177,1004,7196
1/2/2017,2017,1,2, 10 ,5494,1276,1108,7878
1/2/2017,2017,1,2, 11 ,5727,1342,1175,8244
1/2/2017,2017,1,2, 12 ,5777,1368,1164,8309
1/2/2017,2017,1,2, 13 ,5796,1330,1173,8299
1/2/2017,2017,1,2, 14 ,5841,1369,1211,8421
1/2/2017,2017,1,2, 15 ,5824,1365,1212,8401
1/2/2017,2017,1,2, 16 ,5137,1343,1211,7691
1/2/2017,2017,1,2, 17 ,5660,1348,1213,8221
1/2/2017,2017,1,2, 18 ,6322,1570,1384,9276
1/2/2017,2017,1,2, 19 ,6403,1576,1369,9348
1/2/2017,2017,1,2, 20 ,6365,1507,1321,9193
1/2/2017,2017,1,2, 21 ,6245,1438,1243,8926
1/2/2017,2017,1,2, 22 ,5899,1308,1123,8330
1/2/2017,2017,1,2, 23 ,5520,1234,1038,7792
1/2/2017,2017,1,2, 24 ,5300,1156,970,7426
1/3/2017,2017,1,3, 1 ,5067,1111,928,7106
1/3/2017,2017,1,3, 2 ,4894,1070,878,6842
1/3/2017,2017,1,3, 3 ,4745,1038,872,6655
1/3/2017,2017,1,3, 4 ,4712,1038,892,6642
1/3/2017,2017,1,3, 5 ,4842,1070,830,6742
1/3/2017,2017,1,3, 6 ,5061,1114,989,7164
1/3/2017,2017,1,3, 7 ,5304,1098,948,7350
1/3/2017,2017,1,3, 8 ,6013,1244,1051,8308
1/3/2017,2017,1,3, 9 ,6804,1415,1238,9457
1/3/2017,2017,1,3, 10 ,7227,1531,1355,10113
1/3/2017,2017,1,3, 11 ,7647,1628,1427,10702
1/3/2017,2017,1,3, 12 ,7561,1607,1426,10594
1/3/2017,2017,1,3, 13 ,7616,1637,1422,10675
1/3/2017,2017,1,3, 14 ,7906,1666,1475,11047
1/3/2017,2017,1,3, 15 ,7774,1662,1477,10913
1/3/2017,2017,1,3, 16 ,7658,1645,1468,10771
1/3/2017,2017,1,3, 17 ,7362,1560,1422,10344
1/3/2017,2017,1,3, 18 ,7561,1702,1532,10795
1/3/2017,2017,1,3, 19 ,7451,1701,1499,10651
1/3/2017,2017,1,3, 20 ,7270,1651,1442,10363
1/3/2017,2017,1,3, 21 ,7056,1554,1371,9981
1/3/2017,2017,1,3, 22 ,6668,1420,1229,9317
1/3/2017,2017,1,3, 23 ,6312,1318,1128,8758
1/3/2017,2017,1,3, 24 ,5925,1235,1055,8215
1/4/2017,2017,1,4, 1 ,5641,1193,1005,7839
1/4/2017,2017,1,4, 2 ,5496,1156,971,7623
1/4/2017,2017,1,4, 3 ,5244,1130,940,7314
1/4/2017,2017,1,4, 4 ,5296,1120,937,7353
1/4/2017,2017,1,4, 5 ,5445,1144,985,7574
1/4/2017,2017,1,4, 6 ,5648,1191,1041,7880
1/4/2017,2017,1,4, 7 ,5702,1160,980,7842
1/4/2017,2017,1,4, 8 ,6427,1294,1090,8811
1/4/2017,2017,1,4, 9 ,7295,1513,1298,10106
1/4/2017,2017,1,4, 10 ,7756,1641,1409,10806
1/4/2017,2017,1,4, 11 ,8076,1711,1461,11248
1/4/2017,2017,1,4, 12 ,7848,1675,1429,10952
1/4/2017,2017,1,4, 13 ,7829,1689,1427,10945
1/4/2017,2017,1,4, 14 ,8056,1766,1471,11293
1/4/2017,2017,1,4, 15 ,7968,1747,1463,11178
1/4/2017,2017,1,4, 16 ,7845,1696,1439,10980
1/4/2017,2017,1,4, 17 ,7536,1627,1403,10566
1/4/2017,2017,1,4, 18 ,7730,1779,1514,11023
1/4/2017,2017,1,4, 19 ,7635,1757,1494,10886
1/4/2017,2017,1,4, 20 ,7404,1690,1436,10530
1/4/2017,2017,1,4, 21 ,7234,1598,1366,10198
1/4/2017,2017,1,4, 22 ,6867,1471,1223,9561
1/4/2017,2017,1,4, 23 ,6486,1371,1141,8998
1/4/2017,2017,1,4, 24 ,6124,1290,1052,8466
1/5/2017,2017,1,5, 1 ,5841,1241,1004,8086
1/5/2017,2017,1,5, 2 ,5684,1203,976,7863
1/5/2017,2017,1,5, 3 ,5540,1185,946,7671
1/5/2017,2017,1,5, 4 ,5480,1161,937,7578
1/5/2017,2017,1,5, 5 ,5567,1187,976,7730
1/5/2017,2017,1,5, 6 ,5830,1224,1038,8092
1/5/2017,2017,1,5, 7 ,5890,1199,1017,8106
1/5/2017,2017,1,5, 8 ,6582,1299,1052,8933
1/5/2017,2017,1,5, 9 ,7297,1511,1241,10049
1/5/2017,2017,1,5, 10 ,7772,1611,1358,10741
1/5/2017,2017,1,5, 11 ,7920,1688,1407,11015
1/5/2017,2017,1,5, 12 ,7694,1664,1335,10693
1/5/2017,2017,1,5, 13 ,7655,1666,1352,10673
1/5/2017,2017,1,5, 14 ,7961,1729,1386,11076
1/5/2017,2017,1,5, 15 ,7907,1713,1376,10996
1/5/2017,2017,1,5, 16 ,7811,1689,1364,10864
1/5/2017,2017,1,5, 17 ,7508,1621,1347,10476
1/5/2017,2017,1,5, 18 ,7711,1764,1460,10935
1/5/2017,2017,1,5, 19 ,7662,1746,1412,10820
1/5/2017,2017,1,5, 20 ,7423,1674,1373,10470
1/5/2017,2017,1,5, 21 ,7226,1577,1296,10099
1/5/2017,2017,1,5, 22 ,6855,1445,1166,9466
1/5/2017,2017,1,5, 23 ,6467,1328,1073,8868
1/5/2017,2017,1,5, 24 ,6052,1251,1002,8305
1/6/2017,2017,1,6, 1 ,5799,1203,961,7963
1/6/2017,2017,1,6, 2 ,5551,1165,935,7651
1/6/2017,2017,1,6, 3 ,5475,1135,914,7524
1/6/2017,2017,1,6, 4 ,5367,1124,917,7408
1/6/2017,2017,1,6, 5 ,5517,1160,945,7622
1/6/2017,2017,1,6, 6 ,5683,1207,998,7888
1/6/2017,2017,1,6, 7 ,5728,1156,968,7852
1/6/2017,2017,1,6, 8 ,6396,1277,1079,8752
1/6/2017,2017,1,6, 9 ,7150,1485,1208,9843
1/6/2017,2017,1,6, 10 ,7648,1591,1280,10519
1/6/2017,2017,1,6, 11 ,7954,1663,1316,10933
1/6/2017,2017,1,6, 12 ,7754,1614,1268,10636
1/6/2017,2017,1,6, 13 ,7744,1604,1265,10613
1/6/2017,2017,1,6, 14 ,8043,1659,1313,11015
1/6/2017,2017,1,6, 15 ,7931,1635,1310,10876
1/6/2017,2017,1,6, 16 ,7840,1602,1305,10747
1/6/2017,2017,1,6, 17 ,7459,1573,1323,10355
1/6/2017,2017,1,6, 18 ,7707,1718,1416,10841
1/6/2017,2017,1,6, 19 ,7567,1694,1389,10650
1/6/2017,2017,1,6, 20 ,7300,1636,1314,10250
1/6/2017,2017,1,6, 21 ,7183,1564,1233,9980
1/6/2017,2017,1,6, 22 ,6825,1436,1102,9363
1/6/2017,2017,1,6, 23 ,6429,1332,1016,8777
1/6/2017,2017,1,6, 24 ,6042,1258,945,8245
1/7/2017,2017,1,7, 1 ,5802,1204,904,7910
1/7/2017,2017,1,7, 2 ,5618,1163,878,7659
1/7/2017,2017,1,7, 3 ,5438,1131,857,7426
1/7/2017,2017,1,7, 4 ,5345,1115,830,7290
1/7/2017,2017,1,7, 5 ,5348,1124,874,7346
1/7/2017,2017,1,7, 6 ,5395,1135,918,7448
1/7/2017,2017,1,7, 7 ,5440,1132,949,7521
1/7/2017,2017,1,7, 8 ,5930,1232,1009,8171
1/7/2017,2017,1,7, 9 ,6541,1392,1120,9053
1/7/2017,2017,1,7, 10 ,7078,1482,1194,9754
1/7/2017,2017,1,7, 11 ,7410,1534,1229,10173
1/7/2017,2017,1,7, 12 ,7235,1498,1197,9930
1/7/2017,2017,1,7, 13 ,7202,1483,1179,9864
1/7/2017,2017,1,7, 14 ,7449,1528,1205,10182
1/7/2017,2017,1,7, 15 ,7263,1490,1187,9940
1/7/2017,2017,1,7, 16 ,7135,1465,1196,9796
1/7/2017,2017,1,7, 17 ,6851,1453,1220,9524
1/7/2017,2017,1,7, 18 ,7160,1628,1375,10163
1/7/2017,2017,1,7, 19 ,7291,1626,1323,10240
1/7/2017,2017,1,7, 20 ,7134,1563,1260,9957
1/7/2017,2017,1,7, 21 ,6924,1497,1200,9621
1/7/2017,2017,1,7, 22 ,6657,1396,1085,9138
1/7/2017,2017,1,7, 23 ,6174,1289,986,8449
1/7/2017,2017,1,7, 24 ,5805,1214,946,7965
1/8/2017,2017,1,8, 1 ,5532,1167,873,7572
1/8/2017,2017,1,8, 2 ,5312,1132,849,7293
1/8/2017,2017,1,8, 3 ,5194,1107,818,7119
1/8/2017,2017,1,8, 4 ,5070,1084,818,6972
1/8/2017,2017,1,8, 5 ,5047,1092,835,6974
1/8/2017,2017,1,8, 6 ,4975,1097,862,6934
1/8/2017,2017,1,8, 7 ,4939,1102,883,6924
1/8/2017,2017,1,8, 8 ,5190,1123,914,7227
1/8/2017,2017,1,8, 9 ,5542,1189,981,7712
1/8/2017,2017,1,8, 10 ,5925,1245,1050,8220
1/8/2017,2017,1,8, 11 ,6244,1286,1108,8638
1/8/2017,2017,1,8, 12 ,6248,1267,1119,8634
1/8/2017,2017,1,8, 13 ,6217,1253,1104,8574
1/8/2017,2017,1,8, 14 ,6242,1237,1107,8586
1/8/2017,2017,1,8, 15 ,6203,1210,1093,8506
1/8/2017,2017,1,8, 16 ,6055,1208,1088,8351
1/8/2017,2017,1,8, 17 ,6039,1274,1123,8436
1/8/2017,2017,1,8, 18 ,6616,1469,1305,9390
1/8/2017,2017,1,8, 19 ,6727,1461,1288,9476
1/8/2017,2017,1,8, 20 ,6717,1408,1230,9355
1/8/2017,2017,1,8, 21 ,6564,1319,1169,9052
1/8/2017,2017,1,8, 22 ,6219,1203,1044,8466
1/8/2017,2017,1,8, 23 ,5864,1136,966,7966
1/8/2017,2017,1,8, 24 ,5544,1075,892,7511
1/9/2017,2017,1,9, 1 ,5229,1028,857,7114
1/9/2017,2017,1,9, 2 ,5020,993,822,6835
1/9/2017,2017,1,9, 3 ,4819,980,809,6608
1/9/2017,2017,1,9, 4 ,4778,978,803,6559
1/9/2017,2017,1,9, 5 ,5033,1014,850,6897
1/9/2017,2017,1,9, 6 ,5311,1086,944,7341
1/9/2017,2017,1,9, 7 ,5445,1117,874,7436
1/9/2017,2017,1,9, 8 ,6071,1223,994,8288
1/9/2017,2017,1,9, 9 ,6896,1374,1180,9450
1/9/2017,2017,1,9, 10 ,7440,1449,1322,10211
1/9/2017,2017,1,9, 11 ,7762,1530,1386,10678
1/9/2017,2017,1,9, 12 ,7624,1483,1342,10449
1/9/2017,2017,1,9, 13 ,7647,1456,1354,10457
1/9/2017,2017,1,9, 14 ,7925,1479,1411,10815
1/9/2017,2017,1,9, 15 ,7847,1474,1390,10711
1/9/2017,2017,1,9, 16 ,7731,1502,1366,10599
1/9/2017,2017,1,9, 17 ,7393,1508,1329,10230
1/9/2017,2017,1,9, 18 ,7629,1619,1412,10660
1/9/2017,2017,1,9, 19 ,7575,1560,1392,10527
1/9/2017,2017,1,9, 20 ,7328,1482,1371,10181
1/9/2017,2017,1,9, 21 ,7161,1406,1287,9854
1/9/2017,2017,1,9, 22 ,6801,1277,1166,9244
1/9/2017,2017,1,9, 23 ,6380,1191,1080,8651
1/9/2017,2017,1,9, 24 ,5980,1119,1002,8101
1/10/2017,2017,1,10, 1 ,5696,1078,960,7734
1/10/2017,2017,1,10, 2 ,5542,1059,929,7530
1/10/2017,2017,1,10, 3 ,5390,1041,903,7334
1/10/2017,2017,1,10, 4 ,5353,1028,903,7284
1/10/2017,2017,1,10, 5 ,5592,1079,943,7614
1/10/2017,2017,1,10, 6 ,5808,1153,1024,7985
1/10/2017,2017,1,10, 7 ,5894,1139,954,7987
1/10/2017,2017,1,10, 8 ,6500,1225,1055,8780
1/10/2017,2017,1,10, 9 ,7183,1411,1260,9854
1/10/2017,2017,1,10, 10 ,7593,1489,1298,10380
1/10/2017,2017,1,10, 11 ,7818,1541,1394,10753
1/10/2017,2017,1,10, 12 ,7553,1488,1380,10421
1/10/2017,2017,1,10, 13 ,7517,1469,1383,10369
1/10/2017,2017,1,10, 14 ,7680,1499,1452,10631
1/10/2017,2017,1,10, 15 ,7548,1512,1418,10478
1/10/2017,2017,1,10, 16 ,7510,1505,1404,10419
1/10/2017,2017,1,10, 17 ,7366,1500,1350,10216
1/10/2017,2017,1,10, 18 ,7619,1629,1466,10714
1/10/2017,2017,1,10, 19 ,7396,1610,1423,10429
1/10/2017,2017,1,10, 20 ,7144,1525,1369,10038
1/10/2017,2017,1,10, 21 ,6867,1427,1307,9601
1/10/2017,2017,1,10, 22 ,6366,1299,1185,8850
1/10/2017,2017,1,10, 23 ,5964,1196,1092,8252
1/10/2017,2017,1,10, 24 ,5658,1135,1002,7795
1/11/2017,2017,1,11, 1 ,5392,1082,966,7440
1/11/2017,2017,1,11, 2 ,5290,1066,941,7297
1/11/2017,2017,1,11, 3 ,5174,1059,911,7144
1/11/2017,2017,1,11, 4 ,5159,1038,900,7097
1/11/2017,2017,1,11, 5 ,5416,1089,942,7447
1/11/2017,2017,1,11, 6 ,5720,1167,1012,7899
1/11/2017,2017,1,11, 7 ,5868,1156,936,7960
1/11/2017,2017,1,11, 8 ,6441,1237,1002,8680
1/11/2017,2017,1,11, 9 ,7147,1409,1192,9748
1/11/2017,2017,1,11, 10 ,7604,1491,1335,10430
1/11/2017,2017,1,11, 11 ,7765,1536,1388,10689
1/11/2017,2017,1,11, 12 ,7520,1488,1377,10385
1/11/2017,2017,1,11, 13 ,7491,1470,1393,10354
1/11/2017,2017,1,11, 14 ,7677,1536,1442,10655
1/11/2017,2017,1,11, 15 ,7607,1523,1438,10568
1/11/2017,2017,1,11, 16 ,7511,1519,1407,10437
1/11/2017,2017,1,11, 17 ,7302,1512,1341,10155
1/11/2017,2017,1,11, 18 ,7582,1639,1423,10644
1/11/2017,2017,1,11, 19 ,7499,1618,1428,10545
1/11/2017,2017,1,11, 20 ,7204,1551,1374,10129
1/11/2017,2017,1,11, 21 ,6913,1451,1328,9692
1/11/2017,2017,1,11, 22 ,6466,1308,1187,8961
1/11/2017,2017,1,11, 23 ,6042,1209,1107,8358
1/11/2017,2017,1,11, 24 ,5703,1131,1016,7850
1/12/2017,2017,1,12, 1 ,5437,1085,976,7498
1/12/2017,2017,1,12, 2 ,5307,1057,946,7310
1/12/2017,2017,1,12, 3 ,5142,1027,914,7083
1/12/2017,2017,1,12, 4 ,5170,1032,908,7110
1/12/2017,2017,1,12, 5 ,5354,1079,964,7397
1/12/2017,2017,1,12, 6 ,5670,1151,1047,7868
1/12/2017,2017,1,12, 7 ,5824,1127,961,7912
1/12/2017,2017,1,12, 8 ,6314,1223,1063,8600
1/12/2017,2017,1,12, 9 ,7110,1424,1245,9779
1/12/2017,2017,1,12, 10 ,7580,1512,1352,10444
1/12/2017,2017,1,12, 11 ,7815,1570,1442,10827
1/12/2017,2017,1,12, 12 ,7619,1542,1402,10563
1/12/2017,2017,1,12, 13 ,7545,1535,1415,10495
1/12/2017,2017,1,12, 14 ,7822,1588,1465,10875
1/12/2017,2017,1,12, 15 ,7731,1574,1461,10766
1/12/2017,2017,1,12, 16 ,7621,1556,1432,10609
1/12/2017,2017,1,12, 17 ,7442,1517,1390,10349
1/12/2017,2017,1,12, 18 ,7690,1650,1488,10828
1/12/2017,2017,1,12, 19 ,7645,1630,1454,10729
1/12/2017,2017,1,12, 20 ,7390,1564,1411,10365
1/12/2017,2017,1,12, 21 ,7120,1477,1342,9939
1/12/2017,2017,1,12, 22 ,6677,1334,1207,9218
1/12/2017,2017,1,12, 23 ,6246,1232,1109,8587
1/12/2017,2017,1,12, 24 ,5857,1163,1018,8038
1/13/2017,2017,1,13, 1 ,5648,1112,993,7753
1/13/2017,2017,1,13, 2 ,5485,1080,964,7529
1/13/2017,2017,1,13, 3 ,5285,1053,938,7276
1/13/2017,2017,1,13, 4 ,5221,1042,926,7189
1/13/2017,2017,1,13, 5 ,5436,1077,968,7481
1/13/2017,2017,1,13, 6 ,5682,1154,1041,7877
1/13/2017,2017,1,13, 7 ,5785,1133,972,7890
1/13/2017,2017,1,13, 8 ,6360,1215,1086,8661
1/13/2017,2017,1,13, 9 ,7160,1409,1296,9865
1/13/2017,2017,1,13, 10 ,7684,1520,1389,10593
1/13/2017,2017,1,13, 11 ,8033,1579,1476,11088
1/13/2017,2017,1,13, 12 ,7872,1523,1441,10836
1/13/2017,2017,1,13, 13 ,7869,1491,1475,10835
1/13/2017,2017,1,13, 14 ,8171,1560,1529,11260
1/13/2017,2017,1,13, 15 ,7731,1528,1490,10749
1/13/2017,2017,1,13, 16 ,7970,1506,1466,10942
1/13/2017,2017,1,13, 17 ,7572,1476,1393,10441
1/13/2017,2017,1,13, 18 ,7707,1622,1500,10829
1/13/2017,2017,1,13, 19 ,7695,1611,1507,10813
1/13/2017,2017,1,13, 20 ,7449,1540,1439,10428
1/13/2017,2017,1,13, 21 ,7232,1461,1358,10051
1/13/2017,2017,1,13, 22 ,6877,1338,1263,9478
1/13/2017,2017,1,13, 23 ,6525,1243,1153,8921
1/13/2017,2017,1,13, 24 ,6076,1170,1085,8331
1/14/2017,2017,1,14, 1 ,5792,1113,1031,7936
1/14/2017,2017,1,14, 2 ,5604,1082,993,7679
1/14/2017,2017,1,14, 3 ,5452,1049,966,7467
1/14/2017,2017,1,14, 4 ,5384,1039,949,7372
1/14/2017,2017,1,14, 5 ,5353,1059,966,7378
1/14/2017,2017,1,14, 6 ,5433,1092,988,7513
1/14/2017,2017,1,14, 7 ,5500,1110,994,7604
1/14/2017,2017,1,14, 8 ,5966,1180,1084,8230
1/14/2017,2017,1,14, 9 ,6608,1305,1215,9128
1/14/2017,2017,1,14, 10 ,7151,1348,1323,9822
1/14/2017,2017,1,14, 11 ,7464,1394,1390,10248
1/14/2017,2017,1,14, 12 ,7282,1377,1377,10036
1/14/2017,2017,1,14, 13 ,7217,1365,1376,9958
1/14/2017,2017,1,14, 14 ,7380,1383,1443,10206
1/14/2017,2017,1,14, 15 ,7255,1351,1413,10019
1/14/2017,2017,1,14, 16 ,7080,1341,1372,9793
1/14/2017,2017,1,14, 17 ,6828,1351,1325,9504
1/14/2017,2017,1,14, 18 ,7186,1512,1431,10129
1/14/2017,2017,1,14, 19 ,7274,1507,1473,10254
1/14/2017,2017,1,14, 20 ,7097,1458,1405,9960
1/14/2017,2017,1,14, 21 ,6992,1382,1370,9744
1/14/2017,2017,1,14, 22 ,6700,1287,1281,9268
1/14/2017,2017,1,14, 23 ,6263,1188,1178,8629
1/14/2017,2017,1,14, 24 ,5945,1118,1076,8139
1/15/2017,2017,1,15, 1 ,5690,1074,1015,7779
1/15/2017,2017,1,15, 2 ,5542,1043,981,7566
1/15/2017,2017,1,15, 3 ,5326,1025,951,7302
1/15/2017,2017,1,15, 4 ,5201,1020,935,7156
1/15/2017,2017,1,15, 5 ,5123,1025,943,7091
1/15/2017,2017,1,15, 6 ,5093,1032,954,7079
1/15/2017,2017,1,15, 7 ,5087,1044,931,7062
1/15/2017,2017,1,15, 8 ,5316,1091,977,7384
1/15/2017,2017,1,15, 9 ,5730,1163,1060,7953
1/15/2017,2017,1,15, 10 ,6138,1244,1116,8498
1/15/2017,2017,1,15, 11 ,6407,1272,1175,8854
1/15/2017,2017,1,15, 12 ,6343,1256,1175,8774
1/15/2017,2017,1,15, 13 ,6312,1248,1177,8737
1/15/2017,2017,1,15, 14 ,6333,1261,1198,8792
1/15/2017,2017,1,15, 15 ,6222,1231,1182,8635
1/15/2017,2017,1,15, 16 ,6113,1215,1168,8496
1/15/2017,2017,1,15, 17 ,6140,1257,1184,8581
1/15/2017,2017,1,15, 18 ,6665,1449,1365,9479
1/15/2017,2017,1,15, 19 ,6847,1483,1402,9732
1/15/2017,2017,1,15, 20 ,6794,1430,1384,9608
1/15/2017,2017,1,15, 21 ,6551,1344,1325,9220
1/15/2017,2017,1,15, 22 ,6240,1246,1226,8712
1/15/2017,2017,1,15, 23 ,5850,1148,1109,8107
1/15/2017,2017,1,15, 24 ,5560,1090,1056,7706
1/16/2017,2017,1,16, 1 ,5251,1046,1019,7316
1/16/2017,2017,1,16, 2 ,5064,1011,985,7060
1/16/2017,2017,1,16, 3 ,4976,983,944,6903
1/16/2017,2017,1,16, 4 ,4953,983,936,6872
1/16/2017,2017,1,16, 5 ,5113,1019,972,7104
1/16/2017,2017,1,16, 6 ,5481,1070,1053,7604
1/16/2017,2017,1,16, 7 ,5647,1094,984,7725
1/16/2017,2017,1,16, 8 ,6214,1145,1074,8433
1/16/2017,2017,1,16, 9 ,6985,1313,1271,9569
1/16/2017,2017,1,16, 10 ,7420,1389,1400,10209
1/16/2017,2017,1,16, 11 ,7660,1405,1460,10525
1/16/2017,2017,1,16, 12 ,7411,1376,1449,10236
1/16/2017,2017,1,16, 13 ,7360,1317,1430,10107
1/16/2017,2017,1,16, 14 ,7621,1335,1465,10421
1/16/2017,2017,1,16, 15 ,7534,1343,1417,10294
1/16/2017,2017,1,16, 16 ,7450,1350,1393,10193
1/16/2017,2017,1,16, 17 ,7213,1349,1320,9882
1/16/2017,2017,1,16, 18 ,7349,1477,1383,10209
1/16/2017,2017,1,16, 19 ,7312,1431,1330,10073
1/16/2017,2017,1,16, 20 ,7064,1367,1280,9711
1/16/2017,2017,1,16, 21 ,6798,1272,1163,9233
1/16/2017,2017,1,16, 22 ,6448,1146,1049,8643
1/16/2017,2017,1,16, 23 ,5994,1044,964,8002
1/16/2017,2017,1,16, 24 ,5710,986,912,7608
1/17/2017,2017,1,17, 1 ,5415,944,942,7301
1/17/2017,2017,1,17, 2 ,5285,931,881,7097
1/17/2017,2017,1,17, 3 ,5175,911,862,6948
1/17/2017,2017,1,17, 4 ,5144,914,873,6931
1/17/2017,2017,1,17, 5 ,5362,958,930,7250
1/17/2017,2017,1,17, 6 ,5648,1028,1009,7685
1/17/2017,2017,1,17, 7 ,5733,1065,951,7749
1/17/2017,2017,1,17, 8 ,6315,1134,1035,8484
1/17/2017,2017,1,17, 9 ,7031,1302,1207,9540
1/17/2017,2017,1,17, 10 ,7531,1372,1320,10223
1/17/2017,2017,1,17, 11 ,7789,1408,1351,10548
1/17/2017,2017,1,17, 12 ,7488,1372,1370,10230
1/17/2017,2017,1,17, 13 ,7467,1344,1383,10194
1/17/2017,2017,1,17, 14 ,7724,1386,1432,10542
1/17/2017,2017,1,17, 15 ,7611,1392,1421,10424
1/17/2017,2017,1,17, 16 ,7448,1374,1410,10232
1/17/2017,2017,1,17, 17 ,7269,1390,1354,10013
1/17/2017,2017,1,17, 18 ,7394,1509,1439,10342
1/17/2017,2017,1,17, 19 ,7442,1493,1439,10374
1/17/2017,2017,1,17, 20 ,7204,1448,1389,10041
1/17/2017,2017,1,17, 21 ,6957,1360,1316,9633
1/17/2017,2017,1,17, 22 ,6492,1222,1165,8879
1/17/2017,2017,1,17, 23 ,6120,1127,1096,8343
1/17/2017,2017,1,17, 24 ,5647,1064,1021,7732
1/18/2017,2017,1,18, 1 ,5483,1008,965,7456
1/18/2017,2017,1,18, 2 ,5358,993,952,7303
1/18/2017,2017,1,18, 3 ,5227,974,935,7136
1/18/2017,2017,1,18, 4 ,5241,970,928,7139
1/18/2017,2017,1,18, 5 ,5454,1020,982,7456
1/18/2017,2017,1,18, 6 ,5708,1119,1058,7885
1/18/2017,2017,1,18, 7 ,5799,1101,989,7889
1/18/2017,2017,1,18, 8 ,6303,1161,1094,8558
1/18/2017,2017,1,18, 9 ,7053,1325,1243,9621
1/18/2017,2017,1,18, 10 ,7506,1415,1349,10270
1/18/2017,2017,1,18, 11 ,7795,1488,1417,10700
1/18/2017,2017,1,18, 12 ,7549,1442,1378,10369
1/18/2017,2017,1,18, 13 ,7517,1419,1391,10327
1/18/2017,2017,1,18, 14 ,7821,1482,1424,10727
1/18/2017,2017,1,18, 15 ,7784,1462,1402,10648
1/18/2017,2017,1,18, 16 ,7645,1456,1390,10491
1/18/2017,2017,1,18, 17 ,7377,1427,1359,10163
1/18/2017,2017,1,18, 18 ,7564,1571,1456,10591
1/18/2017,2017,1,18, 19 ,7530,1569,1418,10517
1/18/2017,2017,1,18, 20 ,7279,1483,1365,10127
1/18/2017,2017,1,18, 21 ,7023,1381,1284,9688
1/18/2017,2017,1,18, 22 ,6593,1263,1123,8979
1/18/2017,2017,1,18, 23 ,6159,1161,1053,8373
1/18/2017,2017,1,18, 24 ,5738,1076,986,7800
1/19/2017,2017,1,19, 1 ,5549,1034,930,7513
1/19/2017,2017,1,19, 2 ,5423,993,914,7330
1/19/2017,2017,1,19, 3 ,5247,996,865,7108
1/19/2017,2017,1,19, 4 ,5230,995,875,7100
1/19/2017,2017,1,19, 5 ,5444,1045,938,7427
1/19/2017,2017,1,19, 6 ,5686,1128,1028,7842
1/19/2017,2017,1,19, 7 ,5737,1106,994,7837
1/19/2017,2017,1,19, 8 ,6287,1164,1060,8511
1/19/2017,2017,1,19, 9 ,7079,1345,1210,9634
1/19/2017,2017,1,19, 10 ,7587,1438,1300,10325
1/19/2017,2017,1,19, 11 ,7863,1504,1346,10713
1/19/2017,2017,1,19, 12 ,7640,1452,1310,10402
1/19/2017,2017,1,19, 13 ,7678,1435,1294,10407
1/19/2017,2017,1,19, 14 ,7951,1492,1344,10787
1/19/2017,2017,1,19, 15 ,7901,1483,1350,10734
1/19/2017,2017,1,19, 16 ,7888,1467,1328,10683
1/19/2017,2017,1,19, 17 ,7582,1468,1312,10362
1/19/2017,2017,1,19, 18 ,7673,1562,1425,10660
1/19/2017,2017,1,19, 19 ,7696,1558,1396,10650
1/19/2017,2017,1,19, 20 ,7485,1478,1339,10302
1/19/2017,2017,1,19, 21 ,7163,1380,1251,9794
1/19/2017,2017,1,19, 22 ,6708,1245,1136,9089
1/19/2017,2017,1,19, 23 ,6374,1145,1040,8559
1/19/2017,2017,1,19, 24 ,5927,1046,966,7939
1/20/2017,2017,1,20, 1 ,5663,1022,929,7614
1/20/2017,2017,1,20, 2 ,5506,999,901,7406
1/20/2017,2017,1,20, 3 ,5307,983,878,7168
1/20/2017,2017,1,20, 4 ,5310,983,881,7174
1/20/2017,2017,1,20, 5 ,5440,1033,927,7400
1/20/2017,2017,1,20, 6 ,5718,1120,1011,7849
1/20/2017,2017,1,20, 7 ,5741,1097,938,7776
1/20/2017,2017,1,20, 8 ,6303,1196,1029,8528
1/20/2017,2017,1,20, 9 ,7056,1388,1208,9652
1/20/2017,2017,1,20, 10 ,7553,1466,1284,10303
1/20/2017,2017,1,20, 11 ,7743,1530,1359,10632
1/20/2017,2017,1,20, 12 ,7582,1490,1325,10397
1/20/2017,2017,1,20, 13 ,7613,1495,1353,10461
1/20/2017,2017,1,20, 14 ,7942,1533,1405,10880
1/20/2017,2017,1,20, 15 ,7848,1515,1397,10760
1/20/2017,2017,1,20, 16 ,7699,1501,1370,10570
1/20/2017,2017,1,20, 17 ,7361,1453,1347,10161
1/20/2017,2017,1,20, 18 ,7411,1583,1450,10444
1/20/2017,2017,1,20, 19 ,7513,1600,1444,10557
1/20/2017,2017,1,20, 20 ,7279,1528,1381,10188
1/20/2017,2017,1,20, 21 ,7085,1435,1296,9816
1/20/2017,2017,1,20, 22 ,6654,1312,1203,9169
1/20/2017,2017,1,20, 23 ,6235,1210,1084,8529
1/20/2017,2017,1,20, 24 ,5803,1118,1020,7941
1/21/2017,2017,1,21, 1 ,5601,1095,970,7666
1/21/2017,2017,1,21, 2 ,5420,1072,931,7423
1/21/2017,2017,1,21, 3 ,5305,1042,913,7260
1/21/2017,2017,1,21, 4 ,5162,1035,898,7095
1/21/2017,2017,1,21, 5 ,5212,1055,913,7180
1/21/2017,2017,1,21, 6 ,5291,1088,989,7368
1/21/2017,2017,1,21, 7 ,5463,1097,957,7517
1/21/2017,2017,1,21, 8 ,5949,1188,1011,8148
1/21/2017,2017,1,21, 9 ,6569,1323,1153,9045
1/21/2017,2017,1,21, 10 ,7082,1405,1249,9736
1/21/2017,2017,1,21, 11 ,7325,1458,1303,10086
1/21/2017,2017,1,21, 12 ,7123,1432,1277,9832
1/21/2017,2017,1,21, 13 ,7060,1422,1297,9779
1/21/2017,2017,1,21, 14 ,7333,1464,1311,10108
1/21/2017,2017,1,21, 15 ,7226,1416,1275,9917
1/21/2017,2017,1,21, 16 ,7088,1394,1257,9739
1/21/2017,2017,1,21, 17 ,6777,1378,1244,9399
1/21/2017,2017,1,21, 18 ,7050,1525,1369,9944
1/21/2017,2017,1,21, 19 ,7269,1551,1368,10188
1/21/2017,2017,1,21, 20 ,6994,1490,1319,9803
1/21/2017,2017,1,21, 21 ,6848,1392,1246,9486
1/21/2017,2017,1,21, 22 ,6536,1292,1149,8977
1/21/2017,2017,1,21, 23 ,6142,1205,1052,8399
1/21/2017,2017,1,21, 24 ,5791,1121,973,7885
1/22/2017,2017,1,22, 1 ,5481,1086,919,7486
1/22/2017,2017,1,22, 2 ,5364,1064,890,7318
1/22/2017,2017,1,22, 3 ,5184,1030,872,7086
1/22/2017,2017,1,22, 4 ,5069,1028,860,6957
1/22/2017,2017,1,22, 5 ,5031,1023,873,6927
1/22/2017,2017,1,22, 6 ,4989,1025,893,6907
1/22/2017,2017,1,22, 7 ,5057,1046,891,6994
1/22/2017,2017,1,22, 8 ,5221,1100,917,7238
1/22/2017,2017,1,22, 9 ,5650,1173,981,7804
1/22/2017,2017,1,22, 10 ,6130,1241,1047,8418
1/22/2017,2017,1,22, 11 ,6363,1297,1112,8772
1/22/2017,2017,1,22, 12 ,6249,1293,1129,8671
1/22/2017,2017,1,22, 13 ,6237,1297,1142,8676
1/22/2017,2017,1,22, 14 ,6211,1288,1162,8661
1/22/2017,2017,1,22, 15 ,6125,1281,1137,8543
1/22/2017,2017,1,22, 16 ,6088,1250,1118,8456
1/22/2017,2017,1,22, 17 ,6092,1259,1140,8491
1/22/2017,2017,1,22, 18 ,6612,1442,1314,9368
1/22/2017,2017,1,22, 19 ,6906,1492,1340,9738
1/22/2017,2017,1,22, 20 ,6865,1441,1305,9611
1/22/2017,2017,1,22, 21 ,6646,1379,1248,9273
1/22/2017,2017,1,22, 22 ,6264,1278,1134,8676
1/22/2017,2017,1,22, 23 ,5894,1182,1058,8134
1/22/2017,2017,1,22, 24 ,5521,1105,978,7604
1/23/2017,2017,1,23, 1 ,5254,1055,924,7233
1/23/2017,2017,1,23, 2 ,5116,1032,898,7046
1/23/2017,2017,1,23, 3 ,4957,997,854,6808
1/23/2017,2017,1,23, 4 ,4914,998,863,6775
1/23/2017,2017,1,23, 5 ,5199,1050,911,7160
1/23/2017,2017,1,23, 6 ,5523,1108,998,7629
1/23/2017,2017,1,23, 7 ,5730,1086,951,7767
1/23/2017,2017,1,23, 8 ,6296,1184,1023,8503
1/23/2017,2017,1,23, 9 ,7103,1410,1186,9699
1/23/2017,2017,1,23, 10 ,7599,1503,1277,10379
1/23/2017,2017,1,23, 11 ,7822,1573,1292,10687
1/23/2017,2017,1,23, 12 ,7547,1538,1275,10360
1/23/2017,2017,1,23, 13 ,7506,1528,1275,10309
1/23/2017,2017,1,23, 14 ,7793,1612,1322,10727
1/23/2017,2017,1,23, 15 ,7780,1600,1317,10697
1/23/2017,2017,1,23, 16 ,7744,1574,1297,10615
1/23/2017,2017,1,23, 17 ,7428,1503,1263,10194
1/23/2017,2017,1,23, 18 ,7656,1622,1393,10671
1/23/2017,2017,1,23, 19 ,7632,1649,1374,10655
1/23/2017,2017,1,23, 20 ,7346,1563,1297,10206
1/23/2017,2017,1,23, 21 ,7079,1488,1221,9788
1/23/2017,2017,1,23, 22 ,6682,1361,1095,9138
1/23/2017,2017,1,23, 23 ,6154,1249,1008,8411
1/23/2017,2017,1,23, 24 ,5712,1170,933,7815
1/24/2017,2017,1,24, 1 ,5519,1118,911,7548
1/24/2017,2017,1,24, 2 ,5329,1091,896,7316
1/24/2017,2017,1,24, 3 ,5164,1057,872,7093
1/24/2017,2017,1,24, 4 ,5171,1046,873,7090
1/24/2017,2017,1,24, 5 ,5425,1086,927,7438
1/24/2017,2017,1,24, 6 ,5685,1150,1027,7862
1/24/2017,2017,1,24, 7 ,5730,1121,969,7820
1/24/2017,2017,1,24, 8 ,6249,1218,1045,8512
1/24/2017,2017,1,24, 9 ,7017,1439,1199,9655
1/24/2017,2017,1,24, 10 ,7415,1518,1285,10218
1/24/2017,2017,1,24, 11 ,7633,1579,1336,10548
1/24/2017,2017,1,24, 12 ,7371,1537,1318,10226
1/24/2017,2017,1,24, 13 ,7343,1536,1291,10170
1/24/2017,2017,1,24, 14 ,7640,1607,1335,10582
1/24/2017,2017,1,24, 15 ,7582,1556,1328,10466
1/24/2017,2017,1,24, 16 ,7495,1564,1330,10389
1/24/2017,2017,1,24, 17 ,7269,1520,1310,10099
1/24/2017,2017,1,24, 18 ,7457,1609,1400,10466
1/24/2017,2017,1,24, 19 ,7484,1640,1356,10480
1/24/2017,2017,1,24, 20 ,7246,1574,1267,10087
1/24/2017,2017,1,24, 21 ,6986,1495,1226,9707
1/24/2017,2017,1,24, 22 ,6547,1360,1079,8986
1/24/2017,2017,1,24, 23 ,6026,1250,1008,8284
1/24/2017,2017,1,24, 24 ,5658,1175,942,7775
1/25/2017,2017,1,25, 1 ,5427,1126,902,7455
1/25/2017,2017,1,25, 2 ,5243,1097,873,7213
1/25/2017,2017,1,25, 3 ,5170,1070,858,7098
1/25/2017,2017,1,25, 4 ,5162,1060,866,7088
1/25/2017,2017,1,25, 5 ,5377,1104,906,7387
1/25/2017,2017,1,25, 6 ,5624,1174,1006,7804
1/25/2017,2017,1,25, 7 ,5783,1125,944,7852
1/25/2017,2017,1,25, 8 ,6356,1222,1033,8611
1/25/2017,2017,1,25, 9 ,6988,1440,1201,9629
1/25/2017,2017,1,25, 10 ,7246,1522,1303,10071
1/25/2017,2017,1,25, 11 ,7938,1595,1360,10893
1/25/2017,2017,1,25, 12 ,7429,1556,1315,10300
1/25/2017,2017,1,25, 13 ,7445,1560,1272,10277
1/25/2017,2017,1,25, 14 ,7750,1632,1324,10706
1/25/2017,2017,1,25, 15 ,7554,1604,1297,10455
1/25/2017,2017,1,25, 16 ,7436,1586,1316,10338
1/25/2017,2017,1,25, 17 ,7257,1504,1297,10058
1/25/2017,2017,1,25, 18 ,7401,1609,1398,10408
1/25/2017,2017,1,25, 19 ,7458,1640,1396,10494
1/25/2017,2017,1,25, 20 ,7194,1575,1353,10122
1/25/2017,2017,1,25, 21 ,6913,1498,1268,9679
1/25/2017,2017,1,25, 22 ,6473,1357,1131,8961
1/25/2017,2017,1,25, 23 ,6038,1246,1041,8325
1/25/2017,2017,1,25, 24 ,5644,1168,978,7790
1/26/2017,2017,1,26, 1 ,5432,1128,935,7495
1/26/2017,2017,1,26, 2 ,5337,1092,898,7327
1/26/2017,2017,1,26, 3 ,5173,1065,881,7119
1/26/2017,2017,1,26, 4 ,5166,1067,862,7095
1/26/2017,2017,1,26, 5 ,5398,1100,909,7407
1/26/2017,2017,1,26, 6 ,5688,1160,994,7842
1/26/2017,2017,1,26, 7 ,5735,1128,922,7785
1/26/2017,2017,1,26, 8 ,6228,1235,1012,8475
1/26/2017,2017,1,26, 9 ,6983,1430,1192,9605
1/26/2017,2017,1,26, 10 ,7399,1531,1262,10192
1/26/2017,2017,1,26, 11 ,7686,1602,1345,10633
1/26/2017,2017,1,26, 12 ,7468,1578,1330,10376
1/26/2017,2017,1,26, 13 ,7421,1572,1331,10324
1/26/2017,2017,1,26, 14 ,7672,1635,1396,10703
1/26/2017,2017,1,26, 15 ,7560,1627,1400,10587
1/26/2017,2017,1,26, 16 ,7427,1607,1366,10400
1/26/2017,2017,1,26, 17 ,7172,1514,1313,9999
1/26/2017,2017,1,26, 18 ,7301,1630,1429,10360
1/26/2017,2017,1,26, 19 ,7407,1667,1433,10507
1/26/2017,2017,1,26, 20 ,7162,1598,1369,10129
1/26/2017,2017,1,26, 21 ,6893,1509,1296,9698
1/26/2017,2017,1,26, 22 ,6458,1375,1160,8993
1/26/2017,2017,1,26, 23 ,6014,1264,1030,8308
1/26/2017,2017,1,26, 24 ,5634,1176,993,7803
1/27/2017,2017,1,27, 1 ,5453,1132,950,7535
1/27/2017,2017,1,27, 2 ,5294,1094,909,7297
1/27/2017,2017,1,27, 3 ,5134,1077,894,7105
1/27/2017,2017,1,27, 4 ,5127,1056,896,7079
1/27/2017,2017,1,27, 5 ,5338,1103,942,7383
1/27/2017,2017,1,27, 6 ,5601,1159,1024,7784
1/27/2017,2017,1,27, 7 ,5655,1133,977,7765
1/27/2017,2017,1,27, 8 ,6181,1231,1030,8442
1/27/2017,2017,1,27, 9 ,6832,1442,1169,9443
1/27/2017,2017,1,27, 10 ,7344,1537,1296,10177
1/27/2017,2017,1,27, 11 ,7505,1610,1331,10446
1/27/2017,2017,1,27, 12 ,7285,1570,1300,10155
1/27/2017,2017,1,27, 13 ,7233,1570,1300,10103
1/27/2017,2017,1,27, 14 ,7536,1614,1347,10497
1/27/2017,2017,1,27, 15 ,7496,1609,1324,10429
1/27/2017,2017,1,27, 16 ,7403,1584,1328,10315
1/27/2017,2017,1,27, 17 ,7145,1508,1291,9944
1/27/2017,2017,1,27, 18 ,7143,1635,1403,10181
1/27/2017,2017,1,27, 19 ,7275,1658,1371,10304
1/27/2017,2017,1,27, 20 ,7054,1590,1349,9993
1/27/2017,2017,1,27, 21 ,6683,1506,1276,9465
1/27/2017,2017,1,27, 22 ,6334,1382,1157,8873
1/27/2017,2017,1,27, 23 ,5912,1277,1081,8270
1/27/2017,2017,1,27, 24 ,5574,1198,1013,7785
1/28/2017,2017,1,28, 1 ,5302,1138,958,7398
1/28/2017,2017,1,28, 2 ,5111,1099,922,7132
1/28/2017,2017,1,28, 3 ,4988,1066,905,6959
1/28/2017,2017,1,28, 4 ,4978,1057,904,6939
1/28/2017,2017,1,28, 5 ,4960,1065,927,6952
1/28/2017,2017,1,28, 6 ,5015,1096,966,7077
1/28/2017,2017,1,28, 7 ,5068,1105,976,7149
1/28/2017,2017,1,28, 8 ,5440,1161,967,7568
1/28/2017,2017,1,28, 9 ,5846,1287,1090,8223
1/28/2017,2017,1,28, 10 ,6537,1356,1154,9047
1/28/2017,2017,1,28, 11 ,6750,1412,1193,9355
1/28/2017,2017,1,28, 12 ,6675,1380,1147,9202
1/28/2017,2017,1,28, 13 ,6553,1370,1136,9059
1/28/2017,2017,1,28, 14 ,6646,1400,1167,9213
1/28/2017,2017,1,28, 15 ,6504,1373,1157,9034
1/28/2017,2017,1,28, 16 ,6443,1343,1163,8949
1/28/2017,2017,1,28, 17 ,6281,1336,1197,8814
1/28/2017,2017,1,28, 18 ,6590,1485,1299,9374
1/28/2017,2017,1,28, 19 ,6813,1525,1263,9601
1/28/2017,2017,1,28, 20 ,6710,1475,1253,9438
1/28/2017,2017,1,28, 21 ,6488,1393,1157,9038
1/28/2017,2017,1,28, 22 ,6170,1272,1027,8469
1/28/2017,2017,1,28, 23 ,5793,1169,946,7908
1/28/2017,2017,1,28, 24 ,5429,1091,922,7442
1/29/2017,2017,1,29, 1 ,5137,1060,882,7079
1/29/2017,2017,1,29, 2 ,5009,1025,858,6892
1/29/2017,2017,1,29, 3 ,4868,1000,837,6705
1/29/2017,2017,1,29, 4 ,4843,977,834,6654
1/29/2017,2017,1,29, 5 ,4770,989,853,6612
1/29/2017,2017,1,29, 6 ,4845,1009,894,6748
1/29/2017,2017,1,29, 7 ,4916,1037,885,6838
1/29/2017,2017,1,29, 8 ,5190,1054,924,7168
1/29/2017,2017,1,29, 9 ,5564,1141,970,7675
1/29/2017,2017,1,29, 10 ,6001,1216,1044,8261
1/29/2017,2017,1,29, 11 ,6279,1279,1100,8658
1/29/2017,2017,1,29, 12 ,6147,1253,1126,8526
1/29/2017,2017,1,29, 13 ,6072,1255,1152,8479
1/29/2017,2017,1,29, 14 ,6079,1263,1168,8510
1/29/2017,2017,1,29, 15 ,5967,1255,1184,8406
1/29/2017,2017,1,29, 16 ,5818,1226,1144,8188
1/29/2017,2017,1,29, 17 ,5897,1233,1156,8286
1/29/2017,2017,1,29, 18 ,6336,1421,1296,9053
1/29/2017,2017,1,29, 19 ,6746,1501,1360,9607
1/29/2017,2017,1,29, 20 ,6669,1469,1330,9468
1/29/2017,2017,1,29, 21 ,6438,1399,1252,9089
1/29/2017,2017,1,29, 22 ,6182,1290,1139,8611
1/29/2017,2017,1,29, 23 ,5773,1190,1059,8022
1/29/2017,2017,1,29, 24 ,5486,1112,989,7587
1/30/2017,2017,1,30, 1 ,5173,1065,949,7187
1/30/2017,2017,1,30, 2 ,5032,1029,911,6972
1/30/2017,2017,1,30, 3 ,4949,1002,893,6844
1/30/2017,2017,1,30, 4 ,4961,995,894,6850
1/30/2017,2017,1,30, 5 ,5153,1044,948,7145
1/30/2017,2017,1,30, 6 ,5502,1116,1036,7654
1/30/2017,2017,1,30, 7 ,5723,1088,975,7786
1/30/2017,2017,1,30, 8 ,6422,1222,1086,8730
1/30/2017,2017,1,30, 9 ,7301,1485,1308,10094
1/30/2017,2017,1,30, 10 ,7787,1605,1437,10829
1/30/2017,2017,1,30, 11 ,8018,1650,1487,11155
1/30/2017,2017,1,30, 12 ,7818,1601,1451,10870
1/30/2017,2017,1,30, 13 ,7786,1595,1436,10817
1/30/2017,2017,1,30, 14 ,7992,1666,1427,11085
1/30/2017,2017,1,30, 15 ,7974,1628,1481,11083
1/30/2017,2017,1,30, 16 ,7875,1602,1450,10927
1/30/2017,2017,1,30, 17 ,7687,1534,1409,10630
1/30/2017,2017,1,30, 18 ,7834,1652,1478,10964
1/30/2017,2017,1,30, 19 ,7788,1681,1468,10937
1/30/2017,2017,1,30, 20 ,7579,1591,1409,10579
1/30/2017,2017,1,30, 21 ,7336,1505,1326,10167
1/30/2017,2017,1,30, 22 ,6957,1371,1194,9522
1/30/2017,2017,1,30, 23 ,6562,1268,1067,8897
1/30/2017,2017,1,30, 24 ,6141,1180,985,8306
1/31/2017,2017,1,31, 1 ,5875,1136,950,7961
1/31/2017,2017,1,31, 2 ,5586,1109,925,7620
1/31/2017,2017,1,31, 3 ,5484,1088,901,7473
1/31/2017,2017,1,31, 4 ,5479,1083,905,7467
1/31/2017,2017,1,31, 5 ,5653,1126,943,7722
1/31/2017,2017,1,31, 6 ,5937,1196,1044,8177
1/31/2017,2017,1,31, 7 ,5991,1148,966,8105
1/31/2017,2017,1,31, 8 ,6660,1260,1069,8989
1/31/2017,2017,1,31, 9 ,7507,1471,1262,10240
1/31/2017,2017,1,31, 10 ,7896,1564,1357,10817
1/31/2017,2017,1,31, 11 ,8233,1636,1427,11296
1/31/2017,2017,1,31, 12 ,7978,1618,1424,11020
1/31/2017,2017,1,31, 13 ,7949,1614,1424,10987
1/31/2017,2017,1,31, 14 ,8295,1694,1477,11466
1/31/2017,2017,1,31, 15 ,8225,1677,1483,11385
1/31/2017,2017,1,31, 16 ,8082,1649,1453,11184
1/31/2017,2017,1,31, 17 ,7770,1559,1406,10735
1/31/2017,2017,1,31, 18 ,7902,1679,1481,11062
1/31/2017,2017,1,31, 19 ,7946,1712,1485,11143
1/31/2017,2017,1,31, 20 ,7791,1663,1285,10739
1/31/2017,2017,1,31, 21 ,7547,1577,1268,10392
1/31/2017,2017,1,31, 22 ,7190,1457,1211,9858
1/31/2017,2017,1,31, 23 ,6739,1323,1126,9188
1/31/2017,2017,1,31, 24 ,6396,1240,1047,8683
2/1/2017,2017,2,1, 1 ,6035,1194,996,8225
2/1/2017,2017,2,1, 2 ,5846,1145,960,7951
2/1/2017,2017,2,1, 3 ,5740,1125,954,7819
2/1/2017,2017,2,1, 4 ,5675,1114,942,7731
2/1/2017,2017,2,1, 5 ,5865,1154,1000,8019
2/1/2017,2017,2,1, 6 ,6058,1223,1082,8363
2/1/2017,2017,2,1, 7 ,6119,1174,985,8278
2/1/2017,2017,2,1, 8 ,6767,1285,1076,9128
2/1/2017,2017,2,1, 9 ,7485,1505,1293,10283
2/1/2017,2017,2,1, 10 ,7993,1613,1379,10985
2/1/2017,2017,2,1, 11 ,8296,1679,1447,11422
2/1/2017,2017,2,1, 12 ,8124,1655,1428,11207
2/1/2017,2017,2,1, 13 ,8046,1640,1403,11089
2/1/2017,2017,2,1, 14 ,8344,1655,1424,11423
2/1/2017,2017,2,1, 15 ,8305,1624,1400,11329
2/1/2017,2017,2,1, 16 ,8057,1604,1359,11020
2/1/2017,2017,2,1, 17 ,7827,1541,1342,10710
2/1/2017,2017,2,1, 18 ,7817,1658,1457,10932
2/1/2017,2017,2,1, 19 ,7940,1673,1404,11017
2/1/2017,2017,2,1, 20 ,7718,1597,1354,10669
2/1/2017,2017,2,1, 21 ,7541,1518,1292,10351
2/1/2017,2017,2,1, 22 ,7135,1376,1190,9701
2/1/2017,2017,2,1, 23 ,6704,1260,1089,9053
2/1/2017,2017,2,1, 24 ,6379,1187,1016,8582
2/2/2017,2017,2,2, 1 ,5989,1133,977,8099
2/2/2017,2017,2,2, 2 ,5822,1107,942,7871
2/2/2017,2017,2,2, 3 ,5703,1081,919,7703
2/2/2017,2017,2,2, 4 ,5624,1076,900,7600
2/2/2017,2017,2,2, 5 ,5804,1121,963,7888
2/2/2017,2017,2,2, 6 ,6020,1175,1063,8258
2/2/2017,2017,2,2, 7 ,6044,1136,982,8162
2/2/2017,2017,2,2, 8 ,6667,1260,1057,8984
2/2/2017,2017,2,2, 9 ,7474,1487,1228,10189
2/2/2017,2017,2,2, 10 ,7872,1589,1352,10813
2/2/2017,2017,2,2, 11 ,8143,1653,1412,11208
2/2/2017,2017,2,2, 12 ,7938,1600,1391,10929
2/2/2017,2017,2,2, 13 ,7828,1585,1396,10809
2/2/2017,2017,2,2, 14 ,8036,1679,1441,11156
2/2/2017,2017,2,2, 15 ,7934,1640,1382,10956
2/2/2017,2017,2,2, 16 ,7786,1629,1385,10800
2/2/2017,2017,2,2, 17 ,7495,1556,1365,10416
2/2/2017,2017,2,2, 18 ,7604,1640,1474,10718
2/2/2017,2017,2,2, 19 ,7628,1697,1479,10804
2/2/2017,2017,2,2, 20 ,7341,1629,1408,10378
2/2/2017,2017,2,2, 21 ,7107,1536,1351,9994
2/2/2017,2017,2,2, 22 ,6747,1402,1216,9365
2/2/2017,2017,2,2, 23 ,6281,1292,1100,8673
2/2/2017,2017,2,2, 24 ,5959,1220,1012,8191
2/3/2017,2017,2,3, 1 ,5672,1171,974,7817
2/3/2017,2017,2,3, 2 ,5496,1138,948,7582
2/3/2017,2017,2,3, 3 ,5451,1105,921,7477
2/3/2017,2017,2,3, 4 ,5372,1096,920,7388
2/3/2017,2017,2,3, 5 ,5572,1137,975,7684
2/3/2017,2017,2,3, 6 ,5799,1187,1038,8024
2/3/2017,2017,2,3, 7 ,5783,1164,979,7926
2/3/2017,2017,2,3, 8 ,6416,1272,1059,8747
2/3/2017,2017,2,3, 9 ,7111,1464,1223,9798
2/3/2017,2017,2,3, 10 ,7487,1545,1341,10373
2/3/2017,2017,2,3, 11 ,7764,1602,1402,10768
2/3/2017,2017,2,3, 12 ,7508,1535,1370,10413
2/3/2017,2017,2,3, 13 ,7465,1533,1351,10349
2/3/2017,2017,2,3, 14 ,7751,1568,1410,10729
2/3/2017,2017,2,3, 15 ,7703,1612,1409,10724
2/3/2017,2017,2,3, 16 ,7558,1574,1359,10491
2/3/2017,2017,2,3, 17 ,7219,1495,1327,10041
2/3/2017,2017,2,3, 18 ,7271,1620,1429,10320
2/3/2017,2017,2,3, 19 ,7470,1648,1450,10568
2/3/2017,2017,2,3, 20 ,7143,1563,1378,10084
2/3/2017,2017,2,3, 21 ,6989,1483,1313,9785
2/3/2017,2017,2,3, 22 ,6551,1349,950,8850
2/3/2017,2017,2,3, 23 ,6203,1249,898,8350
2/3/2017,2017,2,3, 24 ,5868,1165,892,7925
2/4/2017,2017,2,4, 1 ,5600,1117,970,7687
2/4/2017,2017,2,4, 2 ,5461,1078,933,7472
2/4/2017,2017,2,4, 3 ,5285,1047,914,7246
2/4/2017,2017,2,4, 4 ,5226,1024,910,7160
2/4/2017,2017,2,4, 5 ,5240,1045,930,7215
2/4/2017,2017,2,4, 6 ,5360,1056,980,7396
2/4/2017,2017,2,4, 7 ,5409,1088,995,7492
2/4/2017,2017,2,4, 8 ,5869,1158,1009,8036
2/4/2017,2017,2,4, 9 ,6481,1329,1139,8949
2/4/2017,2017,2,4, 10 ,6929,1405,1213,9547
2/4/2017,2017,2,4, 11 ,7292,1458,1261,10011
2/4/2017,2017,2,4, 12 ,7085,1410,1250,9745
2/4/2017,2017,2,4, 13 ,6975,1397,1245,9617
2/4/2017,2017,2,4, 14 ,7207,1441,1263,9911
2/4/2017,2017,2,4, 15 ,7075,1413,1263,9751
2/4/2017,2017,2,4, 16 ,6883,1389,1243,9515
2/4/2017,2017,2,4, 17 ,6681,1384,1232,9297
2/4/2017,2017,2,4, 18 ,6769,1532,1355,9656
2/4/2017,2017,2,4, 19 ,7035,1565,1384,9984
2/4/2017,2017,2,4, 20 ,6861,1510,1349,9720
2/4/2017,2017,2,4, 21 ,6750,1439,1274,9463
2/4/2017,2017,2,4, 22 ,6442,1330,1182,8954
2/4/2017,2017,2,4, 23 ,5963,1223,1047,8233
2/4/2017,2017,2,4, 24 ,5646,1133,999,7778
2/5/2017,2017,2,5, 1 ,5420,1093,962,7475
2/5/2017,2017,2,5, 2 ,5259,1052,931,7242
2/5/2017,2017,2,5, 3 ,5092,1031,911,7034
2/5/2017,2017,2,5, 4 ,5027,1015,886,6928
2/5/2017,2017,2,5, 5 ,4992,1008,891,6891
2/5/2017,2017,2,5, 6 ,4969,1029,933,6931
2/5/2017,2017,2,5, 7 ,5007,1047,896,6950
2/5/2017,2017,2,5, 8 ,5263,1090,939,7292
2/5/2017,2017,2,5, 9 ,5672,1164,996,7832
2/5/2017,2017,2,5, 10 ,6096,1244,1075,8415
2/5/2017,2017,2,5, 11 ,6360,1299,1140,8799
2/5/2017,2017,2,5, 12 ,6344,1289,1152,8785
2/5/2017,2017,2,5, 13 ,6350,1278,1155,8783
2/5/2017,2017,2,5, 14 ,6387,1288,1180,8855
2/5/2017,2017,2,5, 15 ,6346,1280,1159,8785
2/5/2017,2017,2,5, 16 ,6209,1257,1161,8627
2/5/2017,2017,2,5, 17 ,6122,1265,1146,8533
2/5/2017,2017,2,5, 18 ,6411,1401,1290,9102
2/5/2017,2017,2,5, 19 ,6889,1510,1352,9751
2/5/2017,2017,2,5, 20 ,6795,1480,1340,9615
2/5/2017,2017,2,5, 21 ,6623,1408,1290,9321
2/5/2017,2017,2,5, 22 ,6247,1294,1142,8683
2/5/2017,2017,2,5, 23 ,5943,1196,1088,8227
2/5/2017,2017,2,5, 24 ,5628,1123,1008,7759
2/6/2017,2017,2,6, 1 ,5260,1079,974,7313
2/6/2017,2017,2,6, 2 ,5105,1041,938,7084
2/6/2017,2017,2,6, 3 ,4998,1013,907,6918
2/6/2017,2017,2,6, 4 ,4898,1008,910,6816
2/6/2017,2017,2,6, 5 ,5230,1055,951,7236
2/6/2017,2017,2,6, 6 ,5543,1131,1052,7726
2/6/2017,2017,2,6, 7 ,5707,1102,958,7767
2/6/2017,2017,2,6, 8 ,6321,1209,1094,8624
2/6/2017,2017,2,6, 9 ,7184,1422,1277,9883
2/6/2017,2017,2,6, 10 ,7619,1485,1425,10529
2/6/2017,2017,2,6, 11 ,7834,1546,1477,10857
2/6/2017,2017,2,6, 12 ,7608,1506,1461,10575
2/6/2017,2017,2,6, 13 ,7566,1498,1469,10533
2/6/2017,2017,2,6, 14 ,7809,1571,1537,10917
2/6/2017,2017,2,6, 15 ,7778,1577,1544,10899
2/6/2017,2017,2,6, 16 ,7675,1575,1507,10757
2/6/2017,2017,2,6, 17 ,7349,1510,1429,10288
2/6/2017,2017,2,6, 18 ,7389,1576,1489,10454
2/6/2017,2017,2,6, 19 ,7536,1635,1527,10698
2/6/2017,2017,2,6, 20 ,7229,1561,1488,10278
2/6/2017,2017,2,6, 21 ,7010,1484,1423,9917
2/6/2017,2017,2,6, 22 ,6629,1348,1280,9257
2/6/2017,2017,2,6, 23 ,6186,1230,1169,8585
2/6/2017,2017,2,6, 24 ,5813,1141,988,7942
2/7/2017,2017,2,7, 1 ,5667,1097,1051,7815
2/7/2017,2017,2,7, 2 ,5468,1063,1014,7545
2/7/2017,2017,2,7, 3 ,5231,1038,991,7260
2/7/2017,2017,2,7, 4 ,5251,1031,969,7251
2/7/2017,2017,2,7, 5 ,5360,1073,1017,7450
2/7/2017,2017,2,7, 6 ,5724,1152,1097,7973
2/7/2017,2017,2,7, 7 ,5807,1099,1009,7915
2/7/2017,2017,2,7, 8 ,6420,1233,1116,8769
2/7/2017,2017,2,7, 9 ,7090,1420,1312,9822
2/7/2017,2017,2,7, 10 ,7583,1501,1432,10516
2/7/2017,2017,2,7, 11 ,7895,1588,1498,10981
2/7/2017,2017,2,7, 12 ,7716,1550,1498,10764
2/7/2017,2017,2,7, 13 ,7743,1551,1441,10735
2/7/2017,2017,2,7, 14 ,8068,1631,1534,11233
2/7/2017,2017,2,7, 15 ,7967,1616,1572,11155
2/7/2017,2017,2,7, 16 ,7845,1598,1536,10979
2/7/2017,2017,2,7, 17 ,7506,1529,1388,10423
2/7/2017,2017,2,7, 18 ,7429,1591,1517,10537
2/7/2017,2017,2,7, 19 ,7657,1680,1563,10900
2/7/2017,2017,2,7, 20 ,7445,1607,1492,10544
2/7/2017,2017,2,7, 21 ,7245,1529,1395,10169
2/7/2017,2017,2,7, 22 ,6832,1392,1298,9522
2/7/2017,2017,2,7, 23 ,6415,1276,1185,8876
2/7/2017,2017,2,7, 24 ,5980,1198,1121,8299
2/8/2017,2017,2,8, 1 ,5713,1139,1066,7918
2/8/2017,2017,2,8, 2 ,5532,1115,1030,7677
2/8/2017,2017,2,8, 3 ,5461,1099,1006,7566
2/8/2017,2017,2,8, 4 ,5432,1080,989,7501
2/8/2017,2017,2,8, 5 ,5638,1129,1055,7822
2/8/2017,2017,2,8, 6 ,5899,1189,1131,8219
2/8/2017,2017,2,8, 7 ,5947,1145,1029,8121
2/8/2017,2017,2,8, 8 ,6496,1255,1091,8842
2/8/2017,2017,2,8, 9 ,7182,1472,1278,9932
2/8/2017,2017,2,8, 10 ,7682,1553,1438,10673
2/8/2017,2017,2,8, 11 ,7997,1646,1503,11146
2/8/2017,2017,2,8, 12 ,7713,1572,1484,10769
2/8/2017,2017,2,8, 13 ,7760,1604,1489,10853
2/8/2017,2017,2,8, 14 ,8088,1673,1555,11316
2/8/2017,2017,2,8, 15 ,8046,1669,1568,11283
2/8/2017,2017,2,8, 16 ,7635,1635,1549,10819
2/8/2017,2017,2,8, 17 ,7610,1542,1476,10628
2/8/2017,2017,2,8, 18 ,7516,1620,1513,10649
2/8/2017,2017,2,8, 19 ,7766,1707,1568,11041
2/8/2017,2017,2,8, 20 ,7483,1629,1521,10633
2/8/2017,2017,2,8, 21 ,7213,1543,1447,10203
2/8/2017,2017,2,8, 22 ,6889,1401,1297,9587
2/8/2017,2017,2,8, 23 ,6456,1298,1218,8972
2/8/2017,2017,2,8, 24 ,5906,1213,1142,8261
2/9/2017,2017,2,9, 1 ,5699,1157,1062,7918
2/9/2017,2017,2,9, 2 ,5529,1127,1050,7706
2/9/2017,2017,2,9, 3 ,5476,1102,1037,7615
2/9/2017,2017,2,9, 4 ,5414,1088,1022,7524
2/9/2017,2017,2,9, 5 ,5615,1124,1070,7809
2/9/2017,2017,2,9, 6 ,5864,1192,1142,8198
2/9/2017,2017,2,9, 7 ,5952,1147,1071,8170
2/9/2017,2017,2,9, 8 ,6474,1243,1163,8880
2/9/2017,2017,2,9, 9 ,7275,1436,1287,9998
2/9/2017,2017,2,9, 10 ,7738,1538,1431,10707
2/9/2017,2017,2,9, 11 ,8104,1606,1491,11201
2/9/2017,2017,2,9, 12 ,7832,1555,1481,10868
2/9/2017,2017,2,9, 13 ,7890,1534,1473,10897
2/9/2017,2017,2,9, 14 ,8076,1589,1537,11202
2/9/2017,2017,2,9, 15 ,8029,1577,1525,11131
2/9/2017,2017,2,9, 16 ,7870,1560,1502,10932
2/9/2017,2017,2,9, 17 ,7585,1486,1454,10525
2/9/2017,2017,2,9, 18 ,7607,1586,1495,10688
2/9/2017,2017,2,9, 19 ,7720,1636,1541,10897
2/9/2017,2017,2,9, 20 ,7479,1568,1500,10547
2/9/2017,2017,2,9, 21 ,7191,1494,1452,10137
2/9/2017,2017,2,9, 22 ,6758,1358,1308,9424
2/9/2017,2017,2,9, 23 ,6376,1250,1188,8814
2/9/2017,2017,2,9, 24 ,6009,1169,1196,8374
2/10/2017,2017,2,10, 1 ,5791,1128,956,7875
2/10/2017,2017,2,10, 2 ,5638,1085,961,7684
2/10/2017,2017,2,10, 3 ,5493,1056,927,7476
2/10/2017,2017,2,10, 4 ,5445,1049,922,7416
2/10/2017,2017,2,10, 5 ,5605,1083,940,7628
2/10/2017,2017,2,10, 6 ,5769,1147,1015,7931
2/10/2017,2017,2,10, 7 ,5876,1103,953,7932
2/10/2017,2017,2,10, 8 ,6389,1206,1044,8639
2/10/2017,2017,2,10, 9 ,7096,1396,1222,9714
2/10/2017,2017,2,10, 10 ,7539,1512,1303,10354
2/10/2017,2017,2,10, 11 ,7764,1569,1368,10701
2/10/2017,2017,2,10, 12 ,7605,1515,1395,10515
2/10/2017,2017,2,10, 13 ,7589,1514,1419,10522
2/10/2017,2017,2,10, 14 ,7878,1581,1481,10940
2/10/2017,2017,2,10, 15 ,7696,1585,1476,10757
2/10/2017,2017,2,10, 16 ,7667,1565,1449,10681
2/10/2017,2017,2,10, 17 ,7315,1471,1370,10156
2/10/2017,2017,2,10, 18 ,7216,1547,1450,10213
2/10/2017,2017,2,10, 19 ,7455,1601,1487,10543
2/10/2017,2017,2,10, 20 ,7081,1534,1419,10034
2/10/2017,2017,2,10, 21 ,6909,1454,1367,9730
2/10/2017,2017,2,10, 22 ,6564,1321,1216,9101
2/10/2017,2017,2,10, 23 ,6125,1209,1101,8435
2/10/2017,2017,2,10, 24 ,5857,1142,1081,8080
2/11/2017,2017,2,11, 1 ,5555,1090,1002,7647
2/11/2017,2017,2,11, 2 ,5409,1060,965,7434
2/11/2017,2017,2,11, 3 ,5273,1029,936,7238
2/11/2017,2017,2,11, 4 ,5273,1017,933,7223
2/11/2017,2017,2,11, 5 ,5283,1045,942,7270
2/11/2017,2017,2,11, 6 ,5353,1060,981,7394
2/11/2017,2017,2,11, 7 ,5430,1083,961,7474
2/11/2017,2017,2,11, 8 ,5884,1181,1021,8086
2/11/2017,2017,2,11, 9 ,6410,1319,1157,8886
2/11/2017,2017,2,11, 10 ,6812,1425,1251,9488
2/11/2017,2017,2,11, 11 ,7085,1473,1310,9868
2/11/2017,2017,2,11, 12 ,6883,1429,1298,9610
2/11/2017,2017,2,11, 13 ,6775,1414,1284,9473
2/11/2017,2017,2,11, 14 ,6992,1442,1353,9787
2/11/2017,2017,2,11, 15 ,6817,1440,1342,9599
2/11/2017,2017,2,11, 16 ,6728,1401,1326,9455
2/11/2017,2017,2,11, 17 ,6431,1370,1296,9097
2/11/2017,2017,2,11, 18 ,6706,1468,1407,9581
2/11/2017,2017,2,11, 19 ,6906,1562,1391,9859
2/11/2017,2017,2,11, 20 ,6700,1501,1350,9551
2/11/2017,2017,2,11, 21 ,6498,1428,1325,9251
2/11/2017,2017,2,11, 22 ,6118,1314,1235,8667
2/11/2017,2017,2,11, 23 ,5763,1209,1145,8117
2/11/2017,2017,2,11, 24 ,5377,1110,1019,7506
2/12/2017,2017,2,12, 1 ,5173,1061,970,7204
2/12/2017,2017,2,12, 2 ,5066,1031,954,7051
2/12/2017,2017,2,12, 3 ,4900,1003,924,6827
2/12/2017,2017,2,12, 4 ,4830,993,904,6727
2/12/2017,2017,2,12, 5 ,4847,991,906,6744
2/12/2017,2017,2,12, 6 ,4824,1005,922,6751
2/12/2017,2017,2,12, 7 ,4858,1024,923,6805
2/12/2017,2017,2,12, 8 ,5125,1054,939,7118
2/12/2017,2017,2,12, 9 ,5487,1111,992,7590
2/12/2017,2017,2,12, 10 ,5870,1180,1067,8117
2/12/2017,2017,2,12, 11 ,6099,1234,1059,8392
2/12/2017,2017,2,12, 12 ,6017,1184,1062,8263
2/12/2017,2017,2,12, 13 ,5969,1202,1071,8242
2/12/2017,2017,2,12, 14 ,5992,1208,1094,8294
2/12/2017,2017,2,12, 15 ,5943,1204,1102,8249
2/12/2017,2017,2,12, 16 ,5817,1197,1086,8100
2/12/2017,2017,2,12, 17 ,5701,1199,1084,7984
2/12/2017,2017,2,12, 18 ,6060,1351,1240,8651
2/12/2017,2017,2,12, 19 ,6429,1464,1313,9206
2/12/2017,2017,2,12, 20 ,6287,1409,1262,8958
2/12/2017,2017,2,12, 21 ,6017,1311,1178,8506
2/12/2017,2017,2,12, 22 ,5626,1193,1077,7896
2/12/2017,2017,2,12, 23 ,5311,1092,968,7371
2/12/2017,2017,2,12, 24 ,4937,1036,902,6875
2/13/2017,2017,2,13, 1 ,4771,985,780,6536
2/13/2017,2017,2,13, 2 ,4656,948,752,6356
2/13/2017,2017,2,13, 3 ,4557,927,734,6218
2/13/2017,2017,2,13, 4 ,4598,927,734,6259
2/13/2017,2017,2,13, 5 ,4839,979,788,6606
2/13/2017,2017,2,13, 6 ,5223,1065,892,7180
2/13/2017,2017,2,13, 7 ,5446,1046,821,7313
2/13/2017,2017,2,13, 8 ,6041,1143,894,8078
2/13/2017,2017,2,13, 9 ,6676,1342,1053,9071
2/13/2017,2017,2,13, 10 ,7083,1441,1138,9662
2/13/2017,2017,2,13, 11 ,7290,1491,1261,10042
2/13/2017,2017,2,13, 12 ,7118,1442,1227,9787
2/13/2017,2017,2,13, 13 ,6988,1431,1222,9641
2/13/2017,2017,2,13, 14 ,7245,1491,1243,9979
2/13/2017,2017,2,13, 15 ,7168,1489,1298,9955
2/13/2017,2017,2,13, 16 ,7054,1449,1273,9776
2/13/2017,2017,2,13, 17 ,6903,1404,1226,9533
2/13/2017,2017,2,13, 18 ,6937,1476,1298,9711
2/13/2017,2017,2,13, 19 ,7078,1566,1346,9990
2/13/2017,2017,2,13, 20 ,6810,1485,1203,9498
2/13/2017,2017,2,13, 21 ,6455,1382,1132,8969
2/13/2017,2017,2,13, 22 ,6010,1230,1001,8241
2/13/2017,2017,2,13, 23 ,5591,1128,914,7633
2/13/2017,2017,2,13, 24 ,5214,1052,816,7082
2/14/2017,2017,2,14, 1 ,4972,1025,904,6901
2/14/2017,2017,2,14, 2 ,4845,995,877,6717
2/14/2017,2017,2,14, 3 ,4816,961,878,6655
2/14/2017,2017,2,14, 4 ,4866,974,870,6710
2/14/2017,2017,2,14, 5 ,5123,1025,936,7084
2/14/2017,2017,2,14, 6 ,5425,1109,1031,7565
2/14/2017,2017,2,14, 7 ,5597,1079,963,7639
2/14/2017,2017,2,14, 8 ,6061,1175,1050,8286
2/14/2017,2017,2,14, 9 ,6743,1355,1210,9308
2/14/2017,2017,2,14, 10 ,7084,1448,1315,9847
2/14/2017,2017,2,14, 11 ,7366,1498,1350,10214
2/14/2017,2017,2,14, 12 ,7034,1439,1326,9799
2/14/2017,2017,2,14, 13 ,6968,1425,1333,9726
2/14/2017,2017,2,14, 14 ,7245,1512,1386,10143
2/14/2017,2017,2,14, 15 ,7233,1516,1382,10131
2/14/2017,2017,2,14, 16 ,7177,1480,1364,10021
2/14/2017,2017,2,14, 17 ,6879,1431,1324,9634
2/14/2017,2017,2,14, 18 ,6862,1506,1403,9771
2/14/2017,2017,2,14, 19 ,7054,1562,1404,10020
2/14/2017,2017,2,14, 20 ,6827,1468,1346,9641
2/14/2017,2017,2,14, 21 ,6482,1360,1286,9128
2/14/2017,2017,2,14, 22 ,6008,1225,1122,8355
2/14/2017,2017,2,14, 23 ,5556,1147,1027,7730
2/14/2017,2017,2,14, 24 ,5183,1065,951,7199
2/15/2017,2017,2,15, 1 ,4955,1035,924,6914
2/15/2017,2017,2,15, 2 ,4844,996,931,6771
2/15/2017,2017,2,15, 3 ,4693,981,915,6589
2/15/2017,2017,2,15, 4 ,4721,991,913,6625
2/15/2017,2017,2,15, 5 ,5037,1029,953,7019
2/15/2017,2017,2,15, 6 ,5365,1106,1038,7509
2/15/2017,2017,2,15, 7 ,5447,1075,958,7480
2/15/2017,2017,2,15, 8 ,5967,1185,1036,8188
2/15/2017,2017,2,15, 9 ,6548,1360,1194,9102
2/15/2017,2017,2,15, 10 ,7083,1449,1294,9826
2/15/2017,2017,2,15, 11 ,7324,1511,1325,10160
2/15/2017,2017,2,15, 12 ,7071,1443,1272,9786
2/15/2017,2017,2,15, 13 ,7036,1461,1245,9742
2/15/2017,2017,2,15, 14 ,7278,1515,1222,10015
2/15/2017,2017,2,15, 15 ,7277,1509,1251,10037
2/15/2017,2017,2,15, 16 ,7218,1471,1253,9942
2/15/2017,2017,2,15, 17 ,6957,1440,1251,9648
2/15/2017,2017,2,15, 18 ,7037,1523,1349,9909
2/15/2017,2017,2,15, 19 ,7136,1564,1328,10028
2/15/2017,2017,2,15, 20 ,6906,1485,1250,9641
2/15/2017,2017,2,15, 21 ,6599,1402,1166,9167
2/15/2017,2017,2,15, 22 ,6138,1260,1043,8441
2/15/2017,2017,2,15, 23 ,5696,1158,957,7811
2/15/2017,2017,2,15, 24 ,5263,1077,911,7251
2/16/2017,2017,2,16, 1 ,5010,1032,887,6929
2/16/2017,2017,2,16, 2 ,4967,1014,882,6863
2/16/2017,2017,2,16, 3 ,4865,994,858,6717
2/16/2017,2017,2,16, 4 ,4917,996,852,6765
2/16/2017,2017,2,16, 5 ,5176,1051,906,7133
2/16/2017,2017,2,16, 6 ,5584,1117,975,7676
2/16/2017,2017,2,16, 7 ,5624,1112,981,7717
2/16/2017,2017,2,16, 8 ,6168,1182,1017,8367
2/16/2017,2017,2,16, 9 ,6737,1352,1065,9154
2/16/2017,2017,2,16, 10 ,7140,1421,1191,9752
2/16/2017,2017,2,16, 11 ,7543,1436,1234,10213
2/16/2017,2017,2,16, 12 ,7265,1389,1223,9877
2/16/2017,2017,2,16, 13 ,7276,1355,1210,9841
2/16/2017,2017,2,16, 14 ,7597,1397,1236,10230
2/16/2017,2017,2,16, 15 ,7502,1380,1265,10147
2/16/2017,2017,2,16, 16 ,7390,1369,1261,10020
2/16/2017,2017,2,16, 17 ,7139,1345,1243,9727
2/16/2017,2017,2,16, 18 ,7246,1474,1353,10073
2/16/2017,2017,2,16, 19 ,7497,1471,1381,10349
2/16/2017,2017,2,16, 20 ,7202,1387,1319,9908
2/16/2017,2017,2,16, 21 ,6804,1277,1174,9255
2/16/2017,2017,2,16, 22 ,6444,1143,1090,8677
2/16/2017,2017,2,16, 23 ,6004,1055,995,8054
2/16/2017,2017,2,16, 24 ,5632,992,915,7539
2/17/2017,2017,2,17, 1 ,5330,965,894,7189
2/17/2017,2017,2,17, 2 ,5201,943,851,6995
2/17/2017,2017,2,17, 3 ,5088,932,825,6845
2/17/2017,2017,2,17, 4 ,5139,940,835,6914
2/17/2017,2017,2,17, 5 ,5341,995,891,7227
2/17/2017,2017,2,17, 6 ,5628,1076,986,7690
2/17/2017,2017,2,17, 7 ,5674,1069,922,7665
2/17/2017,2017,2,17, 8 ,6208,1170,995,8373
2/17/2017,2017,2,17, 9 ,6906,1363,1166,9435
2/17/2017,2017,2,17, 10 ,7433,1475,1254,10162
2/17/2017,2017,2,17, 11 ,7638,1542,1300,10480
2/17/2017,2017,2,17, 12 ,7398,1490,1258,10146
2/17/2017,2017,2,17, 13 ,7308,1485,1259,10052
2/17/2017,2017,2,17, 14 ,7614,1549,1303,10466
2/17/2017,2017,2,17, 15 ,7568,1563,1313,10444
2/17/2017,2017,2,17, 16 ,7522,1545,1326,10393
2/17/2017,2017,2,17, 17 ,7273,1473,1303,10049
2/17/2017,2017,2,17, 18 ,7331,1571,1378,10280
2/17/2017,2017,2,17, 19 ,7504,1612,1385,10501
2/17/2017,2017,2,17, 20 ,7306,1557,1320,10183
2/17/2017,2017,2,17, 21 ,7039,1470,1248,9757
2/17/2017,2017,2,17, 22 ,6640,1341,1135,9116
2/17/2017,2017,2,17, 23 ,6207,1237,1054,8498
2/17/2017,2017,2,17, 24 ,5859,1164,905,7928
2/18/2017,2017,2,18, 1 ,5578,1113,929,7620
2/18/2017,2017,2,18, 2 ,5483,1081,913,7477
2/18/2017,2017,2,18, 3 ,5363,1053,881,7297
2/18/2017,2017,2,18, 4 ,5283,1041,881,7205
2/18/2017,2017,2,18, 5 ,5367,1059,900,7326
2/18/2017,2017,2,18, 6 ,5451,1094,956,7501
2/18/2017,2017,2,18, 7 ,5552,1099,940,7591
2/18/2017,2017,2,18, 8 ,5983,1185,1023,8191
2/18/2017,2017,2,18, 9 ,6552,1350,1069,8971
2/18/2017,2017,2,18, 10 ,7100,1462,1226,9788
2/18/2017,2017,2,18, 11 ,7401,1507,1249,10157
2/18/2017,2017,2,18, 12 ,7124,1473,1243,9840
2/18/2017,2017,2,18, 13 ,6969,1467,1246,9682
2/18/2017,2017,2,18, 14 ,7077,1536,1302,9915
2/18/2017,2017,2,18, 15 ,7016,1499,1317,9832
2/18/2017,2017,2,18, 16 ,6866,1465,1304,9635
2/18/2017,2017,2,18, 17 ,6757,1419,1256,9432
2/18/2017,2017,2,18, 18 ,6571,1518,1381,9470
2/18/2017,2017,2,18, 19 ,7174,1613,1422,10209
2/18/2017,2017,2,18, 20 ,7009,1549,1357,9915
2/18/2017,2017,2,18, 21 ,6813,1493,1282,9588
2/18/2017,2017,2,18, 22 ,6533,1370,1190,9093
2/18/2017,2017,2,18, 23 ,6163,1265,1089,8517
2/18/2017,2017,2,18, 24 ,5845,1189,1019,8053
2/19/2017,2017,2,19, 1 ,5512,1137,973,7622
2/19/2017,2017,2,19, 2 ,5380,1102,942,7424
2/19/2017,2017,2,19, 3 ,5301,1076,910,7287
2/19/2017,2017,2,19, 4 ,5219,1058,895,7172
2/19/2017,2017,2,19, 5 ,5172,1055,899,7126
2/19/2017,2017,2,19, 6 ,5183,1051,933,7167
2/19/2017,2017,2,19, 7 ,5196,1070,925,7191
2/19/2017,2017,2,19, 8 ,5374,1116,913,7403
2/19/2017,2017,2,19, 9 ,5741,1203,980,7924
2/19/2017,2017,2,19, 10 ,6075,1272,1062,8409
2/19/2017,2017,2,19, 11 ,6277,1334,1124,8735
2/19/2017,2017,2,19, 12 ,6156,1324,1171,8651
2/19/2017,2017,2,19, 13 ,6034,1302,1170,8506
2/19/2017,2017,2,19, 14 ,6030,1317,1168,8515
2/19/2017,2017,2,19, 15 ,6022,1317,1093,8432
2/19/2017,2017,2,19, 16 ,5952,1291,1154,8397
2/19/2017,2017,2,19, 17 ,5939,1293,1170,8402
2/19/2017,2017,2,19, 18 ,6221,1420,1273,8914
2/19/2017,2017,2,19, 19 ,6758,1531,1326,9615
2/19/2017,2017,2,19, 20 ,6629,1495,1287,9411
2/19/2017,2017,2,19, 21 ,6420,1426,1225,9071
2/19/2017,2017,2,19, 22 ,6077,1315,1112,8504
2/19/2017,2017,2,19, 23 ,5636,1217,1022,7875
2/19/2017,2017,2,19, 24 ,5314,1136,957,7407
2/20/2017,2017,2,20, 1 ,5047,1079,918,7044
2/20/2017,2017,2,20, 2 ,4892,1044,884,6820
2/20/2017,2017,2,20, 3 ,4745,1019,868,6632
2/20/2017,2017,2,20, 4 ,4738,1017,855,6610
2/20/2017,2017,2,20, 5 ,5040,1057,912,7009
2/20/2017,2017,2,20, 6 ,5412,1136,1006,7554
2/20/2017,2017,2,20, 7 ,5507,1111,958,7576
2/20/2017,2017,2,20, 8 ,6197,1207,1049,8453
2/20/2017,2017,2,20, 9 ,7056,1400,1212,9668
2/20/2017,2017,2,20, 10 ,7658,1487,1337,10482
2/20/2017,2017,2,20, 11 ,7948,1549,1397,10894
2/20/2017,2017,2,20, 12 ,7856,1500,1380,10736
2/20/2017,2017,2,20, 13 ,7885,1500,1367,10752
2/20/2017,2017,2,20, 14 ,8233,1544,1458,11235
2/20/2017,2017,2,20, 15 ,8209,1538,1429,11176
2/20/2017,2017,2,20, 16 ,8464,1529,1379,11372
2/20/2017,2017,2,20, 17 ,7798,1497,1357,10652
2/20/2017,2017,2,20, 18 ,7629,1549,1419,10597
2/20/2017,2017,2,20, 19 ,7907,1587,1459,10953
2/20/2017,2017,2,20, 20 ,7670,1541,1394,10605
2/20/2017,2017,2,20, 21 ,7390,1471,1314,10175
2/20/2017,2017,2,20, 22 ,7067,1323,1173,9563
2/20/2017,2017,2,20, 23 ,6632,1223,1073,8928
2/20/2017,2017,2,20, 24 ,6216,1146,978,8340
2/21/2017,2017,2,21, 1 ,5954,1098,948,8000
2/21/2017,2017,2,21, 2 ,5783,1073,913,7769
2/21/2017,2017,2,21, 3 ,5606,1050,893,7549
2/21/2017,2017,2,21, 4 ,5583,1025,890,7498
2/21/2017,2017,2,21, 5 ,5826,1088,955,7869
2/21/2017,2017,2,21, 6 ,6027,1168,1049,8244
2/21/2017,2017,2,21, 7 ,6051,1131,960,8142
2/21/2017,2017,2,21, 8 ,6686,1235,1063,8984
2/21/2017,2017,2,21, 9 ,7458,1448,1221,10127
2/21/2017,2017,2,21, 10 ,7941,1569,1337,10847
2/21/2017,2017,2,21, 11 ,8332,1615,1395,11342
2/21/2017,2017,2,21, 12 ,8036,1577,1394,11007
2/21/2017,2017,2,21, 13 ,7989,1597,1398,10984
2/21/2017,2017,2,21, 14 ,8340,1675,1465,11480
2/21/2017,2017,2,21, 15 ,8320,1652,1453,11425
2/21/2017,2017,2,21, 16 ,8174,1608,1439,11221
2/21/2017,2017,2,21, 17 ,7801,1524,1363,10688
2/21/2017,2017,2,21, 18 ,7642,1574,1459,10675
2/21/2017,2017,2,21, 19 ,7928,1678,1469,11075
2/21/2017,2017,2,21, 20 ,7710,1591,1313,10614
2/21/2017,2017,2,21, 21 ,7536,1518,1335,10389
2/21/2017,2017,2,21, 22 ,7122,1379,1163,9664
2/21/2017,2017,2,21, 23 ,6701,1269,1098,9068
2/21/2017,2017,2,21, 24 ,6255,1192,1020,8467
2/22/2017,2017,2,22, 1 ,5983,1136,1027,8146
2/22/2017,2017,2,22, 2 ,5735,1102,986,7823
2/22/2017,2017,2,22, 3 ,5604,1068,959,7631
2/22/2017,2017,2,22, 4 ,5526,1062,950,7538
2/22/2017,2017,2,22, 5 ,5726,1107,1014,7847
2/22/2017,2017,2,22, 6 ,6039,1178,1094,8311
2/22/2017,2017,2,22, 7 ,6033,1130,989,8152
2/22/2017,2017,2,22, 8 ,6651,1244,1099,8994
2/22/2017,2017,2,22, 9 ,7516,1452,1310,10278
2/22/2017,2017,2,22, 10 ,8027,1546,1417,10990
2/22/2017,2017,2,22, 11 ,8325,1608,1489,11422
2/22/2017,2017,2,22, 12 ,8079,1576,1459,11114
2/22/2017,2017,2,22, 13 ,8080,1580,1466,11126
2/22/2017,2017,2,22, 14 ,8395,1676,1515,11586
2/22/2017,2017,2,22, 15 ,8392,1648,1512,11552
2/22/2017,2017,2,22, 16 ,8243,1599,1491,11333
2/22/2017,2017,2,22, 17 ,7886,1532,1430,10848
2/22/2017,2017,2,22, 18 ,7748,1608,1495,10851
2/22/2017,2017,2,22, 19 ,7997,1695,1532,11224
2/22/2017,2017,2,22, 20 ,7799,1610,1471,10880
2/22/2017,2017,2,22, 21 ,7574,1537,1407,10518
2/22/2017,2017,2,22, 22 ,7115,1402,1264,9781
2/22/2017,2017,2,22, 23 ,6741,1297,1163,9201
2/22/2017,2017,2,22, 24 ,6249,1219,1087,8555
2/23/2017,2017,2,23, 1 ,6001,1171,1048,8220
2/23/2017,2017,2,23, 2 ,5840,1125,1015,7980
2/23/2017,2017,2,23, 3 ,5652,1109,989,7750
2/23/2017,2017,2,23, 4 ,5596,1094,984,7674
2/23/2017,2017,2,23, 5 ,5801,1137,1031,7969
2/23/2017,2017,2,23, 6 ,6045,1195,1108,8348
2/23/2017,2017,2,23, 7 ,6069,1123,1013,8205
2/23/2017,2017,2,23, 8 ,6770,1214,1094,9078
2/23/2017,2017,2,23, 9 ,7518,1403,1294,10215
2/23/2017,2017,2,23, 10 ,8016,1513,1406,10935
2/23/2017,2017,2,23, 11 ,8335,1592,1435,11362
2/23/2017,2017,2,23, 12 ,8212,1526,1367,11105
2/23/2017,2017,2,23, 13 ,8206,1533,1392,11131
2/23/2017,2017,2,23, 14 ,8585,1596,1452,11633
2/23/2017,2017,2,23, 15 ,8570,1571,1461,11602
2/23/2017,2017,2,23, 16 ,8431,1568,1426,11425
2/23/2017,2017,2,23, 17 ,8064,1544,1425,11033
2/23/2017,2017,2,23, 18 ,7909,1629,1508,11046
2/23/2017,2017,2,23, 19 ,8218,1625,1479,11322
2/23/2017,2017,2,23, 20 ,8004,1561,1428,10993
2/23/2017,2017,2,23, 21 ,7777,1453,1351,10581
2/23/2017,2017,2,23, 22 ,7406,1334,1215,9955
2/23/2017,2017,2,23, 23 ,6930,1240,1122,9292
2/23/2017,2017,2,23, 24 ,6541,1162,1027,8730
2/24/2017,2017,2,24, 1 ,6240,1116,1006,8362
2/24/2017,2017,2,24, 2 ,6037,1082,972,8091
2/24/2017,2017,2,24, 3 ,5860,1055,948,7863
2/24/2017,2017,2,24, 4 ,5787,1055,938,7780
2/24/2017,2017,2,24, 5 ,5934,1104,968,8006
2/24/2017,2017,2,24, 6 ,6115,1163,1070,8348
2/24/2017,2017,2,24, 7 ,6184,1152,1013,8349
2/24/2017,2017,2,24, 8 ,6829,1243,1080,9152
2/24/2017,2017,2,24, 9 ,7593,1437,1263,10293
2/24/2017,2017,2,24, 10 ,8138,1564,1353,11055
2/24/2017,2017,2,24, 11 ,8429,1615,1418,11462
2/24/2017,2017,2,24, 12 ,8235,1560,1402,11197
2/24/2017,2017,2,24, 13 ,8248,1601,1405,11254
2/24/2017,2017,2,24, 14 ,8586,1657,1466,11709
2/24/2017,2017,2,24, 15 ,8499,1640,1448,11587
2/24/2017,2017,2,24, 16 ,8333,1586,1425,11344
2/24/2017,2017,2,24, 17 ,7985,1528,1349,10862
2/24/2017,2017,2,24, 18 ,7891,1600,1404,10895
2/24/2017,2017,2,24, 19 ,8024,1679,1433,11136
2/24/2017,2017,2,24, 20 ,7890,1597,1415,10902
2/24/2017,2017,2,24, 21 ,7619,1523,1344,10486
2/24/2017,2017,2,24, 22 ,7291,1409,1229,9929
2/24/2017,2017,2,24, 23 ,6823,1288,1116,9227
2/24/2017,2017,2,24, 24 ,6515,1205,1029,8749
2/25/2017,2017,2,25, 1 ,6222,1157,984,8363
2/25/2017,2017,2,25, 2 ,5987,1126,956,8069
2/25/2017,2017,2,25, 3 ,5834,1095,931,7860
2/25/2017,2017,2,25, 4 ,5701,1066,909,7676
2/25/2017,2017,2,25, 5 ,5670,1081,922,7673
2/25/2017,2017,2,25, 6 ,5598,1077,971,7646
2/25/2017,2017,2,25, 7 ,5631,1101,948,7680
2/25/2017,2017,2,25, 8 ,6004,1170,1011,8185
2/25/2017,2017,2,25, 9 ,6566,1305,1094,8965
2/25/2017,2017,2,25, 10 ,7011,1400,1200,9611
2/25/2017,2017,2,25, 11 ,7395,1464,1279,10138
2/25/2017,2017,2,25, 12 ,7281,1449,1248,9978
2/25/2017,2017,2,25, 13 ,7310,1461,1275,10046
2/25/2017,2017,2,25, 14 ,7511,1503,1263,10277
2/25/2017,2017,2,25, 15 ,7343,1471,1263,10077
2/25/2017,2017,2,25, 16 ,7145,1418,1261,9824
2/25/2017,2017,2,25, 17 ,6901,1394,1239,9534
2/25/2017,2017,2,25, 18 ,7040,1499,1339,9878
2/25/2017,2017,2,25, 19 ,7464,1612,1400,10476
2/25/2017,2017,2,25, 20 ,7278,1561,1349,10188
2/25/2017,2017,2,25, 21 ,7207,1497,1293,9997
2/25/2017,2017,2,25, 22 ,6935,1401,1176,9512
2/25/2017,2017,2,25, 23 ,6553,1283,1047,8883
2/25/2017,2017,2,25, 24 ,6146,1191,989,8326
2/26/2017,2017,2,26, 1 ,5851,1141,944,7936
2/26/2017,2017,2,26, 2 ,5738,1103,906,7747
2/26/2017,2017,2,26, 3 ,5581,1076,892,7549
2/26/2017,2017,2,26, 4 ,5430,1058,875,7363
2/26/2017,2017,2,26, 5 ,5347,1066,880,7293
2/26/2017,2017,2,26, 6 ,5427,1073,908,7408
2/26/2017,2017,2,26, 7 ,5291,1064,903,7258
2/26/2017,2017,2,26, 8 ,5620,1122,933,7675
2/26/2017,2017,2,26, 9 ,6019,1202,1007,8228
2/26/2017,2017,2,26, 10 ,6451,1296,1081,8828
2/26/2017,2017,2,26, 11 ,6756,1336,1143,9235
2/26/2017,2017,2,26, 12 ,6646,1340,1137,9123
2/26/2017,2017,2,26, 13 ,6705,1349,1134,9188
2/26/2017,2017,2,26, 14 ,6730,1341,1175,9246
2/26/2017,2017,2,26, 15 ,6647,1335,1164,9146
2/26/2017,2017,2,26, 16 ,6496,1319,1142,8957
2/26/2017,2017,2,26, 17 ,6407,1311,1142,8860
2/26/2017,2017,2,26, 18 ,6618,1407,1285,9310
2/26/2017,2017,2,26, 19 ,7206,1549,1362,10117
2/26/2017,2017,2,26, 20 ,7137,1520,1322,9979
2/26/2017,2017,2,26, 21 ,7001,1457,1252,9710
2/26/2017,2017,2,26, 22 ,6676,1339,1095,9110
2/26/2017,2017,2,26, 23 ,6353,1239,1012,8604
2/26/2017,2017,2,26, 24 ,5923,1150,942,8015
2/27/2017,2017,2,27, 1 ,5670,1100,940,7710
2/27/2017,2017,2,27, 2 ,5475,1089,908,7472
2/27/2017,2017,2,27, 3 ,5327,1042,886,7255
2/27/2017,2017,2,27, 4 ,5286,1030,882,7198
2/27/2017,2017,2,27, 5 ,5483,1071,940,7494
2/27/2017,2017,2,27, 6 ,5760,1143,1034,7937
2/27/2017,2017,2,27, 7 ,5851,1117,962,7930
2/27/2017,2017,2,27, 8 ,6593,1242,1058,8893
2/27/2017,2017,2,27, 9 ,7433,1442,1229,10104
2/27/2017,2017,2,27, 10 ,7962,1559,1338,10859
2/27/2017,2017,2,27, 11 ,8275,1614,1376,11265
2/27/2017,2017,2,27, 12 ,8118,1587,1365,11070
2/27/2017,2017,2,27, 13 ,8110,1596,1374,11080
2/27/2017,2017,2,27, 14 ,8423,1651,1429,11503
2/27/2017,2017,2,27, 15 ,8374,1628,1450,11452
2/27/2017,2017,2,27, 16 ,8157,1605,1423,11185
2/27/2017,2017,2,27, 17 ,7802,1534,1381,10717
2/27/2017,2017,2,27, 18 ,7635,1594,1452,10681
2/27/2017,2017,2,27, 19 ,7978,1683,1475,11136
2/27/2017,2017,2,27, 20 ,7782,1631,1431,10844
2/27/2017,2017,2,27, 21 ,7588,1557,1346,10491
2/27/2017,2017,2,27, 22 ,7209,1418,1217,9844
2/27/2017,2017,2,27, 23 ,6763,1313,1118,9194
2/27/2017,2017,2,27, 24 ,6293,1231,1026,8550
2/28/2017,2017,2,28, 1 ,5994,1180,999,8173
2/28/2017,2017,2,28, 2 ,5815,1155,956,7926
2/28/2017,2017,2,28, 3 ,5684,1124,928,7736
2/28/2017,2017,2,28, 4 ,5612,1110,927,7649
2/28/2017,2017,2,28, 5 ,5800,1151,985,7936
2/28/2017,2017,2,28, 6 ,6009,1216,1076,8301
2/28/2017,2017,2,28, 7 ,6085,1133,967,8185
2/28/2017,2017,2,28, 8 ,6692,1266,1122,9080
2/28/2017,2017,2,28, 9 ,7516,1486,1280,10282
2/28/2017,2017,2,28, 10 ,7961,1591,1423,10975
2/28/2017,2017,2,28, 11 ,8250,1648,1467,11365
2/28/2017,2017,2,28, 12 ,8060,1627,1437,11124
2/28/2017,2017,2,28, 13 ,8044,1629,1436,11109
2/28/2017,2017,2,28, 14 ,8432,1694,1509,11635
2/28/2017,2017,2,28, 15 ,8381,1692,1517,11590
2/28/2017,2017,2,28, 16 ,8169,1636,1485,11290
2/28/2017,2017,2,28, 17 ,7855,1577,1394,10826
2/28/2017,2017,2,28, 18 ,7707,1667,1444,10818
2/28/2017,2017,2,28, 19 ,8041,1744,1507,11292
2/28/2017,2017,2,28, 20 ,7815,1673,1452,10940
2/28/2017,2017,2,28, 21 ,7630,1590,1370,10590
2/28/2017,2017,2,28, 22 ,7206,1461,1241,9908
2/28/2017,2017,2,28, 23 ,6775,1350,1142,9267
2/28/2017,2017,2,28, 24 ,6395,1253,1045,8693
3/1/2017,2017,3,1, 1 ,6126,1206,997,8329
3/1/2017,2017,3,1, 2 ,5933,1166,963,8062
3/1/2017,2017,3,1, 3 ,5696,1143,957,7796
3/1/2017,2017,3,1, 4 ,5624,1129,979,7732
3/1/2017,2017,3,1, 5 ,5797,1168,996,7961
3/1/2017,2017,3,1, 6 ,6000,1213,1064,8277
3/1/2017,2017,3,1, 7 ,5993,1176,972,8141
3/1/2017,2017,3,1, 8 ,6740,1311,1099,9150
3/1/2017,2017,3,1, 9 ,7454,1520,1267,10241
3/1/2017,2017,3,1, 10 ,8013,1646,1429,11088
3/1/2017,2017,3,1, 11 ,8309,1714,1497,11520
3/1/2017,2017,3,1, 12 ,8126,1674,1464,11264
3/1/2017,2017,3,1, 13 ,8168,1682,1514,11364
3/1/2017,2017,3,1, 14 ,8458,1768,1548,11774
3/1/2017,2017,3,1, 15 ,8380,1760,1526,11666
3/1/2017,2017,3,1, 16 ,8321,1711,1502,11534
3/1/2017,2017,3,1, 17 ,7876,1613,1416,10905
3/1/2017,2017,3,1, 18 ,7628,1640,1431,10699
3/1/2017,2017,3,1, 19 ,7935,1750,1512,11197
3/1/2017,2017,3,1, 20 ,7706,1698,1470,10874
3/1/2017,2017,3,1, 21 ,7534,1625,1407,10566
3/1/2017,2017,3,1, 22 ,7243,1493,1275,10011
3/1/2017,2017,3,1, 23 ,6766,1370,1169,9305
3/1/2017,2017,3,1, 24 ,6426,1275,1090,8791
3/2/2017,2017,3,2, 1 ,6101,1218,1021,8340
3/2/2017,2017,3,2, 2 ,5945,1185,998,8128
3/2/2017,2017,3,2, 3 ,5648,1154,967,7769
3/2/2017,2017,3,2, 4 ,5638,1142,955,7735
3/2/2017,2017,3,2, 5 ,5859,1178,1001,8038
3/2/2017,2017,3,2, 6 ,6075,1233,1080,8388
3/2/2017,2017,3,2, 7 ,6112,1176,994,8282
3/2/2017,2017,3,2, 8 ,6789,1318,1085,9192
3/2/2017,2017,3,2, 9 ,7483,1541,1279,10303
3/2/2017,2017,3,2, 10 ,7909,1665,1387,10961
3/2/2017,2017,3,2, 11 ,8207,1722,1447,11376
3/2/2017,2017,3,2, 12 ,7937,1677,1425,11039
3/2/2017,2017,3,2, 13 ,7868,1695,1424,10987
3/2/2017,2017,3,2, 14 ,8372,1760,1480,11612
3/2/2017,2017,3,2, 15 ,8255,1760,1461,11476
3/2/2017,2017,3,2, 16 ,8128,1717,1428,11273
3/2/2017,2017,3,2, 17 ,7734,1615,1400,10749
3/2/2017,2017,3,2, 18 ,7699,1690,1490,10879
3/2/2017,2017,3,2, 19 ,7852,1767,1485,11104
3/2/2017,2017,3,2, 20 ,7657,1695,1414,10766
3/2/2017,2017,3,2, 21 ,7499,1621,1360,10480
3/2/2017,2017,3,2, 22 ,7093,1494,1222,9809
3/2/2017,2017,3,2, 23 ,6659,1376,1116,9151
3/2/2017,2017,3,2, 24 ,6299,1288,1046,8633
3/3/2017,2017,3,3, 1 ,6029,1231,1005,8265
3/3/2017,2017,3,3, 2 ,5891,1197,973,8061
3/3/2017,2017,3,3, 3 ,5717,1162,948,7827
3/3/2017,2017,3,3, 4 ,5712,1151,952,7815
3/3/2017,2017,3,3, 5 ,5814,1175,984,7973
3/3/2017,2017,3,3, 6 ,6045,1221,1083,8349
3/3/2017,2017,3,3, 7 ,6067,1191,1016,8274
3/3/2017,2017,3,3, 8 ,6638,1315,1098,9051
3/3/2017,2017,3,3, 9 ,7463,1544,1265,10272
3/3/2017,2017,3,3, 10 ,7905,1652,1351,10908
3/3/2017,2017,3,3, 11 ,8192,1723,1409,11324
3/3/2017,2017,3,3, 12 ,7930,1683,1374,10987
3/3/2017,2017,3,3, 13 ,7928,1681,1362,10971
3/3/2017,2017,3,3, 14 ,8215,1755,1426,11396
3/3/2017,2017,3,3, 15 ,8108,1720,1420,11248
3/3/2017,2017,3,3, 16 ,8051,1695,1396,11142
3/3/2017,2017,3,3, 17 ,7589,1584,1357,10530
3/3/2017,2017,3,3, 18 ,7655,1659,1437,10751
3/3/2017,2017,3,3, 19 ,7772,1742,1442,10956
3/3/2017,2017,3,3, 20 ,7652,1690,1383,10725
3/3/2017,2017,3,3, 21 ,7456,1623,1327,10406
3/3/2017,2017,3,3, 22 ,7108,1494,1141,9743
3/3/2017,2017,3,3, 23 ,6682,1367,1028,9077
3/3/2017,2017,3,3, 24 ,6306,1280,921,8507
3/4/2017,2017,3,4, 1 ,5969,1225,967,8161
3/4/2017,2017,3,4, 2 ,5791,1180,944,7915
3/4/2017,2017,3,4, 3 ,5693,1162,919,7774
3/4/2017,2017,3,4, 4 ,5578,1143,912,7633
3/4/2017,2017,3,4, 5 ,5609,1157,917,7683
3/4/2017,2017,3,4, 6 ,5659,1165,944,7768
3/4/2017,2017,3,4, 7 ,5718,1156,935,7809
3/4/2017,2017,3,4, 8 ,6145,1261,979,8385
3/4/2017,2017,3,4, 9 ,6757,1409,1155,9321
3/4/2017,2017,3,4, 10 ,7161,1505,1211,9877
3/4/2017,2017,3,4, 11 ,7428,1578,1311,10317
3/4/2017,2017,3,4, 12 ,7199,1546,1291,10036
3/4/2017,2017,3,4, 13 ,7155,1556,1317,10028
3/4/2017,2017,3,4, 14 ,7314,1605,1368,10287
3/4/2017,2017,3,4, 15 ,7214,1543,1336,10093
3/4/2017,2017,3,4, 16 ,7135,1532,1304,9971
3/4/2017,2017,3,4, 17 ,6865,1495,1256,9616
3/4/2017,2017,3,4, 18 ,7013,1546,1368,9927
3/4/2017,2017,3,4, 19 ,7412,1668,1433,10513
3/4/2017,2017,3,4, 20 ,7292,1617,1397,10306
3/4/2017,2017,3,4, 21 ,7161,1559,1333,10053
3/4/2017,2017,3,4, 22 ,6840,1447,1237,9524
3/4/2017,2017,3,4, 23 ,6422,1353,1134,8909
3/4/2017,2017,3,4, 24 ,6038,1247,1048,8333
3/5/2017,2017,3,5, 1 ,5753,1190,989,7932
3/5/2017,2017,3,5, 2 ,5542,1143,952,7637
3/5/2017,2017,3,5, 3 ,5416,1110,925,7451
3/5/2017,2017,3,5, 4 ,5283,1088,916,7287
3/5/2017,2017,3,5, 5 ,5228,1094,850,7172
3/5/2017,2017,3,5, 6 ,5216,1092,929,7237
3/5/2017,2017,3,5, 7 ,5189,1089,905,7183
3/5/2017,2017,3,5, 8 ,5464,1126,933,7523
3/5/2017,2017,3,5, 9 ,5956,1184,977,8117
3/5/2017,2017,3,5, 10 ,6346,1278,1038,8662
3/5/2017,2017,3,5, 11 ,6665,1323,1101,9089
3/5/2017,2017,3,5, 12 ,6619,1327,1115,9061
3/5/2017,2017,3,5, 13 ,6626,1338,1099,9063
3/5/2017,2017,3,5, 14 ,6663,1332,1096,9091
3/5/2017,2017,3,5, 15 ,6677,1336,1092,9105
3/5/2017,2017,3,5, 16 ,6544,1313,1084,8941
3/5/2017,2017,3,5, 17 ,6408,1297,1128,8833
3/5/2017,2017,3,5, 18 ,6545,1449,1235,9229
3/5/2017,2017,3,5, 19 ,7103,1600,1310,10013
3/5/2017,2017,3,5, 20 ,7123,1570,1258,9951
3/5/2017,2017,3,5, 21 ,6979,1497,1188,9664
3/5/2017,2017,3,5, 22 ,6613,1385,1085,9083
3/5/2017,2017,3,5, 23 ,6226,1302,1029,8557
3/5/2017,2017,3,5, 24 ,5845,1207,937,7989
3/6/2017,2017,3,6, 1 ,5556,1149,879,7584
3/6/2017,2017,3,6, 2 ,5347,1107,857,7311
3/6/2017,2017,3,6, 3 ,5190,1083,831,7104
3/6/2017,2017,3,6, 4 ,5156,1065,835,7056
3/6/2017,2017,3,6, 5 ,5349,1109,881,7339
3/6/2017,2017,3,6, 6 ,5644,1190,984,7818
3/6/2017,2017,3,6, 7 ,5797,1154,952,7903
3/6/2017,2017,3,6, 8 ,6480,1249,1050,8779
3/6/2017,2017,3,6, 9 ,7292,1457,1221,9970
3/6/2017,2017,3,6, 10 ,7892,1559,1331,10782
3/6/2017,2017,3,6, 11 ,8277,1626,1324,11227
3/6/2017,2017,3,6, 12 ,8150,1601,1281,11032
3/6/2017,2017,3,6, 13 ,8220,1581,1263,11064
3/6/2017,2017,3,6, 14 ,8563,1649,1313,11525
3/6/2017,2017,3,6, 15 ,8502,1631,1312,11445
3/6/2017,2017,3,6, 16 ,8389,1612,1325,11326
3/6/2017,2017,3,6, 17 ,7987,1568,1333,10888
3/6/2017,2017,3,6, 18 ,7762,1661,1405,10828
3/6/2017,2017,3,6, 19 ,8131,1698,1395,11224
3/6/2017,2017,3,6, 20 ,7878,1630,1347,10855
3/6/2017,2017,3,6, 21 ,7635,1553,1239,10427
3/6/2017,2017,3,6, 22 ,7245,1416,1103,9764
3/6/2017,2017,3,6, 23 ,6853,1300,1024,9177
3/6/2017,2017,3,6, 24 ,6364,1228,952,8544
3/7/2017,2017,3,7, 1 ,6032,1182,914,8128
3/7/2017,2017,3,7, 2 ,5899,1150,892,7941
3/7/2017,2017,3,7, 3 ,5645,1129,874,7648
3/7/2017,2017,3,7, 4 ,5630,1124,886,7640
3/7/2017,2017,3,7, 5 ,5799,1125,943,7867
3/7/2017,2017,3,7, 6 ,5990,1182,1037,8209
3/7/2017,2017,3,7, 7 ,5975,1155,970,8100
3/7/2017,2017,3,7, 8 ,6681,1285,1059,9025
3/7/2017,2017,3,7, 9 ,7444,1486,1232,10162
3/7/2017,2017,3,7, 10 ,7902,1552,1330,10784
3/7/2017,2017,3,7, 11 ,8287,1639,1362,11288
3/7/2017,2017,3,7, 12 ,8064,1576,1267,10907
3/7/2017,2017,3,7, 13 ,8145,1568,1323,11036
3/7/2017,2017,3,7, 14 ,8519,1617,1388,11524
3/7/2017,2017,3,7, 15 ,8481,1626,1381,11488
3/7/2017,2017,3,7, 16 ,8281,1591,1370,11242
3/7/2017,2017,3,7, 17 ,7933,1555,1334,10822
3/7/2017,2017,3,7, 18 ,7816,1648,1425,10889
3/7/2017,2017,3,7, 19 ,8060,1665,1412,11137
3/7/2017,2017,3,7, 20 ,7873,1593,1345,10811
3/7/2017,2017,3,7, 21 ,7606,1512,1265,10383
3/7/2017,2017,3,7, 22 ,7230,1371,1141,9742
3/7/2017,2017,3,7, 23 ,6838,1258,1042,9138
3/7/2017,2017,3,7, 24 ,6342,1183,966,8491
3/8/2017,2017,3,8, 1 ,6155,1148,955,8258
3/8/2017,2017,3,8, 2 ,5959,1113,927,7999
3/8/2017,2017,3,8, 3 ,5780,1075,895,7750
3/8/2017,2017,3,8, 4 ,5672,1058,900,7630
3/8/2017,2017,3,8, 5 ,5863,1106,963,7932
3/8/2017,2017,3,8, 6 ,6107,1176,1058,8341
3/8/2017,2017,3,8, 7 ,6149,1163,964,8276
3/8/2017,2017,3,8, 8 ,6749,1252,1048,9049
3/8/2017,2017,3,8, 9 ,7529,1427,1216,10172
3/8/2017,2017,3,8, 10 ,7994,1532,1321,10847
3/8/2017,2017,3,8, 11 ,8306,1567,1332,11205
3/8/2017,2017,3,8, 12 ,8120,1540,1349,11009
3/8/2017,2017,3,8, 13 ,8134,1556,1359,11049
3/8/2017,2017,3,8, 14 ,8479,1632,1397,11508
3/8/2017,2017,3,8, 15 ,8451,1633,1429,11513
3/8/2017,2017,3,8, 16 ,8303,1591,1410,11304
3/8/2017,2017,3,8, 17 ,7856,1543,1375,10774
3/8/2017,2017,3,8, 18 ,7616,1594,1464,10674
3/8/2017,2017,3,8, 19 ,8056,1643,1420,11119
3/8/2017,2017,3,8, 20 ,7803,1584,1384,10771
3/8/2017,2017,3,8, 21 ,7615,1508,1283,10406
3/8/2017,2017,3,8, 22 ,7190,1371,1150,9711
3/8/2017,2017,3,8, 23 ,6809,1257,1056,9122
3/8/2017,2017,3,8, 24 ,6438,1182,982,8602
3/9/2017,2017,3,9, 1 ,6086,1146,941,8173
3/9/2017,2017,3,9, 2 ,5906,1104,921,7931
3/9/2017,2017,3,9, 3 ,5743,1072,906,7721
3/9/2017,2017,3,9, 4 ,5663,1057,901,7621
3/9/2017,2017,3,9, 5 ,5821,1108,938,7867
3/9/2017,2017,3,9, 6 ,6012,1181,1031,8224
3/9/2017,2017,3,9, 7 ,6120,1144,983,8247
3/9/2017,2017,3,9, 8 ,6760,1218,1072,9050
3/9/2017,2017,3,9, 9 ,7541,1405,1139,10085
3/9/2017,2017,3,9, 10 ,8001,1471,1221,10693
3/9/2017,2017,3,9, 11 ,8285,1519,1273,11077
3/9/2017,2017,3,9, 12 ,8037,1451,1244,10732
3/9/2017,2017,3,9, 13 ,8018,1442,1230,10690
3/9/2017,2017,3,9, 14 ,8451,1517,1310,11278
3/9/2017,2017,3,9, 15 ,8356,1517,1295,11168
3/9/2017,2017,3,9, 16 ,8185,1502,1296,10983
3/9/2017,2017,3,9, 17 ,7792,1465,1306,10563
3/9/2017,2017,3,9, 18 ,7666,1575,1385,10626
3/9/2017,2017,3,9, 19 ,7983,1618,1375,10976
3/9/2017,2017,3,9, 20 ,7781,1555,1300,10636
3/9/2017,2017,3,9, 21 ,7446,1462,1213,10121
3/9/2017,2017,3,9, 22 ,7080,1334,1107,9521
3/9/2017,2017,3,9, 23 ,6688,1220,1004,8912
3/9/2017,2017,3,9, 24 ,6294,1155,934,8383
3/10/2017,2017,3,10, 1 ,5999,1122,895,8016
3/10/2017,2017,3,10, 2 ,5754,1098,872,7724
3/10/2017,2017,3,10, 3 ,5694,1064,860,7618
3/10/2017,2017,3,10, 4 ,5596,1060,849,7505
3/10/2017,2017,3,10, 5 ,5744,1103,902,7749
3/10/2017,2017,3,10, 6 ,5934,1176,1009,8119
3/10/2017,2017,3,10, 7 ,6025,1131,924,8080
3/10/2017,2017,3,10, 8 ,6688,1249,1040,8977
3/10/2017,2017,3,10, 9 ,7479,1462,1231,10172
3/10/2017,2017,3,10, 10 ,7993,1508,1350,10851
3/10/2017,2017,3,10, 11 ,8319,1599,1397,11315
3/10/2017,2017,3,10, 12 ,8163,1571,1373,11107
3/10/2017,2017,3,10, 13 ,8254,1597,1329,11180
3/10/2017,2017,3,10, 14 ,8607,1670,1427,11704
3/10/2017,2017,3,10, 15 ,8552,1629,1413,11594
3/10/2017,2017,3,10, 16 ,8353,1591,1383,11327
3/10/2017,2017,3,10, 17 ,7894,1529,1338,10761
3/10/2017,2017,3,10, 18 ,7835,1615,1420,10870
3/10/2017,2017,3,10, 19 ,8011,1679,1431,11121
3/10/2017,2017,3,10, 20 ,7805,1616,1380,10801
3/10/2017,2017,3,10, 21 ,7520,1561,1342,10423
3/10/2017,2017,3,10, 22 ,7192,1431,1181,9804
3/10/2017,2017,3,10, 23 ,6716,1322,1089,9127
3/10/2017,2017,3,10, 24 ,6347,1236,1015,8598
3/11/2017,2017,3,11, 1 ,6044,1191,958,8193
3/11/2017,2017,3,11, 2 ,5794,1158,925,7877
3/11/2017,2017,3,11, 3 ,5655,1137,898,7690
3/11/2017,2017,3,11, 4 ,5527,1125,894,7546
3/11/2017,2017,3,11, 5 ,5524,1139,908,7571
3/11/2017,2017,3,11, 6 ,5549,1140,967,7656
3/11/2017,2017,3,11, 7 ,5640,1177,960,7777
3/11/2017,2017,3,11, 8 ,6199,1234,1053,8486
3/11/2017,2017,3,11, 9 ,6865,1369,1154,9388
3/11/2017,2017,3,11, 10 ,7410,1435,1269,10114
3/11/2017,2017,3,11, 11 ,7904,1492,1345,10741
3/11/2017,2017,3,11, 12 ,7717,1436,1319,10472
3/11/2017,2017,3,11, 13 ,7670,1444,1342,10456
3/11/2017,2017,3,11, 14 ,7959,1508,1400,10867
3/11/2017,2017,3,11, 15 ,7862,1479,1398,10739
3/11/2017,2017,3,11, 16 ,7646,1425,1356,10427
3/11/2017,2017,3,11, 17 ,7275,1437,1310,10022
3/11/2017,2017,3,11, 18 ,7198,1542,1426,10166
3/11/2017,2017,3,11, 19 ,7648,1604,1431,10683
3/11/2017,2017,3,11, 20 ,7530,1556,1384,10470
3/11/2017,2017,3,11, 21 ,7361,1485,1325,10171
3/11/2017,2017,3,11, 22 ,7099,1383,1220,9702
3/11/2017,2017,3,11, 23 ,6618,1267,1121,9006
3/11/2017,2017,3,11, 24 ,6243,1193,1030,8466
3/12/2017,2017,3,12, 1 ,6038,1141,984,8163
3/12/2017,2017,3,12, 2 ,5793,1111,953,7857
3/12/2017,2017,3,12, 3 ,5626,1085,929,7640
3/12/2017,2017,3,12, 4 ,5495,1072,920,7487
3/12/2017,2017,3,12, 5 ,5428,1074,934,7436
3/12/2017,2017,3,12, 6 ,5333,1064,949,7346
3/12/2017,2017,3,12, 7 ,5282,1072,941,7295
3/12/2017,2017,3,12, 8 ,5632,1118,966,7716
3/12/2017,2017,3,12, 9 ,6059,1187,1048,8294
3/12/2017,2017,3,12, 10 ,6613,1270,1131,9014
3/12/2017,2017,3,12, 11 ,6852,1336,1202,9390
3/12/2017,2017,3,12, 12 ,6844,1330,1224,9398
3/12/2017,2017,3,12, 13 ,6932,1336,1238,9506
3/12/2017,2017,3,12, 14 ,6995,1329,1244,9568
3/12/2017,2017,3,12, 15 ,6942,1292,1201,9435
3/12/2017,2017,3,12, 16 ,6810,1300,1185,9295
3/12/2017,2017,3,12, 17 ,6580,1292,1184,9056
3/12/2017,2017,3,12, 18 ,6646,1447,1321,9414
3/12/2017,2017,3,12, 19 ,7276,1591,1362,10229
3/12/2017,2017,3,12, 20 ,7278,1518,1303,10099
3/12/2017,2017,3,12, 21 ,7103,1451,1253,9807
3/12/2017,2017,3,12, 22 ,6900,1348,1119,9367
3/12/2017,2017,3,12, 23 ,6478,1239,1044,8761
3/12/2017,2017,3,12, 24 ,6141,1166,991,8298
3/13/2017,2017,3,13, 1 ,5816,1111,945,7872
3/13/2017,2017,3,13, 2 ,5597,1079,907,7583
3/13/2017,2017,3,13, 3 ,5482,1055,883,7420
3/13/2017,2017,3,13, 4 ,5393,1055,881,7329
3/13/2017,2017,3,13, 5 ,5611,1099,927,7637
3/13/2017,2017,3,13, 6 ,5864,1176,1025,8065
3/13/2017,2017,3,13, 7 ,5954,1130,943,8027
3/13/2017,2017,3,13, 8 ,6737,1274,1073,9084
3/13/2017,2017,3,13, 9 ,7634,1495,1272,10401
3/13/2017,2017,3,13, 10 ,8209,1605,1399,11213
3/13/2017,2017,3,13, 11 ,8528,1659,1470,11657
3/13/2017,2017,3,13, 12 ,8450,1635,1473,11558
3/13/2017,2017,3,13, 13 ,8524,1631,1491,11646
3/13/2017,2017,3,13, 14 ,8936,1696,1551,12183
3/13/2017,2017,3,13, 15 ,8861,1665,1547,12073
3/13/2017,2017,3,13, 16 ,8770,1643,1505,11918
3/13/2017,2017,3,13, 17 ,8389,1584,1446,11419
3/13/2017,2017,3,13, 18 ,8127,1646,1511,11284
3/13/2017,2017,3,13, 19 ,8424,1702,1516,11642
3/13/2017,2017,3,13, 20 ,8321,1625,1441,11387
3/13/2017,2017,3,13, 21 ,8110,1560,1377,11047
3/13/2017,2017,3,13, 22 ,7699,1425,1262,10386
3/13/2017,2017,3,13, 23 ,7349,1314,1153,9816
3/13/2017,2017,3,13, 24 ,6949,1228,1063,9240
3/14/2017,2017,3,14, 1 ,6597,1178,1020,8795
3/14/2017,2017,3,14, 2 ,6419,1130,994,8543
3/14/2017,2017,3,14, 3 ,6236,1103,968,8307
3/14/2017,2017,3,14, 4 ,6168,1102,971,8241
3/14/2017,2017,3,14, 5 ,6279,1144,1012,8435
3/14/2017,2017,3,14, 6 ,6382,1212,1094,8688
3/14/2017,2017,3,14, 7 ,6446,1163,1002,8611
3/14/2017,2017,3,14, 8 ,7258,1313,1143,9714
3/14/2017,2017,3,14, 9 ,8043,1529,1331,10903
3/14/2017,2017,3,14, 10 ,8552,1645,1430,11627
3/14/2017,2017,3,14, 11 ,8979,1705,1492,12176
3/14/2017,2017,3,14, 12 ,8740,1660,1471,11871
3/14/2017,2017,3,14, 13 ,8814,1660,1473,11947
3/14/2017,2017,3,14, 14 ,9181,1745,1534,12460
3/14/2017,2017,3,14, 15 ,9147,1723,1565,12435
3/14/2017,2017,3,14, 16 ,8972,1686,1514,12172
3/14/2017,2017,3,14, 17 ,8535,1612,1462,11609
3/14/2017,2017,3,14, 18 ,8246,1690,1519,11455
3/14/2017,2017,3,14, 19 ,8567,1761,1526,11854
3/14/2017,2017,3,14, 20 ,8463,1698,1441,11602
3/14/2017,2017,3,14, 21 ,8210,1621,1382,11213
3/14/2017,2017,3,14, 22 ,7860,1481,1241,10582
3/14/2017,2017,3,14, 23 ,7463,1386,1143,9992
3/14/2017,2017,3,14, 24 ,7001,1288,1102,9391
3/15/2017,2017,3,15, 1 ,6711,1239,1082,9032
3/15/2017,2017,3,15, 2 ,6509,1192,1029,8730
3/15/2017,2017,3,15, 3 ,6256,1161,992,8409
3/15/2017,2017,3,15, 4 ,6173,1153,1001,8327
3/15/2017,2017,3,15, 5 ,6298,1190,1061,8549
3/15/2017,2017,3,15, 6 ,6421,1235,1091,8747
3/15/2017,2017,3,15, 7 ,6414,1196,1008,8618
3/15/2017,2017,3,15, 8 ,7143,1339,1170,9652
3/15/2017,2017,3,15, 9 ,7943,1550,1361,10854
3/15/2017,2017,3,15, 10 ,8453,1669,1458,11580
3/15/2017,2017,3,15, 11 ,8673,1734,1520,11927
3/15/2017,2017,3,15, 12 ,8476,1694,1504,11674
3/15/2017,2017,3,15, 13 ,8440,1715,1523,11678
3/15/2017,2017,3,15, 14 ,8682,1784,1549,12015
3/15/2017,2017,3,15, 15 ,8652,1742,1548,11942
3/15/2017,2017,3,15, 16 ,8503,1675,1516,11694
3/15/2017,2017,3,15, 17 ,8137,1623,1476,11236
3/15/2017,2017,3,15, 18 ,8024,1705,1540,11269
3/15/2017,2017,3,15, 19 ,8296,1723,1526,11545
3/15/2017,2017,3,15, 20 ,8117,1661,1468,11246
3/15/2017,2017,3,15, 21 ,7915,1566,1396,10877
3/15/2017,2017,3,15, 22 ,7596,1418,1263,10277
3/15/2017,2017,3,15, 23 ,7183,1344,1180,9707
3/15/2017,2017,3,15, 24 ,6802,1251,1100,9153
3/16/2017,2017,3,16, 1 ,6519,1204,1046,8769
3/16/2017,2017,3,16, 2 ,6268,1167,1009,8444
3/16/2017,2017,3,16, 3 ,6117,1141,982,8240
3/16/2017,2017,3,16, 4 ,6025,1128,979,8132
3/16/2017,2017,3,16, 5 ,6230,1172,1032,8434
3/16/2017,2017,3,16, 6 ,6276,1224,1006,8506
3/16/2017,2017,3,16, 7 ,7061,1178,1016,9255
3/16/2017,2017,3,16, 8 ,7517,1308,1111,9936
3/16/2017,2017,3,16, 9 ,7930,1499,1286,10715
3/16/2017,2017,3,16, 10 ,8303,1606,1399,11308
3/16/2017,2017,3,16, 11 ,8588,1662,1465,11715
3/16/2017,2017,3,16, 12 ,8350,1618,1447,11415
3/16/2017,2017,3,16, 13 ,8380,1625,1443,11448
3/16/2017,2017,3,16, 14 ,8740,1673,1501,11914
3/16/2017,2017,3,16, 15 ,8692,1655,1490,11837
3/16/2017,2017,3,16, 16 ,8580,1623,1464,11667
3/16/2017,2017,3,16, 17 ,8115,1569,1412,11096
3/16/2017,2017,3,16, 18 ,7930,1653,1519,11102
3/16/2017,2017,3,16, 19 ,8195,1697,1533,11425
3/16/2017,2017,3,16, 20 ,8036,1624,1466,11126
3/16/2017,2017,3,16, 21 ,7776,1549,1396,10721
3/16/2017,2017,3,16, 22 ,7437,1422,1278,10137
3/16/2017,2017,3,16, 23 ,7058,1326,1197,9581
3/16/2017,2017,3,16, 24 ,6627,1248,1089,8964
3/17/2017,2017,3,17, 1 ,6373,1197,1042,8612
3/17/2017,2017,3,17, 2 ,6140,1156,1006,8302
3/17/2017,2017,3,17, 3 ,5971,1123,987,8081
3/17/2017,2017,3,17, 4 ,5877,1115,970,7962
3/17/2017,2017,3,17, 5 ,6050,1161,1028,8239
3/17/2017,2017,3,17, 6 ,6133,1206,1082,8421
3/17/2017,2017,3,17, 7 ,6135,1176,996,8307
3/17/2017,2017,3,17, 8 ,6924,1326,1100,9350
3/17/2017,2017,3,17, 9 ,7767,1523,1270,10560
3/17/2017,2017,3,17, 10 ,8166,1620,1379,11165
3/17/2017,2017,3,17, 11 ,8436,1678,1439,11553
3/17/2017,2017,3,17, 12 ,8222,1628,1419,11269
3/17/2017,2017,3,17, 13 ,8288,1621,1414,11323
3/17/2017,2017,3,17, 14 ,8633,1710,1389,11732
3/17/2017,2017,3,17, 15 ,8568,1707,1461,11736
3/17/2017,2017,3,17, 16 ,8371,1654,1420,11445
3/17/2017,2017,3,17, 17 ,7953,1562,1333,10848
3/17/2017,2017,3,17, 18 ,7716,1602,1423,10741
3/17/2017,2017,3,17, 19 ,8008,1712,1476,11196
3/17/2017,2017,3,17, 20 ,7812,1645,1476,10933
3/17/2017,2017,3,17, 21 ,7685,1565,1423,10673
3/17/2017,2017,3,17, 22 ,7329,1459,1280,10068
3/17/2017,2017,3,17, 23 ,6963,1343,1174,9480
3/17/2017,2017,3,17, 24 ,6539,1261,1109,8909
3/18/2017,2017,3,18, 1 ,6241,1209,1036,8486
3/18/2017,2017,3,18, 2 ,6040,1163,993,8196
3/18/2017,2017,3,18, 3 ,5874,1133,981,7988
3/18/2017,2017,3,18, 4 ,5728,1112,962,7802
3/18/2017,2017,3,18, 5 ,5734,1125,994,7853
3/18/2017,2017,3,18, 6 ,5762,1128,1023,7913
3/18/2017,2017,3,18, 7 ,5807,1141,1003,7951
3/18/2017,2017,3,18, 8 ,6396,1258,1091,8745
3/18/2017,2017,3,18, 9 ,7043,1403,1206,9652
3/18/2017,2017,3,18, 10 ,7479,1473,1227,10179
3/18/2017,2017,3,18, 11 ,7812,1517,1366,10695
3/18/2017,2017,3,18, 12 ,7607,1504,1323,10434
3/18/2017,2017,3,18, 13 ,7571,1500,1360,10431
3/18/2017,2017,3,18, 14 ,7800,1532,1397,10729
3/18/2017,2017,3,18, 15 ,7691,1500,1363,10554
3/18/2017,2017,3,18, 16 ,7539,1453,1386,10378
3/18/2017,2017,3,18, 17 ,7199,1400,1328,9927
3/18/2017,2017,3,18, 18 ,7124,1485,1408,10017
3/18/2017,2017,3,18, 19 ,7622,1609,1488,10719
3/18/2017,2017,3,18, 20 ,7520,1558,1412,10490
3/18/2017,2017,3,18, 21 ,7294,1505,1346,10145
3/18/2017,2017,3,18, 22 ,7089,1419,1296,9804
3/18/2017,2017,3,18, 23 ,6681,1300,1184,9165
3/18/2017,2017,3,18, 24 ,6316,1203,1077,8596
3/19/2017,2017,3,19, 1 ,6113,1145,1030,8288
3/19/2017,2017,3,19, 2 ,5942,1114,992,8048
3/19/2017,2017,3,19, 3 ,5674,1080,972,7726
3/19/2017,2017,3,19, 4 ,5565,1065,962,7592
3/19/2017,2017,3,19, 5 ,5507,1071,963,7541
3/19/2017,2017,3,19, 6 ,5403,1056,983,7442
3/19/2017,2017,3,19, 7 ,5414,1076,938,7428
3/19/2017,2017,3,19, 8 ,5724,1129,961,7814
3/19/2017,2017,3,19, 9 ,6148,1233,1048,8429
3/19/2017,2017,3,19, 10 ,6507,1312,1130,8949
3/19/2017,2017,3,19, 11 ,6858,1372,1181,9411
3/19/2017,2017,3,19, 12 ,6733,1370,1173,9276
3/19/2017,2017,3,19, 13 ,6756,1374,1159,9289
3/19/2017,2017,3,19, 14 ,6782,1386,1205,9373
3/19/2017,2017,3,19, 15 ,6651,1369,1193,9213
3/19/2017,2017,3,19, 16 ,6423,1347,1163,8933
3/19/2017,2017,3,19, 17 ,6306,1323,1119,8748
3/19/2017,2017,3,19, 18 ,6457,1422,1270,9149
3/19/2017,2017,3,19, 19 ,7118,1586,1389,10093
3/19/2017,2017,3,19, 20 ,7086,1551,1366,10003
3/19/2017,2017,3,19, 21 ,6957,1493,1318,9768
3/19/2017,2017,3,19, 22 ,6709,1385,1229,9323
3/19/2017,2017,3,19, 23 ,6260,1299,1102,8661
3/19/2017,2017,3,19, 24 ,5944,1215,1039,8198
3/20/2017,2017,3,20, 1 ,5659,1156,984,7799
3/20/2017,2017,3,20, 2 ,5507,1112,950,7569
3/20/2017,2017,3,20, 3 ,5331,1089,911,7331
3/20/2017,2017,3,20, 4 ,5285,1066,916,7267
3/20/2017,2017,3,20, 5 ,5492,1110,961,7563
3/20/2017,2017,3,20, 6 ,5732,1180,1038,7950
3/20/2017,2017,3,20, 7 ,5918,1146,972,8036
3/20/2017,2017,3,20, 8 ,6692,1280,1123,9095
3/20/2017,2017,3,20, 9 ,7499,1466,1322,10287
3/20/2017,2017,3,20, 10 ,8063,1581,1433,11077
3/20/2017,2017,3,20, 11 ,8381,1632,1519,11532
3/20/2017,2017,3,20, 12 ,8202,1587,1495,11284
3/20/2017,2017,3,20, 13 ,8305,1566,1505,11376
3/20/2017,2017,3,20, 14 ,8620,1601,1555,11776
3/20/2017,2017,3,20, 15 ,8607,1590,1540,11737
3/20/2017,2017,3,20, 16 ,8448,1580,1517,11545
3/20/2017,2017,3,20, 17 ,7995,1546,1453,10994
3/20/2017,2017,3,20, 18 ,7796,1617,1476,10889
3/20/2017,2017,3,20, 19 ,8123,1672,1519,11314
3/20/2017,2017,3,20, 20 ,7988,1601,1492,11081
3/20/2017,2017,3,20, 21 ,7759,1507,1419,10685
3/20/2017,2017,3,20, 22 ,7350,1374,1285,10009
3/20/2017,2017,3,20, 23 ,6908,1265,1160,9333
3/20/2017,2017,3,20, 24 ,6495,1196,1078,8769
3/21/2017,2017,3,21, 1 ,6193,1155,1038,8386
3/21/2017,2017,3,21, 2 ,6013,1124,1004,8141
3/21/2017,2017,3,21, 3 ,5842,1098,975,7915
3/21/2017,2017,3,21, 4 ,5779,1095,968,7842
3/21/2017,2017,3,21, 5 ,5893,1138,1004,8035
3/21/2017,2017,3,21, 6 ,6095,1200,1067,8362
3/21/2017,2017,3,21, 7 ,6136,1165,979,8280
3/21/2017,2017,3,21, 8 ,6794,1295,1124,9213
3/21/2017,2017,3,21, 9 ,7650,1507,1320,10477
3/21/2017,2017,3,21, 10 ,8028,1612,1455,11095
3/21/2017,2017,3,21, 11 ,8348,1683,1533,11564
3/21/2017,2017,3,21, 12 ,8141,1650,1516,11307
3/21/2017,2017,3,21, 13 ,8141,1665,1514,11320
3/21/2017,2017,3,21, 14 ,8526,1753,1570,11849
3/21/2017,2017,3,21, 15 ,8459,1737,1568,11764
3/21/2017,2017,3,21, 16 ,8324,1700,1510,11534
3/21/2017,2017,3,21, 17 ,8027,1624,1449,11100
3/21/2017,2017,3,21, 18 ,8017,1659,1533,11209
3/21/2017,2017,3,21, 19 ,8203,1741,1575,11519
3/21/2017,2017,3,21, 20 ,8074,1692,1540,11306
3/21/2017,2017,3,21, 21 ,7900,1600,1482,10982
3/21/2017,2017,3,21, 22 ,7504,1447,1329,10280
3/21/2017,2017,3,21, 23 ,7085,1339,1236,9660
3/21/2017,2017,3,21, 24 ,6669,1242,1148,9059
3/22/2017,2017,3,22, 1 ,6358,1191,1092,8641
3/22/2017,2017,3,22, 2 ,6217,1171,1062,8450
3/22/2017,2017,3,22, 3 ,6015,1133,1023,8171
3/22/2017,2017,3,22, 4 ,5920,1132,1013,8065
3/22/2017,2017,3,22, 5 ,6059,1167,1055,8281
3/22/2017,2017,3,22, 6 ,6221,1222,1090,8533
3/22/2017,2017,3,22, 7 ,6344,1184,1016,8544
3/22/2017,2017,3,22, 8 ,6980,1342,1173,9495
3/22/2017,2017,3,22, 9 ,7911,1544,1391,10846
3/22/2017,2017,3,22, 10 ,8354,1648,1497,11499
3/22/2017,2017,3,22, 11 ,8714,1731,1569,12014
3/22/2017,2017,3,22, 12 ,8518,1694,1560,11772
3/22/2017,2017,3,22, 13 ,8638,1710,1563,11911
3/22/2017,2017,3,22, 14 ,9003,1755,1633,12391
3/22/2017,2017,3,22, 15 ,8942,1777,1580,12299
3/22/2017,2017,3,22, 16 ,8844,1738,1557,12139
3/22/2017,2017,3,22, 17 ,8442,1660,1486,11588
3/22/2017,2017,3,22, 18 ,8185,1690,1536,11411
3/22/2017,2017,3,22, 19 ,8553,1794,1562,11909
3/22/2017,2017,3,22, 20 ,8438,1720,1540,11698
3/22/2017,2017,3,22, 21 ,8248,1643,1476,11367
3/22/2017,2017,3,22, 22 ,7853,1517,1341,10711
3/22/2017,2017,3,22, 23 ,7508,1397,1232,10137
3/22/2017,2017,3,22, 24 ,7067,1313,1137,9517
3/23/2017,2017,3,23, 1 ,6782,1263,1067,9112
3/23/2017,2017,3,23, 2 ,6536,1211,1055,8802
3/23/2017,2017,3,23, 3 ,6357,1178,1017,8552
3/23/2017,2017,3,23, 4 ,6246,1165,1006,8417
3/23/2017,2017,3,23, 5 ,6324,1195,1043,8562
3/23/2017,2017,3,23, 6 ,6421,1227,1101,8749
3/23/2017,2017,3,23, 7 ,6474,1192,1028,8694
3/23/2017,2017,3,23, 8 ,7313,1336,1204,9853
3/23/2017,2017,3,23, 9 ,8151,1578,1366,11095
3/23/2017,2017,3,23, 10 ,8619,1704,1494,11817
3/23/2017,2017,3,23, 11 ,8935,1786,1580,12301
3/23/2017,2017,3,23, 12 ,8788,1738,1521,12047
3/23/2017,2017,3,23, 13 ,8915,1755,1550,12220
3/23/2017,2017,3,23, 14 ,9298,1829,1620,12747
3/23/2017,2017,3,23, 15 ,9269,1822,1599,12690
3/23/2017,2017,3,23, 16 ,9177,1768,1573,12518
3/23/2017,2017,3,23, 17 ,8683,1685,1497,11865
3/23/2017,2017,3,23, 18 ,8423,1674,1550,11647
3/23/2017,2017,3,23, 19 ,8783,1790,1588,12161
3/23/2017,2017,3,23, 20 ,8588,1713,1529,11830
3/23/2017,2017,3,23, 21 ,8487,1644,1447,11578
3/23/2017,2017,3,23, 22 ,8146,1523,1329,10998
3/23/2017,2017,3,23, 23 ,7835,1403,1225,10463
3/23/2017,2017,3,23, 24 ,7375,1318,1038,9731
3/24/2017,2017,3,24, 1 ,7068,1257,1067,9392
3/24/2017,2017,3,24, 2 ,6877,1221,1030,9128
3/24/2017,2017,3,24, 3 ,6625,1184,987,8796
3/24/2017,2017,3,24, 4 ,6524,1167,963,8654
3/24/2017,2017,3,24, 5 ,6593,1188,1022,8803
3/24/2017,2017,3,24, 6 ,6646,1222,1066,8934
3/24/2017,2017,3,24, 7 ,6660,1209,1000,8869
3/24/2017,2017,3,24, 8 ,7456,1368,1138,9962
3/24/2017,2017,3,24, 9 ,8356,1600,1346,11302
3/24/2017,2017,3,24, 10 ,8885,1706,1467,12058
3/24/2017,2017,3,24, 11 ,9187,1784,1526,12497
3/24/2017,2017,3,24, 12 ,9025,1755,1505,12285
3/24/2017,2017,3,24, 13 ,9104,1756,1526,12386
3/24/2017,2017,3,24, 14 ,9440,1814,1607,12861
3/24/2017,2017,3,24, 15 ,9324,1802,1554,12680
3/24/2017,2017,3,24, 16 ,9142,1769,1537,12448
3/24/2017,2017,3,24, 17 ,8636,1665,1422,11723
3/24/2017,2017,3,24, 18 ,8360,1686,1509,11555
3/24/2017,2017,3,24, 19 ,8633,1794,1562,11989
3/24/2017,2017,3,24, 20 ,8506,1730,1530,11766
3/24/2017,2017,3,24, 21 ,8473,1672,1447,11592
3/24/2017,2017,3,24, 22 ,8152,1555,1318,11025
3/24/2017,2017,3,24, 23 ,7797,1446,1210,10453
3/24/2017,2017,3,24, 24 ,7367,1355,1228,9950
3/25/2017,2017,3,25, 1 ,7051,1300,1117,9468
3/25/2017,2017,3,25, 2 ,6809,1256,1116,9181
3/25/2017,2017,3,25, 3 ,6517,1227,1026,8770
3/25/2017,2017,3,25, 4 ,6392,1202,1008,8602
3/25/2017,2017,3,25, 5 ,6289,1205,1014,8508
3/25/2017,2017,3,25, 6 ,6237,1182,1042,8461
3/25/2017,2017,3,25, 7 ,6270,1218,1031,8519
3/25/2017,2017,3,25, 8 ,6773,1330,1118,9221
3/25/2017,2017,3,25, 9 ,7477,1494,1301,10272
3/25/2017,2017,3,25, 10 ,8054,1598,1344,10996
3/25/2017,2017,3,25, 11 ,8433,1654,1443,11530
3/25/2017,2017,3,25, 12 ,8243,1638,1437,11318
3/25/2017,2017,3,25, 13 ,8301,1651,1445,11397
3/25/2017,2017,3,25, 14 ,8634,1699,1477,11810
3/25/2017,2017,3,25, 15 ,8494,1650,1489,11633
3/25/2017,2017,3,25, 16 ,8267,1620,1452,11339
3/25/2017,2017,3,25, 17 ,7824,1553,1390,10767
3/25/2017,2017,3,25, 18 ,7657,1603,1443,10703
3/25/2017,2017,3,25, 19 ,8189,1721,1529,11439
3/25/2017,2017,3,25, 20 ,8186,1680,1489,11355
3/25/2017,2017,3,25, 21 ,8115,1608,1414,11137
3/25/2017,2017,3,25, 22 ,7944,1540,1353,10837
3/25/2017,2017,3,25, 23 ,7610,1433,1209,10252
3/25/2017,2017,3,25, 24 ,7164,1348,1128,9640
3/26/2017,2017,3,26, 1 ,6828,1279,1049,9156
3/26/2017,2017,3,26, 2 ,6609,1251,1030,8890
3/26/2017,2017,3,26, 3 ,6392,1202,994,8588
3/26/2017,2017,3,26, 4 ,6181,1178,985,8344
3/26/2017,2017,3,26, 5 ,6064,1168,973,8205
3/26/2017,2017,3,26, 6 ,5845,1140,984,7969
3/26/2017,2017,3,26, 7 ,5709,1147,959,7815
3/26/2017,2017,3,26, 8 ,6035,1210,995,8240
3/26/2017,2017,3,26, 9 ,6465,1305,1059,8829
3/26/2017,2017,3,26, 10 ,6952,1406,1090,9448
3/26/2017,2017,3,26, 11 ,7259,1446,1214,9919
3/26/2017,2017,3,26, 12 ,7237,1453,1273,9963
3/26/2017,2017,3,26, 13 ,7324,1469,1272,10065
3/26/2017,2017,3,26, 14 ,7463,1485,1281,10229
3/26/2017,2017,3,26, 15 ,7437,1466,1246,10149
3/26/2017,2017,3,26, 16 ,7149,1422,1221,9792
3/26/2017,2017,3,26, 17 ,6996,1398,1236,9630
3/26/2017,2017,3,26, 18 ,6999,1545,1343,9887
3/26/2017,2017,3,26, 19 ,7680,1674,1400,10754
3/26/2017,2017,3,26, 20 ,7655,1650,1383,10688
3/26/2017,2017,3,26, 21 ,7710,1583,1333,10626
3/26/2017,2017,3,26, 22 ,7422,1472,1226,10120
3/26/2017,2017,3,26, 23 ,7189,1374,1145,9708
3/26/2017,2017,3,26, 24 ,6814,1304,1054,9172
3/27/2017,2017,3,27, 1 ,6508,1250,1020,8778
3/27/2017,2017,3,27, 2 ,6221,1216,979,8416
3/27/2017,2017,3,27, 3 ,5996,1181,950,8127
3/27/2017,2017,3,27, 4 ,5922,1175,947,8044
3/27/2017,2017,3,27, 5 ,6005,1203,974,8182
3/27/2017,2017,3,27, 6 ,6093,1242,1045,8380
3/27/2017,2017,3,27, 7 ,6393,1220,1001,8614
3/27/2017,2017,3,27, 8 ,7269,1368,1139,9776
3/27/2017,2017,3,27, 9 ,8129,1586,1364,11079
3/27/2017,2017,3,27, 10 ,8649,1695,1488,11832
3/27/2017,2017,3,27, 11 ,8889,1732,1556,12177
3/27/2017,2017,3,27, 12 ,8676,1697,1498,11871
3/27/2017,2017,3,27, 13 ,8709,1717,1513,11939
3/27/2017,2017,3,27, 14 ,9004,1766,1534,12304
3/27/2017,2017,3,27, 15 ,8914,1756,1541,12211
3/27/2017,2017,3,27, 16 ,8767,1728,1503,11998
3/27/2017,2017,3,27, 17 ,8313,1643,1425,11381
3/27/2017,2017,3,27, 18 ,8043,1722,1491,11256
3/27/2017,2017,3,27, 19 ,8374,1781,1509,11664
3/27/2017,2017,3,27, 20 ,8210,1731,1424,11365
3/27/2017,2017,3,27, 21 ,8046,1643,1403,11092
3/27/2017,2017,3,27, 22 ,7753,1517,1288,10558
3/27/2017,2017,3,27, 23 ,7378,1417,1194,9989
3/27/2017,2017,3,27, 24 ,7005,1335,1109,9449
3/28/2017,2017,3,28, 1 ,6664,1274,1061,8999
3/28/2017,2017,3,28, 2 ,6455,1241,1036,8732
3/28/2017,2017,3,28, 3 ,6257,1211,1012,8480
3/28/2017,2017,3,28, 4 ,6197,1200,1001,8398
3/28/2017,2017,3,28, 5 ,6271,1210,1034,8515
3/28/2017,2017,3,28, 6 ,6342,1251,1103,8696
3/28/2017,2017,3,28, 7 ,6433,1239,1057,8729
3/28/2017,2017,3,28, 8 ,7132,1344,1169,9645
3/28/2017,2017,3,28, 9 ,7917,1535,1344,10796
3/28/2017,2017,3,28, 10 ,8355,1634,1420,11409
3/28/2017,2017,3,28, 11 ,8690,1712,1475,11877
3/28/2017,2017,3,28, 12 ,8475,1650,1404,11529
3/28/2017,2017,3,28, 13 ,8443,1662,1391,11496
3/28/2017,2017,3,28, 14 ,8779,1715,1460,11954
3/28/2017,2017,3,28, 15 ,8680,1705,1446,11831
3/28/2017,2017,3,28, 16 ,8455,1685,1434,11574
3/28/2017,2017,3,28, 17 ,8036,1606,1424,11066
3/28/2017,2017,3,28, 18 ,7865,1690,1492,11047
3/28/2017,2017,3,28, 19 ,8122,1729,1490,11341
3/28/2017,2017,3,28, 20 ,8007,1668,1425,11100
3/28/2017,2017,3,28, 21 ,7795,1567,1340,10702
3/28/2017,2017,3,28, 22 ,7533,1439,1207,10179
3/28/2017,2017,3,28, 23 ,7103,1348,1091,9542
3/28/2017,2017,3,28, 24 ,6772,1258,1030,9060
3/29/2017,2017,3,29, 1 ,6456,1208,979,8643
3/29/2017,2017,3,29, 2 ,6326,1181,948,8455
3/29/2017,2017,3,29, 3 ,6105,1150,935,8190
3/29/2017,2017,3,29, 4 ,6012,1136,912,8060
3/29/2017,2017,3,29, 5 ,6110,1169,970,8249
3/29/2017,2017,3,29, 6 ,6203,1201,1030,8434
3/29/2017,2017,3,29, 7 ,6312,1196,999,8507
3/29/2017,2017,3,29, 8 ,7059,1331,1112,9502
3/29/2017,2017,3,29, 9 ,7821,1535,1313,10669
3/29/2017,2017,3,29, 10 ,8363,1661,1330,11354
3/29/2017,2017,3,29, 11 ,8716,1701,1376,11793
3/29/2017,2017,3,29, 12 ,8587,1647,1481,11715
3/29/2017,2017,3,29, 13 ,8590,1687,1486,11763
3/29/2017,2017,3,29, 14 ,8996,1743,1556,12295
3/29/2017,2017,3,29, 15 ,8917,1736,1497,12150
3/29/2017,2017,3,29, 16 ,8722,1715,1466,11903
3/29/2017,2017,3,29, 17 ,8205,1636,1442,11283
3/29/2017,2017,3,29, 18 ,7975,1695,1491,11161
3/29/2017,2017,3,29, 19 ,8347,1765,1555,11667
3/29/2017,2017,3,29, 20 ,8185,1702,1475,11362
3/29/2017,2017,3,29, 21 ,8046,1623,1437,11106
3/29/2017,2017,3,29, 22 ,7785,1481,1298,10564
3/29/2017,2017,3,29, 23 ,7350,1378,1182,9910
3/29/2017,2017,3,29, 24 ,6933,1305,1126,9364
3/30/2017,2017,3,30, 1 ,6638,1248,1074,8960
3/30/2017,2017,3,30, 2 ,6431,1209,1035,8675
3/30/2017,2017,3,30, 3 ,6226,1181,1011,8418
3/30/2017,2017,3,30, 4 ,6072,1163,987,8222
3/30/2017,2017,3,30, 5 ,6129,1183,1032,8344
3/30/2017,2017,3,30, 6 ,6177,1223,1062,8462
3/30/2017,2017,3,30, 7 ,6339,1214,1040,8593
3/30/2017,2017,3,30, 8 ,7175,1346,1176,9697
3/30/2017,2017,3,30, 9 ,8028,1556,1376,10960
3/30/2017,2017,3,30, 10 ,8549,1633,1469,11651
3/30/2017,2017,3,30, 11 ,8916,1700,1593,12209
3/30/2017,2017,3,30, 12 ,8695,1649,1520,11864
3/30/2017,2017,3,30, 13 ,8711,1634,1556,11901
3/30/2017,2017,3,30, 14 ,9026,1676,1564,12266
3/30/2017,2017,3,30, 15 ,9004,1670,1579,12253
3/30/2017,2017,3,30, 16 ,8793,1651,1546,11990
3/30/2017,2017,3,30, 17 ,8269,1592,1482,11343
3/30/2017,2017,3,30, 18 ,7956,1632,1541,11129
3/30/2017,2017,3,30, 19 ,8297,1705,1564,11566
3/30/2017,2017,3,30, 20 ,8113,1634,1500,11247
3/30/2017,2017,3,30, 21 ,7973,1554,1443,10970
3/30/2017,2017,3,30, 22 ,7696,1420,1310,10426
3/30/2017,2017,3,30, 23 ,7285,1322,1214,9821
3/30/2017,2017,3,30, 24 ,6886,1250,1121,9257
3/31/2017,2017,3,31, 1 ,6558,1193,1129,8880
3/31/2017,2017,3,31, 2 ,6311,1160,1047,8518
3/31/2017,2017,3,31, 3 ,6124,1131,1022,8277
3/31/2017,2017,3,31, 4 ,6022,1118,1001,8141
3/31/2017,2017,3,31, 5 ,6052,1139,1029,8220
3/31/2017,2017,3,31, 6 ,6075,1190,1069,8334
3/31/2017,2017,3,31, 7 ,6259,1191,1031,8481
3/31/2017,2017,3,31, 8 ,7109,1319,1160,9588
3/31/2017,2017,3,31, 9 ,8041,1498,1368,10907
3/31/2017,2017,3,31, 10 ,8456,1605,1471,11532
3/31/2017,2017,3,31, 11 ,8813,1651,1527,11991
3/31/2017,2017,3,31, 12 ,8713,1587,1498,11798
3/31/2017,2017,3,31, 13 ,8744,1577,1504,11825
3/31/2017,2017,3,31, 14 ,9124,1626,1529,12279
3/31/2017,2017,3,31, 15 ,9056,1611,1517,12184
3/31/2017,2017,3,31, 16 ,8855,1578,1477,11910
3/31/2017,2017,3,31, 17 ,8321,1542,1449,11312
3/31/2017,2017,3,31, 18 ,8101,1623,1504,11228
3/31/2017,2017,3,31, 19 ,8447,1671,1500,11618
3/31/2017,2017,3,31, 20 ,8326,1616,1436,11378
3/31/2017,2017,3,31, 21 ,8154,1528,1369,11051
3/31/2017,2017,3,31, 22 ,7906,1411,1275,10592
3/31/2017,2017,3,31, 23 ,7513,1309,1137,9959
3/31/2017,2017,3,31, 24 ,7132,1230,1071,9433
4/1/2017,2017,4,1, 1 ,6797,1176,1024,8997
4/1/2017,2017,4,1, 2 ,6535,1140,996,8671
4/1/2017,2017,4,1, 3 ,6337,1117,974,8428
4/1/2017,2017,4,1, 4 ,6177,1102,962,8241
4/1/2017,2017,4,1, 5 ,6088,1113,992,8193
4/1/2017,2017,4,1, 6 ,6012,1132,1013,8157
4/1/2017,2017,4,1, 7 ,6114,1157,989,8260
4/1/2017,2017,4,1, 8 ,6658,1262,1056,8976
4/1/2017,2017,4,1, 9 ,7292,1421,1174,9887
4/1/2017,2017,4,1, 10 ,7887,1531,1278,10696
4/1/2017,2017,4,1, 11 ,8191,1597,1355,11143
4/1/2017,2017,4,1, 12 ,8108,1573,1336,11017
4/1/2017,2017,4,1, 13 ,8105,1564,1354,11023
4/1/2017,2017,4,1, 14 ,8383,1623,1395,11401
4/1/2017,2017,4,1, 15 ,8312,1589,1373,11274
4/1/2017,2017,4,1, 16 ,8050,1546,1332,10928
4/1/2017,2017,4,1, 17 ,7562,1491,1307,10360
4/1/2017,2017,4,1, 18 ,7455,1580,1429,10464
4/1/2017,2017,4,1, 19 ,7917,1657,1436,11010
4/1/2017,2017,4,1, 20 ,7908,1625,1382,10915
4/1/2017,2017,4,1, 21 ,7893,1558,1310,10761
4/1/2017,2017,4,1, 22 ,7625,1433,1214,10272
4/1/2017,2017,4,1, 23 ,7313,1331,1086,9730
4/1/2017,2017,4,1, 24 ,6916,1242,1036,9194
4/2/2017,2017,4,2, 1 ,6664,1186,976,8826
4/2/2017,2017,4,2, 2 ,6448,1166,945,8559
4/2/2017,2017,4,2, 3 ,6237,1133,929,8299
4/2/2017,2017,4,2, 4 ,6038,1121,915,8074
4/2/2017,2017,4,2, 5 ,5968,1115,928,8011
4/2/2017,2017,4,2, 6 ,5764,1087,929,7780
4/2/2017,2017,4,2, 7 ,5704,1116,935,7755
4/2/2017,2017,4,2, 8 ,5917,1148,969,8034
4/2/2017,2017,4,2, 9 ,6301,1242,1047,8590
4/2/2017,2017,4,2, 10 ,6696,1351,1128,9175
4/2/2017,2017,4,2, 11 ,6932,1383,1186,9501
4/2/2017,2017,4,2, 12 ,6840,1416,1190,9446
4/2/2017,2017,4,2, 13 ,6769,1413,1204,9386
4/2/2017,2017,4,2, 14 ,6764,1441,1226,9431
4/2/2017,2017,4,2, 15 ,6680,1398,1191,9269
4/2/2017,2017,4,2, 16 ,6539,1378,1174,9091
4/2/2017,2017,4,2, 17 ,6423,1358,1194,8975
4/2/2017,2017,4,2, 18 ,6646,1481,1335,9462
4/2/2017,2017,4,2, 19 ,7112,1577,1384,10073
4/2/2017,2017,4,2, 20 ,7110,1545,1340,9995
4/2/2017,2017,4,2, 21 ,6960,1465,1272,9697
4/2/2017,2017,4,2, 22 ,6640,1366,1124,9130
4/2/2017,2017,4,2, 23 ,6296,1261,1083,8640
4/2/2017,2017,4,2, 24 ,6012,1186,1002,8200
4/3/2017,2017,4,3, 1 ,5657,1136,965,7758
4/3/2017,2017,4,3, 2 ,5474,1101,944,7519
4/3/2017,2017,4,3, 3 ,5325,1076,898,7299
4/3/2017,2017,4,3, 4 ,5281,1069,895,7245
4/3/2017,2017,4,3, 5 ,5386,1100,939,7425
4/3/2017,2017,4,3, 6 ,5560,1128,996,7684
4/3/2017,2017,4,3, 7 ,5881,1132,993,8006
4/3/2017,2017,4,3, 8 ,6511,1243,1116,8870
4/3/2017,2017,4,3, 9 ,7401,1450,1317,10168
4/3/2017,2017,4,3, 10 ,7958,1553,1438,10949
4/3/2017,2017,4,3, 11 ,8299,1621,1506,11426
4/3/2017,2017,4,3, 12 ,8117,1590,1504,11211
4/3/2017,2017,4,3, 13 ,8097,1574,1491,11162
4/3/2017,2017,4,3, 14 ,8442,1616,1520,11578
4/3/2017,2017,4,3, 15 ,8380,1615,1485,11480
4/3/2017,2017,4,3, 16 ,8219,1585,1452,11256
4/3/2017,2017,4,3, 17 ,7755,1544,1426,10725
4/3/2017,2017,4,3, 18 ,7512,1603,1480,10595
4/3/2017,2017,4,3, 19 ,7874,1629,1502,11005
4/3/2017,2017,4,3, 20 ,7689,1552,1431,10672
4/3/2017,2017,4,3, 21 ,7408,1459,1372,10239
4/3/2017,2017,4,3, 22 ,6997,1333,1255,9585
4/3/2017,2017,4,3, 23 ,6663,1225,1157,9045
4/3/2017,2017,4,3, 24 ,6221,1153,1071,8445
4/4/2017,2017,4,4, 1 ,5948,1116,1032,8096
4/4/2017,2017,4,4, 2 ,5770,1095,999,7864
4/4/2017,2017,4,4, 3 ,5638,1072,969,7679
4/4/2017,2017,4,4, 4 ,5569,1061,961,7591
4/4/2017,2017,4,4, 5 ,5359,1088,1000,7447
4/4/2017,2017,4,4, 6 ,5793,1149,1048,7990
4/4/2017,2017,4,4, 7 ,6032,1149,1027,8208
4/4/2017,2017,4,4, 8 ,6727,1259,1133,9119
4/4/2017,2017,4,4, 9 ,7478,1435,1331,10244
4/4/2017,2017,4,4, 10 ,7906,1522,1426,10854
4/4/2017,2017,4,4, 11 ,8226,1563,1486,11275
4/4/2017,2017,4,4, 12 ,8040,1504,1456,11000
4/4/2017,2017,4,4, 13 ,8028,1474,1449,10951
4/4/2017,2017,4,4, 14 ,8321,1521,1491,11333
4/4/2017,2017,4,4, 15 ,8213,1519,1461,11193
4/4/2017,2017,4,4, 16 ,8123,1508,1446,11077
4/4/2017,2017,4,4, 17 ,7722,1488,1403,10613
4/4/2017,2017,4,4, 18 ,7520,1566,1491,10577
4/4/2017,2017,4,4, 19 ,7831,1581,1490,10902
4/4/2017,2017,4,4, 20 ,7631,1506,1428,10565
4/4/2017,2017,4,4, 21 ,7473,1418,1366,10257
4/4/2017,2017,4,4, 22 ,7115,1300,1239,9654
4/4/2017,2017,4,4, 23 ,6716,1207,1142,9065
4/4/2017,2017,4,4, 24 ,6308,1140,1062,8510
4/5/2017,2017,4,5, 1 ,6024,1100,1021,8145
4/5/2017,2017,4,5, 2 ,5855,1066,982,7903
4/5/2017,2017,4,5, 3 ,5641,1053,968,7662
4/5/2017,2017,4,5, 4 ,5577,1047,957,7581
4/5/2017,2017,4,5, 5 ,5653,1070,991,7714
4/5/2017,2017,4,5, 6 ,5764,1129,1042,7935
4/5/2017,2017,4,5, 7 ,5998,1140,1029,8167
4/5/2017,2017,4,5, 8 ,6772,1260,1149,9181
4/5/2017,2017,4,5, 9 ,7540,1460,1324,10324
4/5/2017,2017,4,5, 10 ,8105,1573,1431,11109
4/5/2017,2017,4,5, 11 ,8423,1621,1483,11527
4/5/2017,2017,4,5, 12 ,8262,1579,1463,11304
4/5/2017,2017,4,5, 13 ,8249,1575,1459,11283
4/5/2017,2017,4,5, 14 ,8562,1624,1491,11677
4/5/2017,2017,4,5, 15 ,8488,1625,1468,11581
4/5/2017,2017,4,5, 16 ,8297,1608,1436,11341
4/5/2017,2017,4,5, 17 ,7885,1545,1414,10844
4/5/2017,2017,4,5, 18 ,7642,1623,1458,10723
4/5/2017,2017,4,5, 19 ,8031,1665,1440,11136
4/5/2017,2017,4,5, 20 ,7835,1612,1397,10844
4/5/2017,2017,4,5, 21 ,7668,1534,1298,10500
4/5/2017,2017,4,5, 22 ,7346,1399,1175,9920
4/5/2017,2017,4,5, 23 ,6966,1291,1092,9349
4/5/2017,2017,4,5, 24 ,6514,1220,1017,8751
4/6/2017,2017,4,6, 1 ,6194,1172,992,8358
4/6/2017,2017,4,6, 2 ,6023,1134,957,8114
4/6/2017,2017,4,6, 3 ,5807,1113,940,7860
4/6/2017,2017,4,6, 4 ,5748,1110,938,7796
4/6/2017,2017,4,6, 5 ,5817,1135,969,7921
4/6/2017,2017,4,6, 6 ,5862,1165,1027,8054
4/6/2017,2017,4,6, 7 ,6094,1164,1012,8270
4/6/2017,2017,4,6, 8 ,6900,1291,1112,9303
4/6/2017,2017,4,6, 9 ,7717,1430,1302,10449
4/6/2017,2017,4,6, 10 ,8180,1569,1414,11163
4/6/2017,2017,4,6, 11 ,8577,1608,1436,11621
4/6/2017,2017,4,6, 12 ,8431,1541,1464,11436
4/6/2017,2017,4,6, 13 ,8427,1532,1488,11447
4/6/2017,2017,4,6, 14 ,8857,1570,1509,11936
4/6/2017,2017,4,6, 15 ,8737,1597,1504,11838
4/6/2017,2017,4,6, 16 ,8597,1577,1499,11673
4/6/2017,2017,4,6, 17 ,8161,1541,1423,11125
4/6/2017,2017,4,6, 18 ,7902,1622,1508,11032
4/6/2017,2017,4,6, 19 ,8232,1668,1507,11407
4/6/2017,2017,4,6, 20 ,8046,1592,1455,11093
4/6/2017,2017,4,6, 21 ,7864,1511,1396,10771
4/6/2017,2017,4,6, 22 ,7614,1399,1277,10290
4/6/2017,2017,4,6, 23 ,7285,1296,1136,9717
4/6/2017,2017,4,6, 24 ,6745,1216,1090,9051
4/7/2017,2017,4,7, 1 ,6442,1169,1043,8654
4/7/2017,2017,4,7, 2 ,6249,1133,1008,8390
4/7/2017,2017,4,7, 3 ,6054,1112,971,8137
4/7/2017,2017,4,7, 4 ,5950,1099,972,8021
4/7/2017,2017,4,7, 5 ,5992,1117,998,8107
4/7/2017,2017,4,7, 6 ,5999,1151,1019,8169
4/7/2017,2017,4,7, 7 ,6267,1176,1025,8468
4/7/2017,2017,4,7, 8 ,7051,1315,1155,9521
4/7/2017,2017,4,7, 9 ,7918,1509,1360,10787
4/7/2017,2017,4,7, 10 ,8384,1610,1471,11465
4/7/2017,2017,4,7, 11 ,8750,1682,1545,11977
4/7/2017,2017,4,7, 12 ,8634,1664,1527,11825
4/7/2017,2017,4,7, 13 ,8685,1662,1526,11873
4/7/2017,2017,4,7, 14 ,9019,1731,1553,12303
4/7/2017,2017,4,7, 15 ,9005,1729,1522,12256
4/7/2017,2017,4,7, 16 ,8732,1697,1505,11934
4/7/2017,2017,4,7, 17 ,8232,1603,1457,11292
4/7/2017,2017,4,7, 18 ,7963,1649,1522,11134
4/7/2017,2017,4,7, 19 ,8273,1742,1541,11556
4/7/2017,2017,4,7, 20 ,8156,1682,1499,11337
4/7/2017,2017,4,7, 21 ,8068,1617,1439,11124
4/7/2017,2017,4,7, 22 ,7799,1482,1327,10608
4/7/2017,2017,4,7, 23 ,7449,1387,1232,10068
4/7/2017,2017,4,7, 24 ,7042,1299,1129,9470
4/8/2017,2017,4,8, 1 ,6732,1250,1095,9077
4/8/2017,2017,4,8, 2 ,6506,1203,1062,8771
4/8/2017,2017,4,8, 3 ,6338,1176,1028,8542
4/8/2017,2017,4,8, 4 ,6207,1156,1015,8378
4/8/2017,2017,4,8, 5 ,6132,1162,1018,8312
4/8/2017,2017,4,8, 6 ,5969,1157,1020,8146
4/8/2017,2017,4,8, 7 ,6074,1176,1021,8271
4/8/2017,2017,4,8, 8 ,6723,1296,1116,9135
4/8/2017,2017,4,8, 9 ,7462,1470,1188,10120
4/8/2017,2017,4,8, 10 ,8061,1575,1294,10930
4/8/2017,2017,4,8, 11 ,8367,1643,1358,11368
4/8/2017,2017,4,8, 12 ,8214,1617,1365,11196
4/8/2017,2017,4,8, 13 ,8175,1622,1376,11173
4/8/2017,2017,4,8, 14 ,8437,1660,1421,11518
4/8/2017,2017,4,8, 15 ,8389,1642,1408,11439
4/8/2017,2017,4,8, 16 ,7651,1591,1375,10617
4/8/2017,2017,4,8, 17 ,7578,1520,1301,10399
4/8/2017,2017,4,8, 18 ,7528,1611,1397,10536
4/8/2017,2017,4,8, 19 ,8052,1722,1540,11314
4/8/2017,2017,4,8, 20 ,8064,1677,1487,11228
4/8/2017,2017,4,8, 21 ,8031,1619,1437,11087
4/8/2017,2017,4,8, 22 ,7871,1533,1355,10759
4/8/2017,2017,4,8, 23 ,7528,1411,1230,10169
4/8/2017,2017,4,8, 24 ,7067,1303,1141,9511
4/9/2017,2017,4,9, 1 ,6801,1227,1089,9117
4/9/2017,2017,4,9, 2 ,6595,1185,1035,8815
4/9/2017,2017,4,9, 3 ,6401,1149,1009,8559
4/9/2017,2017,4,9, 4 ,6249,1126,980,8355
4/9/2017,2017,4,9, 5 ,6128,1116,977,8221
4/9/2017,2017,4,9, 6 ,5853,1065,960,7878
4/9/2017,2017,4,9, 7 ,5772,1038,965,7775
4/9/2017,2017,4,9, 8 ,6047,1109,1053,8209
4/9/2017,2017,4,9, 9 ,6437,1219,1119,8775
4/9/2017,2017,4,9, 10 ,6970,1274,1187,9431
4/9/2017,2017,4,9, 11 ,7276,1373,1254,9903
4/9/2017,2017,4,9, 12 ,7200,1371,1255,9826
4/9/2017,2017,4,9, 13 ,7305,1375,1269,9949
4/9/2017,2017,4,9, 14 ,7346,1397,1294,10037
4/9/2017,2017,4,9, 15 ,7322,1383,1284,9989
4/9/2017,2017,4,9, 16 ,7132,1386,1254,9772
4/9/2017,2017,4,9, 17 ,6932,1376,1190,9498
4/9/2017,2017,4,9, 18 ,6996,1470,1256,9722
4/9/2017,2017,4,9, 19 ,7600,1642,1406,10648
4/9/2017,2017,4,9, 20 ,7720,1603,1417,10740
4/9/2017,2017,4,9, 21 ,7735,1565,1336,10636
4/9/2017,2017,4,9, 22 ,7497,1452,1260,10209
4/9/2017,2017,4,9, 23 ,7180,1352,1139,9671
4/9/2017,2017,4,9, 24 ,6832,1266,1079,9177
4/10/2017,2017,4,10, 1 ,6558,1199,1014,8771
4/10/2017,2017,4,10, 2 ,6305,1162,984,8451
4/10/2017,2017,4,10, 3 ,6102,1125,957,8184
4/10/2017,2017,4,10, 4 ,6035,1104,936,8075
4/10/2017,2017,4,10, 5 ,5973,1119,956,8048
4/10/2017,2017,4,10, 6 ,6007,1140,987,8134
4/10/2017,2017,4,10, 7 ,6389,1180,1011,8580
4/10/2017,2017,4,10, 8 ,7288,1345,1160,9793
4/10/2017,2017,4,10, 9 ,8163,1581,1373,11117
4/10/2017,2017,4,10, 10 ,8667,1696,1513,11876
4/10/2017,2017,4,10, 11 ,9075,1760,1553,12388
4/10/2017,2017,4,10, 12 ,9061,1747,1579,12387
4/10/2017,2017,4,10, 13 ,9015,1743,1565,12323
4/10/2017,2017,4,10, 14 ,9406,1788,1624,12818
4/10/2017,2017,4,10, 15 ,9286,1780,1635,12701
4/10/2017,2017,4,10, 16 ,9183,1728,1600,12511
4/10/2017,2017,4,10, 17 ,8667,1643,1501,11811
4/10/2017,2017,4,10, 18 ,8380,1650,1488,11518
4/10/2017,2017,4,10, 19 ,8648,1762,1551,11961
4/10/2017,2017,4,10, 20 ,8525,1698,1507,11730
4/10/2017,2017,4,10, 21 ,8421,1591,1436,11448
4/10/2017,2017,4,10, 22 ,8229,1485,1336,11050
4/10/2017,2017,4,10, 23 ,7841,1370,1231,10442
4/10/2017,2017,4,10, 24 ,7471,1279,1147,9897
4/11/2017,2017,4,11, 1 ,7099,1221,1090,9410
4/11/2017,2017,4,11, 2 ,6908,1189,1031,9128
4/11/2017,2017,4,11, 3 ,6706,1151,996,8853
4/11/2017,2017,4,11, 4 ,6530,1136,973,8639
4/11/2017,2017,4,11, 5 ,6537,1149,996,8682
4/11/2017,2017,4,11, 6 ,6470,1171,1012,8653
4/11/2017,2017,4,11, 7 ,6658,1199,1020,8877
4/11/2017,2017,4,11, 8 ,7421,1374,1189,9984
4/11/2017,2017,4,11, 9 ,8197,1590,1354,11141
4/11/2017,2017,4,11, 10 ,8694,1680,1505,11879
4/11/2017,2017,4,11, 11 ,9057,1751,1576,12384
4/11/2017,2017,4,11, 12 ,8941,1742,1560,12243
4/11/2017,2017,4,11, 13 ,9013,1728,1585,12326
4/11/2017,2017,4,11, 14 ,9298,1797,1622,12717
4/11/2017,2017,4,11, 15 ,9245,1795,1621,12661
4/11/2017,2017,4,11, 16 ,9056,1751,1576,12383
4/11/2017,2017,4,11, 17 ,8493,1638,1473,11604
4/11/2017,2017,4,11, 18 ,8151,1693,1511,11355
4/11/2017,2017,4,11, 19 ,8479,1775,1559,11813
4/11/2017,2017,4,11, 20 ,8396,1708,1467,11571
4/11/2017,2017,4,11, 21 ,8334,1642,1428,11404
4/11/2017,2017,4,11, 22 ,8085,1532,1324,10941
4/11/2017,2017,4,11, 23 ,7759,1416,1234,10409
4/11/2017,2017,4,11, 24 ,7382,1338,1151,9871
4/12/2017,2017,4,12, 1 ,7133,1262,1098,9493
4/12/2017,2017,4,12, 2 ,6912,1215,1054,9181
4/12/2017,2017,4,12, 3 ,6687,1179,1025,8891
4/12/2017,2017,4,12, 4 ,6545,1173,1010,8728
4/12/2017,2017,4,12, 5 ,6468,1185,1023,8676
4/12/2017,2017,4,12, 6 ,6351,1181,1039,8571
4/12/2017,2017,4,12, 7 ,6494,1206,1027,8727
4/12/2017,2017,4,12, 8 ,7300,1387,1162,9849
4/12/2017,2017,4,12, 9 ,8030,1592,1376,10998
4/12/2017,2017,4,12, 10 ,8526,1672,1520,11718
4/12/2017,2017,4,12, 11 ,8843,1749,1571,12163
4/12/2017,2017,4,12, 12 ,8759,1714,1546,12019
4/12/2017,2017,4,12, 13 ,8728,1705,1563,11996
4/12/2017,2017,4,12, 14 ,9033,1722,1600,12355
4/12/2017,2017,4,12, 15 ,8828,1698,1565,12091
4/12/2017,2017,4,12, 16 ,8445,1620,1502,11567
4/12/2017,2017,4,12, 17 ,7924,1559,1414,10897
4/12/2017,2017,4,12, 18 ,7703,1600,1468,10771
4/12/2017,2017,4,12, 19 ,8048,1745,1523,11316
4/12/2017,2017,4,12, 20 ,7922,1692,1487,11101
4/12/2017,2017,4,12, 21 ,7804,1628,1427,10859
4/12/2017,2017,4,12, 22 ,7610,1539,1320,10469
4/12/2017,2017,4,12, 23 ,7294,1405,1219,9918
4/12/2017,2017,4,12, 24 ,6921,1321,1131,9373
4/13/2017,2017,4,13, 1 ,6622,1269,1091,8982
4/13/2017,2017,4,13, 2 ,6381,1220,1043,8644
4/13/2017,2017,4,13, 3 ,6136,1190,1007,8333
4/13/2017,2017,4,13, 4 ,5919,1162,985,8066
4/13/2017,2017,4,13, 5 ,5715,1153,975,7843
4/13/2017,2017,4,13, 6 ,5238,1114,951,7303
4/13/2017,2017,4,13, 7 ,5108,1122,949,7179
4/13/2017,2017,4,13, 8 ,5300,1175,1017,7492
4/13/2017,2017,4,13, 9 ,5617,1254,1122,7993
4/13/2017,2017,4,13, 10 ,5912,1307,1169,8388
4/13/2017,2017,4,13, 11 ,6123,1355,1229,8707
4/13/2017,2017,4,13, 12 ,6118,1353,1222,8693
4/13/2017,2017,4,13, 13 ,6223,1370,1237,8830
4/13/2017,2017,4,13, 14 ,6424,1374,1230,9028
4/13/2017,2017,4,13, 15 ,6419,1358,1183,8960
4/13/2017,2017,4,13, 16 ,6236,1310,1162,8708
4/13/2017,2017,4,13, 17 ,5922,1269,1133,8324
4/13/2017,2017,4,13, 18 ,5953,1344,1235,8532
4/13/2017,2017,4,13, 19 ,6565,1509,1293,9367
4/13/2017,2017,4,13, 20 ,6586,1470,1242,9298
4/13/2017,2017,4,13, 21 ,6596,1441,1198,9235
4/13/2017,2017,4,13, 22 ,6555,1379,1120,9054
4/13/2017,2017,4,13, 23 ,6387,1297,1035,8719
4/13/2017,2017,4,13, 24 ,6192,1244,983,8419
4/14/2017,2017,4,14, 1 ,5856,1194,942,7992
4/14/2017,2017,4,14, 2 ,5656,1149,911,7716
4/14/2017,2017,4,14, 3 ,5400,1120,880,7400
4/14/2017,2017,4,14, 4 ,5204,1090,869,7163
4/14/2017,2017,4,14, 5 ,5117,1072,859,7048
4/14/2017,2017,4,14, 6 ,4799,1028,830,6657
4/14/2017,2017,4,14, 7 ,4643,1026,836,6505
4/14/2017,2017,4,14, 8 ,4808,1066,873,6747
4/14/2017,2017,4,14, 9 ,5019,1091,884,6994
4/14/2017,2017,4,14, 10 ,5166,1117,924,7207
4/14/2017,2017,4,14, 11 ,5388,1155,969,7512
4/14/2017,2017,4,14, 12 ,5358,1151,968,7477
4/14/2017,2017,4,14, 13 ,5450,1155,966,7571
4/14/2017,2017,4,14, 14 ,5584,1161,986,7731
4/14/2017,2017,4,14, 15 ,5580,1145,962,7687
4/14/2017,2017,4,14, 16 ,5432,1107,928,7467
4/14/2017,2017,4,14, 17 ,5209,1086,942,7237
4/14/2017,2017,4,14, 18 ,5352,1176,1100,7628
4/14/2017,2017,4,14, 19 ,5964,1346,1195,8505
4/14/2017,2017,4,14, 20 ,6108,1354,1185,8647
4/14/2017,2017,4,14, 21 ,6222,1353,1082,8657
4/14/2017,2017,4,14, 22 ,6350,1315,1030,8695
4/14/2017,2017,4,14, 23 ,6120,1240,921,8281
4/14/2017,2017,4,14, 24 ,5901,1189,879,7969
4/15/2017,2017,4,15, 1 ,5616,1144,897,7657
4/15/2017,2017,4,15, 2 ,5420,1105,862,7387
4/15/2017,2017,4,15, 3 ,5257,1075,847,7179
4/15/2017,2017,4,15, 4 ,5111,1058,832,7001
4/15/2017,2017,4,15, 5 ,5031,1053,833,6917
4/15/2017,2017,4,15, 6 ,4821,1020,851,6692
4/15/2017,2017,4,15, 7 ,4991,1004,875,6870
4/15/2017,2017,4,15, 8 ,5398,1071,953,7422
4/15/2017,2017,4,15, 9 ,5842,1166,1057,8065
4/15/2017,2017,4,15, 10 ,6260,1223,1140,8623
4/15/2017,2017,4,15, 11 ,6558,1281,1202,9041
4/15/2017,2017,4,15, 12 ,6559,1277,1221,9057
4/15/2017,2017,4,15, 13 ,6670,1291,1212,9173
4/15/2017,2017,4,15, 14 ,6772,1325,1211,9308
4/15/2017,2017,4,15, 15 ,6708,1337,1224,9269
4/15/2017,2017,4,15, 16 ,6609,1334,1196,9139
4/15/2017,2017,4,15, 17 ,6407,1320,1190,8917
4/15/2017,2017,4,15, 18 ,6554,1420,1290,9264
4/15/2017,2017,4,15, 19 ,7094,1542,1361,9997
4/15/2017,2017,4,15, 20 ,7098,1511,1326,9935
4/15/2017,2017,4,15, 21 ,7076,1443,1279,9798
4/15/2017,2017,4,15, 22 ,6916,1361,1197,9474
4/15/2017,2017,4,15, 23 ,6721,1274,1121,9116
4/15/2017,2017,4,15, 24 ,6425,1207,1052,8684
4/16/2017,2017,4,16, 1 ,6173,1149,997,8319
4/16/2017,2017,4,16, 2 ,5985,1110,962,8057
4/16/2017,2017,4,16, 3 ,5775,1066,939,7780
4/16/2017,2017,4,16, 4 ,5554,1039,918,7511
4/16/2017,2017,4,16, 5 ,5501,1032,918,7451
4/16/2017,2017,4,16, 6 ,5359,1013,903,7275
4/16/2017,2017,4,16, 7 ,5331,1025,917,7273
4/16/2017,2017,4,16, 8 ,5658,1066,969,7693
4/16/2017,2017,4,16, 9 ,6143,1129,1054,8326
4/16/2017,2017,4,16, 10 ,6552,1200,1144,8896
4/16/2017,2017,4,16, 11 ,6662,1245,1200,9107
4/16/2017,2017,4,16, 12 ,6709,1233,1202,9144
4/16/2017,2017,4,16, 13 ,6645,1223,1198,9066
4/16/2017,2017,4,16, 14 ,6629,1224,1238,9091
4/16/2017,2017,4,16, 15 ,6544,1218,1229,8991
4/16/2017,2017,4,16, 16 ,6402,1243,1170,8815
4/16/2017,2017,4,16, 17 ,6338,1256,1177,8771
4/16/2017,2017,4,16, 18 ,6526,1404,1289,9219
4/16/2017,2017,4,16, 19 ,7150,1503,1409,10062
4/16/2017,2017,4,16, 20 ,7174,1444,1363,9981
4/16/2017,2017,4,16, 21 ,7085,1395,1319,9799
4/16/2017,2017,4,16, 22 ,6854,1279,1210,9343
4/16/2017,2017,4,16, 23 ,6553,1190,1107,8850
4/16/2017,2017,4,16, 24 ,6277,1140,1057,8474
4/17/2017,2017,4,17, 1 ,5935,1088,1005,8028
4/17/2017,2017,4,17, 2 ,5779,1064,968,7811
4/17/2017,2017,4,17, 3 ,5635,1038,932,7605
4/17/2017,2017,4,17, 4 ,5508,1027,915,7450
4/17/2017,2017,4,17, 5 ,5530,1048,934,7512
4/17/2017,2017,4,17, 6 ,5657,1064,960,7681
4/17/2017,2017,4,17, 7 ,6094,1109,986,8189
4/17/2017,2017,4,17, 8 ,7049,1294,1173,9516
4/17/2017,2017,4,17, 9 ,7956,1519,1404,10879
4/17/2017,2017,4,17, 10 ,8617,1646,1543,11806
4/17/2017,2017,4,17, 11 ,8959,1705,1617,12281
4/17/2017,2017,4,17, 12 ,8882,1692,1593,12167
4/17/2017,2017,4,17, 13 ,8918,1695,1601,12214
4/17/2017,2017,4,17, 14 ,9243,1768,1655,12666
4/17/2017,2017,4,17, 15 ,9253,1757,1646,12656
4/17/2017,2017,4,17, 16 ,9067,1727,1589,12383
4/17/2017,2017,4,17, 17 ,8570,1640,1513,11723
4/17/2017,2017,4,17, 18 ,8289,1697,1548,11534
4/17/2017,2017,4,17, 19 ,8549,1789,1589,11927
4/17/2017,2017,4,17, 20 ,8466,1734,1531,11731
4/17/2017,2017,4,17, 21 ,8266,1642,1471,11379
4/17/2017,2017,4,17, 22 ,8083,1542,1353,10978
4/17/2017,2017,4,17, 23 ,7703,1428,1249,10380
4/17/2017,2017,4,17, 24 ,7409,1350,1137,9896
4/18/2017,2017,4,18, 1 ,7018,1299,1118,9435
4/18/2017,2017,4,18, 2 ,6792,1252,1081,9125
4/18/2017,2017,4,18, 3 ,6619,1205,1045,8869
4/18/2017,2017,4,18, 4 ,6472,1192,1025,8689
4/18/2017,2017,4,18, 5 ,6479,1203,1040,8722
4/18/2017,2017,4,18, 6 ,6332,1213,1064,8609
4/18/2017,2017,4,18, 7 ,6641,1233,1066,8940
4/18/2017,2017,4,18, 8 ,7624,1412,1227,10263
4/18/2017,2017,4,18, 9 ,8481,1651,1434,11566
4/18/2017,2017,4,18, 10 ,8928,1757,1551,12236
4/18/2017,2017,4,18, 11 ,9232,1827,1646,12705
4/18/2017,2017,4,18, 12 ,9075,1786,1616,12477
4/18/2017,2017,4,18, 13 ,9049,1794,1618,12461
4/18/2017,2017,4,18, 14 ,9443,1876,1695,13014
4/18/2017,2017,4,18, 15 ,9395,1845,1688,12928
4/18/2017,2017,4,18, 16 ,9234,1819,1648,12701
4/18/2017,2017,4,18, 17 ,8803,1723,1538,12064
4/18/2017,2017,4,18, 18 ,8449,1747,1582,11778
4/18/2017,2017,4,18, 19 ,8814,1820,1635,12269
4/18/2017,2017,4,18, 20 ,8732,1767,1555,12054
4/18/2017,2017,4,18, 21 ,8527,1683,1510,11720
4/18/2017,2017,4,18, 22 ,8380,1552,1398,11330
4/18/2017,2017,4,18, 23 ,8082,1465,1290,10837
4/18/2017,2017,4,18, 24 ,7674,1374,1170,10218
4/19/2017,2017,4,19, 1 ,7350,1319,1145,9814
4/19/2017,2017,4,19, 2 ,7119,1275,1064,9458
4/19/2017,2017,4,19, 3 ,6816,1251,1062,9129
4/19/2017,2017,4,19, 4 ,6657,1226,1037,8920
4/19/2017,2017,4,19, 5 ,6582,1236,1063,8881
4/19/2017,2017,4,19, 6 ,6489,1223,1078,8790
4/19/2017,2017,4,19, 7 ,6822,1239,1085,9146
4/19/2017,2017,4,19, 8 ,7717,1423,1226,10366
4/19/2017,2017,4,19, 9 ,8562,1679,1440,11681
4/19/2017,2017,4,19, 10 ,9063,1777,1547,12387
4/19/2017,2017,4,19, 11 ,9439,1839,1624,12902
4/19/2017,2017,4,19, 12 ,9303,1806,1605,12714
4/19/2017,2017,4,19, 13 ,9325,1800,1627,12752
4/19/2017,2017,4,19, 14 ,9676,1860,1672,13208
4/19/2017,2017,4,19, 15 ,9657,1854,1647,13158
4/19/2017,2017,4,19, 16 ,9426,1807,1580,12813
4/19/2017,2017,4,19, 17 ,8888,1718,1500,12106
4/19/2017,2017,4,19, 18 ,8610,1741,1542,11893
4/19/2017,2017,4,19, 19 ,8981,1846,1584,12411
4/19/2017,2017,4,19, 20 ,8805,1774,1537,12116
4/19/2017,2017,4,19, 21 ,8574,1708,1478,11760
4/19/2017,2017,4,19, 22 ,8462,1582,1334,11378
4/19/2017,2017,4,19, 23 ,8081,1471,1240,10792
4/19/2017,2017,4,19, 24 ,7615,1379,1163,10157
4/20/2017,2017,4,20, 1 ,7358,1325,1106,9789
4/20/2017,2017,4,20, 2 ,7136,1286,1083,9505
4/20/2017,2017,4,20, 3 ,6960,1254,1046,9260
4/20/2017,2017,4,20, 4 ,6780,1223,1031,9034
4/20/2017,2017,4,20, 5 ,6735,1252,1053,9040
4/20/2017,2017,4,20, 6 ,6712,1235,1072,9019
4/20/2017,2017,4,20, 7 ,7003,1250,1075,9328
4/20/2017,2017,4,20, 8 ,7771,1420,1227,10418
4/20/2017,2017,4,20, 9 ,8650,1658,1441,11749
4/20/2017,2017,4,20, 10 ,9157,1756,1560,12473
4/20/2017,2017,4,20, 11 ,9456,1828,1626,12910
4/20/2017,2017,4,20, 12 ,9347,1827,1589,12763
4/20/2017,2017,4,20, 13 ,9403,1831,1626,12860
4/20/2017,2017,4,20, 14 ,9702,1882,1644,13228
4/20/2017,2017,4,20, 15 ,9639,1875,1617,13131
4/20/2017,2017,4,20, 16 ,9478,1823,1601,12902
4/20/2017,2017,4,20, 17 ,8905,1738,1519,12162
4/20/2017,2017,4,20, 18 ,8531,1748,1573,11852
4/20/2017,2017,4,20, 19 ,8955,1850,1608,12413
4/20/2017,2017,4,20, 20 ,8903,1785,1546,12234
4/20/2017,2017,4,20, 21 ,8817,1714,1511,12042
4/20/2017,2017,4,20, 22 ,8677,1609,1395,11681
4/20/2017,2017,4,20, 23 ,8296,1481,1272,11049
4/20/2017,2017,4,20, 24 ,7804,1385,1191,10380
4/21/2017,2017,4,21, 1 ,7584,1342,1135,10061
4/21/2017,2017,4,21, 2 ,7336,1304,1103,9743
4/21/2017,2017,4,21, 3 ,7112,1267,1058,9437
4/21/2017,2017,4,21, 4 ,6934,1241,1038,9213
4/21/2017,2017,4,21, 5 ,6810,1258,1055,9123
4/21/2017,2017,4,21, 6 ,6712,1240,1081,9033
4/21/2017,2017,4,21, 7 ,7060,1256,1081,9397
4/21/2017,2017,4,21, 8 ,7791,1438,1210,10439
4/21/2017,2017,4,21, 9 ,8682,1665,1407,11754
4/21/2017,2017,4,21, 10 ,9181,1760,1502,12443
4/21/2017,2017,4,21, 11 ,9478,1844,1621,12943
4/21/2017,2017,4,21, 12 ,9372,1792,1576,12740
4/21/2017,2017,4,21, 13 ,9427,1806,1586,12819
4/21/2017,2017,4,21, 14 ,9787,1876,1646,13309
4/21/2017,2017,4,21, 15 ,9679,1869,1642,13190
4/21/2017,2017,4,21, 16 ,9395,1830,1604,12829
4/21/2017,2017,4,21, 17 ,8806,1723,1490,12019
4/21/2017,2017,4,21, 18 ,8521,1734,1547,11802
4/21/2017,2017,4,21, 19 ,8876,1842,1584,12302
4/21/2017,2017,4,21, 20 ,8739,1791,1460,11990
4/21/2017,2017,4,21, 21 ,8693,1731,1423,11847
4/21/2017,2017,4,21, 22 ,8563,1618,1326,11507
4/21/2017,2017,4,21, 23 ,8211,1483,1276,10970
4/21/2017,2017,4,21, 24 ,7843,1381,1178,10402
4/22/2017,2017,4,22, 1 ,7547,1333,1138,10018
4/22/2017,2017,4,22, 2 ,7261,1283,1087,9631
4/22/2017,2017,4,22, 3 ,7032,1251,1051,9334
4/22/2017,2017,4,22, 4 ,6873,1235,1055,9163
4/22/2017,2017,4,22, 5 ,6715,1244,1073,9032
4/22/2017,2017,4,22, 6 ,6548,1214,1065,8827
4/22/2017,2017,4,22, 7 ,6650,1231,1064,8945
4/22/2017,2017,4,22, 8 ,7166,1357,1157,9680
4/22/2017,2017,4,22, 9 ,7818,1533,1322,10673
4/22/2017,2017,4,22, 10 ,8267,1643,1417,11327
4/22/2017,2017,4,22, 11 ,8535,1714,1469,11718
4/22/2017,2017,4,22, 12 ,8511,1672,1453,11636
4/22/2017,2017,4,22, 13 ,8533,1680,1456,11669
4/22/2017,2017,4,22, 14 ,8845,1727,1533,12105
4/22/2017,2017,4,22, 15 ,8693,1701,1495,11889
4/22/2017,2017,4,22, 16 ,8491,1647,1432,11570
4/22/2017,2017,4,22, 17 ,7994,1580,1411,10985
4/22/2017,2017,4,22, 18 ,7877,1647,1457,10981
4/22/2017,2017,4,22, 19 ,8444,1788,1517,11749
4/22/2017,2017,4,22, 20 ,8449,1749,1487,11685
4/22/2017,2017,4,22, 21 ,8466,1711,1398,11575
4/22/2017,2017,4,22, 22 ,8277,1649,1317,11243
4/22/2017,2017,4,22, 23 ,8053,1518,1194,10765
4/22/2017,2017,4,22, 24 ,7641,1427,1117,10185
4/23/2017,2017,4,23, 1 ,7335,1363,1064,9762
4/23/2017,2017,4,23, 2 ,7035,1313,1023,9371
4/23/2017,2017,4,23, 3 ,6864,1276,999,9139
4/23/2017,2017,4,23, 4 ,6629,1238,994,8861
4/23/2017,2017,4,23, 5 ,6465,1230,1014,8709
4/23/2017,2017,4,23, 6 ,6178,1200,995,8373
4/23/2017,2017,4,23, 7 ,6124,1197,962,8283
4/23/2017,2017,4,23, 8 ,6433,1251,999,8683
4/23/2017,2017,4,23, 9 ,6845,1339,1090,9274
4/23/2017,2017,4,23, 10 ,7302,1441,1220,9963
4/23/2017,2017,4,23, 11 ,7540,1500,1273,10313
4/23/2017,2017,4,23, 12 ,7585,1493,1305,10383
4/23/2017,2017,4,23, 13 ,7606,1511,1349,10466
4/23/2017,2017,4,23, 14 ,7741,1518,1318,10577
4/23/2017,2017,4,23, 15 ,7678,1493,1294,10465
4/23/2017,2017,4,23, 16 ,7441,1428,1213,10082
4/23/2017,2017,4,23, 17 ,7235,1445,1237,9917
4/23/2017,2017,4,23, 18 ,7312,1560,1383,10255
4/23/2017,2017,4,23, 19 ,7855,1698,1444,10997
4/23/2017,2017,4,23, 20 ,7976,1655,1411,11042
4/23/2017,2017,4,23, 21 ,7932,1602,1358,10892
4/23/2017,2017,4,23, 22 ,7822,1524,1276,10622
4/23/2017,2017,4,23, 23 ,7541,1418,1213,10172
4/23/2017,2017,4,23, 24 ,7264,1345,1103,9712
4/24/2017,2017,4,24, 1 ,6975,1272,1057,9304
4/24/2017,2017,4,24, 2 ,6668,1236,1022,8926
4/24/2017,2017,4,24, 3 ,6426,1183,992,8601
4/24/2017,2017,4,24, 4 ,6260,1163,975,8398
4/24/2017,2017,4,24, 5 ,6202,1174,956,8332
4/24/2017,2017,4,24, 6 ,6225,1173,988,8386
4/24/2017,2017,4,24, 7 ,6589,1213,1008,8810
4/24/2017,2017,4,24, 8 ,7594,1397,1177,10168
4/24/2017,2017,4,24, 9 ,8451,1632,1389,11472
4/24/2017,2017,4,24, 10 ,8984,1741,1508,12233
4/24/2017,2017,4,24, 11 ,9429,1823,1565,12817
4/24/2017,2017,4,24, 12 ,9370,1806,1556,12732
4/24/2017,2017,4,24, 13 ,9398,1806,1558,12762
4/24/2017,2017,4,24, 14 ,9701,1863,1625,13189
4/24/2017,2017,4,24, 15 ,9603,1860,1606,13069
4/24/2017,2017,4,24, 16 ,9405,1827,1577,12809
4/24/2017,2017,4,24, 17 ,8797,1720,1473,11990
4/24/2017,2017,4,24, 18 ,8381,1726,1515,11622
4/24/2017,2017,4,24, 19 ,8783,1842,1525,12150
4/24/2017,2017,4,24, 20 ,8731,1771,1409,11911
4/24/2017,2017,4,24, 21 ,8662,1710,1468,11840
4/24/2017,2017,4,24, 22 ,8508,1600,1331,11439
4/24/2017,2017,4,24, 23 ,8140,1504,1248,10892
4/24/2017,2017,4,24, 24 ,7709,1416,1185,10310
4/25/2017,2017,4,25, 1 ,7395,1360,1125,9880
4/25/2017,2017,4,25, 2 ,7130,1314,1095,9539
4/25/2017,2017,4,25, 3 ,6959,1258,1068,9285
4/25/2017,2017,4,25, 4 ,6730,1249,1042,9021
4/25/2017,2017,4,25, 5 ,6688,1246,1065,8999
4/25/2017,2017,4,25, 6 ,6541,1242,1067,8850
4/25/2017,2017,4,25, 7 ,6832,1265,1086,9183
4/25/2017,2017,4,25, 8 ,7752,1447,1250,10449
4/25/2017,2017,4,25, 9 ,8591,1650,1447,11688
4/25/2017,2017,4,25, 10 ,9099,1776,1554,12429
4/25/2017,2017,4,25, 11 ,9484,1840,1609,12933
4/25/2017,2017,4,25, 12 ,9285,1807,1623,12715
4/25/2017,2017,4,25, 13 ,9376,1820,1612,12808
4/25/2017,2017,4,25, 14 ,9692,1896,1649,13237
4/25/2017,2017,4,25, 15 ,9625,1880,1649,13154
4/25/2017,2017,4,25, 16 ,9413,1836,1596,12845
4/25/2017,2017,4,25, 17 ,8898,1746,1494,12138
4/25/2017,2017,4,25, 18 ,8570,1746,1526,11842
4/25/2017,2017,4,25, 19 ,8915,1848,1587,12350
4/25/2017,2017,4,25, 20 ,8803,1781,1561,12145
4/25/2017,2017,4,25, 21 ,8642,1703,1470,11815
4/25/2017,2017,4,25, 22 ,8430,1606,1392,11428
4/25/2017,2017,4,25, 23 ,8088,1500,1274,10862
4/25/2017,2017,4,25, 24 ,7704,1401,1208,10313
4/26/2017,2017,4,26, 1 ,7390,1353,1151,9894
4/26/2017,2017,4,26, 2 ,7059,1315,1119,9493
4/26/2017,2017,4,26, 3 ,6818,1256,1080,9154
4/26/2017,2017,4,26, 4 ,6590,1244,1066,8900
4/26/2017,2017,4,26, 5 ,6546,1251,1097,8894
4/26/2017,2017,4,26, 6 ,6450,1244,1089,8783
4/26/2017,2017,4,26, 7 ,6772,1277,1086,9135
4/26/2017,2017,4,26, 8 ,7623,1462,1253,10338
4/26/2017,2017,4,26, 9 ,8452,1675,1468,11595
4/26/2017,2017,4,26, 10 ,9073,1781,1504,12358
4/26/2017,2017,4,26, 11 ,9386,1870,1639,12895
4/26/2017,2017,4,26, 12 ,9268,1808,1629,12705
4/26/2017,2017,4,26, 13 ,9286,1807,1628,12721
4/26/2017,2017,4,26, 14 ,9665,1885,1674,13224
4/26/2017,2017,4,26, 15 ,9664,1890,1671,13225
4/26/2017,2017,4,26, 16 ,9462,1849,1629,12940
4/26/2017,2017,4,26, 17 ,8927,1753,1526,12206
4/26/2017,2017,4,26, 18 ,8556,1768,1571,11895
4/26/2017,2017,4,26, 19 ,8975,1866,1613,12454
4/26/2017,2017,4,26, 20 ,8936,1794,1572,12302
4/26/2017,2017,4,26, 21 ,8837,1747,1522,12106
4/26/2017,2017,4,26, 22 ,8709,1626,1403,11738
4/26/2017,2017,4,26, 23 ,8308,1531,1310,11149
4/26/2017,2017,4,26, 24 ,7942,1413,1212,10567
4/27/2017,2017,4,27, 1 ,7637,1368,1178,10183
4/27/2017,2017,4,27, 2 ,7345,1324,1140,9809
4/27/2017,2017,4,27, 3 ,7127,1291,1105,9523
4/27/2017,2017,4,27, 4 ,6984,1259,1077,9320
4/27/2017,2017,4,27, 5 ,6835,1260,1102,9197
4/27/2017,2017,4,27, 6 ,6697,1242,1087,9026
4/27/2017,2017,4,27, 7 ,6988,1266,1099,9353
4/27/2017,2017,4,27, 8 ,7840,1441,1248,10529
4/27/2017,2017,4,27, 9 ,8779,1668,1432,11879
4/27/2017,2017,4,27, 10 ,9202,1791,1555,12548
4/27/2017,2017,4,27, 11 ,9553,1877,1618,13048
4/27/2017,2017,4,27, 12 ,9440,1819,1585,12844
4/27/2017,2017,4,27, 13 ,9461,1833,1595,12889
4/27/2017,2017,4,27, 14 ,9860,1874,1634,13368
4/27/2017,2017,4,27, 15 ,9776,1847,1635,13258
4/27/2017,2017,4,27, 16 ,9539,1817,1569,12925
4/27/2017,2017,4,27, 17 ,8991,1730,1532,12253
4/27/2017,2017,4,27, 18 ,8681,1757,1585,12023
4/27/2017,2017,4,27, 19 ,9009,1836,1603,12448
4/27/2017,2017,4,27, 20 ,8923,1765,1552,12240
4/27/2017,2017,4,27, 21 ,8696,1696,1500,11892
4/27/2017,2017,4,27, 22 ,8505,1575,1388,11468
4/27/2017,2017,4,27, 23 ,8169,1487,1279,10935
4/27/2017,2017,4,27, 24 ,7755,1398,1230,10383
4/28/2017,2017,4,28, 1 ,7520,1337,1165,10022
4/28/2017,2017,4,28, 2 ,7253,1295,1115,9663
4/28/2017,2017,4,28, 3 ,6988,1260,1090,9338
4/28/2017,2017,4,28, 4 ,6756,1228,1077,9061
4/28/2017,2017,4,28, 5 ,6703,1227,1085,9015
4/28/2017,2017,4,28, 6 ,6468,1220,1092,8780
4/28/2017,2017,4,28, 7 ,6574,1257,1086,8917
4/28/2017,2017,4,28, 8 ,7259,1446,1236,9941
4/28/2017,2017,4,28, 9 ,7891,1680,1464,11035
4/28/2017,2017,4,28, 10 ,8378,1784,1544,11706
4/28/2017,2017,4,28, 11 ,8720,1843,1631,12194
4/28/2017,2017,4,28, 12 ,8614,1819,1575,12008
4/28/2017,2017,4,28, 13 ,8754,1822,1603,12179
4/28/2017,2017,4,28, 14 ,9016,1893,1659,12568
4/28/2017,2017,4,28, 15 ,8938,1867,1635,12440
4/28/2017,2017,4,28, 16 ,8743,1847,1541,12131
4/28/2017,2017,4,28, 17 ,8250,1745,1515,11510
4/28/2017,2017,4,28, 18 ,8186,1743,1592,11521
4/28/2017,2017,4,28, 19 ,8678,1850,1580,12108
4/28/2017,2017,4,28, 20 ,8691,1819,1554,12064
4/28/2017,2017,4,28, 21 ,8678,1744,1492,11914
4/28/2017,2017,4,28, 22 ,8548,1626,1379,11553
4/28/2017,2017,4,28, 23 ,8169,1527,1298,10994
4/28/2017,2017,4,28, 24 ,7748,1449,1196,10393
4/29/2017,2017,4,29, 1 ,7392,1366,1151,9909
4/29/2017,2017,4,29, 2 ,7163,1325,1114,9602
4/29/2017,2017,4,29, 3 ,6929,1284,1075,9288
4/29/2017,2017,4,29, 4 ,6751,1265,1070,9086
4/29/2017,2017,4,29, 5 ,6562,1252,1063,8877
4/29/2017,2017,4,29, 6 ,6350,1225,1077,8652
4/29/2017,2017,4,29, 7 ,6397,1248,1058,8703
4/29/2017,2017,4,29, 8 ,6956,1365,1133,9454
4/29/2017,2017,4,29, 9 ,7640,1557,1299,10496
4/29/2017,2017,4,29, 10 ,8137,1669,1364,11170
4/29/2017,2017,4,29, 11 ,8516,1726,1470,11712
4/29/2017,2017,4,29, 12 ,8320,1695,1434,11449
4/29/2017,2017,4,29, 13 ,8397,1694,1448,11539
4/29/2017,2017,4,29, 14 ,8692,1744,1495,11931
4/29/2017,2017,4,29, 15 ,8492,1727,1483,11702
4/29/2017,2017,4,29, 16 ,8254,1676,1451,11381
4/29/2017,2017,4,29, 17 ,7840,1607,1384,10831
4/29/2017,2017,4,29, 18 ,7778,1676,1487,10941
4/29/2017,2017,4,29, 19 ,8328,1796,1522,11646
4/29/2017,2017,4,29, 20 ,8367,1747,1491,11605
4/29/2017,2017,4,29, 21 ,8351,1711,1474,11536
4/29/2017,2017,4,29, 22 ,8285,1615,1383,11283
4/29/2017,2017,4,29, 23 ,7884,1504,1248,10636
4/29/2017,2017,4,29, 24 ,7569,1410,1182,10161
4/30/2017,2017,4,30, 1 ,7253,1361,1118,9732
4/30/2017,2017,4,30, 2 ,6996,1320,1070,9386
4/30/2017,2017,4,30, 3 ,6752,1271,1054,9077
4/30/2017,2017,4,30, 4 ,6521,1256,1043,8820
4/30/2017,2017,4,30, 5 ,6413,1243,1014,8670
4/30/2017,2017,4,30, 6 ,6072,1201,1016,8289
4/30/2017,2017,4,30, 7 ,6005,1190,997,8192
4/30/2017,2017,4,30, 8 ,6263,1256,1054,8573
4/30/2017,2017,4,30, 9 ,6663,1367,1149,9179
4/30/2017,2017,4,30, 10 ,6993,1457,1228,9678
4/30/2017,2017,4,30, 11 ,7279,1529,1297,10105
4/30/2017,2017,4,30, 12 ,7240,1532,1310,10082
4/30/2017,2017,4,30, 13 ,7279,1538,1299,10116
4/30/2017,2017,4,30, 14 ,7373,1545,1307,10225
4/30/2017,2017,4,30, 15 ,7281,1534,1271,10086
4/30/2017,2017,4,30, 16 ,7056,1504,1242,9802
4/30/2017,2017,4,30, 17 ,6955,1468,1235,9658
4/30/2017,2017,4,30, 18 ,7088,1566,1348,10002
4/30/2017,2017,4,30, 19 ,7651,1698,1414,10763
4/30/2017,2017,4,30, 20 ,7720,1683,1374,10777
4/30/2017,2017,4,30, 21 ,7774,1633,1340,10747
4/30/2017,2017,4,30, 22 ,7621,1547,1238,10406
4/30/2017,2017,4,30, 23 ,7368,1456,1161,9985
4/30/2017,2017,4,30, 24 ,6981,1388,1102,9471
5/1/2017,2017,5,1, 1 ,6799,1329,1032,9160
5/1/2017,2017,5,1, 2 ,6490,1276,989,8755
5/1/2017,2017,5,1, 3 ,6276,1247,964,8487
5/1/2017,2017,5,1, 4 ,6077,1218,953,8248
5/1/2017,2017,5,1, 5 ,5908,1217,960,8085
5/1/2017,2017,5,1, 6 ,5679,1184,954,7817
5/1/2017,2017,5,1, 7 ,5694,1198,952,7844
5/1/2017,2017,5,1, 8 ,6056,1288,1014,8358
5/1/2017,2017,5,1, 9 ,6594,1419,1166,9179
5/1/2017,2017,5,1, 10 ,7156,1507,1294,9957
5/1/2017,2017,5,1, 11 ,7487,1580,1369,10436
5/1/2017,2017,5,1, 12 ,7482,1583,1362,10427
5/1/2017,2017,5,1, 13 ,7524,1590,1375,10489
5/1/2017,2017,5,1, 14 ,7788,1620,1411,10819
5/1/2017,2017,5,1, 15 ,7780,1615,1386,10781
5/1/2017,2017,5,1, 16 ,7529,1554,1346,10429
5/1/2017,2017,5,1, 17 ,7163,1501,1271,9935
5/1/2017,2017,5,1, 18 ,7296,1619,1415,10330
5/1/2017,2017,5,1, 19 ,7878,1734,1454,11066
5/1/2017,2017,5,1, 20 ,7975,1704,1421,11100
5/1/2017,2017,5,1, 21 ,7955,1654,1371,10980
5/1/2017,2017,5,1, 22 ,7820,1557,1271,10648
5/1/2017,2017,5,1, 23 ,7540,1457,1163,10160
5/1/2017,2017,5,1, 24 ,7170,1380,1101,9651
5/2/2017,2017,5,2, 1 ,6915,1323,1073,9311
5/2/2017,2017,5,2, 2 ,6599,1282,1059,8940
5/2/2017,2017,5,2, 3 ,6362,1248,1001,8611
5/2/2017,2017,5,2, 4 ,6270,1229,989,8488
5/2/2017,2017,5,2, 5 ,6234,1237,1016,8487
5/2/2017,2017,5,2, 6 ,6234,1228,1022,8484
5/2/2017,2017,5,2, 7 ,6581,1262,1017,8860
5/2/2017,2017,5,2, 8 ,7579,1471,1205,10255
5/2/2017,2017,5,2, 9 ,8503,1699,1397,11599
5/2/2017,2017,5,2, 10 ,9036,1816,1522,12374
5/2/2017,2017,5,2, 11 ,9490,1889,1618,12997
5/2/2017,2017,5,2, 12 ,9434,1853,1585,12872
5/2/2017,2017,5,2, 13 ,9416,1847,1603,12866
5/2/2017,2017,5,2, 14 ,9776,1916,1657,13349
5/2/2017,2017,5,2, 15 ,9574,1890,1625,13089
5/2/2017,2017,5,2, 16 ,9372,1863,1594,12829
5/2/2017,2017,5,2, 17 ,8889,1768,1517,12174
5/2/2017,2017,5,2, 18 ,8669,1769,1529,11967
5/2/2017,2017,5,2, 19 ,8890,1900,1574,12364
5/2/2017,2017,5,2, 20 ,8855,1821,1536,12212
5/2/2017,2017,5,2, 21 ,8723,1741,1492,11956
5/2/2017,2017,5,2, 22 ,8560,1631,1389,11580
5/2/2017,2017,5,2, 23 ,8248,1563,1283,11094
5/2/2017,2017,5,2, 24 ,7834,1481,1194,10509
5/3/2017,2017,5,3, 1 ,7539,1400,1144,10083
5/3/2017,2017,5,3, 2 ,7309,1367,1126,9802
5/3/2017,2017,5,3, 3 ,7057,1333,1071,9461
5/3/2017,2017,5,3, 4 ,6855,1305,1052,9212
5/3/2017,2017,5,3, 5 ,6807,1308,1078,9193
5/3/2017,2017,5,3, 6 ,6696,1291,1086,9073
5/3/2017,2017,5,3, 7 ,6992,1329,1084,9405
5/3/2017,2017,5,3, 8 ,7950,1506,1228,10684
5/3/2017,2017,5,3, 9 ,8789,1736,1417,11942
5/3/2017,2017,5,3, 10 ,9280,1843,1515,12638
5/3/2017,2017,5,3, 11 ,9564,1897,1568,13029
5/3/2017,2017,5,3, 12 ,9484,1849,1530,12863
5/3/2017,2017,5,3, 13 ,9503,1844,1499,12846
5/3/2017,2017,5,3, 14 ,9732,1888,1517,13137
5/3/2017,2017,5,3, 15 ,9479,1859,1491,12829
5/3/2017,2017,5,3, 16 ,9253,1840,1449,12542
5/3/2017,2017,5,3, 17 ,8866,1764,1443,12073
5/3/2017,2017,5,3, 18 ,8690,1782,1474,11946
5/3/2017,2017,5,3, 19 ,8857,1837,1489,12183
5/3/2017,2017,5,3, 20 ,8812,1725,1405,11942
5/3/2017,2017,5,3, 21 ,8678,1593,1262,11533
5/3/2017,2017,5,3, 22 ,8422,1504,1154,11080
5/3/2017,2017,5,3, 23 ,8051,1409,1118,10578
5/3/2017,2017,5,3, 24 ,7669,1343,1177,10189
5/4/2017,2017,5,4, 1 ,7364,1269,994,9627
5/4/2017,2017,5,4, 2 ,7058,1239,954,9251
5/4/2017,2017,5,4, 3 ,6864,1215,942,9021
5/4/2017,2017,5,4, 4 ,6710,1183,907,8800
5/4/2017,2017,5,4, 5 ,6648,1189,980,8817
5/4/2017,2017,5,4, 6 ,6548,1197,983,8728
5/4/2017,2017,5,4, 7 ,6825,1238,1019,9082
5/4/2017,2017,5,4, 8 ,7721,1398,1126,10245
5/4/2017,2017,5,4, 9 ,8741,1636,1146,11523
5/4/2017,2017,5,4, 10 ,9243,1721,1260,12224
5/4/2017,2017,5,4, 11 ,9587,1811,1337,12735
5/4/2017,2017,5,4, 12 ,9493,1789,1436,12718
5/4/2017,2017,5,4, 13 ,9548,1789,1314,12651
5/4/2017,2017,5,4, 14 ,9837,1870,1336,13043
5/4/2017,2017,5,4, 15 ,9790,1887,1397,13074
5/4/2017,2017,5,4, 16 ,9563,1847,1453,12863
5/4/2017,2017,5,4, 17 ,9021,1754,1393,12168
5/4/2017,2017,5,4, 18 ,8706,1757,1412,11875
5/4/2017,2017,5,4, 19 ,9038,1857,1537,12432
5/4/2017,2017,5,4, 20 ,8912,1802,1451,12165
5/4/2017,2017,5,4, 21 ,8796,1741,1342,11879
5/4/2017,2017,5,4, 22 ,8570,1640,1318,11528
5/4/2017,2017,5,4, 23 ,8247,1536,1209,10992
5/4/2017,2017,5,4, 24 ,7801,1440,997,10238
5/5/2017,2017,5,5, 1 ,7418,1382,1057,9857
5/5/2017,2017,5,5, 2 ,7128,1332,1036,9496
5/5/2017,2017,5,5, 3 ,6911,1290,1005,9206
5/5/2017,2017,5,5, 4 ,6767,1262,989,9018
5/5/2017,2017,5,5, 5 ,6730,1254,1005,8989
5/5/2017,2017,5,5, 6 ,6540,1242,1009,8791
5/5/2017,2017,5,5, 7 ,6878,1284,1021,9183
5/5/2017,2017,5,5, 8 ,7772,1476,1207,10455
5/5/2017,2017,5,5, 9 ,8698,1694,1380,11772
5/5/2017,2017,5,5, 10 ,9182,1821,1510,12513
5/5/2017,2017,5,5, 11 ,9500,1873,1596,12969
5/5/2017,2017,5,5, 12 ,9354,1836,1558,12748
5/5/2017,2017,5,5, 13 ,9368,1828,1525,12721
5/5/2017,2017,5,5, 14 ,9665,1912,1634,13211
5/5/2017,2017,5,5, 15 ,9493,1861,1559,12913
5/5/2017,2017,5,5, 16 ,9318,1821,1538,12677
5/5/2017,2017,5,5, 17 ,8828,1714,1458,12000
5/5/2017,2017,5,5, 18 ,8562,1737,1492,11791
5/5/2017,2017,5,5, 19 ,8863,1826,1527,12216
5/5/2017,2017,5,5, 20 ,8812,1793,1454,12059
5/5/2017,2017,5,5, 21 ,8688,1728,1385,11801
5/5/2017,2017,5,5, 22 ,8454,1608,1297,11359
5/5/2017,2017,5,5, 23 ,8158,1509,1221,10888
5/5/2017,2017,5,5, 24 ,7750,1403,1132,10285
5/6/2017,2017,5,6, 1 ,7413,1365,1086,9864
5/6/2017,2017,5,6, 2 ,7164,1332,1042,9538
5/6/2017,2017,5,6, 3 ,6957,1284,1020,9261
5/6/2017,2017,5,6, 4 ,6745,1248,1000,8993
5/6/2017,2017,5,6, 5 ,6615,1245,1012,8872
5/6/2017,2017,5,6, 6 ,6392,1206,1005,8603
5/6/2017,2017,5,6, 7 ,6528,1230,1002,8760
5/6/2017,2017,5,6, 8 ,7133,1359,1106,9598
5/6/2017,2017,5,6, 9 ,7861,1525,1243,10629
5/6/2017,2017,5,6, 10 ,8551,1636,1335,11522
5/6/2017,2017,5,6, 11 ,8841,1687,1407,11935
5/6/2017,2017,5,6, 12 ,8697,1648,1405,11750
5/6/2017,2017,5,6, 13 ,8759,1655,1416,11830
5/6/2017,2017,5,6, 14 ,8955,1705,1445,12105
5/6/2017,2017,5,6, 15 ,8806,1685,1410,11901
5/6/2017,2017,5,6, 16 ,8439,1625,1361,11425
5/6/2017,2017,5,6, 17 ,7948,1570,1362,10880
5/6/2017,2017,5,6, 18 ,7968,1649,1442,11059
5/6/2017,2017,5,6, 19 ,8383,1768,1469,11620
5/6/2017,2017,5,6, 20 ,8403,1725,1432,11560
5/6/2017,2017,5,6, 21 ,8387,1665,1368,11420
5/6/2017,2017,5,6, 22 ,8202,1585,1275,11062
5/6/2017,2017,5,6, 23 ,7902,1491,1159,10552
5/6/2017,2017,5,6, 24 ,7519,1406,1081,10006
5/7/2017,2017,5,7, 1 ,7261,1355,988,9604
5/7/2017,2017,5,7, 2 ,7022,1305,973,9300
5/7/2017,2017,5,7, 3 ,6771,1269,970,9010
5/7/2017,2017,5,7, 4 ,6565,1234,967,8766
5/7/2017,2017,5,7, 5 ,6392,1228,957,8577
5/7/2017,2017,5,7, 6 ,6075,1171,937,8183
5/7/2017,2017,5,7, 7 ,6103,1185,925,8213
5/7/2017,2017,5,7, 8 ,6432,1245,997,8674
5/7/2017,2017,5,7, 9 ,6985,1333,1098,9416
5/7/2017,2017,5,7, 10 ,7367,1369,1195,9931
5/7/2017,2017,5,7, 11 ,7747,1430,1246,10423
5/7/2017,2017,5,7, 12 ,7698,1415,1255,10368
5/7/2017,2017,5,7, 13 ,7698,1433,1252,10383
5/7/2017,2017,5,7, 14 ,7834,1437,1274,10545
5/7/2017,2017,5,7, 15 ,7791,1411,1253,10455
5/7/2017,2017,5,7, 16 ,7595,1385,1224,10204
5/7/2017,2017,5,7, 17 ,7277,1385,1234,9896
5/7/2017,2017,5,7, 18 ,7248,1505,1352,10105
5/7/2017,2017,5,7, 19 ,7910,1657,1384,10951
5/7/2017,2017,5,7, 20 ,8000,1623,1378,11001
5/7/2017,2017,5,7, 21 ,8055,1567,1309,10931
5/7/2017,2017,5,7, 22 ,7915,1470,1218,10603
5/7/2017,2017,5,7, 23 ,7668,1375,1136,10179
5/7/2017,2017,5,7, 24 ,7373,1316,1032,9721
5/8/2017,2017,5,8, 1 ,7029,1252,1004,9285
5/8/2017,2017,5,8, 2 ,6740,1215,972,8927
5/8/2017,2017,5,8, 3 ,6538,1164,951,8653
5/8/2017,2017,5,8, 4 ,6326,1140,929,8395
5/8/2017,2017,5,8, 5 ,6310,1167,964,8441
5/8/2017,2017,5,8, 6 ,6242,1165,969,8376
5/8/2017,2017,5,8, 7 ,6720,1204,981,8905
5/8/2017,2017,5,8, 8 ,7676,1381,1163,10220
5/8/2017,2017,5,8, 9 ,8545,1616,1330,11491
5/8/2017,2017,5,8, 10 ,9156,1730,1451,12337
5/8/2017,2017,5,8, 11 ,9475,1775,1542,12792
5/8/2017,2017,5,8, 12 ,9371,1753,1539,12663
5/8/2017,2017,5,8, 13 ,9413,1760,1497,12670
5/8/2017,2017,5,8, 14 ,9792,1805,1519,13116
5/8/2017,2017,5,8, 15 ,9801,1812,1525,13138
5/8/2017,2017,5,8, 16 ,9635,1802,1494,12931
5/8/2017,2017,5,8, 17 ,9099,1700,1426,12225
5/8/2017,2017,5,8, 18 ,8657,1744,1470,11871
5/8/2017,2017,5,8, 19 ,8979,1803,1466,12248
5/8/2017,2017,5,8, 20 ,8928,1764,1395,12087
5/8/2017,2017,5,8, 21 ,8763,1680,1332,11775
5/8/2017,2017,5,8, 22 ,8634,1584,1197,11415
5/8/2017,2017,5,8, 23 ,8223,1499,1103,10825
5/8/2017,2017,5,8, 24 ,7837,1408,1039,10284
5/9/2017,2017,5,9, 1 ,7556,1351,1002,9909
5/9/2017,2017,5,9, 2 ,7273,1311,979,9563
5/9/2017,2017,5,9, 3 ,7055,1276,959,9290
5/9/2017,2017,5,9, 4 ,6810,1243,942,8995
5/9/2017,2017,5,9, 5 ,6742,1251,955,8948
5/9/2017,2017,5,9, 6 ,6561,1228,991,8780
5/9/2017,2017,5,9, 7 ,6889,1260,1002,9151
5/9/2017,2017,5,9, 8 ,7782,1444,1135,10361
5/9/2017,2017,5,9, 9 ,8729,1648,1345,11722
5/9/2017,2017,5,9, 10 ,9277,1770,1482,12529
5/9/2017,2017,5,9, 11 ,9684,1841,1553,13078
5/9/2017,2017,5,9, 12 ,9518,1812,1530,12860
5/9/2017,2017,5,9, 13 ,9631,1773,1555,12959
5/9/2017,2017,5,9, 14 ,10024,1884,1564,13472
5/9/2017,2017,5,9, 15 ,9966,1862,1560,13388
5/9/2017,2017,5,9, 16 ,9661,1802,1531,12994
5/9/2017,2017,5,9, 17 ,9148,1705,1372,12225
5/9/2017,2017,5,9, 18 ,8679,1744,1413,11836
5/9/2017,2017,5,9, 19 ,9104,1836,1498,12438
5/9/2017,2017,5,9, 20 ,9006,1789,1488,12283
5/9/2017,2017,5,9, 21 ,8976,1715,1388,12079
5/9/2017,2017,5,9, 22 ,8880,1590,1281,11751
5/9/2017,2017,5,9, 23 ,8439,1465,1160,11064
5/9/2017,2017,5,9, 24 ,8034,1353,1067,10454
5/10/2017,2017,5,10, 1 ,7738,1316,1047,10101
5/10/2017,2017,5,10, 2 ,7459,1272,1031,9762
5/10/2017,2017,5,10, 3 ,7213,1240,993,9446
5/10/2017,2017,5,10, 4 ,7001,1222,986,9209
5/10/2017,2017,5,10, 5 ,6940,1229,993,9162
5/10/2017,2017,5,10, 6 ,6756,1221,1017,8994
5/10/2017,2017,5,10, 7 ,7120,1242,1023,9385
5/10/2017,2017,5,10, 8 ,8047,1401,1133,10581
5/10/2017,2017,5,10, 9 ,8846,1598,1358,11802
5/10/2017,2017,5,10, 10 ,9375,1737,1484,12596
5/10/2017,2017,5,10, 11 ,9673,1803,1538,13014
5/10/2017,2017,5,10, 12 ,9616,1770,1511,12897
5/10/2017,2017,5,10, 13 ,9655,1738,1502,12895
5/10/2017,2017,5,10, 14 ,9968,1818,1531,13317
5/10/2017,2017,5,10, 15 ,9890,1823,1525,13238
5/10/2017,2017,5,10, 16 ,9620,1808,1514,12942
5/10/2017,2017,5,10, 17 ,9079,1712,1437,12228
5/10/2017,2017,5,10, 18 ,8736,1725,1504,11965
5/10/2017,2017,5,10, 19 ,9041,1844,1511,12396
5/10/2017,2017,5,10, 20 ,8968,1793,1469,12230
5/10/2017,2017,5,10, 21 ,8948,1735,1428,12111
5/10/2017,2017,5,10, 22 ,8744,1619,1300,11663
5/10/2017,2017,5,10, 23 ,8411,1504,1188,11103
5/10/2017,2017,5,10, 24 ,7981,1417,1193,10591
5/11/2017,2017,5,11, 1 ,7708,1351,1076,10135
5/11/2017,2017,5,11, 2 ,7445,1304,1020,9769
5/11/2017,2017,5,11, 3 ,7220,1267,995,9482
5/11/2017,2017,5,11, 4 ,6949,1200,988,9137
5/11/2017,2017,5,11, 5 ,6979,1244,1008,9231
5/11/2017,2017,5,11, 6 ,6804,1227,1023,9054
5/11/2017,2017,5,11, 7 ,7045,1244,1046,9335
5/11/2017,2017,5,11, 8 ,7927,1407,1231,10565
5/11/2017,2017,5,11, 9 ,8695,1615,1415,11725
5/11/2017,2017,5,11, 10 ,9252,1718,1515,12485
5/11/2017,2017,5,11, 11 ,9536,1793,1566,12895
5/11/2017,2017,5,11, 12 ,9428,1742,1460,12630
5/11/2017,2017,5,11, 13 ,9406,1752,1490,12648
5/11/2017,2017,5,11, 14 ,9739,1817,1549,13105
5/11/2017,2017,5,11, 15 ,9728,1829,1494,13051
5/11/2017,2017,5,11, 16 ,9515,1803,1469,12787
5/11/2017,2017,5,11, 17 ,8951,1706,1419,12076
5/11/2017,2017,5,11, 18 ,8570,1737,1386,11693
5/11/2017,2017,5,11, 19 ,8959,1808,1428,12195
5/11/2017,2017,5,11, 20 ,8917,1756,1421,12094
5/11/2017,2017,5,11, 21 ,8865,1681,1378,11924
5/11/2017,2017,5,11, 22 ,8727,1575,1269,11571
5/11/2017,2017,5,11, 23 ,8368,1476,1181,11025
5/11/2017,2017,5,11, 24 ,7938,1404,1089,10431
5/12/2017,2017,5,12, 1 ,7612,1342,1056,10010
5/12/2017,2017,5,12, 2 ,7425,1297,1020,9742
5/12/2017,2017,5,12, 3 ,7142,1261,984,9387
5/12/2017,2017,5,12, 4 ,7009,1231,977,9217
5/12/2017,2017,5,12, 5 ,6940,1233,1000,9173
5/12/2017,2017,5,12, 6 ,6743,1236,1024,9003
5/12/2017,2017,5,12, 7 ,7075,1260,1040,9375
5/12/2017,2017,5,12, 8 ,7960,1429,1181,10570
5/12/2017,2017,5,12, 9 ,8891,1657,1377,11925
5/12/2017,2017,5,12, 10 ,9339,1751,1510,12600
5/12/2017,2017,5,12, 11 ,9629,1774,1579,12982
5/12/2017,2017,5,12, 12 ,9482,1707,1486,12675
5/12/2017,2017,5,12, 13 ,9533,1715,1444,12692
5/12/2017,2017,5,12, 14 ,9872,1778,1589,13239
5/12/2017,2017,5,12, 15 ,9803,1776,1568,13147
5/12/2017,2017,5,12, 16 ,9612,1641,1518,12771
5/12/2017,2017,5,12, 17 ,9079,1631,1419,12129
5/12/2017,2017,5,12, 18 ,8664,1658,1473,11795
5/12/2017,2017,5,12, 19 ,9001,1764,1493,12258
5/12/2017,2017,5,12, 20 ,8977,1719,1457,12153
5/12/2017,2017,5,12, 21 ,8944,1689,1422,12055
5/12/2017,2017,5,12, 22 ,8773,1559,1304,11636
5/12/2017,2017,5,12, 23 ,8368,1475,1204,11047
5/12/2017,2017,5,12, 24 ,8129,1385,1142,10656
5/13/2017,2017,5,13, 1 ,7787,1327,1091,10205
5/13/2017,2017,5,13, 2 ,7498,1291,1077,9866
5/13/2017,2017,5,13, 3 ,7258,1250,1040,9548
5/13/2017,2017,5,13, 4 ,7026,1230,1012,9268
5/13/2017,2017,5,13, 5 ,6943,1225,1018,9186
5/13/2017,2017,5,13, 6 ,6600,1193,1038,8831
5/13/2017,2017,5,13, 7 ,6745,1200,1031,8976
5/13/2017,2017,5,13, 8 ,7381,1321,1140,9842
5/13/2017,2017,5,13, 9 ,7980,1482,1273,10735
5/13/2017,2017,5,13, 10 ,8548,1584,1356,11488
5/13/2017,2017,5,13, 11 ,8845,1619,1391,11855
5/13/2017,2017,5,13, 12 ,8743,1567,1346,11656
5/13/2017,2017,5,13, 13 ,8815,1570,1355,11740
5/13/2017,2017,5,13, 14 ,9133,1612,1387,12132
5/13/2017,2017,5,13, 15 ,9130,1592,1386,12108
5/13/2017,2017,5,13, 16 ,8733,1535,1355,11623
5/13/2017,2017,5,13, 17 ,8275,1506,1341,11122
5/13/2017,2017,5,13, 18 ,8102,1601,1454,11157
5/13/2017,2017,5,13, 19 ,8649,1688,1430,11767
5/13/2017,2017,5,13, 20 ,8693,1661,1381,11735
5/13/2017,2017,5,13, 21 ,8733,1609,1319,11661
5/13/2017,2017,5,13, 22 ,8576,1511,1231,11318
5/13/2017,2017,5,13, 23 ,8314,1419,1139,10872
5/13/2017,2017,5,13, 24 ,7989,1330,1066,10385
5/14/2017,2017,5,14, 1 ,7595,1284,1031,9910
5/14/2017,2017,5,14, 2 ,7322,1250,989,9561
5/14/2017,2017,5,14, 3 ,7116,1208,972,9296
5/14/2017,2017,5,14, 4 ,6894,1186,976,9056
5/14/2017,2017,5,14, 5 ,6651,1189,983,8823
5/14/2017,2017,5,14, 6 ,6302,1135,976,8413
5/14/2017,2017,5,14, 7 ,6345,1139,976,8460
5/14/2017,2017,5,14, 8 ,6575,1209,991,8775
5/14/2017,2017,5,14, 9 ,7004,1316,989,9309
5/14/2017,2017,5,14, 10 ,7449,1400,1199,10048
5/14/2017,2017,5,14, 11 ,7729,1451,1280,10460
5/14/2017,2017,5,14, 12 ,7736,1453,1277,10466
5/14/2017,2017,5,14, 13 ,7794,1465,1284,10543
5/14/2017,2017,5,14, 14 ,7814,1474,1294,10582
5/14/2017,2017,5,14, 15 ,7682,1452,1251,10385
5/14/2017,2017,5,14, 16 ,7491,1426,1241,10158
5/14/2017,2017,5,14, 17 ,7253,1397,1249,9899
5/14/2017,2017,5,14, 18 ,7292,1513,1345,10150
5/14/2017,2017,5,14, 19 ,7977,1667,1401,11045
5/14/2017,2017,5,14, 20 ,8152,1648,1395,11195
5/14/2017,2017,5,14, 21 ,8221,1597,1354,11172
5/14/2017,2017,5,14, 22 ,8008,1529,973,10510
5/14/2017,2017,5,14, 23 ,7830,1451,948,10229
5/14/2017,2017,5,14, 24 ,7503,1352,943,9798
5/15/2017,2017,5,15, 1 ,7221,1292,920,9433
5/15/2017,2017,5,15, 2 ,6917,1231,894,9042
5/15/2017,2017,5,15, 3 ,6678,1202,911,8791
5/15/2017,2017,5,15, 4 ,6533,1177,930,8640
5/15/2017,2017,5,15, 5 ,6448,1190,995,8633
5/15/2017,2017,5,15, 6 ,6404,1189,1020,8613
5/15/2017,2017,5,15, 7 ,6823,1221,1033,9077
5/15/2017,2017,5,15, 8 ,7833,1390,1189,10412
5/15/2017,2017,5,15, 9 ,8724,1608,1372,11704
5/15/2017,2017,5,15, 10 ,9272,1720,1504,12496
5/15/2017,2017,5,15, 11 ,9590,1779,1589,12958
5/15/2017,2017,5,15, 12 ,9521,1762,1563,12846
5/15/2017,2017,5,15, 13 ,9621,1761,1569,12951
5/15/2017,2017,5,15, 14 ,9909,1815,1624,13348
5/15/2017,2017,5,15, 15 ,9917,1798,1609,13324
5/15/2017,2017,5,15, 16 ,9711,1758,1540,13009
5/15/2017,2017,5,15, 17 ,9249,1686,1489,12424
5/15/2017,2017,5,15, 18 ,8731,1716,1534,11981
5/15/2017,2017,5,15, 19 ,9047,1786,1506,12339
5/15/2017,2017,5,15, 20 ,9083,1735,1497,12315
5/15/2017,2017,5,15, 21 ,9055,1667,1403,12125
5/15/2017,2017,5,15, 22 ,8875,1557,1308,11740
5/15/2017,2017,5,15, 23 ,8568,1446,1207,11221
5/15/2017,2017,5,15, 24 ,8144,1365,1140,10649
5/16/2017,2017,5,16, 1 ,7751,1332,1093,10176
5/16/2017,2017,5,16, 2 ,7500,1287,1053,9840
5/16/2017,2017,5,16, 3 ,7327,1264,1016,9607
5/16/2017,2017,5,16, 4 ,7012,1240,1006,9258
5/16/2017,2017,5,16, 5 ,6940,1242,1028,9210
5/16/2017,2017,5,16, 6 ,6721,1228,1069,9018
5/16/2017,2017,5,16, 7 ,7108,1247,1068,9423
5/16/2017,2017,5,16, 8 ,8056,1451,1194,10701
5/16/2017,2017,5,16, 9 ,8902,1641,1403,11946
5/16/2017,2017,5,16, 10 ,9564,1787,1512,12863
5/16/2017,2017,5,16, 11 ,9826,1833,1584,13243
5/16/2017,2017,5,16, 12 ,9637,1783,1576,12996
5/16/2017,2017,5,16, 13 ,9691,1786,1541,13018
5/16/2017,2017,5,16, 14 ,10017,1868,1627,13512
5/16/2017,2017,5,16, 15 ,9848,1841,1624,13313
5/16/2017,2017,5,16, 16 ,9611,1754,1583,12948
5/16/2017,2017,5,16, 17 ,9143,1685,1531,12359
5/16/2017,2017,5,16, 18 ,8832,1751,1541,12124
5/16/2017,2017,5,16, 19 ,9100,1776,1558,12434
5/16/2017,2017,5,16, 20 ,9095,1741,1495,12331
5/16/2017,2017,5,16, 21 ,9082,1691,1434,12207
5/16/2017,2017,5,16, 22 ,8857,1584,1317,11758
5/16/2017,2017,5,16, 23 ,8592,1480,1207,11279
5/16/2017,2017,5,16, 24 ,8129,1404,1120,10653
5/17/2017,2017,5,17, 1 ,7889,1347,1097,10333
5/17/2017,2017,5,17, 2 ,7668,1308,1066,10042
5/17/2017,2017,5,17, 3 ,7400,1260,1034,9694
5/17/2017,2017,5,17, 4 ,7184,1228,1030,9442
5/17/2017,2017,5,17, 5 ,7055,1241,1046,9342
5/17/2017,2017,5,17, 6 ,6869,1198,1069,9136
5/17/2017,2017,5,17, 7 ,7227,1262,1058,9547
5/17/2017,2017,5,17, 8 ,8169,1456,1235,10860
5/17/2017,2017,5,17, 9 ,9039,1672,1422,12133
5/17/2017,2017,5,17, 10 ,9502,1786,1534,12822
5/17/2017,2017,5,17, 11 ,9775,1878,1632,13285
5/17/2017,2017,5,17, 12 ,9613,1829,1536,12978
5/17/2017,2017,5,17, 13 ,9488,1812,1583,12883
5/17/2017,2017,5,17, 14 ,9832,1856,1629,13317
5/17/2017,2017,5,17, 15 ,9643,1878,1627,13148
5/17/2017,2017,5,17, 16 ,9290,1817,1586,12693
5/17/2017,2017,5,17, 17 ,8917,1730,1509,12156
5/17/2017,2017,5,17, 18 ,8773,1771,1553,12097
5/17/2017,2017,5,17, 19 ,8961,1850,1601,12412
5/17/2017,2017,5,17, 20 ,8923,1790,1566,12279
5/17/2017,2017,5,17, 21 ,8838,1745,1512,12095
5/17/2017,2017,5,17, 22 ,8552,1620,1392,11564
5/17/2017,2017,5,17, 23 ,8214,1524,1170,10908
5/17/2017,2017,5,17, 24 ,7776,1414,1103,10293
5/18/2017,2017,5,18, 1 ,7502,1359,1157,10018
5/18/2017,2017,5,18, 2 ,7196,1320,1124,9640
5/18/2017,2017,5,18, 3 ,6954,1280,1098,9332
5/18/2017,2017,5,18, 4 ,6768,1260,1085,9113
5/18/2017,2017,5,18, 5 ,6753,1259,1086,9098
5/18/2017,2017,5,18, 6 ,6575,1242,1099,8916
5/18/2017,2017,5,18, 7 ,6932,1265,1105,9302
5/18/2017,2017,5,18, 8 ,7921,1468,1272,10661
5/18/2017,2017,5,18, 9 ,8821,1690,1477,11988
5/18/2017,2017,5,18, 10 ,9398,1824,1589,12811
5/18/2017,2017,5,18, 11 ,9764,1875,1672,13311
5/18/2017,2017,5,18, 12 ,9554,1850,1591,12995
5/18/2017,2017,5,18, 13 ,9592,1866,1644,13102
5/18/2017,2017,5,18, 14 ,9861,1897,1618,13376
5/18/2017,2017,5,18, 15 ,9649,1912,1600,13161
5/18/2017,2017,5,18, 16 ,9400,1879,1612,12891
5/18/2017,2017,5,18, 17 ,8967,1762,1496,12225
5/18/2017,2017,5,18, 18 ,8771,1784,1578,12133
5/18/2017,2017,5,18, 19 ,8993,1872,1633,12498
5/18/2017,2017,5,18, 20 ,8929,1816,1564,12309
5/18/2017,2017,5,18, 21 ,8816,1751,1511,12078
5/18/2017,2017,5,18, 22 ,8542,1647,1381,11570
5/18/2017,2017,5,18, 23 ,8230,1540,1276,11046
5/18/2017,2017,5,18, 24 ,7809,1455,1207,10471
5/19/2017,2017,5,19, 1 ,7546,1389,1165,10100
5/19/2017,2017,5,19, 2 ,7327,1348,1128,9803
5/19/2017,2017,5,19, 3 ,7080,1318,1091,9489
5/19/2017,2017,5,19, 4 ,6916,1285,1079,9280
5/19/2017,2017,5,19, 5 ,6845,1293,1086,9224
5/19/2017,2017,5,19, 6 ,6646,1270,1077,8993
5/19/2017,2017,5,19, 7 ,6924,1300,1095,9319
5/19/2017,2017,5,19, 8 ,7899,1491,1242,10632
5/19/2017,2017,5,19, 9 ,8858,1718,1454,12030
5/19/2017,2017,5,19, 10 ,9436,1840,1580,12856
5/19/2017,2017,5,19, 11 ,9755,1891,1636,13282
5/19/2017,2017,5,19, 12 ,9626,1878,1621,13125
5/19/2017,2017,5,19, 13 ,9715,1869,1617,13201
5/19/2017,2017,5,19, 14 ,10033,1933,1664,13630
5/19/2017,2017,5,19, 15 ,9856,1911,1664,13431
5/19/2017,2017,5,19, 16 ,9448,1879,1596,12923
5/19/2017,2017,5,19, 17 ,8908,1773,1488,12169
5/19/2017,2017,5,19, 18 ,8692,1778,1523,11993
5/19/2017,2017,5,19, 19 ,8910,1881,1517,12308
5/19/2017,2017,5,19, 20 ,8935,1848,1547,12330
5/19/2017,2017,5,19, 21 ,8813,1798,1494,12105
5/19/2017,2017,5,19, 22 ,8594,1685,1393,11672
5/19/2017,2017,5,19, 23 ,8242,1577,1291,11110
5/19/2017,2017,5,19, 24 ,7795,1473,1184,10452
5/20/2017,2017,5,20, 1 ,7496,1403,1162,10061
5/20/2017,2017,5,20, 2 ,7239,1353,1127,9719
5/20/2017,2017,5,20, 3 ,6996,1304,1088,9388
5/20/2017,2017,5,20, 4 ,6827,1287,1052,9166
5/20/2017,2017,5,20, 5 ,6736,1298,1086,9120
5/20/2017,2017,5,20, 6 ,6504,1254,1076,8834
5/20/2017,2017,5,20, 7 ,6640,1269,1070,8979
5/20/2017,2017,5,20, 8 ,7343,1404,1180,9927
5/20/2017,2017,5,20, 9 ,8042,1556,1337,10935
5/20/2017,2017,5,20, 10 ,8542,1670,1445,11657
5/20/2017,2017,5,20, 11 ,8828,1726,1502,12056
5/20/2017,2017,5,20, 12 ,8659,1686,1477,11822
5/20/2017,2017,5,20, 13 ,8569,1686,1501,11756
5/20/2017,2017,5,20, 14 ,8766,1702,1514,11982
5/20/2017,2017,5,20, 15 ,8705,1657,1496,11858
5/20/2017,2017,5,20, 16 ,8435,1615,1440,11490
5/20/2017,2017,5,20, 17 ,8019,1586,1420,11025
5/20/2017,2017,5,20, 18 ,7906,1656,1462,11024
5/20/2017,2017,5,20, 19 ,8492,1744,1456,11692
5/20/2017,2017,5,20, 20 ,8537,1716,1452,11705
5/20/2017,2017,5,20, 21 ,8620,1666,1402,11688
5/20/2017,2017,5,20, 22 ,8409,1583,1297,11289
5/20/2017,2017,5,20, 23 ,8095,1473,1216,10784
5/20/2017,2017,5,20, 24 ,7620,1393,1134,10147
5/21/2017,2017,5,21, 1 ,7433,1327,1076,9836
5/21/2017,2017,5,21, 2 ,7181,1300,1055,9536
5/21/2017,2017,5,21, 3 ,6928,1273,1028,9229
5/21/2017,2017,5,21, 4 ,6774,1250,1008,9032
5/21/2017,2017,5,21, 5 ,6536,1232,1018,8786
5/21/2017,2017,5,21, 6 ,6282,1203,1001,8486
5/21/2017,2017,5,21, 7 ,6309,1202,994,8505
5/21/2017,2017,5,21, 8 ,6646,1271,1006,8923
5/21/2017,2017,5,21, 9 ,7172,1355,1071,9598
5/21/2017,2017,5,21, 10 ,7535,1453,1166,10154
5/21/2017,2017,5,21, 11 ,7778,1510,1206,10494
5/21/2017,2017,5,21, 12 ,7738,1512,1212,10462
5/21/2017,2017,5,21, 13 ,7736,1511,1220,10467
5/21/2017,2017,5,21, 14 ,7777,1523,1241,10541
5/21/2017,2017,5,21, 15 ,7579,1500,1221,10300
5/21/2017,2017,5,21, 16 ,7354,1453,1191,9998
5/21/2017,2017,5,21, 17 ,7205,1471,1191,9867
5/21/2017,2017,5,21, 18 ,7421,1606,1345,10372
5/21/2017,2017,5,21, 19 ,7849,1717,1438,11004
5/21/2017,2017,5,21, 20 ,7940,1678,1409,11027
5/21/2017,2017,5,21, 21 ,7924,1640,1342,10906
5/21/2017,2017,5,21, 22 ,7796,1556,1246,10598
5/21/2017,2017,5,21, 23 ,7385,1479,1160,10024
5/21/2017,2017,5,21, 24 ,7201,1386,1090,9677
5/22/2017,2017,5,22, 1 ,6831,1326,1039,9196
5/22/2017,2017,5,22, 2 ,6641,1277,1014,8932
5/22/2017,2017,5,22, 3 ,6397,1248,988,8633
5/22/2017,2017,5,22, 4 ,6277,1235,979,8491
5/22/2017,2017,5,22, 5 ,6285,1235,1003,8523
5/22/2017,2017,5,22, 6 ,6254,1231,1015,8500
5/22/2017,2017,5,22, 7 ,6697,1258,1037,8992
5/22/2017,2017,5,22, 8 ,7678,1431,1213,10322
5/22/2017,2017,5,22, 9 ,8517,1662,1417,11596
5/22/2017,2017,5,22, 10 ,9186,1784,1537,12507
5/22/2017,2017,5,22, 11 ,9598,1849,1596,13043
5/22/2017,2017,5,22, 12 ,9480,1818,1554,12852
5/22/2017,2017,5,22, 13 ,9360,1827,1581,12768
5/22/2017,2017,5,22, 14 ,9603,1880,1623,13106
5/22/2017,2017,5,22, 15 ,9497,1837,1607,12941
5/22/2017,2017,5,22, 16 ,9278,1793,1550,12621
5/22/2017,2017,5,22, 17 ,8859,1744,1502,12105
5/22/2017,2017,5,22, 18 ,8517,1783,1566,11866
5/22/2017,2017,5,22, 19 ,8799,1825,1554,12178
5/22/2017,2017,5,22, 20 ,8695,1769,1520,11984
5/22/2017,2017,5,22, 21 ,8551,1703,1454,11708
5/22/2017,2017,5,22, 22 ,8280,1598,1341,11219
5/22/2017,2017,5,22, 23 ,7964,1510,1220,10694
5/22/2017,2017,5,22, 24 ,7601,1426,1101,10128
5/23/2017,2017,5,23, 1 ,7291,1359,1116,9766
5/23/2017,2017,5,23, 2 ,7006,1324,1050,9380
5/23/2017,2017,5,23, 3 ,6827,1279,1028,9134
5/23/2017,2017,5,23, 4 ,6689,1256,1021,8966
5/23/2017,2017,5,23, 5 ,6656,1266,1036,8958
5/23/2017,2017,5,23, 6 ,6505,1259,1046,8810
5/23/2017,2017,5,23, 7 ,6848,1296,1048,9192
5/23/2017,2017,5,23, 8 ,7723,1478,1227,10428
5/23/2017,2017,5,23, 9 ,8626,1703,1444,11773
5/23/2017,2017,5,23, 10 ,9105,1815,1568,12488
5/23/2017,2017,5,23, 11 ,9415,1904,1605,12924
5/23/2017,2017,5,23, 12 ,9190,1861,1632,12683
5/23/2017,2017,5,23, 13 ,9203,1841,1620,12664
5/23/2017,2017,5,23, 14 ,9498,1905,1692,13095
5/23/2017,2017,5,23, 15 ,9471,1883,1675,13029
5/23/2017,2017,5,23, 16 ,9247,1832,1596,12675
5/23/2017,2017,5,23, 17 ,8797,1762,1538,12097
5/23/2017,2017,5,23, 18 ,8632,1794,1595,12021
5/23/2017,2017,5,23, 19 ,8784,1841,1617,12242
5/23/2017,2017,5,23, 20 ,8851,1794,1571,12216
5/23/2017,2017,5,23, 21 ,8732,1739,1486,11957
5/23/2017,2017,5,23, 22 ,8519,1622,1295,11436
5/23/2017,2017,5,23, 23 ,8103,1533,1240,10876
5/23/2017,2017,5,23, 24 ,7744,1442,1147,10333
5/24/2017,2017,5,24, 1 ,7404,1386,1122,9912
5/24/2017,2017,5,24, 2 ,7182,1342,1088,9612
5/24/2017,2017,5,24, 3 ,6961,1308,1027,9296
5/24/2017,2017,5,24, 4 ,6779,1284,1033,9096
5/24/2017,2017,5,24, 5 ,6727,1269,1049,9045
5/24/2017,2017,5,24, 6 ,6641,1254,1062,8957
5/24/2017,2017,5,24, 7 ,7042,1278,1088,9408
5/24/2017,2017,5,24, 8 ,7991,1457,1230,10678
5/24/2017,2017,5,24, 9 ,8873,1685,1439,11997
5/24/2017,2017,5,24, 10 ,9280,1817,1551,12648
5/24/2017,2017,5,24, 11 ,9497,1879,1619,12995
5/24/2017,2017,5,24, 12 ,9301,1833,1601,12735
5/24/2017,2017,5,24, 13 ,9236,1837,1618,12691
5/24/2017,2017,5,24, 14 ,9574,1861,1662,13097
5/24/2017,2017,5,24, 15 ,9552,1838,1610,13000
5/24/2017,2017,5,24, 16 ,9454,1825,1541,12820
5/24/2017,2017,5,24, 17 ,8893,1727,1484,12104
5/24/2017,2017,5,24, 18 ,8621,1772,1532,11925
5/24/2017,2017,5,24, 19 ,8911,1826,1573,12310
5/24/2017,2017,5,24, 20 ,8896,1740,1531,12167
5/24/2017,2017,5,24, 21 ,8814,1669,1468,11951
5/24/2017,2017,5,24, 22 ,8516,1561,1346,11423
5/24/2017,2017,5,24, 23 ,8202,1465,1243,10910
5/24/2017,2017,5,24, 24 ,7752,1400,1169,10321
5/25/2017,2017,5,25, 1 ,7492,1341,1112,9945
5/25/2017,2017,5,25, 2 ,7229,1305,1080,9614
5/25/2017,2017,5,25, 3 ,6986,1261,1046,9293
5/25/2017,2017,5,25, 4 ,6846,1253,1023,9122
5/25/2017,2017,5,25, 5 ,6808,1259,1061,9128
5/25/2017,2017,5,25, 6 ,6667,1238,1069,8974
5/25/2017,2017,5,25, 7 ,6939,1257,1072,9268
5/25/2017,2017,5,25, 8 ,7896,1442,1203,10541
5/25/2017,2017,5,25, 9 ,8706,1648,1434,11788
5/25/2017,2017,5,25, 10 ,9201,1755,1544,12500
5/25/2017,2017,5,25, 11 ,9431,1842,1623,12896
5/25/2017,2017,5,25, 12 ,9163,1796,1600,12559
5/25/2017,2017,5,25, 13 ,9024,1794,1589,12407
5/25/2017,2017,5,25, 14 ,9202,1849,1620,12671
5/25/2017,2017,5,25, 15 ,9120,1831,1594,12545
5/25/2017,2017,5,25, 16 ,8942,1791,1579,12312
5/25/2017,2017,5,25, 17 ,8632,1731,1513,11876
5/25/2017,2017,5,25, 18 ,8499,1749,1494,11742
5/25/2017,2017,5,25, 19 ,8721,1833,1580,12134
5/25/2017,2017,5,25, 20 ,8676,1731,1519,11926
5/25/2017,2017,5,25, 21 ,8563,1678,1445,11686
5/25/2017,2017,5,25, 22 ,8263,1561,1355,11179
5/25/2017,2017,5,25, 23 ,7817,1471,1114,10402
5/25/2017,2017,5,25, 24 ,7447,1399,1066,9912
5/26/2017,2017,5,26, 1 ,7111,1340,1116,9567
5/26/2017,2017,5,26, 2 ,6923,1300,1083,9306
5/26/2017,2017,5,26, 3 ,6754,1269,1048,9071
5/26/2017,2017,5,26, 4 ,6591,1237,1032,8860
5/26/2017,2017,5,26, 5 ,6556,1248,1049,8853
5/26/2017,2017,5,26, 6 ,6500,1236,1033,8769
5/26/2017,2017,5,26, 7 ,6870,1272,1051,9193
5/26/2017,2017,5,26, 8 ,7750,1443,1201,10394
5/26/2017,2017,5,26, 9 ,8608,1642,1347,11597
5/26/2017,2017,5,26, 10 ,9145,1752,1531,12428
5/26/2017,2017,5,26, 11 ,9489,1852,1602,12943
5/26/2017,2017,5,26, 12 ,9362,1796,1469,12627
5/26/2017,2017,5,26, 13 ,9278,1801,1512,12591
5/26/2017,2017,5,26, 14 ,9615,1856,1634,13105
5/26/2017,2017,5,26, 15 ,9422,1849,1619,12890
5/26/2017,2017,5,26, 16 ,9101,1794,1533,12428
5/26/2017,2017,5,26, 17 ,8761,1718,1463,11942
5/26/2017,2017,5,26, 18 ,8493,1748,1526,11767
5/26/2017,2017,5,26, 19 ,8669,1834,1552,12055
5/26/2017,2017,5,26, 20 ,8652,1786,1505,11943
5/26/2017,2017,5,26, 21 ,8552,1725,1440,11717
5/26/2017,2017,5,26, 22 ,8238,1612,1318,11168
5/26/2017,2017,5,26, 23 ,7809,1503,1244,10556
5/26/2017,2017,5,26, 24 ,7405,1407,1158,9970
5/27/2017,2017,5,27, 1 ,7125,1342,1113,9580
5/27/2017,2017,5,27, 2 ,6910,1294,1089,9293
5/27/2017,2017,5,27, 3 ,6711,1257,1061,9029
5/27/2017,2017,5,27, 4 ,6547,1236,1035,8818
5/27/2017,2017,5,27, 5 ,6458,1230,1043,8731
5/27/2017,2017,5,27, 6 ,6279,1216,1012,8507
5/27/2017,2017,5,27, 7 ,6522,1249,1021,8792
5/27/2017,2017,5,27, 8 ,7082,1363,1133,9578
5/27/2017,2017,5,27, 9 ,7827,1527,1291,10645
5/27/2017,2017,5,27, 10 ,8347,1656,1403,11406
5/27/2017,2017,5,27, 11 ,8766,1718,1470,11954
5/27/2017,2017,5,27, 12 ,8569,1677,1467,11713
5/27/2017,2017,5,27, 13 ,8529,1684,1473,11686
5/27/2017,2017,5,27, 14 ,8687,1734,1539,11960
5/27/2017,2017,5,27, 15 ,8523,1702,1485,11710
5/27/2017,2017,5,27, 16 ,8261,1644,1446,11351
5/27/2017,2017,5,27, 17 ,8046,1588,1407,11041
5/27/2017,2017,5,27, 18 ,8013,1650,1502,11165
5/27/2017,2017,5,27, 19 ,8310,1771,1558,11639
5/27/2017,2017,5,27, 20 ,8282,1715,1517,11514
5/27/2017,2017,5,27, 21 ,8204,1670,1478,11352
5/27/2017,2017,5,27, 22 ,7944,1582,1378,10904
5/27/2017,2017,5,27, 23 ,7572,1481,1268,10321
5/27/2017,2017,5,27, 24 ,7126,1392,1180,9698
5/28/2017,2017,5,28, 1 ,6856,1335,1142,9333
5/28/2017,2017,5,28, 2 ,6660,1288,1098,9046
5/28/2017,2017,5,28, 3 ,6439,1246,1070,8755
5/28/2017,2017,5,28, 4 ,6331,1211,1034,8576
5/28/2017,2017,5,28, 5 ,6200,1195,1025,8420
5/28/2017,2017,5,28, 6 ,5912,1155,990,8057
5/28/2017,2017,5,28, 7 ,5996,1170,954,8120
5/28/2017,2017,5,28, 8 ,6362,1239,1043,8644
5/28/2017,2017,5,28, 9 ,6872,1322,1121,9315
5/28/2017,2017,5,28, 10 ,7367,1417,1192,9976
5/28/2017,2017,5,28, 11 ,7691,1468,1289,10448
5/28/2017,2017,5,28, 12 ,7606,1470,1310,10386
5/28/2017,2017,5,28, 13 ,7689,1478,1320,10487
5/28/2017,2017,5,28, 14 ,7841,1489,1348,10678
5/28/2017,2017,5,28, 15 ,7705,1470,1294,10469
5/28/2017,2017,5,28, 16 ,7423,1461,1300,10184
5/28/2017,2017,5,28, 17 ,7246,1448,1287,9981
5/28/2017,2017,5,28, 18 ,7369,1542,1377,10288
5/28/2017,2017,5,28, 19 ,8002,1697,1469,11168
5/28/2017,2017,5,28, 20 ,8152,1683,1452,11287
5/28/2017,2017,5,28, 21 ,8139,1635,1402,11176
5/28/2017,2017,5,28, 22 ,7989,1543,1310,10842
5/28/2017,2017,5,28, 23 ,7602,1451,1211,10264
5/28/2017,2017,5,28, 24 ,7321,1363,1140,9824
5/29/2017,2017,5,29, 1 ,6829,1301,1094,9224
5/29/2017,2017,5,29, 2 ,6591,1259,1056,8906
5/29/2017,2017,5,29, 3 ,6320,1217,1037,8574
5/29/2017,2017,5,29, 4 ,6183,1185,999,8367
5/29/2017,2017,5,29, 5 ,6243,1175,1007,8425
5/29/2017,2017,5,29, 6 ,6176,1182,1007,8365
5/29/2017,2017,5,29, 7 ,6624,1231,1039,8894
5/29/2017,2017,5,29, 8 ,7684,1430,1197,10311
5/29/2017,2017,5,29, 9 ,8628,1672,1416,11716
5/29/2017,2017,5,29, 10 ,9229,1801,1528,12558
5/29/2017,2017,5,29, 11 ,9616,1864,1589,13069
5/29/2017,2017,5,29, 12 ,9525,1845,1566,12936
5/29/2017,2017,5,29, 13 ,9522,1842,1572,12936
5/29/2017,2017,5,29, 14 ,9853,1912,1633,13398
5/29/2017,2017,5,29, 15 ,9592,1891,1626,13109
5/29/2017,2017,5,29, 16 ,9282,1860,1592,12734
5/29/2017,2017,5,29, 17 ,8885,1772,1516,12173
5/29/2017,2017,5,29, 18 ,8640,1763,1497,11900
5/29/2017,2017,5,29, 19 ,8870,1901,1591,12362
5/29/2017,2017,5,29, 20 ,8827,1848,1521,12196
5/29/2017,2017,5,29, 21 ,8720,1771,1444,11935
5/29/2017,2017,5,29, 22 ,8476,1646,1359,11481
5/29/2017,2017,5,29, 23 ,8108,1557,1253,10918
5/29/2017,2017,5,29, 24 ,7720,1471,1184,10375
5/30/2017,2017,5,30, 1 ,7345,1401,1133,9879
5/30/2017,2017,5,30, 2 ,7106,1363,1105,9574
5/30/2017,2017,5,30, 3 ,6987,1321,1075,9383
5/30/2017,2017,5,30, 4 ,6617,1287,1030,8934
5/30/2017,2017,5,30, 5 ,6731,1281,1029,9041
5/30/2017,2017,5,30, 6 ,6571,1262,1045,8878
5/30/2017,2017,5,30, 7 ,6877,1291,1056,9224
5/30/2017,2017,5,30, 8 ,7831,1487,1220,10538
5/30/2017,2017,5,30, 9 ,8832,1734,1366,11932
5/30/2017,2017,5,30, 10 ,9338,1791,1512,12641
5/30/2017,2017,5,30, 11 ,9767,1890,1596,13253
5/30/2017,2017,5,30, 12 ,9646,1858,1573,13077
5/30/2017,2017,5,30, 13 ,9618,1856,1523,12997
5/30/2017,2017,5,30, 14 ,9919,1922,1588,13429
5/30/2017,2017,5,30, 15 ,9803,1888,1537,13228
5/30/2017,2017,5,30, 16 ,9364,1847,1526,12737
5/30/2017,2017,5,30, 17 ,8922,1767,1482,12171
5/30/2017,2017,5,30, 18 ,8769,1773,1487,12029
5/30/2017,2017,5,30, 19 ,8726,1877,1513,12116
5/30/2017,2017,5,30, 20 ,8590,1830,1476,11896
5/30/2017,2017,5,30, 21 ,8416,1761,1421,11598
5/30/2017,2017,5,30, 22 ,8223,1639,1297,11159
5/30/2017,2017,5,30, 23 ,7794,1533,1201,10528
5/30/2017,2017,5,30, 24 ,7461,1440,1130,10031
5/31/2017,2017,5,31, 1 ,7190,1393,1063,9646
5/31/2017,2017,5,31, 2 ,6981,1350,1040,9371
5/31/2017,2017,5,31, 3 ,6808,1314,1018,9140
5/31/2017,2017,5,31, 4 ,6568,1276,1005,8849
5/31/2017,2017,5,31, 5 ,6553,1298,1011,8862
5/31/2017,2017,5,31, 6 ,6482,1265,1018,8765
5/31/2017,2017,5,31, 7 ,6819,1296,1018,9133
5/31/2017,2017,5,31, 8 ,7664,1478,1197,10339
5/31/2017,2017,5,31, 9 ,8671,1717,1373,11761
5/31/2017,2017,5,31, 10 ,9124,1805,1529,12458
5/31/2017,2017,5,31, 11 ,9602,1892,1601,13095
5/31/2017,2017,5,31, 12 ,9478,1874,1562,12914
5/31/2017,2017,5,31, 13 ,9442,1866,1571,12879
5/31/2017,2017,5,31, 14 ,9693,1908,1628,13229
5/31/2017,2017,5,31, 15 ,9734,1904,1616,13254
5/31/2017,2017,5,31, 16 ,9429,1870,1584,12883
5/31/2017,2017,5,31, 17 ,9001,1784,1488,12273
5/31/2017,2017,5,31, 18 ,8669,1781,1525,11975
5/31/2017,2017,5,31, 19 ,8945,1859,1583,12387
5/31/2017,2017,5,31, 20 ,8897,1801,1547,12245
5/31/2017,2017,5,31, 21 ,8859,1754,1483,12096
5/31/2017,2017,5,31, 22 ,8625,1626,1345,11596
5/31/2017,2017,5,31, 23 ,8247,1524,1265,11036
5/31/2017,2017,5,31, 24 ,7820,1445,1154,10419
6/1/2017,2017,6,1, 1 ,7447,1385,1128,9960
6/1/2017,2017,6,1, 2 ,7280,1332,1104,9716
6/1/2017,2017,6,1, 3 ,6955,1296,1081,9332
6/1/2017,2017,6,1, 4 ,6712,1273,1050,9035
6/1/2017,2017,6,1, 5 ,6731,1283,1062,9076
6/1/2017,2017,6,1, 6 ,6599,1263,1042,8904
6/1/2017,2017,6,1, 7 ,6982,1297,1062,9341
6/1/2017,2017,6,1, 8 ,7933,1486,1209,10628
6/1/2017,2017,6,1, 9 ,8759,1727,1421,11907
6/1/2017,2017,6,1, 10 ,9398,1814,1496,12708
6/1/2017,2017,6,1, 11 ,9684,1907,1579,13170
6/1/2017,2017,6,1, 12 ,9532,1862,1548,12942
6/1/2017,2017,6,1, 13 ,9567,1846,1556,12969
6/1/2017,2017,6,1, 14 ,9862,1926,1609,13397
6/1/2017,2017,6,1, 15 ,9719,1899,1556,13174
6/1/2017,2017,6,1, 16 ,9532,1876,1542,12950
6/1/2017,2017,6,1, 17 ,9061,1750,1466,12277
6/1/2017,2017,6,1, 18 ,8748,1764,1490,12002
6/1/2017,2017,6,1, 19 ,9035,1863,1563,12461
6/1/2017,2017,6,1, 20 ,9077,1798,1496,12371
6/1/2017,2017,6,1, 21 ,9009,1739,1450,12198
6/1/2017,2017,6,1, 22 ,8738,1628,1311,11677
6/1/2017,2017,6,1, 23 ,8347,1520,1227,11094
6/1/2017,2017,6,1, 24 ,7883,1451,1140,10474
6/2/2017,2017,6,2, 1 ,7595,1383,1094,10072
6/2/2017,2017,6,2, 2 ,7270,1326,1087,9683
6/2/2017,2017,6,2, 3 ,7060,1281,1046,9387
6/2/2017,2017,6,2, 4 ,6857,1261,1014,9132
6/2/2017,2017,6,2, 5 ,6828,1269,1046,9143
6/2/2017,2017,6,2, 6 ,6672,1259,1030,8961
6/2/2017,2017,6,2, 7 ,7004,1291,1047,9342
6/2/2017,2017,6,2, 8 ,7911,1484,1226,10621
6/2/2017,2017,6,2, 9 ,8899,1719,1421,12039
6/2/2017,2017,6,2, 10 ,9450,1857,1553,12860
6/2/2017,2017,6,2, 11 ,9667,1926,1643,13236
6/2/2017,2017,6,2, 12 ,9472,1856,1588,12916
6/2/2017,2017,6,2, 13 ,9462,1871,1604,12937
6/2/2017,2017,6,2, 14 ,9684,1917,1671,13272
6/2/2017,2017,6,2, 15 ,9648,1929,1665,13242
6/2/2017,2017,6,2, 16 ,9514,1876,1606,12996
6/2/2017,2017,6,2, 17 ,9070,1768,1524,12362
6/2/2017,2017,6,2, 18 ,8685,1748,1544,11977
6/2/2017,2017,6,2, 19 ,8988,1876,1606,12470
6/2/2017,2017,6,2, 20 ,8971,1828,1553,12352
6/2/2017,2017,6,2, 21 ,8962,1784,1513,12259
6/2/2017,2017,6,2, 22 ,8723,1676,1401,11800
6/2/2017,2017,6,2, 23 ,8374,1550,1307,11231
6/2/2017,2017,6,2, 24 ,7913,1470,1221,10604
6/3/2017,2017,6,3, 1 ,7573,1412,1165,10150
6/3/2017,2017,6,3, 2 ,7344,1355,1137,9836
6/3/2017,2017,6,3, 3 ,7182,1317,1093,9592
6/3/2017,2017,6,3, 4 ,6944,1284,1068,9296
6/3/2017,2017,6,3, 5 ,6830,1285,1066,9181
6/3/2017,2017,6,3, 6 ,6516,1244,1039,8799
6/3/2017,2017,6,3, 7 ,6782,1235,1040,9057
6/3/2017,2017,6,3, 8 ,7425,1363,1149,9937
6/3/2017,2017,6,3, 9 ,8140,1550,1286,10976
6/3/2017,2017,6,3, 10 ,8739,1659,1371,11769
6/3/2017,2017,6,3, 11 ,9013,1711,1455,12179
6/3/2017,2017,6,3, 12 ,8780,1683,1460,11923
6/3/2017,2017,6,3, 13 ,8880,1693,1475,12048
6/3/2017,2017,6,3, 14 ,9115,1745,1518,12378
6/3/2017,2017,6,3, 15 ,8913,1730,1489,12132
6/3/2017,2017,6,3, 16 ,8615,1675,1431,11721
6/3/2017,2017,6,3, 17 ,8183,1574,1380,11137
6/3/2017,2017,6,3, 18 ,8071,1617,1432,11120
6/3/2017,2017,6,3, 19 ,8504,1748,1511,11763
6/3/2017,2017,6,3, 20 ,8591,1728,1509,11828
6/3/2017,2017,6,3, 21 ,8628,1689,1470,11787
6/3/2017,2017,6,3, 22 ,8397,1582,1340,11319
6/3/2017,2017,6,3, 23 ,8112,1492,1262,10866
6/3/2017,2017,6,3, 24 ,7685,1388,1235,10308
6/4/2017,2017,6,4, 1 ,7339,1319,1120,9778
6/4/2017,2017,6,4, 2 ,7137,1278,1085,9500
6/4/2017,2017,6,4, 3 ,6906,1237,1051,9194
6/4/2017,2017,6,4, 4 ,6650,1208,1021,8879
6/4/2017,2017,6,4, 5 ,6569,1198,1017,8784
6/4/2017,2017,6,4, 6 ,6127,1193,974,8294
6/4/2017,2017,6,4, 7 ,6184,1155,959,8298
6/4/2017,2017,6,4, 8 ,6512,1229,1025,8766
6/4/2017,2017,6,4, 9 ,7053,1326,1130,9509
6/4/2017,2017,6,4, 10 ,7508,1418,1227,10153
6/4/2017,2017,6,4, 11 ,7752,1486,1293,10531
6/4/2017,2017,6,4, 12 ,7749,1482,1309,10540
6/4/2017,2017,6,4, 13 ,7731,1489,1323,10543
6/4/2017,2017,6,4, 14 ,7814,1503,1338,10655
6/4/2017,2017,6,4, 15 ,7727,1487,1330,10544
6/4/2017,2017,6,4, 16 ,7585,1444,1271,10300
6/4/2017,2017,6,4, 17 ,7419,1419,1264,10102
6/4/2017,2017,6,4, 18 ,7390,1502,1357,10249
6/4/2017,2017,6,4, 19 ,8141,1663,1435,11239
6/4/2017,2017,6,4, 20 ,8304,1651,1389,11344
6/4/2017,2017,6,4, 21 ,8403,1600,1331,11334
6/4/2017,2017,6,4, 22 ,8213,1503,1214,10930
6/4/2017,2017,6,4, 23 ,7937,1404,1127,10468
6/4/2017,2017,6,4, 24 ,7467,1329,1064,9860
6/5/2017,2017,6,5, 1 ,7176,1265,1002,9443
6/5/2017,2017,6,5, 2 ,6964,1219,980,9163
6/5/2017,2017,6,5, 3 ,6725,1224,958,8907
6/5/2017,2017,6,5, 4 ,6536,1169,945,8650
6/5/2017,2017,6,5, 5 ,6629,1209,1007,8845
6/5/2017,2017,6,5, 6 ,6498,1180,1005,8683
6/5/2017,2017,6,5, 7 ,6746,1180,959,8885
6/5/2017,2017,6,5, 8 ,7692,1385,1134,10211
6/5/2017,2017,6,5, 9 ,8732,1640,1295,11667
6/5/2017,2017,6,5, 10 ,9365,1760,1502,12627
6/5/2017,2017,6,5, 11 ,9571,1789,1556,12916
6/5/2017,2017,6,5, 12 ,9377,1739,1505,12621
6/5/2017,2017,6,5, 13 ,9412,1726,1494,12632
6/5/2017,2017,6,5, 14 ,9775,1789,1556,13120
6/5/2017,2017,6,5, 15 ,9614,1759,1567,12940
6/5/2017,2017,6,5, 16 ,9431,1732,1470,12633
6/5/2017,2017,6,5, 17 ,8966,1655,1444,12065
6/5/2017,2017,6,5, 18 ,8620,1671,1497,11788
6/5/2017,2017,6,5, 19 ,8873,1750,1511,12134
6/5/2017,2017,6,5, 20 ,8907,1686,1455,12048
6/5/2017,2017,6,5, 21 ,8847,1632,1338,11817
6/5/2017,2017,6,5, 22 ,8594,1516,1248,11358
6/5/2017,2017,6,5, 23 ,8183,1417,1155,10755
6/5/2017,2017,6,5, 24 ,7781,1338,1086,10205
6/6/2017,2017,6,6, 1 ,7417,1273,1041,9731
6/6/2017,2017,6,6, 2 ,7132,1231,1010,9373
6/6/2017,2017,6,6, 3 ,6943,1194,985,9122
6/6/2017,2017,6,6, 4 ,6819,1168,980,8967
6/6/2017,2017,6,6, 5 ,6876,1205,1035,9116
6/6/2017,2017,6,6, 6 ,6715,1222,1029,8966
6/6/2017,2017,6,6, 7 ,6927,1173,973,9073
6/6/2017,2017,6,6, 8 ,7830,1323,1121,10274
6/6/2017,2017,6,6, 9 ,8748,1545,1325,11618
6/6/2017,2017,6,6, 10 ,9201,1645,1444,12290
6/6/2017,2017,6,6, 11 ,9590,1767,1518,12875
6/6/2017,2017,6,6, 12 ,9442,1713,1420,12575
6/6/2017,2017,6,6, 13 ,9547,1731,1469,12747
6/6/2017,2017,6,6, 14 ,9916,1783,1602,13301
6/6/2017,2017,6,6, 15 ,9879,1764,1591,13234
6/6/2017,2017,6,6, 16 ,9697,1740,1523,12960
6/6/2017,2017,6,6, 17 ,9189,1660,1498,12347
6/6/2017,2017,6,6, 18 ,8751,1679,1521,11951
6/6/2017,2017,6,6, 19 ,9109,1787,1541,12437
6/6/2017,2017,6,6, 20 ,9118,1717,1498,12333
6/6/2017,2017,6,6, 21 ,9034,1647,1388,12069
6/6/2017,2017,6,6, 22 ,8785,1513,1288,11586
6/6/2017,2017,6,6, 23 ,8331,1402,1192,10925
6/6/2017,2017,6,6, 24 ,7968,1317,1112,10397
6/7/2017,2017,6,7, 1 ,7638,1248,1075,9961
6/7/2017,2017,6,7, 2 ,7356,1215,1046,9617
6/7/2017,2017,6,7, 3 ,7082,1178,1029,9289
6/7/2017,2017,6,7, 4 ,6908,1160,1018,9086
6/7/2017,2017,6,7, 5 ,7002,1197,1052,9251
6/7/2017,2017,6,7, 6 ,6822,1190,1063,9075
6/7/2017,2017,6,7, 7 ,6962,1161,1030,9153
6/7/2017,2017,6,7, 8 ,7905,1360,1145,10410
6/7/2017,2017,6,7, 9 ,8730,1580,1237,11547
6/7/2017,2017,6,7, 10 ,9188,1679,1361,12228
6/7/2017,2017,6,7, 11 ,9560,1741,1440,12741
6/7/2017,2017,6,7, 12 ,9383,1701,1420,12504
6/7/2017,2017,6,7, 13 ,9310,1670,1410,12390
6/7/2017,2017,6,7, 14 ,9572,1711,1459,12742
6/7/2017,2017,6,7, 15 ,9516,1706,1473,12695
6/7/2017,2017,6,7, 16 ,9244,1674,1460,12378
6/7/2017,2017,6,7, 17 ,8917,1611,1422,11950
6/7/2017,2017,6,7, 18 ,8521,1632,1479,11632
6/7/2017,2017,6,7, 19 ,8765,1711,1554,12030
6/7/2017,2017,6,7, 20 ,8838,1673,1505,12016
6/7/2017,2017,6,7, 21 ,8760,1600,1401,11761
6/7/2017,2017,6,7, 22 ,8394,1469,1267,11130
6/7/2017,2017,6,7, 23 ,7968,1377,1196,10541
6/7/2017,2017,6,7, 24 ,7671,1292,1130,10093
6/8/2017,2017,6,8, 1 ,7280,1243,1044,9567
6/8/2017,2017,6,8, 2 ,7048,1190,1012,9250
6/8/2017,2017,6,8, 3 ,6818,1163,1003,8984
6/8/2017,2017,6,8, 4 ,6713,1143,994,8850
6/8/2017,2017,6,8, 5 ,6810,1194,1040,9044
6/8/2017,2017,6,8, 6 ,6607,1174,1041,8822
6/8/2017,2017,6,8, 7 ,6875,1152,1027,9054
6/8/2017,2017,6,8, 8 ,7964,1333,1142,10439
6/8/2017,2017,6,8, 9 ,8804,1577,1330,11711
6/8/2017,2017,6,8, 10 ,9320,1671,1438,12429
6/8/2017,2017,6,8, 11 ,9656,1733,1505,12894
6/8/2017,2017,6,8, 12 ,9383,1643,1435,12461
6/8/2017,2017,6,8, 13 ,9400,1620,1467,12487
6/8/2017,2017,6,8, 14 ,9789,1662,1472,12923
6/8/2017,2017,6,8, 15 ,9741,1663,1467,12871
6/8/2017,2017,6,8, 16 ,9598,1641,1440,12679
6/8/2017,2017,6,8, 17 ,9047,1609,1432,12088
6/8/2017,2017,6,8, 18 ,8688,1648,1482,11818
6/8/2017,2017,6,8, 19 ,8990,1734,1461,12185
6/8/2017,2017,6,8, 20 ,8896,1673,1400,11969
6/8/2017,2017,6,8, 21 ,8854,1584,1326,11764
6/8/2017,2017,6,8, 22 ,8667,1458,1183,11308
6/8/2017,2017,6,8, 23 ,8269,1354,1087,10710
6/8/2017,2017,6,8, 24 ,7932,1264,1040,10236
6/9/2017,2017,6,9, 1 ,7577,1196,986,9759
6/9/2017,2017,6,9, 2 ,7295,1157,931,9383
6/9/2017,2017,6,9, 3 ,7074,1123,940,9137
6/9/2017,2017,6,9, 4 ,6886,1104,936,8926
6/9/2017,2017,6,9, 5 ,6917,1161,990,9068
6/9/2017,2017,6,9, 6 ,6766,1177,1007,8950
6/9/2017,2017,6,9, 7 ,6886,1139,963,8988
6/9/2017,2017,6,9, 8 ,7836,1287,1100,10223
6/9/2017,2017,6,9, 9 ,8662,1452,1271,11385
6/9/2017,2017,6,9, 10 ,9233,1570,1406,12209
6/9/2017,2017,6,9, 11 ,9524,1625,1464,12613
6/9/2017,2017,6,9, 12 ,9209,1603,1436,12248
6/9/2017,2017,6,9, 13 ,9149,1575,1450,12174
6/9/2017,2017,6,9, 14 ,9282,1627,1503,12412
6/9/2017,2017,6,9, 15 ,9073,1622,1489,12184
6/9/2017,2017,6,9, 16 ,8854,1610,1449,11913
6/9/2017,2017,6,9, 17 ,8437,1567,1415,11419
6/9/2017,2017,6,9, 18 ,8207,1622,1462,11291
6/9/2017,2017,6,9, 19 ,8438,1676,1486,11600
6/9/2017,2017,6,9, 20 ,8432,1624,1436,11492
6/9/2017,2017,6,9, 21 ,8337,1550,1369,11256
6/9/2017,2017,6,9, 22 ,8048,1434,1259,10741
6/9/2017,2017,6,9, 23 ,7621,1327,1157,10105
6/9/2017,2017,6,9, 24 ,7261,1262,1035,9558
6/10/2017,2017,6,10, 1 ,6954,1205,1036,9195
6/10/2017,2017,6,10, 2 ,6782,1166,1004,8952
6/10/2017,2017,6,10, 3 ,6503,1146,987,8636
6/10/2017,2017,6,10, 4 ,6412,1126,962,8500
6/10/2017,2017,6,10, 5 ,6265,1128,976,8369
6/10/2017,2017,6,10, 6 ,5996,1130,965,8091
6/10/2017,2017,6,10, 7 ,6239,1136,950,8325
6/10/2017,2017,6,10, 8 ,6755,1246,1077,9078
6/10/2017,2017,6,10, 9 ,7426,1447,1226,10099
6/10/2017,2017,6,10, 10 ,7925,1582,1304,10811
6/10/2017,2017,6,10, 11 ,8103,1637,1402,11142
6/10/2017,2017,6,10, 12 ,7787,1603,1381,10771
6/10/2017,2017,6,10, 13 ,7649,1597,1392,10638
6/10/2017,2017,6,10, 14 ,7943,1673,1470,11086
6/10/2017,2017,6,10, 15 ,7849,1640,1461,10950
6/10/2017,2017,6,10, 16 ,7724,1615,1419,10758
6/10/2017,2017,6,10, 17 ,7510,1523,1355,10388
6/10/2017,2017,6,10, 18 ,7592,1611,1426,10629
6/10/2017,2017,6,10, 19 ,7942,1724,1499,11165
6/10/2017,2017,6,10, 20 ,7915,1668,1465,11048
6/10/2017,2017,6,10, 21 ,7889,1612,1425,10926
6/10/2017,2017,6,10, 22 ,7613,1527,1310,10450
6/10/2017,2017,6,10, 23 ,7218,1411,1215,9844
6/10/2017,2017,6,10, 24 ,6858,1307,1120,9285
6/11/2017,2017,6,11, 1 ,6564,1267,1067,8898
6/11/2017,2017,6,11, 2 ,6371,1242,1035,8648
6/11/2017,2017,6,11, 3 ,6123,1201,1009,8333
6/11/2017,2017,6,11, 4 ,5986,1184,973,8143
6/11/2017,2017,6,11, 5 ,5904,1171,972,8047
6/11/2017,2017,6,11, 6 ,5665,1141,949,7755
6/11/2017,2017,6,11, 7 ,5744,1154,951,7849
6/11/2017,2017,6,11, 8 ,6151,1218,999,8368
6/11/2017,2017,6,11, 9 ,6616,1328,1080,9024
6/11/2017,2017,6,11, 10 ,7128,1419,1158,9705
6/11/2017,2017,6,11, 11 ,7375,1462,1244,10081
6/11/2017,2017,6,11, 12 ,7310,1459,1205,9974
6/11/2017,2017,6,11, 13 ,7255,1485,1238,9978
6/11/2017,2017,6,11, 14 ,7150,1480,1256,9886
6/11/2017,2017,6,11, 15 ,6979,1476,1248,9703
6/11/2017,2017,6,11, 16 ,6817,1439,1217,9473
6/11/2017,2017,6,11, 17 ,6787,1422,1194,9403
6/11/2017,2017,6,11, 18 ,6986,1489,1320,9795
6/11/2017,2017,6,11, 19 ,7537,1689,1408,10634
6/11/2017,2017,6,11, 20 ,7693,1672,1397,10762
6/11/2017,2017,6,11, 21 ,7599,1607,1310,10516
6/11/2017,2017,6,11, 22 ,7375,1519,1206,10100
6/11/2017,2017,6,11, 23 ,7000,1423,1124,9547
6/11/2017,2017,6,11, 24 ,6668,1348,1049,9065
6/12/2017,2017,6,12, 1 ,6376,1277,1002,8655
6/12/2017,2017,6,12, 2 ,6153,1237,959,8349
6/12/2017,2017,6,12, 3 ,5924,1200,937,8061
6/12/2017,2017,6,12, 4 ,5765,1173,911,7849
6/12/2017,2017,6,12, 5 ,5735,1174,926,7835
6/12/2017,2017,6,12, 6 ,5504,1149,919,7572
6/12/2017,2017,6,12, 7 ,5687,1172,938,7797
6/12/2017,2017,6,12, 8 ,6144,1273,979,8396
6/12/2017,2017,6,12, 9 ,6734,1408,1086,9228
6/12/2017,2017,6,12, 10 ,7276,1509,1214,9999
6/12/2017,2017,6,12, 11 ,7612,1556,1275,10443
6/12/2017,2017,6,12, 12 ,7600,1526,1280,10406
6/12/2017,2017,6,12, 13 ,7657,1523,1278,10458
6/12/2017,2017,6,12, 14 ,7765,1537,1307,10609
6/12/2017,2017,6,12, 15 ,7785,1525,1305,10615
6/12/2017,2017,6,12, 16 ,7616,1498,1292,10406
6/12/2017,2017,6,12, 17 ,7349,1482,1299,10130
6/12/2017,2017,6,12, 18 ,7411,1585,1382,10378
6/12/2017,2017,6,12, 19 ,8000,1692,1413,11105
6/12/2017,2017,6,12, 20 ,8204,1671,1385,11260
6/12/2017,2017,6,12, 21 ,8199,1604,1330,11133
6/12/2017,2017,6,12, 22 ,7930,1474,1197,10601
6/12/2017,2017,6,12, 23 ,7525,1379,1096,10000
6/12/2017,2017,6,12, 24 ,7151,1290,1116,9557
6/13/2017,2017,6,13, 1 ,6794,1253,989,9036
6/13/2017,2017,6,13, 2 ,6516,1209,960,8685
6/13/2017,2017,6,13, 3 ,6325,1182,937,8444
6/13/2017,2017,6,13, 4 ,6194,1175,933,8302
6/13/2017,2017,6,13, 5 ,6299,1227,1009,8535
6/13/2017,2017,6,13, 6 ,6163,1201,1007,8371
6/13/2017,2017,6,13, 7 ,6564,1194,953,8711
6/13/2017,2017,6,13, 8 ,7666,1414,1143,10223
6/13/2017,2017,6,13, 9 ,8659,1648,1361,11668
6/13/2017,2017,6,13, 10 ,9246,1782,1502,12530
6/13/2017,2017,6,13, 11 ,9587,1856,1566,13009
6/13/2017,2017,6,13, 12 ,9320,1779,1501,12600
6/13/2017,2017,6,13, 13 ,9331,1784,1509,12624
6/13/2017,2017,6,13, 14 ,9574,1876,1583,13033
6/13/2017,2017,6,13, 15 ,9636,1860,1584,13080
6/13/2017,2017,6,13, 16 ,9522,1824,1573,12919
6/13/2017,2017,6,13, 17 ,9049,1727,1502,12278
6/13/2017,2017,6,13, 18 ,8688,1726,1518,11932
6/13/2017,2017,6,13, 19 ,8981,1862,1582,12425
6/13/2017,2017,6,13, 20 ,9055,1812,1517,12384
6/13/2017,2017,6,13, 21 ,8947,1756,1468,12171
6/13/2017,2017,6,13, 22 ,8723,1622,1330,11675
6/13/2017,2017,6,13, 23 ,8278,1509,1232,11019
6/13/2017,2017,6,13, 24 ,7797,1425,1007,10229
6/14/2017,2017,6,14, 1 ,7469,1357,1089,9915
6/14/2017,2017,6,14, 2 ,7235,1321,1063,9619
6/14/2017,2017,6,14, 3 ,6980,1278,1039,9297
6/14/2017,2017,6,14, 4 ,6910,1266,1019,9195
6/14/2017,2017,6,14, 5 ,6922,1301,1083,9306
6/14/2017,2017,6,14, 6 ,6687,1280,1051,9018
6/14/2017,2017,6,14, 7 ,6946,1268,997,9211
6/14/2017,2017,6,14, 8 ,7933,1480,1173,10586
6/14/2017,2017,6,14, 9 ,8939,1701,1377,12017
6/14/2017,2017,6,14, 10 ,9339,1815,1521,12675
6/14/2017,2017,6,14, 11 ,9612,1864,1568,13044
6/14/2017,2017,6,14, 12 ,9422,1843,1552,12817
6/14/2017,2017,6,14, 13 ,9565,1849,1560,12974
6/14/2017,2017,6,14, 14 ,9973,1921,1627,13521
6/14/2017,2017,6,14, 15 ,9781,1900,1611,13292
6/14/2017,2017,6,14, 16 ,9621,1835,1552,13008
6/14/2017,2017,6,14, 17 ,9114,1744,1485,12343
6/14/2017,2017,6,14, 18 ,8891,1775,1520,12186
6/14/2017,2017,6,14, 19 ,8992,1878,1572,12442
6/14/2017,2017,6,14, 20 ,8985,1833,1528,12346
6/14/2017,2017,6,14, 21 ,8818,1778,1407,12003
6/14/2017,2017,6,14, 22 ,8507,1632,1264,11403
6/14/2017,2017,6,14, 23 ,8116,1531,1165,10812
6/14/2017,2017,6,14, 24 ,7733,1445,1113,10291
6/15/2017,2017,6,15, 1 ,7423,1371,1061,9855
6/15/2017,2017,6,15, 2 ,7114,1340,1029,9483
6/15/2017,2017,6,15, 3 ,6962,1308,992,9262
6/15/2017,2017,6,15, 4 ,6817,1279,975,9071
6/15/2017,2017,6,15, 5 ,6870,1308,1023,9201
6/15/2017,2017,6,15, 6 ,6664,1300,1032,8996
6/15/2017,2017,6,15, 7 ,6979,1274,978,9231
6/15/2017,2017,6,15, 8 ,7892,1495,1113,10500
6/15/2017,2017,6,15, 9 ,8739,1691,1304,11734
6/15/2017,2017,6,15, 10 ,9261,1818,1430,12509
6/15/2017,2017,6,15, 11 ,9625,1883,1446,12954
6/15/2017,2017,6,15, 12 ,9431,1845,1395,12671
6/15/2017,2017,6,15, 13 ,9535,1852,1382,12769
6/15/2017,2017,6,15, 14 ,9847,1925,1444,13216
6/15/2017,2017,6,15, 15 ,9746,1903,1425,13074
6/15/2017,2017,6,15, 16 ,9459,1867,1409,12735
6/15/2017,2017,6,15, 17 ,8888,1772,1379,12039
6/15/2017,2017,6,15, 18 ,8538,1773,1432,11743
6/15/2017,2017,6,15, 19 ,8716,1913,1455,12084
6/15/2017,2017,6,15, 20 ,8618,1854,1398,11870
6/15/2017,2017,6,15, 21 ,8577,1787,1311,11675
6/15/2017,2017,6,15, 22 ,8196,1649,1192,11037
6/15/2017,2017,6,15, 23 ,7762,1539,1089,10390
6/15/2017,2017,6,15, 24 ,7350,1432,1146,9928
6/16/2017,2017,6,16, 1 ,7012,1372,934,9318
6/16/2017,2017,6,16, 2 ,6870,1333,955,9158
6/16/2017,2017,6,16, 3 ,6674,1293,940,8907
6/16/2017,2017,6,16, 4 ,6484,1265,921,8670
6/16/2017,2017,6,16, 5 ,6637,1301,986,8924
6/16/2017,2017,6,16, 6 ,6409,1269,1002,8680
6/16/2017,2017,6,16, 7 ,6670,1248,940,8858
6/16/2017,2017,6,16, 8 ,7635,1456,1098,10189
6/16/2017,2017,6,16, 9 ,8584,1692,1295,11571
6/16/2017,2017,6,16, 10 ,9045,1808,1409,12262
6/16/2017,2017,6,16, 11 ,9377,1871,1476,12724
6/16/2017,2017,6,16, 12 ,9277,1843,1448,12568
6/16/2017,2017,6,16, 13 ,9353,1841,1455,12649
6/16/2017,2017,6,16, 14 ,9715,1913,1537,13165
6/16/2017,2017,6,16, 15 ,9662,1895,1524,13081
6/16/2017,2017,6,16, 16 ,9471,1865,1478,12814
6/16/2017,2017,6,16, 17 ,8972,1745,1422,12139
6/16/2017,2017,6,16, 18 ,8578,1735,1477,11790
6/16/2017,2017,6,16, 19 ,8897,1865,1526,12288
6/16/2017,2017,6,16, 20 ,8887,1834,1488,12209
6/16/2017,2017,6,16, 21 ,8865,1774,1414,12053
6/16/2017,2017,6,16, 22 ,8525,1664,1297,11486
6/16/2017,2017,6,16, 23 ,8228,1539,1154,10921
6/16/2017,2017,6,16, 24 ,7843,1461,1059,10363
6/17/2017,2017,6,17, 1 ,7500,1399,1038,9937
6/17/2017,2017,6,17, 2 ,7252,1361,1018,9631
6/17/2017,2017,6,17, 3 ,7035,1329,999,9363
6/17/2017,2017,6,17, 4 ,6810,1298,977,9085
6/17/2017,2017,6,17, 5 ,6667,1287,990,8944
6/17/2017,2017,6,17, 6 ,6414,1249,962,8625
6/17/2017,2017,6,17, 7 ,6653,1264,981,8898
6/17/2017,2017,6,17, 8 ,7256,1401,1081,9738
6/17/2017,2017,6,17, 9 ,8043,1572,1235,10850
6/17/2017,2017,6,17, 10 ,8601,1701,1344,11646
6/17/2017,2017,6,17, 11 ,8926,1750,1410,12086
6/17/2017,2017,6,17, 12 ,8824,1720,1389,11933
6/17/2017,2017,6,17, 13 ,8777,1733,1399,11909
6/17/2017,2017,6,17, 14 ,9075,1751,1420,12246
6/17/2017,2017,6,17, 15 ,8998,1718,1291,12007
6/17/2017,2017,6,17, 16 ,8728,1681,1350,11759
6/17/2017,2017,6,17, 17 ,8303,1606,1318,11227
6/17/2017,2017,6,17, 18 ,8068,1660,1349,11077
6/17/2017,2017,6,17, 19 ,8516,1786,1380,11682
6/17/2017,2017,6,17, 20 ,8649,1745,1363,11757
6/17/2017,2017,6,17, 21 ,8625,1695,1292,11612
6/17/2017,2017,6,17, 22 ,8509,1623,1213,11345
6/17/2017,2017,6,17, 23 ,8153,1504,1087,10744
6/17/2017,2017,6,17, 24 ,7762,1417,1035,10214
6/18/2017,2017,6,18, 1 ,7487,1353,976,9816
6/18/2017,2017,6,18, 2 ,7236,1312,951,9499
6/18/2017,2017,6,18, 3 ,7022,1271,933,9226
6/18/2017,2017,6,18, 4 ,6772,1239,910,8921
6/18/2017,2017,6,18, 5 ,6576,1224,916,8716
6/18/2017,2017,6,18, 6 ,6201,1186,888,8275
6/18/2017,2017,6,18, 7 ,6304,1193,895,8392
6/18/2017,2017,6,18, 8 ,6631,1247,940,8818
6/18/2017,2017,6,18, 9 ,7022,1348,1036,9406
6/18/2017,2017,6,18, 10 ,7458,1437,1157,10052
6/18/2017,2017,6,18, 11 ,7698,1508,1209,10415
6/18/2017,2017,6,18, 12 ,7681,1479,1209,10369
6/18/2017,2017,6,18, 13 ,7759,1486,1222,10467
6/18/2017,2017,6,18, 14 ,7919,1511,1237,10667
6/18/2017,2017,6,18, 15 ,7855,1512,1205,10572
6/18/2017,2017,6,18, 16 ,7570,1479,1176,10225
6/18/2017,2017,6,18, 17 ,7372,1472,1176,10020
6/18/2017,2017,6,18, 18 ,7426,1552,1257,10235
6/18/2017,2017,6,18, 19 ,8030,1722,1376,11128
6/18/2017,2017,6,18, 20 ,8231,1704,1351,11286
6/18/2017,2017,6,18, 21 ,8186,1657,1307,11150
6/18/2017,2017,6,18, 22 ,8101,1546,1217,10864
6/18/2017,2017,6,18, 23 ,7857,1457,1112,10426
6/18/2017,2017,6,18, 24 ,7485,1355,1033,9873
6/19/2017,2017,6,19, 1 ,7139,1294,989,9422
6/19/2017,2017,6,19, 2 ,6904,1266,908,9078
6/19/2017,2017,6,19, 3 ,6617,1231,887,8735
6/19/2017,2017,6,19, 4 ,6457,1211,873,8541
6/19/2017,2017,6,19, 5 ,6495,1259,990,8744
6/19/2017,2017,6,19, 6 ,6336,1243,987,8566
6/19/2017,2017,6,19, 7 ,6695,1222,915,8832
6/19/2017,2017,6,19, 8 ,7689,1422,1116,10227
6/19/2017,2017,6,19, 9 ,8562,1650,1313,11525
6/19/2017,2017,6,19, 10 ,9128,1736,1448,12312
6/19/2017,2017,6,19, 11 ,9433,1801,1519,12753
6/19/2017,2017,6,19, 12 ,9333,1777,1502,12612
6/19/2017,2017,6,19, 13 ,9393,1771,1501,12665
6/19/2017,2017,6,19, 14 ,9716,1829,1582,13127
6/19/2017,2017,6,19, 15 ,9666,1837,1542,13045
6/19/2017,2017,6,19, 16 ,9456,1809,1496,12761
6/19/2017,2017,6,19, 17 ,8937,1746,1471,12154
6/19/2017,2017,6,19, 18 ,8582,1750,1481,11813
6/19/2017,2017,6,19, 19 ,8829,1874,1514,12217
6/19/2017,2017,6,19, 20 ,8860,1805,1464,12129
6/19/2017,2017,6,19, 21 ,8788,1707,1401,11896
6/19/2017,2017,6,19, 22 ,8474,1580,1271,11325
6/19/2017,2017,6,19, 23 ,8106,1485,1160,10751
6/19/2017,2017,6,19, 24 ,7769,1416,1089,10274
6/20/2017,2017,6,20, 1 ,7389,1351,1043,9783
6/20/2017,2017,6,20, 2 ,7142,1312,1005,9459
6/20/2017,2017,6,20, 3 ,6875,1266,991,9132
6/20/2017,2017,6,20, 4 ,6721,1246,985,8952
6/20/2017,2017,6,20, 5 ,6797,1295,1052,9144
6/20/2017,2017,6,20, 6 ,6573,1264,1038,8875
6/20/2017,2017,6,20, 7 ,6828,1233,981,9042
6/20/2017,2017,6,20, 8 ,7861,1438,1164,10463
6/20/2017,2017,6,20, 9 ,8799,1641,1308,11748
6/20/2017,2017,6,20, 10 ,9273,1731,1467,12471
6/20/2017,2017,6,20, 11 ,9537,1786,1545,12868
6/20/2017,2017,6,20, 12 ,9394,1757,1518,12669
6/20/2017,2017,6,20, 13 ,9466,1746,1525,12737
6/20/2017,2017,6,20, 14 ,9789,1797,1569,13155
6/20/2017,2017,6,20, 15 ,9652,1787,1536,12975
6/20/2017,2017,6,20, 16 ,9325,1748,1506,12579
6/20/2017,2017,6,20, 17 ,8902,1697,1456,12055
6/20/2017,2017,6,20, 18 ,8554,1714,1474,11742
6/20/2017,2017,6,20, 19 ,8871,1835,1540,12246
6/20/2017,2017,6,20, 20 ,8883,1785,1434,12102
6/20/2017,2017,6,20, 21 ,8835,1678,1412,11925
6/20/2017,2017,6,20, 22 ,8421,1590,1259,11270
6/20/2017,2017,6,20, 23 ,8064,1464,1154,10682
6/20/2017,2017,6,20, 24 ,7645,1387,1084,10116
6/21/2017,2017,6,21, 1 ,7330,1337,1029,9696
6/21/2017,2017,6,21, 2 ,7048,1284,1015,9347
6/21/2017,2017,6,21, 3 ,6881,1226,1000,9107
6/21/2017,2017,6,21, 4 ,6745,1220,985,8950
6/21/2017,2017,6,21, 5 ,6816,1261,1042,9119
6/21/2017,2017,6,21, 6 ,6652,1255,1020,8927
6/21/2017,2017,6,21, 7 ,6913,1218,976,9107
6/21/2017,2017,6,21, 8 ,7934,1419,1130,10483
6/21/2017,2017,6,21, 9 ,8771,1635,1326,11732
6/21/2017,2017,6,21, 10 ,9305,1748,1437,12490
6/21/2017,2017,6,21, 11 ,9568,1811,1513,12892
6/21/2017,2017,6,21, 12 ,9431,1709,1469,12609
6/21/2017,2017,6,21, 13 ,9356,1679,1462,12497
6/21/2017,2017,6,21, 14 ,9684,1742,1497,12923
6/21/2017,2017,6,21, 15 ,9592,1727,1458,12777
6/21/2017,2017,6,21, 16 ,9398,1718,1447,12563
6/21/2017,2017,6,21, 17 ,8957,1712,1386,12055
6/21/2017,2017,6,21, 18 ,8624,1719,1446,11789
6/21/2017,2017,6,21, 19 ,8884,1818,1430,12132
6/21/2017,2017,6,21, 20 ,8923,1748,1372,12043
6/21/2017,2017,6,21, 21 ,8808,1668,1303,11779
6/21/2017,2017,6,21, 22 ,8510,1552,1154,11216
6/21/2017,2017,6,21, 23 ,8064,1429,1136,10629
6/21/2017,2017,6,21, 24 ,7669,1336,1075,10080
6/22/2017,2017,6,22, 1 ,7367,1305,1015,9687
6/22/2017,2017,6,22, 2 ,7107,1263,994,9364
6/22/2017,2017,6,22, 3 ,6758,1228,965,8951
6/22/2017,2017,6,22, 4 ,6639,1213,959,8811
6/22/2017,2017,6,22, 5 ,6794,1258,1024,9076
6/22/2017,2017,6,22, 6 ,6611,1259,1043,8913
6/22/2017,2017,6,22, 7 ,6890,1207,983,9080
6/22/2017,2017,6,22, 8 ,7848,1384,1118,10350
6/22/2017,2017,6,22, 9 ,8718,1604,1282,11604
6/22/2017,2017,6,22, 10 ,9246,1700,1402,12348
6/22/2017,2017,6,22, 11 ,9468,1768,1443,12679
6/22/2017,2017,6,22, 12 ,9240,1755,1431,12426
6/22/2017,2017,6,22, 13 ,9229,1750,1422,12401
6/22/2017,2017,6,22, 14 ,9512,1790,1518,12820
6/22/2017,2017,6,22, 15 ,9440,1762,1510,12712
6/22/2017,2017,6,22, 16 ,9208,1769,1485,12462
6/22/2017,2017,6,22, 17 ,8751,1675,1451,11877
6/22/2017,2017,6,22, 18 ,8459,1722,1474,11655
6/22/2017,2017,6,22, 19 ,8649,1797,1538,11984
6/22/2017,2017,6,22, 20 ,8648,1739,1417,11804
6/22/2017,2017,6,22, 21 ,8500,1653,1375,11528
6/22/2017,2017,6,22, 22 ,8198,1522,1266,10986
6/22/2017,2017,6,22, 23 ,7809,1416,1164,10389
6/22/2017,2017,6,22, 24 ,7308,1347,1084,9739
6/23/2017,2017,6,23, 1 ,7035,1293,1044,9372
6/23/2017,2017,6,23, 2 ,6859,1246,1020,9125
6/23/2017,2017,6,23, 3 ,6664,1215,1003,8882
6/23/2017,2017,6,23, 4 ,6520,1200,984,8704
6/23/2017,2017,6,23, 5 ,6548,1247,1021,8816
6/23/2017,2017,6,23, 6 ,6485,1256,1037,8778
6/23/2017,2017,6,23, 7 ,6704,1229,974,8907
6/23/2017,2017,6,23, 8 ,7435,1397,1161,9993
6/23/2017,2017,6,23, 9 ,8412,1631,1354,11397
6/23/2017,2017,6,23, 10 ,8987,1727,1491,12205
6/23/2017,2017,6,23, 11 ,9232,1805,1541,12578
6/23/2017,2017,6,23, 12 ,9099,1780,1504,12383
6/23/2017,2017,6,23, 13 ,9135,1771,1521,12427
6/23/2017,2017,6,23, 14 ,9414,1857,1598,12869
6/23/2017,2017,6,23, 15 ,9343,1841,1586,12770
6/23/2017,2017,6,23, 16 ,9162,1772,1537,12471
6/23/2017,2017,6,23, 17 ,8715,1692,1478,11885
6/23/2017,2017,6,23, 18 ,8399,1711,1514,11624
6/23/2017,2017,6,23, 19 ,8818,1813,1537,12168
6/23/2017,2017,6,23, 20 ,8801,1740,1479,12020
6/23/2017,2017,6,23, 21 ,8689,1694,1416,11799
6/23/2017,2017,6,23, 22 ,8392,1556,1258,11206
6/23/2017,2017,6,23, 23 ,8022,1454,947,10423
6/23/2017,2017,6,23, 24 ,7599,1378,904,9881
6/24/2017,2017,6,24, 1 ,7285,1319,1074,9678
6/24/2017,2017,6,24, 2 ,7055,1266,1048,9369
6/24/2017,2017,6,24, 3 ,6814,1238,1022,9074
6/24/2017,2017,6,24, 4 ,6629,1213,992,8834
6/24/2017,2017,6,24, 5 ,6497,1213,962,8672
6/24/2017,2017,6,24, 6 ,6317,1186,968,8471
6/24/2017,2017,6,24, 7 ,6550,1209,961,8720
6/24/2017,2017,6,24, 8 ,7219,1314,995,9528
6/24/2017,2017,6,24, 9 ,7941,1458,1114,10513
6/24/2017,2017,6,24, 10 ,8442,1562,1250,11254
6/24/2017,2017,6,24, 11 ,8769,1621,1322,11712
6/24/2017,2017,6,24, 12 ,8605,1582,1313,11500
6/24/2017,2017,6,24, 13 ,8625,1588,1349,11562
6/24/2017,2017,6,24, 14 ,8956,1634,1390,11980
6/24/2017,2017,6,24, 15 ,8884,1621,1381,11886
6/24/2017,2017,6,24, 16 ,8589,1582,1360,11531
6/24/2017,2017,6,24, 17 ,8143,1530,1327,11000
6/24/2017,2017,6,24, 18 ,7874,1587,1398,10859
6/24/2017,2017,6,24, 19 ,8248,1733,1460,11441
6/24/2017,2017,6,24, 20 ,8392,1709,1459,11560
6/24/2017,2017,6,24, 21 ,8376,1648,1428,11452
6/24/2017,2017,6,24, 22 ,8210,1561,1320,11091
6/24/2017,2017,6,24, 23 ,7939,1445,1199,10583
6/24/2017,2017,6,24, 24 ,7437,1365,1090,9892
6/25/2017,2017,6,25, 1 ,7178,1304,1067,9549
6/25/2017,2017,6,25, 2 ,6916,1252,1034,9202
6/25/2017,2017,6,25, 3 ,6744,1224,993,8961
6/25/2017,2017,6,25, 4 ,6525,1196,962,8683
6/25/2017,2017,6,25, 5 ,6397,1184,923,8504
6/25/2017,2017,6,25, 6 ,6043,1145,896,8084
6/25/2017,2017,6,25, 7 ,6079,1161,889,8129
6/25/2017,2017,6,25, 8 ,6435,1228,957,8620
6/25/2017,2017,6,25, 9 ,6977,1320,1044,9341
6/25/2017,2017,6,25, 10 ,7466,1427,1186,10079
6/25/2017,2017,6,25, 11 ,7776,1463,1251,10490
6/25/2017,2017,6,25, 12 ,7818,1476,1245,10539
6/25/2017,2017,6,25, 13 ,7891,1475,1233,10599
6/25/2017,2017,6,25, 14 ,7970,1496,1255,10721
6/25/2017,2017,6,25, 15 ,7915,1475,1223,10613
6/25/2017,2017,6,25, 16 ,7562,1445,1196,10203
6/25/2017,2017,6,25, 17 ,7248,1446,1180,9874
6/25/2017,2017,6,25, 18 ,7221,1519,1272,10012
6/25/2017,2017,6,25, 19 ,7670,1727,1364,10761
6/25/2017,2017,6,25, 20 ,7759,1689,1335,10783
6/25/2017,2017,6,25, 21 ,7680,1649,1282,10611
6/25/2017,2017,6,25, 22 ,7557,1549,1167,10273
6/25/2017,2017,6,25, 23 ,7287,1458,1093,9838
6/25/2017,2017,6,25, 24 ,6920,1390,1083,9393
6/26/2017,2017,6,26, 1 ,6615,1315,988,8918
6/26/2017,2017,6,26, 2 ,6411,1269,954,8634
6/26/2017,2017,6,26, 3 ,6198,1229,920,8347
6/26/2017,2017,6,26, 4 ,6015,1200,903,8118
6/26/2017,2017,6,26, 5 ,5950,1195,921,8066
6/26/2017,2017,6,26, 6 ,5776,1177,910,7863
6/26/2017,2017,6,26, 7 ,5946,1205,936,8087
6/26/2017,2017,6,26, 8 ,6455,1303,1034,8792
6/26/2017,2017,6,26, 9 ,7105,1449,1148,9702
6/26/2017,2017,6,26, 10 ,7599,1556,1269,10424
6/26/2017,2017,6,26, 11 ,7954,1606,1341,10901
6/26/2017,2017,6,26, 12 ,7922,1582,1348,10852
6/26/2017,2017,6,26, 13 ,8082,1628,1353,11063
6/26/2017,2017,6,26, 14 ,8315,1611,1360,11286
6/26/2017,2017,6,26, 15 ,8301,1597,1362,11260
6/26/2017,2017,6,26, 16 ,7954,1567,1322,10843
6/26/2017,2017,6,26, 17 ,7683,1537,1321,10541
6/26/2017,2017,6,26, 18 ,7715,1611,1417,10743
6/26/2017,2017,6,26, 19 ,8248,1744,1479,11471
6/26/2017,2017,6,26, 20 ,8443,1703,1428,11574
6/26/2017,2017,6,26, 21 ,8437,1638,1355,11430
6/26/2017,2017,6,26, 22 ,8126,1524,1243,10893
6/26/2017,2017,6,26, 23 ,7814,1416,1130,10360
6/26/2017,2017,6,26, 24 ,7368,1342,1069,9779
6/27/2017,2017,6,27, 1 ,7075,1291,1024,9390
6/27/2017,2017,6,27, 2 ,6754,1239,986,8979
6/27/2017,2017,6,27, 3 ,6545,1205,955,8705
6/27/2017,2017,6,27, 4 ,6433,1197,954,8584
6/27/2017,2017,6,27, 5 ,6480,1231,1024,8735
6/27/2017,2017,6,27, 6 ,6422,1254,1033,8709
6/27/2017,2017,6,27, 7 ,6701,1212,979,8892
6/27/2017,2017,6,27, 8 ,7654,1397,1148,10199
6/27/2017,2017,6,27, 9 ,8534,1623,1362,11519
6/27/2017,2017,6,27, 10 ,9098,1735,1484,12317
6/27/2017,2017,6,27, 11 ,9465,1826,1566,12857
6/27/2017,2017,6,27, 12 ,9251,1781,1540,12572
6/27/2017,2017,6,27, 13 ,9258,1786,1540,12584
6/27/2017,2017,6,27, 14 ,9276,1842,1606,12724
6/27/2017,2017,6,27, 15 ,9074,1804,1591,12469
6/27/2017,2017,6,27, 16 ,9022,1766,1551,12339
6/27/2017,2017,6,27, 17 ,8756,1712,1477,11945
6/27/2017,2017,6,27, 18 ,8463,1719,1526,11708
6/27/2017,2017,6,27, 19 ,8824,1814,1555,12193
6/27/2017,2017,6,27, 20 ,8850,1756,1512,12118
6/27/2017,2017,6,27, 21 ,8665,1676,1420,11761
6/27/2017,2017,6,27, 22 ,8405,1524,1289,11218
6/27/2017,2017,6,27, 23 ,8004,1424,1198,10626
6/27/2017,2017,6,27, 24 ,7597,1352,1110,10059
6/28/2017,2017,6,28, 1 ,7277,1291,1060,9628
6/28/2017,2017,6,28, 2 ,6972,1255,1035,9262
6/28/2017,2017,6,28, 3 ,6798,1218,997,9013
6/28/2017,2017,6,28, 4 ,6643,1202,1004,8849
6/28/2017,2017,6,28, 5 ,6661,1248,1064,8973
6/28/2017,2017,6,28, 6 ,6576,1252,1070,8898
6/28/2017,2017,6,28, 7 ,6797,1214,1004,9015
6/28/2017,2017,6,28, 8 ,7844,1412,1174,10430
6/28/2017,2017,6,28, 9 ,8650,1619,1382,11651
6/28/2017,2017,6,28, 10 ,9152,1734,1499,12385
6/28/2017,2017,6,28, 11 ,9383,1754,1570,12707
6/28/2017,2017,6,28, 12 ,9058,1766,1552,12376
6/28/2017,2017,6,28, 13 ,9032,1747,1567,12346
6/28/2017,2017,6,28, 14 ,9322,1773,1624,12719
6/28/2017,2017,6,28, 15 ,9180,1769,1619,12568
6/28/2017,2017,6,28, 16 ,8978,1728,1540,12246
6/28/2017,2017,6,28, 17 ,8663,1671,1481,11815
6/28/2017,2017,6,28, 18 ,8308,1678,1511,11497
6/28/2017,2017,6,28, 19 ,8542,1712,1573,11827
6/28/2017,2017,6,28, 20 ,8458,1682,1495,11635
6/28/2017,2017,6,28, 21 ,8255,1588,1405,11248
6/28/2017,2017,6,28, 22 ,7933,1459,1289,10681
6/28/2017,2017,6,28, 23 ,7520,1368,1199,10087
6/28/2017,2017,6,28, 24 ,7160,1299,1175,9634
6/29/2017,2017,6,29, 1 ,6833,1237,1076,9146
6/29/2017,2017,6,29, 2 ,6588,1195,1030,8813
6/29/2017,2017,6,29, 3 ,6415,1169,1007,8591
6/29/2017,2017,6,29, 4 ,6329,1157,990,8476
6/29/2017,2017,6,29, 5 ,6460,1202,1045,8707
6/29/2017,2017,6,29, 6 ,6347,1217,1071,8635
6/29/2017,2017,6,29, 7 ,6532,1190,1012,8734
6/29/2017,2017,6,29, 8 ,7411,1390,1144,9945
6/29/2017,2017,6,29, 9 ,8294,1640,1304,11238
6/29/2017,2017,6,29, 10 ,8829,1738,1414,11981
6/29/2017,2017,6,29, 11 ,9176,1814,1463,12453
6/29/2017,2017,6,29, 12 ,8997,1769,1455,12221
6/29/2017,2017,6,29, 13 ,9067,1772,1464,12303
6/29/2017,2017,6,29, 14 ,9418,1842,1536,12796
6/29/2017,2017,6,29, 15 ,9258,1846,1541,12645
6/29/2017,2017,6,29, 16 ,8959,1797,1515,12271
6/29/2017,2017,6,29, 17 ,8564,1718,1459,11741
6/29/2017,2017,6,29, 18 ,8324,1729,1504,11557
6/29/2017,2017,6,29, 19 ,8524,1834,1550,11908
6/29/2017,2017,6,29, 20 ,8544,1760,1496,11800
6/29/2017,2017,6,29, 21 ,8467,1689,1412,11568
6/29/2017,2017,6,29, 22 ,8117,1538,1283,10938
6/29/2017,2017,6,29, 23 ,7645,1438,1172,10255
6/29/2017,2017,6,29, 24 ,7297,1377,1120,9794
6/30/2017,2017,6,30, 1 ,6953,1310,1072,9335
6/30/2017,2017,6,30, 2 ,6721,1263,1038,9022
6/30/2017,2017,6,30, 3 ,6529,1214,1015,8758
6/30/2017,2017,6,30, 4 ,6445,1201,1011,8657
6/30/2017,2017,6,30, 5 ,6503,1240,1058,8801
6/30/2017,2017,6,30, 6 ,6404,1261,1062,8727
6/30/2017,2017,6,30, 7 ,6657,1204,1014,8875
6/30/2017,2017,6,30, 8 ,7574,1373,1169,10116
6/30/2017,2017,6,30, 9 ,8496,1597,1366,11459
6/30/2017,2017,6,30, 10 ,8990,1710,1502,12202
6/30/2017,2017,6,30, 11 ,9283,1751,1543,12577
6/30/2017,2017,6,30, 12 ,9073,1751,1531,12355
6/30/2017,2017,6,30, 13 ,9172,1744,1570,12486
6/30/2017,2017,6,30, 14 ,9502,1805,1619,12926
6/30/2017,2017,6,30, 15 ,9411,1788,1594,12793
6/30/2017,2017,6,30, 16 ,9157,1752,1558,12467
6/30/2017,2017,6,30, 17 ,8555,1680,1490,11725
6/30/2017,2017,6,30, 18 ,8271,1697,1508,11476
6/30/2017,2017,6,30, 19 ,8420,1781,1542,11743
6/30/2017,2017,6,30, 20 ,8492,1742,1481,11715
6/30/2017,2017,6,30, 21 ,8410,1629,1380,11419
6/30/2017,2017,6,30, 22 ,8080,1458,1262,10800
6/30/2017,2017,6,30, 23 ,7758,1379,1175,10312
6/30/2017,2017,6,30, 24 ,7353,1308,1089,9750
7/1/2017,2017,7,1, 1 ,7178,1244,1040,9462
7/1/2017,2017,7,1, 2 ,6916,1206,1017,9139
7/1/2017,2017,7,1, 3 ,6744,1176,990,8910
7/1/2017,2017,7,1, 4 ,6525,1146,953,8624
7/1/2017,2017,7,1, 5 ,6397,1150,978,8525
7/1/2017,2017,7,1, 6 ,6218,1156,998,8372
7/1/2017,2017,7,1, 7 ,6380,1176,1005,8561
7/1/2017,2017,7,1, 8 ,7047,1293,1067,9407
7/1/2017,2017,7,1, 9 ,7784,1465,1190,10439
7/1/2017,2017,7,1, 10 ,8322,1579,1311,11212
7/1/2017,2017,7,1, 11 ,8620,1666,1401,11687
7/1/2017,2017,7,1, 12 ,8505,1633,1377,11515
7/1/2017,2017,7,1, 13 ,8519,1635,1388,11542
7/1/2017,2017,7,1, 14 ,8781,1692,1438,11911
7/1/2017,2017,7,1, 15 ,8750,1638,1416,11804
7/1/2017,2017,7,1, 16 ,8470,1619,1370,11459
7/1/2017,2017,7,1, 17 ,8023,1556,1345,10924
7/1/2017,2017,7,1, 18 ,7952,1601,1428,10981
7/1/2017,2017,7,1, 19 ,8211,1715,1458,11384
7/1/2017,2017,7,1, 20 ,8325,1676,1406,11407
7/1/2017,2017,7,1, 21 ,8296,1599,1344,11239
7/1/2017,2017,7,1, 22 ,8043,1491,1244,10778
7/1/2017,2017,7,1, 23 ,7709,1370,1138,10217
7/1/2017,2017,7,1, 24 ,7274,1307,1069,9650
7/2/2017,2017,7,2, 1 ,6976,1249,1021,9246
7/2/2017,2017,7,2, 2 ,6783,1204,982,8969
7/2/2017,2017,7,2, 3 ,6571,1167,950,8688
7/2/2017,2017,7,2, 4 ,6367,1143,948,8458
7/2/2017,2017,7,2, 5 ,6266,1139,955,8360
7/2/2017,2017,7,2, 6 ,5940,1118,967,8025
7/2/2017,2017,7,2, 7 ,6001,1137,962,8100
7/2/2017,2017,7,2, 8 ,6329,1177,981,8487
7/2/2017,2017,7,2, 9 ,6788,1310,1047,9145
7/2/2017,2017,7,2, 10 ,7244,1377,1162,9783
7/2/2017,2017,7,2, 11 ,7570,1469,1227,10266
7/2/2017,2017,7,2, 12 ,7570,1461,1257,10288
7/2/2017,2017,7,2, 13 ,7683,1472,1247,10402
7/2/2017,2017,7,2, 14 ,7745,1468,1255,10468
7/2/2017,2017,7,2, 15 ,7563,1407,1212,10182
7/2/2017,2017,7,2, 16 ,7169,1385,1151,9705
7/2/2017,2017,7,2, 17 ,6993,1403,1186,9582
7/2/2017,2017,7,2, 18 ,7158,1481,1259,9898
7/2/2017,2017,7,2, 19 ,7650,1624,1316,10590
7/2/2017,2017,7,2, 20 ,7696,1598,1312,10606
7/2/2017,2017,7,2, 21 ,7678,1542,1253,10473
7/2/2017,2017,7,2, 22 ,7413,1431,1116,9960
7/2/2017,2017,7,2, 23 ,7039,1314,1028,9381
7/2/2017,2017,7,2, 24 ,6672,1229,981,8882
7/3/2017,2017,7,3, 1 ,6360,1186,948,8494
7/3/2017,2017,7,3, 2 ,6154,1136,912,8202
7/3/2017,2017,7,3, 3 ,5901,1102,907,7910
7/3/2017,2017,7,3, 4 ,5826,1099,900,7825
7/3/2017,2017,7,3, 5 ,5973,1152,965,8090
7/3/2017,2017,7,3, 6 ,6007,1200,970,8177
7/3/2017,2017,7,3, 7 ,6277,1154,947,8378
7/3/2017,2017,7,3, 8 ,7178,1306,1086,9570
7/3/2017,2017,7,3, 9 ,8127,1539,1266,10932
7/3/2017,2017,7,3, 10 ,8732,1660,1399,11791
7/3/2017,2017,7,3, 11 ,9074,1694,1477,12245
7/3/2017,2017,7,3, 12 ,8883,1689,1437,12009
7/3/2017,2017,7,3, 13 ,8947,1671,1439,12057
7/3/2017,2017,7,3, 14 ,9150,1743,1482,12375
7/3/2017,2017,7,3, 15 ,8974,1741,1465,12180
7/3/2017,2017,7,3, 16 ,8643,1704,1437,11784
7/3/2017,2017,7,3, 17 ,8320,1642,1467,11429
7/3/2017,2017,7,3, 18 ,8154,1667,1509,11330
7/3/2017,2017,7,3, 19 ,8347,1763,1564,11674
7/3/2017,2017,7,3, 20 ,8243,1713,1502,11458
7/3/2017,2017,7,3, 21 ,8065,1623,1411,11099
7/3/2017,2017,7,3, 22 ,7725,1470,1217,10412
7/3/2017,2017,7,3, 23 ,7214,1363,1148,9725
7/3/2017,2017,7,3, 24 ,6868,1292,1080,9240
7/4/2017,2017,7,4, 1 ,6607,1230,1063,8900
7/4/2017,2017,7,4, 2 ,6426,1202,1032,8660
7/4/2017,2017,7,4, 3 ,6223,1165,1014,8402
7/4/2017,2017,7,4, 4 ,6216,1158,1009,8383
7/4/2017,2017,7,4, 5 ,6310,1227,1061,8598
7/4/2017,2017,7,4, 6 ,6349,1238,1102,8689
7/4/2017,2017,7,4, 7 ,6505,1186,1012,8703
7/4/2017,2017,7,4, 8 ,7315,1357,1181,9853
7/4/2017,2017,7,4, 9 ,8119,1570,1350,11039
7/4/2017,2017,7,4, 10 ,8551,1663,1466,11680
7/4/2017,2017,7,4, 11 ,8897,1710,1508,12115
7/4/2017,2017,7,4, 12 ,8706,1634,1519,11859
7/4/2017,2017,7,4, 13 ,8725,1620,1510,11855
7/4/2017,2017,7,4, 14 ,9093,1718,1562,12373
7/4/2017,2017,7,4, 15 ,8970,1690,1535,12195
7/4/2017,2017,7,4, 16 ,8781,1682,1483,11946
7/4/2017,2017,7,4, 17 ,8350,1635,1454,11439
7/4/2017,2017,7,4, 18 ,8205,1659,1477,11341
7/4/2017,2017,7,4, 19 ,8442,1774,1523,11739
7/4/2017,2017,7,4, 20 ,8417,1718,1453,11588
7/4/2017,2017,7,4, 21 ,8273,1625,1375,11273
7/4/2017,2017,7,4, 22 ,7626,1473,1239,10338
7/4/2017,2017,7,4, 23 ,7417,1360,1132,9909
7/4/2017,2017,7,4, 24 ,7006,1278,1069,9353
7/5/2017,2017,7,5, 1 ,6684,1228,1012,8924
7/5/2017,2017,7,5, 2 ,6522,1192,994,8708
7/5/2017,2017,7,5, 3 ,6332,1156,960,8448
7/5/2017,2017,7,5, 4 ,6253,1136,958,8347
7/5/2017,2017,7,5, 5 ,6328,1188,1021,8537
7/5/2017,2017,7,5, 6 ,6380,1210,1047,8637
7/5/2017,2017,7,5, 7 ,6524,1161,973,8658
7/5/2017,2017,7,5, 8 ,7389,1367,1135,9891
7/5/2017,2017,7,5, 9 ,8162,1616,1324,11102
7/5/2017,2017,7,5, 10 ,8540,1734,1458,11732
7/5/2017,2017,7,5, 11 ,8873,1804,1505,12182
7/5/2017,2017,7,5, 12 ,8706,1754,1493,11953
7/5/2017,2017,7,5, 13 ,8757,1725,1471,11953
7/5/2017,2017,7,5, 14 ,9177,1829,1529,12535
7/5/2017,2017,7,5, 15 ,9080,1808,1528,12416
7/5/2017,2017,7,5, 16 ,8921,1788,1501,12210
7/5/2017,2017,7,5, 17 ,8527,1701,1451,11679
7/5/2017,2017,7,5, 18 ,8302,1676,1466,11444
7/5/2017,2017,7,5, 19 ,8430,1813,1544,11787
7/5/2017,2017,7,5, 20 ,8400,1745,1481,11626
7/5/2017,2017,7,5, 21 ,8222,1693,1424,11339
7/5/2017,2017,7,5, 22 ,7870,1551,1276,10697
7/5/2017,2017,7,5, 23 ,7449,1439,1164,10052
7/5/2017,2017,7,5, 24 ,7016,1347,1103,9466
7/6/2017,2017,7,6, 1 ,6722,1276,1019,9017
7/6/2017,2017,7,6, 2 ,6475,1241,991,8707
7/6/2017,2017,7,6, 3 ,6364,1190,958,8512
7/6/2017,2017,7,6, 4 ,6229,1191,951,8371
7/6/2017,2017,7,6, 5 ,6379,1234,1020,8633
7/6/2017,2017,7,6, 6 ,6301,1252,1045,8598
7/6/2017,2017,7,6, 7 ,6514,1200,968,8682
7/6/2017,2017,7,6, 8 ,7548,1397,1150,10095
7/6/2017,2017,7,6, 9 ,8417,1624,1331,11372
7/6/2017,2017,7,6, 10 ,8946,1741,1379,12066
7/6/2017,2017,7,6, 11 ,9236,1801,1456,12493
7/6/2017,2017,7,6, 12 ,9029,1754,1427,12210
7/6/2017,2017,7,6, 13 ,9037,1748,1465,12250
7/6/2017,2017,7,6, 14 ,9483,1780,1533,12796
7/6/2017,2017,7,6, 15 ,9358,1842,1524,12724
7/6/2017,2017,7,6, 16 ,9091,1770,1495,12356
7/6/2017,2017,7,6, 17 ,8599,1264,1453,11316
7/6/2017,2017,7,6, 18 ,8367,1314,1478,11159
7/6/2017,2017,7,6, 19 ,8576,1394,1503,11473
7/6/2017,2017,7,6, 20 ,8561,1384,1429,11374
7/6/2017,2017,7,6, 21 ,8535,1353,1356,11244
7/6/2017,2017,7,6, 22 ,8144,1269,1216,10629
7/6/2017,2017,7,6, 23 ,7710,1184,1119,10013
7/6/2017,2017,7,6, 24 ,7355,1120,1100,9575
7/7/2017,2017,7,7, 1 ,6980,1064,1018,9062
7/7/2017,2017,7,7, 2 ,6794,1018,983,8795
7/7/2017,2017,7,7, 3 ,6604,999,951,8554
7/7/2017,2017,7,7, 4 ,6485,982,944,8411
7/7/2017,2017,7,7, 5 ,6599,1021,998,8618
7/7/2017,2017,7,7, 6 ,6433,1045,1056,8534
7/7/2017,2017,7,7, 7 ,6688,1015,987,8690
7/7/2017,2017,7,7, 8 ,7665,1124,1107,9896
7/7/2017,2017,7,7, 9 ,8593,1312,1291,11196
7/7/2017,2017,7,7, 10 ,9024,1407,1377,11808
7/7/2017,2017,7,7, 11 ,9359,1460,1498,12317
7/7/2017,2017,7,7, 12 ,9111,1420,1455,11986
7/7/2017,2017,7,7, 13 ,9078,1443,1457,11978
7/7/2017,2017,7,7, 14 ,9363,1508,1518,12389
7/7/2017,2017,7,7, 15 ,9280,1533,1513,12326
7/7/2017,2017,7,7, 16 ,9074,1473,1502,12049
7/7/2017,2017,7,7, 17 ,8702,1394,1438,11534
7/7/2017,2017,7,7, 18 ,8385,1381,1460,11226
7/7/2017,2017,7,7, 19 ,8732,1458,1502,11692
7/7/2017,2017,7,7, 20 ,8754,1399,1435,11588
7/7/2017,2017,7,7, 21 ,8640,1342,1369,11351
7/7/2017,2017,7,7, 22 ,8303,1269,1246,10818
7/7/2017,2017,7,7, 23 ,7947,1190,1147,10284
7/7/2017,2017,7,7, 24 ,7567,1104,1081,9752
7/8/2017,2017,7,8, 1 ,7247,1081,1031,9359
7/8/2017,2017,7,8, 2 ,7005,1055,1000,9060
7/8/2017,2017,7,8, 3 ,6809,1026,974,8809
7/8/2017,2017,7,8, 4 ,6611,1019,962,8592
7/8/2017,2017,7,8, 5 ,6553,959,957,8469
7/8/2017,2017,7,8, 6 ,6321,971,1006,8298
7/8/2017,2017,7,8, 7 ,6535,992,992,8519
7/8/2017,2017,7,8, 8 ,7194,1117,1099,9410
7/8/2017,2017,7,8, 9 ,7772,1251,1211,10234
7/8/2017,2017,7,8, 10 ,8234,1294,1333,10861
7/8/2017,2017,7,8, 11 ,8466,1342,1389,11197
7/8/2017,2017,7,8, 12 ,8281,1315,1392,10988
7/8/2017,2017,7,8, 13 ,8302,1318,1413,11033
7/8/2017,2017,7,8, 14 ,8657,1355,1481,11493
7/8/2017,2017,7,8, 15 ,8576,1354,1439,11369
7/8/2017,2017,7,8, 16 ,8313,1330,1385,11028
7/8/2017,2017,7,8, 17 ,7907,1298,1366,10571
7/8/2017,2017,7,8, 18 ,7848,1371,1424,10643
7/8/2017,2017,7,8, 19 ,8142,1403,1450,10995
7/8/2017,2017,7,8, 20 ,8121,1375,1374,10870
7/8/2017,2017,7,8, 21 ,7994,1311,1309,10614
7/8/2017,2017,7,8, 22 ,7740,1259,1248,10247
7/8/2017,2017,7,8, 23 ,7434,1155,1160,9749
7/8/2017,2017,7,8, 24 ,7009,1088,1070,9167
7/9/2017,2017,7,9, 1 ,6719,1041,1012,8772
7/9/2017,2017,7,9, 2 ,6451,1006,983,8440
7/9/2017,2017,7,9, 3 ,6263,981,960,8204
7/9/2017,2017,7,9, 4 ,6080,977,943,8000
7/9/2017,2017,7,9, 5 ,6015,986,962,7963
7/9/2017,2017,7,9, 6 ,5726,952,963,7641
7/9/2017,2017,7,9, 7 ,5806,959,930,7695
7/9/2017,2017,7,9, 8 ,6150,1013,987,8150
7/9/2017,2017,7,9, 9 ,6582,1095,1070,8747
7/9/2017,2017,7,9, 10 ,7138,1182,1153,9473
7/9/2017,2017,7,9, 11 ,7340,1240,1218,9798
7/9/2017,2017,7,9, 12 ,7296,1246,1234,9776
7/9/2017,2017,7,9, 13 ,7212,1233,1258,9703
7/9/2017,2017,7,9, 14 ,7263,1231,1254,9748
7/9/2017,2017,7,9, 15 ,7219,1201,1225,9645
7/9/2017,2017,7,9, 16 ,7060,1190,1215,9465
7/9/2017,2017,7,9, 17 ,6870,1193,1217,9280
7/9/2017,2017,7,9, 18 ,6990,1267,1322,9579
7/9/2017,2017,7,9, 19 ,7672,1370,1419,10461
7/9/2017,2017,7,9, 20 ,7884,1342,1393,10619
7/9/2017,2017,7,9, 21 ,7903,1292,1341,10536
7/9/2017,2017,7,9, 22 ,7680,1199,1218,10097
7/9/2017,2017,7,9, 23 ,7343,1111,1118,9572
7/9/2017,2017,7,9, 24 ,6931,1054,1048,9033
7/10/2017,2017,7,10, 1 ,6637,1013,1002,8652
7/10/2017,2017,7,10, 2 ,6358,985,979,8322
7/10/2017,2017,7,10, 3 ,6189,965,955,8109
7/10/2017,2017,7,10, 4 ,6075,956,948,7979
7/10/2017,2017,7,10, 5 ,6198,1006,1014,8218
7/10/2017,2017,7,10, 6 ,6246,1040,1045,8331
7/10/2017,2017,7,10, 7 ,6422,1028,915,8365
7/10/2017,2017,7,10, 8 ,7395,1165,1141,9701
7/10/2017,2017,7,10, 9 ,8414,1376,1347,11137
7/10/2017,2017,7,10, 10 ,8960,1414,1480,11854
7/10/2017,2017,7,10, 11 ,9242,1476,1553,12271
7/10/2017,2017,7,10, 12 ,9052,1473,1518,12043
7/10/2017,2017,7,10, 13 ,9065,1472,1525,12062
7/10/2017,2017,7,10, 14 ,9385,1526,1590,12501
7/10/2017,2017,7,10, 15 ,9297,1497,1561,12355
7/10/2017,2017,7,10, 16 ,9133,1496,1511,12140
7/10/2017,2017,7,10, 17 ,8756,1433,1473,11662
7/10/2017,2017,7,10, 18 ,8437,1399,1511,11347
7/10/2017,2017,7,10, 19 ,8708,1460,1525,11693
7/10/2017,2017,7,10, 20 ,8750,1450,1455,11655
7/10/2017,2017,7,10, 21 ,8634,1341,1355,11330
7/10/2017,2017,7,10, 22 ,8267,1248,1234,10749
7/10/2017,2017,7,10, 23 ,7734,1161,1141,10036
7/10/2017,2017,7,10, 24 ,7234,1086,1032,9352
7/11/2017,2017,7,11, 1 ,6933,1049,1020,9002
7/11/2017,2017,7,11, 2 ,6753,1028,995,8776
7/11/2017,2017,7,11, 3 ,6578,1004,980,8562
7/11/2017,2017,7,11, 4 ,6452,992,992,8436
7/11/2017,2017,7,11, 5 ,6529,1038,1035,8602
7/11/2017,2017,7,11, 6 ,6459,1067,1086,8612
7/11/2017,2017,7,11, 7 ,6697,1036,995,8728
7/11/2017,2017,7,11, 8 ,7575,1182,1141,9898
7/11/2017,2017,7,11, 9 ,8505,1357,1332,11194
7/11/2017,2017,7,11, 10 ,9003,1437,1430,11870
7/11/2017,2017,7,11, 11 ,9197,1452,1498,12147
7/11/2017,2017,7,11, 12 ,9002,1401,1482,11885
7/11/2017,2017,7,11, 13 ,9020,1415,1498,11933
7/11/2017,2017,7,11, 14 ,9327,1480,1561,12368
7/11/2017,2017,7,11, 15 ,9212,1432,1512,12156
7/11/2017,2017,7,11, 16 ,8816,1388,1487,11691
7/11/2017,2017,7,11, 17 ,8468,1367,1464,11299
7/11/2017,2017,7,11, 18 ,8234,1385,1496,11115
7/11/2017,2017,7,11, 19 ,8477,1433,1541,11451
7/11/2017,2017,7,11, 20 ,8541,1352,1435,11328
7/11/2017,2017,7,11, 21 ,8383,1320,1394,11097
7/11/2017,2017,7,11, 22 ,7993,1187,1261,10441
7/11/2017,2017,7,11, 23 ,7552,1113,1153,9818
7/11/2017,2017,7,11, 24 ,7125,1066,1070,9261
7/12/2017,2017,7,12, 1 ,6813,1025,1026,8864
7/12/2017,2017,7,12, 2 ,6677,999,1019,8695
7/12/2017,2017,7,12, 3 ,6405,977,977,8359
7/12/2017,2017,7,12, 4 ,6366,969,989,8324
7/12/2017,2017,7,12, 5 ,6417,1010,1049,8476
7/12/2017,2017,7,12, 6 ,6485,1045,1097,8627
7/12/2017,2017,7,12, 7 ,6652,999,989,8640
7/12/2017,2017,7,12, 8 ,7378,1163,1137,9678
7/12/2017,2017,7,12, 9 ,8129,1356,1351,10836
7/12/2017,2017,7,12, 10 ,8714,1431,1438,11583
7/12/2017,2017,7,12, 11 ,8992,1507,1513,12012
7/12/2017,2017,7,12, 12 ,8842,1437,1491,11770
7/12/2017,2017,7,12, 13 ,8891,1454,1509,11854
7/12/2017,2017,7,12, 14 ,9146,1486,1567,12199
7/12/2017,2017,7,12, 15 ,9021,1447,1547,12015
7/12/2017,2017,7,12, 16 ,8867,1434,1508,11809
7/12/2017,2017,7,12, 17 ,8608,1417,1438,11463
7/12/2017,2017,7,12, 18 ,8381,1405,1475,11261
7/12/2017,2017,7,12, 19 ,8559,1430,1521,11510
7/12/2017,2017,7,12, 20 ,8453,1373,1470,11296
7/12/2017,2017,7,12, 21 ,8274,1311,1408,10993
7/12/2017,2017,7,12, 22 ,7882,1217,1259,10358
7/12/2017,2017,7,12, 23 ,7451,1141,1173,9765
7/12/2017,2017,7,12, 24 ,7097,1071,1075,9243
7/13/2017,2017,7,13, 1 ,6833,1043,1026,8902
7/13/2017,2017,7,13, 2 ,6603,1018,1003,8624
7/13/2017,2017,7,13, 3 ,6383,995,987,8365
7/13/2017,2017,7,13, 4 ,6286,986,988,8260
7/13/2017,2017,7,13, 5 ,6426,1034,1057,8517
7/13/2017,2017,7,13, 6 ,6440,1058,1085,8583
7/13/2017,2017,7,13, 7 ,6589,1026,1011,8626
7/13/2017,2017,7,13, 8 ,7444,1158,1186,9788
7/13/2017,2017,7,13, 9 ,8422,1344,1368,11134
7/13/2017,2017,7,13, 10 ,8868,1414,1502,11784
7/13/2017,2017,7,13, 11 ,9100,1478,1538,12116
7/13/2017,2017,7,13, 12 ,8926,1439,1514,11879
7/13/2017,2017,7,13, 13 ,8944,1454,1555,11953
7/13/2017,2017,7,13, 14 ,9148,1510,1602,12260
7/13/2017,2017,7,13, 15 ,8908,1479,1587,11974
7/13/2017,2017,7,13, 16 ,8577,1465,1538,11580
7/13/2017,2017,7,13, 17 ,8332,1389,1470,11191
7/13/2017,2017,7,13, 18 ,8175,1379,1487,11041
7/13/2017,2017,7,13, 19 ,8318,1445,1553,11316
7/13/2017,2017,7,13, 20 ,8267,1365,1464,11096
7/13/2017,2017,7,13, 21 ,8159,1329,1380,10868
7/13/2017,2017,7,13, 22 ,7714,1206,1281,10201
7/13/2017,2017,7,13, 23 ,7320,1152,1192,9664
7/13/2017,2017,7,13, 24 ,6895,1108,1077,9080
7/14/2017,2017,7,14, 1 ,6613,1069,1071,8753
7/14/2017,2017,7,14, 2 ,6338,1044,1043,8425
7/14/2017,2017,7,14, 3 ,6180,1023,1017,8220
7/14/2017,2017,7,14, 4 ,6128,1024,1015,8167
7/14/2017,2017,7,14, 5 ,6315,1052,1070,8437
7/14/2017,2017,7,14, 6 ,6298,1100,1092,8490
7/14/2017,2017,7,14, 7 ,6475,1071,1026,8572
7/14/2017,2017,7,14, 8 ,7338,1214,1151,9703
7/14/2017,2017,7,14, 9 ,8177,1425,1348,10950
7/14/2017,2017,7,14, 10 ,8715,1467,1439,11621
7/14/2017,2017,7,14, 11 ,8975,1522,1498,11995
7/14/2017,2017,7,14, 12 ,8800,1487,1477,11764
7/14/2017,2017,7,14, 13 ,8792,1462,1485,11739
7/14/2017,2017,7,14, 14 ,9120,1509,1544,12173
7/14/2017,2017,7,14, 15 ,9004,1505,1527,12036
7/14/2017,2017,7,14, 16 ,8904,1497,1466,11867
7/14/2017,2017,7,14, 17 ,8464,1429,1370,11263
7/14/2017,2017,7,14, 18 ,8321,1443,1465,11229
7/14/2017,2017,7,14, 19 ,8380,1494,1486,11360
7/14/2017,2017,7,14, 20 ,8251,1443,1422,11116
7/14/2017,2017,7,14, 21 ,8087,1419,1366,10872
7/14/2017,2017,7,14, 22 ,7666,1349,1226,10241
7/14/2017,2017,7,14, 23 ,7215,1261,1137,9613
7/14/2017,2017,7,14, 24 ,6933,1191,1030,9154
7/15/2017,2017,7,15, 1 ,6650,1140,1025,8815
7/15/2017,2017,7,15, 2 ,6461,1123,995,8579
7/15/2017,2017,7,15, 3 ,6277,1099,969,8345
7/15/2017,2017,7,15, 4 ,6178,1072,950,8200
7/15/2017,2017,7,15, 5 ,6112,1077,966,8155
7/15/2017,2017,7,15, 6 ,6027,1105,989,8121
7/15/2017,2017,7,15, 7 ,6173,1124,997,8294
7/15/2017,2017,7,15, 8 ,6841,1243,1068,9152
7/15/2017,2017,7,15, 9 ,7545,1407,1172,10124
7/15/2017,2017,7,15, 10 ,8112,1495,1226,10833
7/15/2017,2017,7,15, 11 ,8385,1528,1347,11260
7/15/2017,2017,7,15, 12 ,8210,1490,1333,11033
7/15/2017,2017,7,15, 13 ,8154,1469,1330,10953
7/15/2017,2017,7,15, 14 ,8346,1497,1395,11238
7/15/2017,2017,7,15, 15 ,8295,1465,1366,11126
7/15/2017,2017,7,15, 16 ,8090,1408,1310,10808
7/15/2017,2017,7,15, 17 ,7870,1383,1298,10551
7/15/2017,2017,7,15, 18 ,7799,1436,1372,10607
7/15/2017,2017,7,15, 19 ,8094,1488,1424,11006
7/15/2017,2017,7,15, 20 ,8115,1469,1355,10939
7/15/2017,2017,7,15, 21 ,8068,1428,1337,10833
7/15/2017,2017,7,15, 22 ,7798,1386,1289,10473
7/15/2017,2017,7,15, 23 ,7335,1252,1169,9756
7/15/2017,2017,7,15, 24 ,6949,1173,1053,9175
7/16/2017,2017,7,16, 1 ,6616,1129,1042,8787
7/16/2017,2017,7,16, 2 ,6426,1094,1012,8532
7/16/2017,2017,7,16, 3 ,6168,1075,959,8202
7/16/2017,2017,7,16, 4 ,6065,1054,959,8078
7/16/2017,2017,7,16, 5 ,6003,1060,970,8033
7/16/2017,2017,7,16, 6 ,5693,1051,943,7687
7/16/2017,2017,7,16, 7 ,5788,1059,939,7786
7/16/2017,2017,7,16, 8 ,6098,1118,954,8170
7/16/2017,2017,7,16, 9 ,6658,1208,1004,8870
7/16/2017,2017,7,16, 10 ,6968,1293,1093,9354
7/16/2017,2017,7,16, 11 ,7200,1351,1146,9697
7/16/2017,2017,7,16, 12 ,7162,1337,1160,9659
7/16/2017,2017,7,16, 13 ,7112,1339,1220,9671
7/16/2017,2017,7,16, 14 ,7202,1324,1234,9760
7/16/2017,2017,7,16, 15 ,7061,1337,1217,9615
7/16/2017,2017,7,16, 16 ,6912,1304,1190,9406
7/16/2017,2017,7,16, 17 ,6844,1314,1196,9354
7/16/2017,2017,7,16, 18 ,7080,1375,1270,9725
7/16/2017,2017,7,16, 19 ,7527,1498,1406,10431
7/16/2017,2017,7,16, 20 ,7581,1468,1379,10428
7/16/2017,2017,7,16, 21 ,7604,1413,1326,10343
7/16/2017,2017,7,16, 22 ,7333,1346,1222,9901
7/16/2017,2017,7,16, 23 ,6931,1259,1095,9285
7/16/2017,2017,7,16, 24 ,6555,1180,1047,8782
7/17/2017,2017,7,17, 1 ,6330,1119,998,8447
7/17/2017,2017,7,17, 2 ,6089,1084,964,8137
7/17/2017,2017,7,17, 3 ,5858,1052,946,7856
7/17/2017,2017,7,17, 4 ,5783,1043,950,7776
7/17/2017,2017,7,17, 5 ,5947,1098,1008,8053
7/17/2017,2017,7,17, 6 ,6045,1140,1039,8224
7/17/2017,2017,7,17, 7 ,6314,1096,966,8376
7/17/2017,2017,7,17, 8 ,7319,1282,1107,9708
7/17/2017,2017,7,17, 9 ,8288,1525,1363,11176
7/17/2017,2017,7,17, 10 ,8936,1633,1500,12069
7/17/2017,2017,7,17, 11 ,9225,1695,1581,12501
7/17/2017,2017,7,17, 12 ,9068,1663,1552,12283
7/17/2017,2017,7,17, 13 ,9147,1648,1528,12323
7/17/2017,2017,7,17, 14 ,9453,1712,1598,12763
7/17/2017,2017,7,17, 15 ,9360,1682,1581,12623
7/17/2017,2017,7,17, 16 ,9158,1648,1528,12334
7/17/2017,2017,7,17, 17 ,8741,1578,1480,11799
7/17/2017,2017,7,17, 18 ,8474,1591,1507,11572
7/17/2017,2017,7,17, 19 ,8713,1655,1540,11908
7/17/2017,2017,7,17, 20 ,8789,1613,1467,11869
7/17/2017,2017,7,17, 21 ,8677,1540,1395,11612
7/17/2017,2017,7,17, 22 ,8272,1412,1240,10924
7/17/2017,2017,7,17, 23 ,7854,1321,1153,10328
7/17/2017,2017,7,17, 24 ,7385,1240,1076,9701
7/18/2017,2017,7,18, 1 ,7062,1201,1051,9314
7/18/2017,2017,7,18, 2 ,6866,1153,1026,9045
7/18/2017,2017,7,18, 3 ,6616,1129,975,8720
7/18/2017,2017,7,18, 4 ,6500,1117,902,8519
7/18/2017,2017,7,18, 5 ,6645,1151,1043,8839
7/18/2017,2017,7,18, 6 ,6597,1212,1086,8895
7/18/2017,2017,7,18, 7 ,6762,1165,1006,8933
7/18/2017,2017,7,18, 8 ,7656,1308,1131,10095
7/18/2017,2017,7,18, 9 ,8471,1496,1280,11247
7/18/2017,2017,7,18, 10 ,8919,1577,1388,11884
7/18/2017,2017,7,18, 11 ,9112,1637,1443,12192
7/18/2017,2017,7,18, 12 ,8832,1611,1430,11873
7/18/2017,2017,7,18, 13 ,8945,1617,1422,11984
7/18/2017,2017,7,18, 14 ,9169,1689,1465,12323
7/18/2017,2017,7,18, 15 ,9062,1681,1404,12147
7/18/2017,2017,7,18, 16 ,8924,1643,1392,11959
7/18/2017,2017,7,18, 17 ,8612,1582,1321,11515
7/18/2017,2017,7,18, 18 ,8417,1588,1331,11336
7/18/2017,2017,7,18, 19 ,8671,1653,1358,11682
7/18/2017,2017,7,18, 20 ,8640,1611,1347,11598
7/18/2017,2017,7,18, 21 ,8600,1526,1291,11417
7/18/2017,2017,7,18, 22 ,8203,1384,1156,10743
7/18/2017,2017,7,18, 23 ,7751,1240,1066,10057
7/18/2017,2017,7,18, 24 ,7322,1171,1049,9542
7/19/2017,2017,7,19, 1 ,6989,1134,989,9112
7/19/2017,2017,7,19, 2 ,6799,1097,972,8868
7/19/2017,2017,7,19, 3 ,6555,1063,937,8555
7/19/2017,2017,7,19, 4 ,6462,1052,936,8450
7/19/2017,2017,7,19, 5 ,6549,1095,1017,8661
7/19/2017,2017,7,19, 6 ,6540,1181,1054,8775
7/19/2017,2017,7,19, 7 ,6742,1131,979,8852
7/19/2017,2017,7,19, 8 ,7484,1274,1117,9875
7/19/2017,2017,7,19, 9 ,8141,1489,1290,10920
7/19/2017,2017,7,19, 10 ,8598,1551,1408,11557
7/19/2017,2017,7,19, 11 ,8757,1690,1479,11926
7/19/2017,2017,7,19, 12 ,8561,1646,1426,11633
7/19/2017,2017,7,19, 13 ,8540,1652,1419,11611
7/19/2017,2017,7,19, 14 ,8827,1722,1485,12034
7/19/2017,2017,7,19, 15 ,8813,1676,1467,11956
7/19/2017,2017,7,19, 16 ,8666,1616,1465,11747
7/19/2017,2017,7,19, 17 ,8259,1588,1428,11275
7/19/2017,2017,7,19, 18 ,8157,1594,1472,11223
7/19/2017,2017,7,19, 19 ,8459,1647,1440,11546
7/19/2017,2017,7,19, 20 ,8422,1586,1348,11356
7/19/2017,2017,7,19, 21 ,8395,1530,1306,11231
7/19/2017,2017,7,19, 22 ,7961,1431,1207,10599
7/19/2017,2017,7,19, 23 ,7478,1330,1098,9906
7/19/2017,2017,7,19, 24 ,7123,1237,1037,9397
7/20/2017,2017,7,20, 1 ,6826,1177,990,8993
7/20/2017,2017,7,20, 2 ,6578,1148,971,8697
7/20/2017,2017,7,20, 3 ,6360,1114,950,8424
7/20/2017,2017,7,20, 4 ,6293,1100,947,8340
7/20/2017,2017,7,20, 5 ,6422,1126,987,8535
7/20/2017,2017,7,20, 6 ,6434,1196,1062,8692
7/20/2017,2017,7,20, 7 ,6580,1145,1027,8752
7/20/2017,2017,7,20, 8 ,7290,1318,1093,9701
7/20/2017,2017,7,20, 9 ,8120,1525,1286,10931
7/20/2017,2017,7,20, 10 ,8604,1643,1387,11634
7/20/2017,2017,7,20, 11 ,8869,1691,1432,11992
7/20/2017,2017,7,20, 12 ,8615,1651,1417,11683
7/20/2017,2017,7,20, 13 ,8525,1649,1469,11643
7/20/2017,2017,7,20, 14 ,8783,1711,1483,11977
7/20/2017,2017,7,20, 15 ,8689,1703,1467,11859
7/20/2017,2017,7,20, 16 ,8522,1659,1445,11626
7/20/2017,2017,7,20, 17 ,8213,1595,1414,11222
7/20/2017,2017,7,20, 18 ,8111,1598,1475,11184
7/20/2017,2017,7,20, 19 ,8344,1696,1510,11550
7/20/2017,2017,7,20, 20 ,8343,1654,1468,11465
7/20/2017,2017,7,20, 21 ,8202,1588,1389,11179
7/20/2017,2017,7,20, 22 ,7817,1469,1243,10529
7/20/2017,2017,7,20, 23 ,7382,1376,1158,9916
7/20/2017,2017,7,20, 24 ,6990,1293,1088,9371
7/21/2017,2017,7,21, 1 ,6681,1241,1012,8934
7/21/2017,2017,7,21, 2 ,6402,1197,963,8562
7/21/2017,2017,7,21, 3 ,6291,1172,949,8412
7/21/2017,2017,7,21, 4 ,6124,1151,932,8207
7/21/2017,2017,7,21, 5 ,6298,1187,996,8481
7/21/2017,2017,7,21, 6 ,6331,1229,1041,8601
7/21/2017,2017,7,21, 7 ,6519,1178,962,8659
7/21/2017,2017,7,21, 8 ,7382,1362,1086,9830
7/21/2017,2017,7,21, 9 ,8161,1582,1289,11032
7/21/2017,2017,7,21, 10 ,8672,1694,1416,11782
7/21/2017,2017,7,21, 11 ,8991,1693,1497,12181
7/21/2017,2017,7,21, 12 ,8837,1630,1453,11920
7/21/2017,2017,7,21, 13 ,8859,1597,1455,11911
7/21/2017,2017,7,21, 14 ,9144,1608,1521,12273
7/21/2017,2017,7,21, 15 ,9002,1619,1472,12093
7/21/2017,2017,7,21, 16 ,8809,1605,1472,11886
7/21/2017,2017,7,21, 17 ,8464,1557,1440,11461
7/21/2017,2017,7,21, 18 ,8171,1588,1465,11224
7/21/2017,2017,7,21, 19 ,8422,1616,1503,11541
7/21/2017,2017,7,21, 20 ,8388,1549,1421,11358
7/21/2017,2017,7,21, 21 ,8260,1497,1390,11147
7/21/2017,2017,7,21, 22 ,7851,1380,1242,10473
7/21/2017,2017,7,21, 23 ,7374,1277,1148,9799
7/21/2017,2017,7,21, 24 ,6984,1203,1111,9298
7/22/2017,2017,7,22, 1 ,6681,1155,999,8835
7/22/2017,2017,7,22, 2 ,6505,1131,1017,8653
7/22/2017,2017,7,22, 3 ,6329,1112,989,8430
7/22/2017,2017,7,22, 4 ,6232,1095,989,8316
7/22/2017,2017,7,22, 5 ,6147,1116,993,8256
7/22/2017,2017,7,22, 6 ,6033,1134,1017,8184
7/22/2017,2017,7,22, 7 ,6238,1152,1008,8398
7/22/2017,2017,7,22, 8 ,6732,1270,1061,9063
7/22/2017,2017,7,22, 9 ,7413,1447,1178,10038
7/22/2017,2017,7,22, 10 ,8007,1550,1267,10824
7/22/2017,2017,7,22, 11 ,8351,1602,1313,11266
7/22/2017,2017,7,22, 12 ,8191,1553,1231,10975
7/22/2017,2017,7,22, 13 ,8142,1548,1176,10866
7/22/2017,2017,7,22, 14 ,8408,1587,1206,11201
7/22/2017,2017,7,22, 15 ,8340,1552,1217,11109
7/22/2017,2017,7,22, 16 ,8166,1513,1215,10894
7/22/2017,2017,7,22, 17 ,7834,1485,1232,10551
7/22/2017,2017,7,22, 18 ,7740,1530,1338,10608
7/22/2017,2017,7,22, 19 ,8108,1603,1358,11069
7/22/2017,2017,7,22, 20 ,8069,1559,1314,10942
7/22/2017,2017,7,22, 21 ,8039,1510,1250,10799
7/22/2017,2017,7,22, 22 ,7879,1429,1172,10480
7/22/2017,2017,7,22, 23 ,7471,1306,1050,9827
7/22/2017,2017,7,22, 24 ,7045,1234,1095,9374
7/23/2017,2017,7,23, 1 ,6702,1182,933,8817
7/23/2017,2017,7,23, 2 ,6467,1136,901,8504
7/23/2017,2017,7,23, 3 ,6233,1107,884,8224
7/23/2017,2017,7,23, 4 ,6050,1076,871,7997
7/23/2017,2017,7,23, 5 ,5945,1077,891,7913
7/23/2017,2017,7,23, 6 ,5748,1084,928,7760
7/23/2017,2017,7,23, 7 ,5802,1099,961,7862
7/23/2017,2017,7,23, 8 ,6105,1140,993,8238
7/23/2017,2017,7,23, 9 ,6536,1201,1055,8792
7/23/2017,2017,7,23, 10 ,6994,1256,1144,9394
7/23/2017,2017,7,23, 11 ,7196,1289,1152,9637
7/23/2017,2017,7,23, 12 ,7206,1267,1204,9677
7/23/2017,2017,7,23, 13 ,7218,1262,1157,9637
7/23/2017,2017,7,23, 14 ,7293,1257,1178,9728
7/23/2017,2017,7,23, 15 ,7161,1241,1166,9568
7/23/2017,2017,7,23, 16 ,6996,1252,1140,9388
7/23/2017,2017,7,23, 17 ,6893,1287,1166,9346
7/23/2017,2017,7,23, 18 ,6999,1378,1279,9656
7/23/2017,2017,7,23, 19 ,7614,1478,1390,10482
7/23/2017,2017,7,23, 20 ,7764,1442,1363,10569
7/23/2017,2017,7,23, 21 ,7798,1394,1298,10490
7/23/2017,2017,7,23, 22 ,7493,1271,1179,9943
7/23/2017,2017,7,23, 23 ,7127,1189,1082,9398
7/23/2017,2017,7,23, 24 ,6740,1115,968,8823
7/24/2017,2017,7,24, 1 ,6461,1066,961,8488
7/24/2017,2017,7,24, 2 ,6212,1037,930,8179
7/24/2017,2017,7,24, 3 ,6017,1005,909,7931
7/24/2017,2017,7,24, 4 ,5858,1002,903,7763
7/24/2017,2017,7,24, 5 ,6031,1069,955,8055
7/24/2017,2017,7,24, 6 ,6109,1145,900,8154
7/24/2017,2017,7,24, 7 ,6356,1119,954,8429
7/24/2017,2017,7,24, 8 ,7384,1286,1090,9760
7/24/2017,2017,7,24, 9 ,8261,1495,1311,11067
7/24/2017,2017,7,24, 10 ,8797,1629,1414,11840
7/24/2017,2017,7,24, 11 ,9039,1651,1503,12193
7/24/2017,2017,7,24, 12 ,8873,1617,1465,11955
7/24/2017,2017,7,24, 13 ,8867,1639,1422,11928
7/24/2017,2017,7,24, 14 ,9205,1719,1516,12440
7/24/2017,2017,7,24, 15 ,9201,1694,1495,12390
7/24/2017,2017,7,24, 16 ,9045,1658,1447,12150
7/24/2017,2017,7,24, 17 ,8596,1593,1430,11619
7/24/2017,2017,7,24, 18 ,8293,1615,1450,11358
7/24/2017,2017,7,24, 19 ,8645,1686,1506,11837
7/24/2017,2017,7,24, 20 ,8646,1620,1451,11717
7/24/2017,2017,7,24, 21 ,8444,1561,1360,11365
7/24/2017,2017,7,24, 22 ,8094,1464,1244,10802
7/24/2017,2017,7,24, 23 ,7605,1341,1129,10075
7/24/2017,2017,7,24, 24 ,7238,1256,989,9483
7/25/2017,2017,7,25, 1 ,6899,1202,1022,9123
7/25/2017,2017,7,25, 2 ,6719,1174,991,8884
7/25/2017,2017,7,25, 3 ,6556,1140,975,8671
7/25/2017,2017,7,25, 4 ,6362,1101,970,8433
7/25/2017,2017,7,25, 5 ,6477,1145,1034,8656
7/25/2017,2017,7,25, 6 ,6561,1218,1084,8863
7/25/2017,2017,7,25, 7 ,6687,1175,1006,8868
7/25/2017,2017,7,25, 8 ,7454,1309,1134,9897
7/25/2017,2017,7,25, 9 ,8455,1470,1332,11257
7/25/2017,2017,7,25, 10 ,8932,1608,1450,11990
7/25/2017,2017,7,25, 11 ,9103,1610,1528,12241
7/25/2017,2017,7,25, 12 ,8849,1613,1481,11943
7/25/2017,2017,7,25, 13 ,8933,1648,1475,12056
7/25/2017,2017,7,25, 14 ,9266,1697,1523,12486
7/25/2017,2017,7,25, 15 ,9187,1691,1517,12395
7/25/2017,2017,7,25, 16 ,8851,1640,1480,11971
7/25/2017,2017,7,25, 17 ,8452,1576,1413,11441
7/25/2017,2017,7,25, 18 ,8316,1579,1426,11321
7/25/2017,2017,7,25, 19 ,8504,1654,1525,11683
7/25/2017,2017,7,25, 20 ,8494,1560,1464,11518
7/25/2017,2017,7,25, 21 ,8404,1485,1397,11286
7/25/2017,2017,7,25, 22 ,8055,1393,1258,10706
7/25/2017,2017,7,25, 23 ,7559,1305,1153,10017
7/25/2017,2017,7,25, 24 ,7193,1227,1076,9496
7/26/2017,2017,7,26, 1 ,6889,1185,1036,9110
7/26/2017,2017,7,26, 2 ,6669,1151,1009,8829
7/26/2017,2017,7,26, 3 ,6446,1120,986,8552
7/26/2017,2017,7,26, 4 ,6385,1108,989,8482
7/26/2017,2017,7,26, 5 ,6405,1154,1036,8595
7/26/2017,2017,7,26, 6 ,6439,1214,1097,8750
7/26/2017,2017,7,26, 7 ,6572,1152,983,8707
7/26/2017,2017,7,26, 8 ,7386,1304,1135,9825
7/26/2017,2017,7,26, 9 ,8148,1536,1355,11039
7/26/2017,2017,7,26, 10 ,8564,1635,1465,11664
7/26/2017,2017,7,26, 11 ,8712,1693,1522,11927
7/26/2017,2017,7,26, 12 ,8424,1637,1526,11587
7/26/2017,2017,7,26, 13 ,8340,1629,1557,11526
7/26/2017,2017,7,26, 14 ,8438,1678,1640,11756
7/26/2017,2017,7,26, 15 ,8343,1671,1626,11640
7/26/2017,2017,7,26, 16 ,8190,1662,1564,11416
7/26/2017,2017,7,26, 17 ,8010,1601,1495,11106
7/26/2017,2017,7,26, 18 ,7883,1615,1517,11015
7/26/2017,2017,7,26, 19 ,7998,1684,1600,11282
7/26/2017,2017,7,26, 20 ,7952,1625,1542,11119
7/26/2017,2017,7,26, 21 ,7852,1560,1493,10905
7/26/2017,2017,7,26, 22 ,7356,1445,1339,10140
7/26/2017,2017,7,26, 23 ,6984,1355,1236,9575
7/26/2017,2017,7,26, 24 ,6665,1280,1111,9056
7/27/2017,2017,7,27, 1 ,6395,1229,1108,8732
7/27/2017,2017,7,27, 2 ,6237,1193,1069,8499
7/27/2017,2017,7,27, 3 ,6109,1163,1031,8303
7/27/2017,2017,7,27, 4 ,6053,1149,1010,8212
7/27/2017,2017,7,27, 5 ,6232,1184,1068,8484
7/27/2017,2017,7,27, 6 ,6250,1229,1097,8576
7/27/2017,2017,7,27, 7 ,6454,1176,1023,8653
7/27/2017,2017,7,27, 8 ,7184,1350,1158,9692
7/27/2017,2017,7,27, 9 ,7734,1600,1348,10682
7/27/2017,2017,7,27, 10 ,8197,1693,1523,11413
7/27/2017,2017,7,27, 11 ,8300,1750,1600,11650
7/27/2017,2017,7,27, 12 ,8089,1697,1585,11371
7/27/2017,2017,7,27, 13 ,8018,1701,1602,11321
7/27/2017,2017,7,27, 14 ,8264,1714,1671,11649
7/27/2017,2017,7,27, 15 ,8190,1691,1635,11516
7/27/2017,2017,7,27, 16 ,8117,1643,1593,11353
7/27/2017,2017,7,27, 17 ,7970,1588,1529,11087
7/27/2017,2017,7,27, 18 ,8062,1601,1554,11217
7/27/2017,2017,7,27, 19 ,8096,1693,1626,11415
7/27/2017,2017,7,27, 20 ,7787,1629,1556,10972
7/27/2017,2017,7,27, 21 ,7664,1607,1518,10789
7/27/2017,2017,7,27, 22 ,7228,1498,1388,10114
7/27/2017,2017,7,27, 23 ,6853,1415,1275,9543
7/27/2017,2017,7,27, 24 ,6529,1333,1181,9043
7/28/2017,2017,7,28, 1 ,6265,1264,1146,8675
7/28/2017,2017,7,28, 2 ,6106,1225,1095,8426
7/28/2017,2017,7,28, 3 ,5933,1187,1054,8174
7/28/2017,2017,7,28, 4 ,5901,1169,1049,8119
7/28/2017,2017,7,28, 5 ,6016,1210,1101,8327
7/28/2017,2017,7,28, 6 ,6147,1240,1115,8502
7/28/2017,2017,7,28, 7 ,6430,1202,1041,8673
7/28/2017,2017,7,28, 8 ,7139,1374,1198,9711
7/28/2017,2017,7,28, 9 ,7823,1596,1411,10830
7/28/2017,2017,7,28, 10 ,8286,1697,1500,11483
7/28/2017,2017,7,28, 11 ,8512,1745,1609,11866
7/28/2017,2017,7,28, 12 ,8242,1712,1589,11543
7/28/2017,2017,7,28, 13 ,8165,1711,1614,11490
7/28/2017,2017,7,28, 14 ,8390,1778,1677,11845
7/28/2017,2017,7,28, 15 ,8290,1778,1656,11724
7/28/2017,2017,7,28, 16 ,8192,1730,1606,11528
7/28/2017,2017,7,28, 17 ,8091,1661,1516,11268
7/28/2017,2017,7,28, 18 ,7965,1649,1528,11142
7/28/2017,2017,7,28, 19 ,8075,1788,1599,11462
7/28/2017,2017,7,28, 20 ,7928,1743,1530,11201
7/28/2017,2017,7,28, 21 ,7711,1675,1497,10883
7/28/2017,2017,7,28, 22 ,7310,1538,1387,10235
7/28/2017,2017,7,28, 23 ,6938,1441,1272,9651
7/28/2017,2017,7,28, 24 ,6618,1356,1195,9169
7/29/2017,2017,7,29, 1 ,6398,1286,1143,8827
7/29/2017,2017,7,29, 2 ,6234,1254,1111,8599
7/29/2017,2017,7,29, 3 ,5976,1231,1068,8275
7/29/2017,2017,7,29, 4 ,5978,1208,1049,8235
7/29/2017,2017,7,29, 5 ,5953,1183,1048,8184
7/29/2017,2017,7,29, 6 ,5965,1205,1054,8224
7/29/2017,2017,7,29, 7 ,6197,1233,1046,8476
7/29/2017,2017,7,29, 8 ,6772,1343,1142,9257
7/29/2017,2017,7,29, 9 ,7433,1534,1295,10262
7/29/2017,2017,7,29, 10 ,7838,1625,1388,10851
7/29/2017,2017,7,29, 11 ,8126,1656,1488,11270
7/29/2017,2017,7,29, 12 ,7944,1662,1478,11084
7/29/2017,2017,7,29, 13 ,7848,1661,1476,10985
7/29/2017,2017,7,29, 14 ,8102,1703,1553,11358
7/29/2017,2017,7,29, 15 ,7946,1710,1506,11162
7/29/2017,2017,7,29, 16 ,7613,1650,1470,10733
7/29/2017,2017,7,29, 17 ,7365,1618,1402,10385
7/29/2017,2017,7,29, 18 ,7427,1623,1442,10492
7/29/2017,2017,7,29, 19 ,7808,1748,1509,11065
7/29/2017,2017,7,29, 20 ,7857,1742,1485,11084
7/29/2017,2017,7,29, 21 ,7727,1680,1444,10851
7/29/2017,2017,7,29, 22 ,7522,1613,1383,10518
7/29/2017,2017,7,29, 23 ,7206,1470,1243,9919
7/29/2017,2017,7,29, 24 ,6822,1396,1150,9368
7/30/2017,2017,7,30, 1 ,6554,1343,1104,9001
7/30/2017,2017,7,30, 2 ,6362,1292,1058,8712
7/30/2017,2017,7,30, 3 ,6199,1263,1012,8474
7/30/2017,2017,7,30, 4 ,5965,1241,992,8198
7/30/2017,2017,7,30, 5 ,5943,1228,984,8155
7/30/2017,2017,7,30, 6 ,5762,1195,950,7907
7/30/2017,2017,7,30, 7 ,5802,1206,935,7943
7/30/2017,2017,7,30, 8 ,6035,1267,963,8265
7/30/2017,2017,7,30, 9 ,6453,1365,1050,8868
7/30/2017,2017,7,30, 10 ,6924,1466,1128,9518
7/30/2017,2017,7,30, 11 ,7108,1527,1057,9692
7/30/2017,2017,7,30, 12 ,7060,1514,1203,9777
7/30/2017,2017,7,30, 13 ,6969,1518,1253,9740
7/30/2017,2017,7,30, 14 ,7049,1500,1169,9718
7/30/2017,2017,7,30, 15 ,6981,1474,1204,9659
7/30/2017,2017,7,30, 16 ,6896,1457,1233,9586
7/30/2017,2017,7,30, 17 ,6856,1451,1208,9515
7/30/2017,2017,7,30, 18 ,7005,1519,1294,9818
7/30/2017,2017,7,30, 19 ,7665,1716,1381,10762
7/30/2017,2017,7,30, 20 ,7731,1688,1446,10865
7/30/2017,2017,7,30, 21 ,7698,1643,1415,10756
7/30/2017,2017,7,30, 22 ,7432,1532,1293,10257
7/30/2017,2017,7,30, 23 ,7130,1443,1199,9772
7/30/2017,2017,7,30, 24 ,6713,1352,1137,9202
7/31/2017,2017,7,31, 1 ,6399,1299,1073,8771
7/31/2017,2017,7,31, 2 ,6148,1250,1031,8429
7/31/2017,2017,7,31, 3 ,6037,1223,1009,8269
7/31/2017,2017,7,31, 4 ,5941,1205,992,8138
7/31/2017,2017,7,31, 5 ,6151,1232,1054,8437
7/31/2017,2017,7,31, 6 ,6201,1269,1075,8545
7/31/2017,2017,7,31, 7 ,6404,1222,1016,8642
7/31/2017,2017,7,31, 8 ,7273,1410,1179,9862
7/31/2017,2017,7,31, 9 ,8254,1650,1419,11323
7/31/2017,2017,7,31, 10 ,8711,1767,1560,12038
7/31/2017,2017,7,31, 11 ,9084,1842,1650,12576
7/31/2017,2017,7,31, 12 ,8930,1794,1600,12324
7/31/2017,2017,7,31, 13 ,8948,1813,1620,12381
7/31/2017,2017,7,31, 14 ,9217,1893,1652,12762
7/31/2017,2017,7,31, 15 ,9104,1889,1610,12603
7/31/2017,2017,7,31, 16 ,8988,1866,1586,12440
7/31/2017,2017,7,31, 17 ,8584,1789,1509,11882
7/31/2017,2017,7,31, 18 ,8361,1772,1513,11646
7/31/2017,2017,7,31, 19 ,8689,1825,1565,12079
7/31/2017,2017,7,31, 20 ,8539,1783,1494,11816
7/31/2017,2017,7,31, 21 ,8428,1746,1448,11622
7/31/2017,2017,7,31, 22 ,8121,1653,1313,11087
7/31/2017,2017,7,31, 23 ,7725,1533,1226,10484
7/31/2017,2017,7,31, 24 ,7380,1435,1133,9948
8/1/2017,2017,8,1, 1 ,7008,1380,1098,9486
8/1/2017,2017,8,1, 2 ,6795,1338,1070,9203
8/1/2017,2017,8,1, 3 ,6564,1297,1037,8898
8/1/2017,2017,8,1, 4 ,6498,1280,1031,8809
8/1/2017,2017,8,1, 5 ,6642,1313,1089,9044
8/1/2017,2017,8,1, 6 ,6629,1329,1118,9076
8/1/2017,2017,8,1, 7 ,6816,1271,1019,9106
8/1/2017,2017,8,1, 8 ,7692,1464,1154,10310
8/1/2017,2017,8,1, 9 ,8480,1678,1356,11514
8/1/2017,2017,8,1, 10 ,8907,1798,1438,12143
8/1/2017,2017,8,1, 11 ,9192,1891,1552,12635
8/1/2017,2017,8,1, 12 ,9041,1846,1536,12423
8/1/2017,2017,8,1, 13 ,9070,1846,1516,12432
8/1/2017,2017,8,1, 14 ,9453,1887,1626,12966
8/1/2017,2017,8,1, 15 ,9394,1847,1585,12826
8/1/2017,2017,8,1, 16 ,9214,1816,1548,12578
8/1/2017,2017,8,1, 17 ,8733,1729,1456,11918
8/1/2017,2017,8,1, 18 ,8494,1737,1499,11730
8/1/2017,2017,8,1, 19 ,8841,1840,1589,12270
8/1/2017,2017,8,1, 20 ,8937,1796,1522,12255
8/1/2017,2017,8,1, 21 ,8783,1731,1445,11959
8/1/2017,2017,8,1, 22 ,8438,1611,1340,11389
8/1/2017,2017,8,1, 23 ,7988,1513,1219,10720
8/1/2017,2017,8,1, 24 ,7580,1430,1097,10107
8/2/2017,2017,8,2, 1 ,7287,1370,1057,9714
8/2/2017,2017,8,2, 2 ,7066,1337,1039,9442
8/2/2017,2017,8,2, 3 ,6850,1305,1012,9167
8/2/2017,2017,8,2, 4 ,6752,1288,999,9039
8/2/2017,2017,8,2, 5 ,6844,1329,1050,9223
8/2/2017,2017,8,2, 6 ,6842,1355,1091,9288
8/2/2017,2017,8,2, 7 ,6952,1292,972,9216
8/2/2017,2017,8,2, 8 ,7655,1473,1144,10272
8/2/2017,2017,8,2, 9 ,8389,1690,1343,11422
8/2/2017,2017,8,2, 10 ,8704,1820,1471,11995
8/2/2017,2017,8,2, 11 ,8919,1862,1529,12310
8/2/2017,2017,8,2, 12 ,8619,1823,1489,11931
8/2/2017,2017,8,2, 13 ,8563,1810,1464,11837
8/2/2017,2017,8,2, 14 ,8798,1881,1528,12207
8/2/2017,2017,8,2, 15 ,8783,1860,1494,12137
8/2/2017,2017,8,2, 16 ,8740,1826,1467,12033
8/2/2017,2017,8,2, 17 ,8501,1747,1422,11670
8/2/2017,2017,8,2, 18 ,8411,1760,1461,11632
8/2/2017,2017,8,2, 19 ,8511,1819,1483,11813
8/2/2017,2017,8,2, 20 ,8501,1755,1441,11697
8/2/2017,2017,8,2, 21 ,8290,1710,1371,11371
8/2/2017,2017,8,2, 22 ,7914,1578,1218,10710
8/2/2017,2017,8,2, 23 ,7473,1472,1134,10079
8/2/2017,2017,8,2, 24 ,7097,1403,1132,9632
8/3/2017,2017,8,3, 1 ,6820,1346,1027,9193
8/3/2017,2017,8,3, 2 ,6581,1316,1004,8901
8/3/2017,2017,8,3, 3 ,6374,1285,980,8639
8/3/2017,2017,8,3, 4 ,6337,1270,951,8558
8/3/2017,2017,8,3, 5 ,6488,1300,1014,8802
8/3/2017,2017,8,3, 6 ,6540,1327,1084,8951
8/3/2017,2017,8,3, 7 ,6661,1266,1011,8938
8/3/2017,2017,8,3, 8 ,7401,1464,1154,10019
8/3/2017,2017,8,3, 9 ,8186,1689,1343,11218
8/3/2017,2017,8,3, 10 ,8692,1812,1467,11971
8/3/2017,2017,8,3, 11 ,8956,1847,1501,12304
8/3/2017,2017,8,3, 12 ,8769,1779,1492,12040
8/3/2017,2017,8,3, 13 ,8771,1769,1500,12040
8/3/2017,2017,8,3, 14 ,9128,1864,1540,12532
8/3/2017,2017,8,3, 15 ,9038,1848,1523,12409
8/3/2017,2017,8,3, 16 ,8848,1782,1457,12087
8/3/2017,2017,8,3, 17 ,8456,1706,1421,11583
8/3/2017,2017,8,3, 18 ,8185,1745,1456,11386
8/3/2017,2017,8,3, 19 ,8540,1815,1531,11886
8/3/2017,2017,8,3, 20 ,8526,1758,1479,11763
8/3/2017,2017,8,3, 21 ,8342,1661,1404,11407
8/3/2017,2017,8,3, 22 ,7988,1542,1290,10820
8/3/2017,2017,8,3, 23 ,7624,1447,1193,10264
8/3/2017,2017,8,3, 24 ,7158,1358,1120,9636
8/4/2017,2017,8,4, 1 ,6844,1299,1031,9174
8/4/2017,2017,8,4, 2 ,6716,1257,1028,9001
8/4/2017,2017,8,4, 3 ,6454,1234,1008,8696
8/4/2017,2017,8,4, 4 ,6397,1206,1011,8614
8/4/2017,2017,8,4, 5 ,6492,1249,1061,8802
8/4/2017,2017,8,4, 6 ,6495,1280,1092,8867
8/4/2017,2017,8,4, 7 ,6667,1251,1001,8919
8/4/2017,2017,8,4, 8 ,7606,1404,1151,10161
8/4/2017,2017,8,4, 9 ,8312,1622,1376,11310
8/4/2017,2017,8,4, 10 ,8826,1730,1501,12057
8/4/2017,2017,8,4, 11 ,9108,1778,1570,12456
8/4/2017,2017,8,4, 12 ,8874,1727,1555,12156
8/4/2017,2017,8,4, 13 ,8739,1681,1549,11969
8/4/2017,2017,8,4, 14 ,9176,1714,1607,12497
8/4/2017,2017,8,4, 15 ,9093,1719,1594,12406
8/4/2017,2017,8,4, 16 ,8889,1689,1562,12140
8/4/2017,2017,8,4, 17 ,8475,1628,1493,11596
8/4/2017,2017,8,4, 18 ,8241,1654,1517,11412
8/4/2017,2017,8,4, 19 ,8529,1759,1586,11874
8/4/2017,2017,8,4, 20 ,8458,1706,1542,11706
8/4/2017,2017,8,4, 21 ,8331,1625,1475,11431
8/4/2017,2017,8,4, 22 ,7973,1503,1324,10800
8/4/2017,2017,8,4, 23 ,7544,1396,1222,10162
8/4/2017,2017,8,4, 24 ,7068,1314,1165,9547
8/5/2017,2017,8,5, 1 ,6819,1258,1090,9167
8/5/2017,2017,8,5, 2 ,6624,1222,1047,8893
8/5/2017,2017,8,5, 3 ,6469,1191,1021,8681
8/5/2017,2017,8,5, 4 ,6318,1168,1013,8499
8/5/2017,2017,8,5, 5 ,6251,1179,1034,8464
8/5/2017,2017,8,5, 6 ,6193,1172,1048,8413
8/5/2017,2017,8,5, 7 ,6354,1218,1042,8614
8/5/2017,2017,8,5, 8 ,7023,1347,1134,9504
8/5/2017,2017,8,5, 9 ,7733,1526,1237,10496
8/5/2017,2017,8,5, 10 ,8275,1635,1386,11296
8/5/2017,2017,8,5, 11 ,8577,1713,1457,11747
8/5/2017,2017,8,5, 12 ,8379,1672,1436,11487
8/5/2017,2017,8,5, 13 ,8395,1657,1456,11508
8/5/2017,2017,8,5, 14 ,8600,1728,1510,11838
8/5/2017,2017,8,5, 15 ,8451,1702,1492,11645
8/5/2017,2017,8,5, 16 ,8238,1641,1412,11291
8/5/2017,2017,8,5, 17 ,7814,1595,1367,10776
8/5/2017,2017,8,5, 18 ,7753,1626,1441,10820
8/5/2017,2017,8,5, 19 ,8225,1768,1522,11515
8/5/2017,2017,8,5, 20 ,8292,1728,1478,11498
8/5/2017,2017,8,5, 21 ,8267,1684,1412,11363
8/5/2017,2017,8,5, 22 ,8063,1605,1332,11000
8/5/2017,2017,8,5, 23 ,7612,1469,1214,10295
8/5/2017,2017,8,5, 24 ,7209,1374,1099,9682
8/6/2017,2017,8,6, 1 ,6926,1301,1068,9295
8/6/2017,2017,8,6, 2 ,6693,1261,1047,9001
8/6/2017,2017,8,6, 3 ,6481,1221,1013,8715
8/6/2017,2017,8,6, 4 ,6360,1197,973,8530
8/6/2017,2017,8,6, 5 ,6250,1173,976,8399
8/6/2017,2017,8,6, 6 ,5980,1160,975,8115
8/6/2017,2017,8,6, 7 ,5956,1162,961,8079
8/6/2017,2017,8,6, 8 ,6303,1221,1012,8536
8/6/2017,2017,8,6, 9 ,6697,1340,1115,9152
8/6/2017,2017,8,6, 10 ,7204,1432,1204,9840
8/6/2017,2017,8,6, 11 ,7443,1490,1283,10216
8/6/2017,2017,8,6, 12 ,7466,1504,1294,10264
8/6/2017,2017,8,6, 13 ,7506,1516,1306,10328
8/6/2017,2017,8,6, 14 ,7598,1455,1330,10383
8/6/2017,2017,8,6, 15 ,7523,1476,1294,10293
8/6/2017,2017,8,6, 16 ,7390,1449,1250,10089
8/6/2017,2017,8,6, 17 ,7193,1456,1260,9909
8/6/2017,2017,8,6, 18 ,7260,1545,1344,10149
8/6/2017,2017,8,6, 19 ,7960,1687,1454,11101
8/6/2017,2017,8,6, 20 ,8126,1670,1424,11220
8/6/2017,2017,8,6, 21 ,8158,1623,1356,11137
8/6/2017,2017,8,6, 22 ,7840,1512,1218,10570
8/6/2017,2017,8,6, 23 ,7501,1405,1159,10065
8/6/2017,2017,8,6, 24 ,7108,1310,1061,9479
8/7/2017,2017,8,7, 1 ,6765,1248,1025,9038
8/7/2017,2017,8,7, 2 ,6488,1203,993,8684
8/7/2017,2017,8,7, 3 ,6293,1171,964,8428
8/7/2017,2017,8,7, 4 ,6230,1166,963,8359
8/7/2017,2017,8,7, 5 ,6338,1206,1016,8560
8/7/2017,2017,8,7, 6 ,6383,1249,1062,8694
8/7/2017,2017,8,7, 7 ,6675,1195,999,8869
8/7/2017,2017,8,7, 8 ,7626,1362,1161,10149
8/7/2017,2017,8,7, 9 ,8564,1618,1372,11554
8/7/2017,2017,8,7, 10 ,9099,1785,1507,12391
8/7/2017,2017,8,7, 11 ,9374,1854,1605,12833
8/7/2017,2017,8,7, 12 ,9268,1828,1617,12713
8/7/2017,2017,8,7, 13 ,9290,1829,1607,12726
8/7/2017,2017,8,7, 14 ,9716,1931,1650,13297
8/7/2017,2017,8,7, 15 ,9644,1877,1682,13203
8/7/2017,2017,8,7, 16 ,9428,1836,1604,12868
8/7/2017,2017,8,7, 17 ,8992,1713,1524,12229
8/7/2017,2017,8,7, 18 ,8666,1728,1508,11902
8/7/2017,2017,8,7, 19 ,8983,1828,1569,12380
8/7/2017,2017,8,7, 20 ,9028,1789,1506,12323
8/7/2017,2017,8,7, 21 ,8855,1736,1448,12039
8/7/2017,2017,8,7, 22 ,8475,1614,1313,11402
8/7/2017,2017,8,7, 23 ,7988,1487,1204,10679
8/7/2017,2017,8,7, 24 ,7613,1400,1072,10085
8/8/2017,2017,8,8, 1 ,7195,1305,1116,9616
8/8/2017,2017,8,8, 2 ,6989,1269,1082,9340
8/8/2017,2017,8,8, 3 ,6759,1241,1045,9045
8/8/2017,2017,8,8, 4 ,6716,1228,1035,8979
8/8/2017,2017,8,8, 5 ,6809,1275,1090,9174
8/8/2017,2017,8,8, 6 ,6719,1299,1136,9154
8/8/2017,2017,8,8, 7 ,6908,1247,1043,9198
8/8/2017,2017,8,8, 8 ,7828,1427,1219,10474
8/8/2017,2017,8,8, 9 ,8724,1700,1412,11836
8/8/2017,2017,8,8, 10 ,9276,1816,1524,12616
8/8/2017,2017,8,8, 11 ,9549,1890,1567,13006
8/8/2017,2017,8,8, 12 ,9354,1844,1534,12732
8/8/2017,2017,8,8, 13 ,9313,1846,1529,12688
8/8/2017,2017,8,8, 14 ,9664,1934,1575,13173
8/8/2017,2017,8,8, 15 ,9546,1891,1571,13008
8/8/2017,2017,8,8, 16 ,9240,1831,1558,12629
8/8/2017,2017,8,8, 17 ,8896,1764,1531,12191
8/8/2017,2017,8,8, 18 ,8644,1774,1555,11973
8/8/2017,2017,8,8, 19 ,8856,1847,1608,12311
8/8/2017,2017,8,8, 20 ,8922,1824,1535,12281
8/8/2017,2017,8,8, 21 ,8758,1745,1449,11952
8/8/2017,2017,8,8, 22 ,8374,1620,1337,11331
8/8/2017,2017,8,8, 23 ,7887,1514,1215,10616
8/8/2017,2017,8,8, 24 ,7536,1424,1195,10155
8/9/2017,2017,8,9, 1 ,7121,1355,1113,9589
8/9/2017,2017,8,9, 2 ,6893,1298,1060,9251
8/9/2017,2017,8,9, 3 ,6753,1268,1043,9064
8/9/2017,2017,8,9, 4 ,6680,1240,1040,8960
8/9/2017,2017,8,9, 5 ,6767,1283,1087,9137
8/9/2017,2017,8,9, 6 ,6714,1307,1124,9145
8/9/2017,2017,8,9, 7 ,6865,1253,1053,9171
8/9/2017,2017,8,9, 8 ,7787,1453,1214,10454
8/9/2017,2017,8,9, 9 ,8675,1692,1433,11800
8/9/2017,2017,8,9, 10 ,9207,1810,1526,12543
8/9/2017,2017,8,9, 11 ,9488,1884,1613,12985
8/9/2017,2017,8,9, 12 ,9390,1846,1581,12817
8/9/2017,2017,8,9, 13 ,9407,1841,1603,12851
8/9/2017,2017,8,9, 14 ,9777,1946,1662,13385
8/9/2017,2017,8,9, 15 ,9748,1965,1633,13346
8/9/2017,2017,8,9, 16 ,9559,1894,1537,12990
8/9/2017,2017,8,9, 17 ,9069,1801,1496,12366
8/9/2017,2017,8,9, 18 ,8783,1741,1529,12053
8/9/2017,2017,8,9, 19 ,9114,1863,1601,12578
8/9/2017,2017,8,9, 20 ,9096,1813,1503,12412
8/9/2017,2017,8,9, 21 ,9002,1745,1436,12183
8/9/2017,2017,8,9, 22 ,8544,1609,1303,11456
8/9/2017,2017,8,9, 23 ,8094,1501,1198,10793
8/9/2017,2017,8,9, 24 ,7680,1406,1125,10211
8/10/2017,2017,8,10, 1 ,7313,1342,1103,9758
8/10/2017,2017,8,10, 2 ,7080,1285,1048,9413
8/10/2017,2017,8,10, 3 ,6918,1257,1020,9195
8/10/2017,2017,8,10, 4 ,6819,1238,1010,9067
8/10/2017,2017,8,10, 5 ,6844,1270,1047,9161
8/10/2017,2017,8,10, 6 ,6752,1292,1111,9155
8/10/2017,2017,8,10, 7 ,6877,1243,1030,9150
8/10/2017,2017,8,10, 8 ,7818,1452,1171,10441
8/10/2017,2017,8,10, 9 ,8799,1702,1390,11891
8/10/2017,2017,8,10, 10 ,9265,1826,1516,12607
8/10/2017,2017,8,10, 11 ,9512,1887,1573,12972
8/10/2017,2017,8,10, 12 ,9364,1839,1559,12762
8/10/2017,2017,8,10, 13 ,9465,1853,1560,12878
8/10/2017,2017,8,10, 14 ,9913,1944,1638,13495
8/10/2017,2017,8,10, 15 ,9832,1894,1603,13329
8/10/2017,2017,8,10, 16 ,9570,1845,1557,12972
8/10/2017,2017,8,10, 17 ,9150,1771,1487,12408
8/10/2017,2017,8,10, 18 ,8826,1770,1459,12055
8/10/2017,2017,8,10, 19 ,9091,1834,1501,12426
8/10/2017,2017,8,10, 20 ,9108,1773,1483,12364
8/10/2017,2017,8,10, 21 ,8960,1725,1442,12127
8/10/2017,2017,8,10, 22 ,8678,1601,1323,11602
8/10/2017,2017,8,10, 23 ,8212,1480,1190,10882
8/10/2017,2017,8,10, 24 ,7838,1388,1134,10360
8/11/2017,2017,8,11, 1 ,7484,1325,1078,9887
8/11/2017,2017,8,11, 2 ,7242,1283,1052,9577
8/11/2017,2017,8,11, 3 ,6982,1246,1022,9250
8/11/2017,2017,8,11, 4 ,6803,1220,1014,9037
8/11/2017,2017,8,11, 5 ,6877,1254,1071,9202
8/11/2017,2017,8,11, 6 ,6779,1283,1095,9157
8/11/2017,2017,8,11, 7 ,6929,1242,1013,9184
8/11/2017,2017,8,11, 8 ,7896,1458,1156,10510
8/11/2017,2017,8,11, 9 ,8833,1651,1398,11882
8/11/2017,2017,8,11, 10 ,9357,1771,1536,12664
8/11/2017,2017,8,11, 11 ,9607,1840,1591,13038
8/11/2017,2017,8,11, 12 ,9517,1806,1578,12901
8/11/2017,2017,8,11, 13 ,9633,1824,1584,13041
8/11/2017,2017,8,11, 14 ,9810,1857,1634,13301
8/11/2017,2017,8,11, 15 ,9635,1823,1615,13073
8/11/2017,2017,8,11, 16 ,9365,1794,1570,12729
8/11/2017,2017,8,11, 17 ,9017,1726,1501,12244
8/11/2017,2017,8,11, 18 ,8762,1742,1549,12053
8/11/2017,2017,8,11, 19 ,9045,1821,1485,12351
8/11/2017,2017,8,11, 20 ,9054,1797,1415,12266
8/11/2017,2017,8,11, 21 ,8918,1746,1346,12010
8/11/2017,2017,8,11, 22 ,8608,1644,1232,11484
8/11/2017,2017,8,11, 23 ,8242,1529,1165,10936
8/11/2017,2017,8,11, 24 ,7808,1424,1096,10328
8/12/2017,2017,8,12, 1 ,7510,1363,1065,9938
8/12/2017,2017,8,12, 2 ,7269,1305,1039,9613
8/12/2017,2017,8,12, 3 ,6971,1289,1025,9285
8/12/2017,2017,8,12, 4 ,6878,1257,1011,9146
8/12/2017,2017,8,12, 5 ,6776,1256,1013,9045
8/12/2017,2017,8,12, 6 ,6548,1252,1042,8842
8/12/2017,2017,8,12, 7 ,6767,1260,1041,9068
8/12/2017,2017,8,12, 8 ,7407,1383,1137,9927
8/12/2017,2017,8,12, 9 ,8075,1568,1281,10924
8/12/2017,2017,8,12, 10 ,8673,1691,1398,11762
8/12/2017,2017,8,12, 11 ,9020,1703,1466,12189
8/12/2017,2017,8,12, 12 ,8870,1698,1448,12016
8/12/2017,2017,8,12, 13 ,8890,1706,1465,12061
8/12/2017,2017,8,12, 14 ,9068,1690,1500,12258
8/12/2017,2017,8,12, 15 ,8929,1683,1468,12080
8/12/2017,2017,8,12, 16 ,8475,1628,1430,11533
8/12/2017,2017,8,12, 17 ,8077,1571,1379,11027
8/12/2017,2017,8,12, 18 ,8014,1630,1435,11079
8/12/2017,2017,8,12, 19 ,8393,1747,1497,11637
8/12/2017,2017,8,12, 20 ,8370,1707,1449,11526
8/12/2017,2017,8,12, 21 ,8390,1619,1392,11401
8/12/2017,2017,8,12, 22 ,8170,1533,1256,10959
8/12/2017,2017,8,12, 23 ,7753,1408,1177,10338
8/12/2017,2017,8,12, 24 ,7332,1325,1106,9763
8/13/2017,2017,8,13, 1 ,7106,1253,1056,9415
8/13/2017,2017,8,13, 2 ,6837,1212,1012,9061
8/13/2017,2017,8,13, 3 ,6718,1195,983,8896
8/13/2017,2017,8,13, 4 ,6542,1175,969,8686
8/13/2017,2017,8,13, 5 ,6412,1162,980,8554
8/13/2017,2017,8,13, 6 ,6129,1134,973,8236
8/13/2017,2017,8,13, 7 ,6106,1148,957,8211
8/13/2017,2017,8,13, 8 ,6324,1216,990,8530
8/13/2017,2017,8,13, 9 ,6780,1328,1089,9197
8/13/2017,2017,8,13, 10 ,7209,1437,1174,9820
8/13/2017,2017,8,13, 11 ,7477,1506,1259,10242
8/13/2017,2017,8,13, 12 ,7302,1497,1304,10103
8/13/2017,2017,8,13, 13 ,7517,1488,1285,10290
8/13/2017,2017,8,13, 14 ,7637,1489,1295,10421
8/13/2017,2017,8,13, 15 ,7622,1453,1269,10344
8/13/2017,2017,8,13, 16 ,7464,1447,1174,10085
8/13/2017,2017,8,13, 17 ,7293,1451,1230,9974
8/13/2017,2017,8,13, 18 ,7379,1553,1339,10271
8/13/2017,2017,8,13, 19 ,7990,1683,1448,11121
8/13/2017,2017,8,13, 20 ,8032,1655,1433,11120
8/13/2017,2017,8,13, 21 ,8031,1584,1377,10992
8/13/2017,2017,8,13, 22 ,7905,1475,1264,10644
8/13/2017,2017,8,13, 23 ,7464,1377,1126,9967
8/13/2017,2017,8,13, 24 ,7096,1270,1075,9441
8/14/2017,2017,8,14, 1 ,6769,1218,1035,9022
8/14/2017,2017,8,14, 2 ,6507,1174,990,8671
8/14/2017,2017,8,14, 3 ,6308,1153,971,8432
8/14/2017,2017,8,14, 4 ,6251,1145,963,8359
8/14/2017,2017,8,14, 5 ,6352,1183,1021,8556
8/14/2017,2017,8,14, 6 ,6394,1224,1096,8714
8/14/2017,2017,8,14, 7 ,6626,1186,1012,8824
8/14/2017,2017,8,14, 8 ,7621,1376,1154,10151
8/14/2017,2017,8,14, 9 ,8527,1634,1346,11507
8/14/2017,2017,8,14, 10 ,9113,1737,1488,12338
8/14/2017,2017,8,14, 11 ,9412,1816,1530,12758
8/14/2017,2017,8,14, 12 ,9221,1790,1463,12474
8/14/2017,2017,8,14, 13 ,9246,1796,1494,12536
8/14/2017,2017,8,14, 14 ,9465,1875,1550,12890
8/14/2017,2017,8,14, 15 ,9308,1862,1550,12720
8/14/2017,2017,8,14, 16 ,9110,1840,1510,12460
8/14/2017,2017,8,14, 17 ,8745,1754,1469,11968
8/14/2017,2017,8,14, 18 ,8557,1777,1504,11838
8/14/2017,2017,8,14, 19 ,8873,1862,1519,12254
8/14/2017,2017,8,14, 20 ,8827,1797,1477,12101
8/14/2017,2017,8,14, 21 ,8687,1731,1404,11822
8/14/2017,2017,8,14, 22 ,8378,1599,1269,11246
8/14/2017,2017,8,14, 23 ,7916,1481,1164,10561
8/14/2017,2017,8,14, 24 ,7487,1398,1161,10046
8/15/2017,2017,8,15, 1 ,7184,1321,1038,9543
8/15/2017,2017,8,15, 2 ,6954,1282,1003,9239
8/15/2017,2017,8,15, 3 ,6738,1252,974,8964
8/15/2017,2017,8,15, 4 ,6587,1228,975,8790
8/15/2017,2017,8,15, 5 ,6677,1254,1041,8972
8/15/2017,2017,8,15, 6 ,6606,1291,1093,8990
8/15/2017,2017,8,15, 7 ,6837,1235,1006,9078
8/15/2017,2017,8,15, 8 ,7802,1411,1150,10363
8/15/2017,2017,8,15, 9 ,8705,1662,1332,11699
8/15/2017,2017,8,15, 10 ,9203,1769,1432,12404
8/15/2017,2017,8,15, 11 ,9527,1842,1475,12844
8/15/2017,2017,8,15, 12 ,9405,1791,1442,12638
8/15/2017,2017,8,15, 13 ,9529,1797,1469,12795
8/15/2017,2017,8,15, 14 ,9920,1892,1560,13372
8/15/2017,2017,8,15, 15 ,9829,1880,1533,13242
8/15/2017,2017,8,15, 16 ,9569,1834,1499,12902
8/15/2017,2017,8,15, 17 ,9043,1724,1435,12202
8/15/2017,2017,8,15, 18 ,8680,1751,1510,11941
8/15/2017,2017,8,15, 19 ,9033,1841,1549,12423
8/15/2017,2017,8,15, 20 ,9063,1785,1478,12326
8/15/2017,2017,8,15, 21 ,8966,1698,1417,12081
8/15/2017,2017,8,15, 22 ,8618,1558,1268,11444
8/15/2017,2017,8,15, 23 ,8150,1458,1169,10777
8/15/2017,2017,8,15, 24 ,7810,1374,1081,10265
8/16/2017,2017,8,16, 1 ,7490,1323,1051,9864
8/16/2017,2017,8,16, 2 ,7204,1282,1015,9501
8/16/2017,2017,8,16, 3 ,7028,1244,1010,9282
8/16/2017,2017,8,16, 4 ,6915,1231,1007,9153
8/16/2017,2017,8,16, 5 ,6952,1266,1053,9271
8/16/2017,2017,8,16, 6 ,6826,1288,1118,9232
8/16/2017,2017,8,16, 7 ,7022,1219,1037,9278
8/16/2017,2017,8,16, 8 ,7961,1409,1135,10505
8/16/2017,2017,8,16, 9 ,8868,1638,1352,11858
8/16/2017,2017,8,16, 10 ,9351,1746,1449,12546
8/16/2017,2017,8,16, 11 ,9648,1772,1526,12946
8/16/2017,2017,8,16, 12 ,9484,1731,1497,12712
8/16/2017,2017,8,16, 13 ,9532,1730,1518,12780
8/16/2017,2017,8,16, 14 ,9814,1729,1591,13134
8/16/2017,2017,8,16, 15 ,9628,1741,1570,12939
8/16/2017,2017,8,16, 16 ,9393,1697,1543,12633
8/16/2017,2017,8,16, 17 ,8912,1613,1465,11990
8/16/2017,2017,8,16, 18 ,8625,1649,1546,11820
8/16/2017,2017,8,16, 19 ,8938,1693,1584,12215
8/16/2017,2017,8,16, 20 ,8941,1685,1515,12141
8/16/2017,2017,8,16, 21 ,8859,1641,1438,11938
8/16/2017,2017,8,16, 22 ,8511,1516,1302,11329
8/16/2017,2017,8,16, 23 ,8210,1389,1205,10804
8/16/2017,2017,8,16, 24 ,7797,1318,1139,10254
8/17/2017,2017,8,17, 1 ,7415,1276,1075,9766
8/17/2017,2017,8,17, 2 ,7159,1236,1027,9422
8/17/2017,2017,8,17, 3 ,6954,1201,1011,9166
8/17/2017,2017,8,17, 4 ,6785,1180,1003,8968
8/17/2017,2017,8,17, 5 ,6857,1213,1054,9124
8/17/2017,2017,8,17, 6 ,6796,1263,1103,9162
8/17/2017,2017,8,17, 7 ,6887,1224,1010,9121
8/17/2017,2017,8,17, 8 ,7885,1405,1167,10457
8/17/2017,2017,8,17, 9 ,8805,1644,1375,11824
8/17/2017,2017,8,17, 10 ,9333,1746,1494,12573
8/17/2017,2017,8,17, 11 ,9641,1808,1557,13006
8/17/2017,2017,8,17, 12 ,9426,1778,1529,12733
8/17/2017,2017,8,17, 13 ,9470,1786,1538,12794
8/17/2017,2017,8,17, 14 ,9925,1875,1628,13428
8/17/2017,2017,8,17, 15 ,9848,1852,1608,13308
8/17/2017,2017,8,17, 16 ,9663,1823,1589,13075
8/17/2017,2017,8,17, 17 ,9176,1729,1492,12397
8/17/2017,2017,8,17, 18 ,8937,1775,1548,12260
8/17/2017,2017,8,17, 19 ,9266,1823,1589,12678
8/17/2017,2017,8,17, 20 ,9245,1793,1526,12564
8/17/2017,2017,8,17, 21 ,9126,1732,1470,12328
8/17/2017,2017,8,17, 22 ,8796,1582,1350,11728
8/17/2017,2017,8,17, 23 ,8311,1457,1252,11020
8/17/2017,2017,8,17, 24 ,7952,1373,1136,10461
8/18/2017,2017,8,18, 1 ,7668,1303,1136,10107
8/18/2017,2017,8,18, 2 ,7396,1272,1108,9776
8/18/2017,2017,8,18, 3 ,7199,1240,1070,9509
8/18/2017,2017,8,18, 4 ,7053,1220,1047,9320
8/18/2017,2017,8,18, 5 ,7058,1245,1078,9381
8/18/2017,2017,8,18, 6 ,6965,1280,1095,9340
8/18/2017,2017,8,18, 7 ,7004,1247,1039,9290
8/18/2017,2017,8,18, 8 ,7885,1436,1175,10496
8/18/2017,2017,8,18, 9 ,8820,1681,1370,11871
8/18/2017,2017,8,18, 10 ,9315,1794,1489,12598
8/18/2017,2017,8,18, 11 ,9528,1852,1557,12937
8/18/2017,2017,8,18, 12 ,9348,1834,1530,12712
8/18/2017,2017,8,18, 13 ,9462,1846,1567,12875
8/18/2017,2017,8,18, 14 ,9828,1887,1619,13334
8/18/2017,2017,8,18, 15 ,9735,1867,1597,13199
8/18/2017,2017,8,18, 16 ,9466,1816,1555,12837
8/18/2017,2017,8,18, 17 ,8967,1735,1479,12181
8/18/2017,2017,8,18, 18 ,8694,1761,1501,11956
8/18/2017,2017,8,18, 19 ,8697,1790,1552,12039
8/18/2017,2017,8,18, 20 ,8527,1705,1472,11704
8/18/2017,2017,8,18, 21 ,8246,1659,1418,11323
8/18/2017,2017,8,18, 22 ,8119,1542,1274,10935
8/18/2017,2017,8,18, 23 ,7721,1447,1165,10333
8/18/2017,2017,8,18, 24 ,7373,1360,1098,9831
8/19/2017,2017,8,19, 1 ,7158,1300,1058,9516
8/19/2017,2017,8,19, 2 ,6940,1252,1029,9221
8/19/2017,2017,8,19, 3 ,6795,1226,989,9010
8/19/2017,2017,8,19, 4 ,6573,1194,989,8756
8/19/2017,2017,8,19, 5 ,6510,1205,1004,8719
8/19/2017,2017,8,19, 6 ,6440,1202,1032,8674
8/19/2017,2017,8,19, 7 ,6541,1211,1011,8763
8/19/2017,2017,8,19, 8 ,7067,1331,1093,9491
8/19/2017,2017,8,19, 9 ,7835,1526,1237,10598
8/19/2017,2017,8,19, 10 ,8406,1631,1343,11380
8/19/2017,2017,8,19, 11 ,8709,1695,1406,11810
8/19/2017,2017,8,19, 12 ,8593,1661,1409,11663
8/19/2017,2017,8,19, 13 ,8421,1635,1397,11453
8/19/2017,2017,8,19, 14 ,8511,1687,1417,11615
8/19/2017,2017,8,19, 15 ,8388,1642,1401,11431
8/19/2017,2017,8,19, 16 ,8158,1618,1348,11124
8/19/2017,2017,8,19, 17 ,7869,1580,1340,10789
8/19/2017,2017,8,19, 18 ,7876,1668,1458,11002
8/19/2017,2017,8,19, 19 ,8174,1718,1464,11356
8/19/2017,2017,8,19, 20 ,8137,1670,1444,11251
8/19/2017,2017,8,19, 21 ,8025,1602,1365,10992
8/19/2017,2017,8,19, 22 ,7710,1523,1304,10537
8/19/2017,2017,8,19, 23 ,7217,1389,1191,9797
8/19/2017,2017,8,19, 24 ,6882,1310,1130,9322
8/20/2017,2017,8,20, 1 ,6632,1263,1037,8932
8/20/2017,2017,8,20, 2 ,6478,1230,1015,8723
8/20/2017,2017,8,20, 3 ,6266,1204,971,8441
8/20/2017,2017,8,20, 4 ,6116,1182,960,8258
8/20/2017,2017,8,20, 5 ,6034,1170,963,8167
8/20/2017,2017,8,20, 6 ,5820,1152,974,7946
8/20/2017,2017,8,20, 7 ,5861,1164,969,7994
8/20/2017,2017,8,20, 8 ,6115,1223,992,8330
8/20/2017,2017,8,20, 9 ,6602,1316,1082,9000
8/20/2017,2017,8,20, 10 ,7077,1427,1166,9670
8/20/2017,2017,8,20, 11 ,7386,1483,1241,10110
8/20/2017,2017,8,20, 12 ,7401,1485,1252,10138
8/20/2017,2017,8,20, 13 ,7443,1490,1251,10184
8/20/2017,2017,8,20, 14 ,7538,1474,1253,10265
8/20/2017,2017,8,20, 15 ,7472,1464,1233,10169
8/20/2017,2017,8,20, 16 ,7240,1429,1202,9871
8/20/2017,2017,8,20, 17 ,7081,1445,1201,9727
8/20/2017,2017,8,20, 18 ,6970,1557,1336,9863
8/20/2017,2017,8,20, 19 ,7743,1628,1396,10767
8/20/2017,2017,8,20, 20 ,7768,1571,1381,10720
8/20/2017,2017,8,20, 21 ,7703,1507,1328,10538
8/20/2017,2017,8,20, 22 ,7510,1409,1220,10139
8/20/2017,2017,8,20, 23 ,7194,1329,1106,9629
8/20/2017,2017,8,20, 24 ,6896,1245,1061,9202
8/21/2017,2017,8,21, 1 ,6665,1194,1000,8859
8/21/2017,2017,8,21, 2 ,6398,1161,977,8536
8/21/2017,2017,8,21, 3 ,6197,1138,943,8278
8/21/2017,2017,8,21, 4 ,6024,1116,931,8071
8/21/2017,2017,8,21, 5 ,6013,1123,946,8082
8/21/2017,2017,8,21, 6 ,5837,1141,974,7952
8/21/2017,2017,8,21, 7 ,5962,1163,976,8101
8/21/2017,2017,8,21, 8 ,6419,1284,1045,8748
8/21/2017,2017,8,21, 9 ,7026,1440,1181,9647
8/21/2017,2017,8,21, 10 ,7464,1515,1299,10278
8/21/2017,2017,8,21, 11 ,7782,1581,1367,10730
8/21/2017,2017,8,21, 12 ,7520,1548,1361,10429
8/21/2017,2017,8,21, 13 ,7464,1521,1365,10350
8/21/2017,2017,8,21, 14 ,7484,1542,1377,10403
8/21/2017,2017,8,21, 15 ,7374,1553,1392,10319
8/21/2017,2017,8,21, 16 ,7206,1513,1364,10083
8/21/2017,2017,8,21, 17 ,7181,1520,1331,10032
8/21/2017,2017,8,21, 18 ,7378,1618,1435,10431
8/21/2017,2017,8,21, 19 ,7756,1683,1481,10920
8/21/2017,2017,8,21, 20 ,7782,1634,1451,10867
8/21/2017,2017,8,21, 21 ,7593,1562,1373,10528
8/21/2017,2017,8,21, 22 ,7094,1440,1243,9777
8/21/2017,2017,8,21, 23 ,6902,1332,1134,9368
8/21/2017,2017,8,21, 24 ,6512,1267,1076,8855
8/22/2017,2017,8,22, 1 ,6329,1184,1042,8555
8/22/2017,2017,8,22, 2 ,6134,1168,1000,8302
8/22/2017,2017,8,22, 3 ,5973,1144,975,8092
8/22/2017,2017,8,22, 4 ,5889,1125,981,7995
8/22/2017,2017,8,22, 5 ,6054,1174,1030,8258
8/22/2017,2017,8,22, 6 ,6199,1229,1096,8524
8/22/2017,2017,8,22, 7 ,6357,1208,1012,8577
8/22/2017,2017,8,22, 8 ,7179,1390,1181,9750
8/22/2017,2017,8,22, 9 ,7974,1628,1387,10989
8/22/2017,2017,8,22, 10 ,8601,1739,1470,11810
8/22/2017,2017,8,22, 11 ,8953,1822,1534,12309
8/22/2017,2017,8,22, 12 ,8810,1779,1493,12082
8/22/2017,2017,8,22, 13 ,8730,1776,1487,11993
8/22/2017,2017,8,22, 14 ,8995,1845,1547,12387
8/22/2017,2017,8,22, 15 ,8908,1823,1536,12267
8/22/2017,2017,8,22, 16 ,8750,1785,1507,12042
8/22/2017,2017,8,22, 17 ,8354,1731,1465,11550
8/22/2017,2017,8,22, 18 ,8296,1764,1529,11589
8/22/2017,2017,8,22, 19 ,8262,1793,1552,11607
8/22/2017,2017,8,22, 20 ,8264,1748,1488,11500
8/22/2017,2017,8,22, 21 ,8017,1691,1409,11117
8/22/2017,2017,8,22, 22 ,7554,1554,1320,10428
8/22/2017,2017,8,22, 23 ,7138,1427,1176,9741
8/22/2017,2017,8,22, 24 ,6831,1344,1095,9270
8/23/2017,2017,8,23, 1 ,6542,1303,1063,8908
8/23/2017,2017,8,23, 2 ,6385,1247,1014,8646
8/23/2017,2017,8,23, 3 ,6219,1214,1003,8436
8/23/2017,2017,8,23, 4 ,6196,1187,989,8372
8/23/2017,2017,8,23, 5 ,6352,1224,1046,8622
8/23/2017,2017,8,23, 6 ,6452,1266,1085,8803
8/23/2017,2017,8,23, 7 ,6554,1213,1008,8775
8/23/2017,2017,8,23, 8 ,7437,1380,1144,9961
8/23/2017,2017,8,23, 9 ,8285,1610,1347,11242
8/23/2017,2017,8,23, 10 ,8891,1738,1473,12102
8/23/2017,2017,8,23, 11 ,9130,1783,1537,12450
8/23/2017,2017,8,23, 12 ,8974,1733,1505,12212
8/23/2017,2017,8,23, 13 ,8925,1717,1502,12144
8/23/2017,2017,8,23, 14 ,9173,1796,1537,12506
8/23/2017,2017,8,23, 15 ,9065,1781,1501,12347
8/23/2017,2017,8,23, 16 ,8859,1743,1475,12077
8/23/2017,2017,8,23, 17 ,8506,1687,1446,11639
8/23/2017,2017,8,23, 18 ,8415,1744,1519,11678
8/23/2017,2017,8,23, 19 ,8639,1771,1516,11926
8/23/2017,2017,8,23, 20 ,8511,1723,1468,11702
8/23/2017,2017,8,23, 21 ,8254,1654,1404,11312
8/23/2017,2017,8,23, 22 ,7940,1508,1240,10688
8/23/2017,2017,8,23, 23 ,7512,1394,1123,10029
8/23/2017,2017,8,23, 24 ,7130,1293,1033,9456
8/24/2017,2017,8,24, 1 ,6828,1243,1012,9083
8/24/2017,2017,8,24, 2 ,6641,1209,985,8835
8/24/2017,2017,8,24, 3 ,6418,1199,962,8579
8/24/2017,2017,8,24, 4 ,6358,1178,957,8493
8/24/2017,2017,8,24, 5 ,6504,1213,1013,8730
8/24/2017,2017,8,24, 6 ,6552,1240,1061,8853
8/24/2017,2017,8,24, 7 ,6618,1210,990,8818
8/24/2017,2017,8,24, 8 ,7410,1363,1126,9899
8/24/2017,2017,8,24, 9 ,8216,1582,1306,11104
8/24/2017,2017,8,24, 10 ,8641,1690,1445,11776
8/24/2017,2017,8,24, 11 ,8844,1752,1474,12070
8/24/2017,2017,8,24, 12 ,8604,1724,1500,11828
8/24/2017,2017,8,24, 13 ,8567,1719,1506,11792
8/24/2017,2017,8,24, 14 ,8920,1778,1337,12035
8/24/2017,2017,8,24, 15 ,8864,1769,1454,12087
8/24/2017,2017,8,24, 16 ,8655,1754,1467,11876
8/24/2017,2017,8,24, 17 ,8493,1694,1425,11612
8/24/2017,2017,8,24, 18 ,8389,1759,1499,11647
8/24/2017,2017,8,24, 19 ,8539,1788,1494,11821
8/24/2017,2017,8,24, 20 ,8488,1732,1415,11635
8/24/2017,2017,8,24, 21 ,8217,1641,1340,11198
8/24/2017,2017,8,24, 22 ,7819,1493,1193,10505
8/24/2017,2017,8,24, 23 ,7320,1369,1109,9798
8/24/2017,2017,8,24, 24 ,6938,1282,1042,9262
8/25/2017,2017,8,25, 1 ,6559,1226,1016,8801
8/25/2017,2017,8,25, 2 ,6408,1195,972,8575
8/25/2017,2017,8,25, 3 ,6257,1167,960,8384
8/25/2017,2017,8,25, 4 ,6154,1155,911,8220
8/25/2017,2017,8,25, 5 ,6299,1189,930,8418
8/25/2017,2017,8,25, 6 ,6305,1239,983,8527
8/25/2017,2017,8,25, 7 ,6512,1197,903,8612
8/25/2017,2017,8,25, 8 ,7335,1325,1108,9768
8/25/2017,2017,8,25, 9 ,8081,1532,1350,10963
8/25/2017,2017,8,25, 10 ,8504,1634,1464,11602
8/25/2017,2017,8,25, 11 ,8723,1701,1568,11992
8/25/2017,2017,8,25, 12 ,8443,1694,1533,11670
8/25/2017,2017,8,25, 13 ,8328,1689,1550,11567
8/25/2017,2017,8,25, 14 ,8577,1771,1600,11948
8/25/2017,2017,8,25, 15 ,8489,1749,1549,11787
8/25/2017,2017,8,25, 16 ,8360,1708,1515,11583
8/25/2017,2017,8,25, 17 ,8263,1629,1439,11331
8/25/2017,2017,8,25, 18 ,8025,1680,1501,11206
8/25/2017,2017,8,25, 19 ,8094,1776,1525,11395
8/25/2017,2017,8,25, 20 ,7815,1701,1392,10908
8/25/2017,2017,8,25, 21 ,7688,1611,1309,10608
8/25/2017,2017,8,25, 22 ,7217,1488,1199,9904
8/25/2017,2017,8,25, 23 ,6839,1369,1111,9319
8/25/2017,2017,8,25, 24 ,6429,1292,1021,8742
8/26/2017,2017,8,26, 1 ,6191,1226,1033,8450
8/26/2017,2017,8,26, 2 ,6057,1191,1003,8251
8/26/2017,2017,8,26, 3 ,5878,1161,974,8013
8/26/2017,2017,8,26, 4 ,5741,1149,961,7851
8/26/2017,2017,8,26, 5 ,5787,1156,981,7924
8/26/2017,2017,8,26, 6 ,5819,1172,997,7988
8/26/2017,2017,8,26, 7 ,5909,1199,1000,8108
8/26/2017,2017,8,26, 8 ,6445,1330,1096,8871
8/26/2017,2017,8,26, 9 ,7141,1518,1222,9881
8/26/2017,2017,8,26, 10 ,7659,1619,1339,10617
8/26/2017,2017,8,26, 11 ,8020,1688,1413,11121
8/26/2017,2017,8,26, 12 ,7817,1649,1395,10861
8/26/2017,2017,8,26, 13 ,7753,1662,1451,10866
8/26/2017,2017,8,26, 14 ,8058,1732,1467,11257
8/26/2017,2017,8,26, 15 ,7850,1703,1386,10939
8/26/2017,2017,8,26, 16 ,7682,1656,1383,10721
8/26/2017,2017,8,26, 17 ,7484,1596,1341,10421
8/26/2017,2017,8,26, 18 ,7550,1673,1445,10668
8/26/2017,2017,8,26, 19 ,7927,1774,1479,11180
8/26/2017,2017,8,26, 20 ,7879,1719,1424,11022
8/26/2017,2017,8,26, 21 ,7720,1665,1380,10765
8/26/2017,2017,8,26, 22 ,7464,1586,1292,10342
8/26/2017,2017,8,26, 23 ,6979,1445,1166,9590
8/26/2017,2017,8,26, 24 ,6692,1356,1062,9110
8/27/2017,2017,8,27, 1 ,6395,1290,1003,8688
8/27/2017,2017,8,27, 2 ,6139,1242,966,8347
8/27/2017,2017,8,27, 3 ,5957,1205,941,8103
8/27/2017,2017,8,27, 4 ,5843,1186,935,7964
8/27/2017,2017,8,27, 5 ,5791,1175,924,7890
8/27/2017,2017,8,27, 6 ,5577,1154,927,7658
8/27/2017,2017,8,27, 7 ,5574,1165,923,7662
8/27/2017,2017,8,27, 8 ,5973,1243,963,8179
8/27/2017,2017,8,27, 9 ,6473,1362,1011,8846
8/27/2017,2017,8,27, 10 ,7017,1478,1126,9621
8/27/2017,2017,8,27, 11 ,7333,1523,1217,10073
8/27/2017,2017,8,27, 12 ,7362,1541,1229,10132
8/27/2017,2017,8,27, 13 ,7428,1523,1219,10170
8/27/2017,2017,8,27, 14 ,7557,1551,1216,10324
8/27/2017,2017,8,27, 15 ,7465,1526,1201,10192
8/27/2017,2017,8,27, 16 ,7165,1479,1148,9792
8/27/2017,2017,8,27, 17 ,6991,1476,1128,9595
8/27/2017,2017,8,27, 18 ,7186,1595,1292,10073
8/27/2017,2017,8,27, 19 ,7597,1712,1361,10670
8/27/2017,2017,8,27, 20 ,7607,1676,1319,10602
8/27/2017,2017,8,27, 21 ,7537,1595,1251,10383
8/27/2017,2017,8,27, 22 ,7279,1489,1159,9927
8/27/2017,2017,8,27, 23 ,6925,1393,1064,9382
8/27/2017,2017,8,27, 24 ,6599,1322,999,8920
8/28/2017,2017,8,28, 1 ,6295,1254,953,8502
8/28/2017,2017,8,28, 2 ,5995,1207,920,8122
8/28/2017,2017,8,28, 3 ,5797,1170,892,7859
8/28/2017,2017,8,28, 4 ,5687,1142,886,7715
8/28/2017,2017,8,28, 5 ,5681,1143,894,7718
8/28/2017,2017,8,28, 6 ,5595,1164,915,7674
8/28/2017,2017,8,28, 7 ,5706,1169,924,7799
8/28/2017,2017,8,28, 8 ,6098,1251,1001,8350
8/28/2017,2017,8,28, 9 ,6746,1398,1108,9252
8/28/2017,2017,8,28, 10 ,7331,1509,1248,10088
8/28/2017,2017,8,28, 11 ,7665,1563,1316,10544
8/28/2017,2017,8,28, 12 ,7647,1568,1310,10525
8/28/2017,2017,8,28, 13 ,7693,1560,1323,10576
8/28/2017,2017,8,28, 14 ,7931,1579,1356,10866
8/28/2017,2017,8,28, 15 ,7859,1565,1332,10756
8/28/2017,2017,8,28, 16 ,7680,1533,1307,10520
8/28/2017,2017,8,28, 17 ,7336,1520,1288,10144
8/28/2017,2017,8,28, 18 ,7503,1655,1399,10557
8/28/2017,2017,8,28, 19 ,7964,1733,1444,11141
8/28/2017,2017,8,28, 20 ,7734,1684,1394,10812
8/28/2017,2017,8,28, 21 ,7594,1613,1328,10535
8/28/2017,2017,8,28, 22 ,7248,1482,1200,9930
8/28/2017,2017,8,28, 23 ,6913,1366,1092,9371
8/28/2017,2017,8,28, 24 ,6574,1296,1022,8892
8/29/2017,2017,8,29, 1 ,6302,1242,927,8471
8/29/2017,2017,8,29, 2 ,6061,1199,939,8199
8/29/2017,2017,8,29, 3 ,5876,1180,908,7964
8/29/2017,2017,8,29, 4 ,5822,1161,909,7892
8/29/2017,2017,8,29, 5 ,6016,1201,974,8191
8/29/2017,2017,8,29, 6 ,6064,1252,969,8285
8/29/2017,2017,8,29, 7 ,6399,1220,948,8567
8/29/2017,2017,8,29, 8 ,7356,1396,1131,9883
8/29/2017,2017,8,29, 9 ,8226,1662,1343,11231
8/29/2017,2017,8,29, 10 ,8885,1775,1493,12153
8/29/2017,2017,8,29, 11 ,9163,1852,1571,12586
8/29/2017,2017,8,29, 12 ,9048,1821,1527,12396
8/29/2017,2017,8,29, 13 ,9096,1828,1543,12467
8/29/2017,2017,8,29, 14 ,9290,1900,1603,12793
8/29/2017,2017,8,29, 15 ,9035,1891,1587,12513
8/29/2017,2017,8,29, 16 ,8813,1853,1533,12199
8/29/2017,2017,8,29, 17 ,8534,1777,1478,11789
8/29/2017,2017,8,29, 18 ,8312,1814,1532,11658
8/29/2017,2017,8,29, 19 ,8680,1862,1557,12099
8/29/2017,2017,8,29, 20 ,8501,1800,1478,11779
8/29/2017,2017,8,29, 21 ,8346,1723,1408,11477
8/29/2017,2017,8,29, 22 ,7908,1583,1309,10800
8/29/2017,2017,8,29, 23 ,7543,1455,1194,10192
8/29/2017,2017,8,29, 24 ,7121,1375,1114,9610
8/30/2017,2017,8,30, 1 ,6777,1310,1060,9147
8/30/2017,2017,8,30, 2 ,6585,1269,1015,8869
8/30/2017,2017,8,30, 3 ,6455,1233,989,8677
8/30/2017,2017,8,30, 4 ,6293,1216,986,8495
8/30/2017,2017,8,30, 5 ,6373,1247,1015,8635
8/30/2017,2017,8,30, 6 ,6452,1286,1045,8783
8/30/2017,2017,8,30, 7 ,6620,1248,999,8867
8/30/2017,2017,8,30, 8 ,7593,1434,1185,10212
8/30/2017,2017,8,30, 9 ,8355,1676,1406,11437
8/30/2017,2017,8,30, 10 ,8825,1783,1522,12130
8/30/2017,2017,8,30, 11 ,9083,1852,1593,12528
8/30/2017,2017,8,30, 12 ,8841,1822,1553,12216
8/30/2017,2017,8,30, 13 ,8805,1845,1576,12226
8/30/2017,2017,8,30, 14 ,9084,1916,1641,12641
8/30/2017,2017,8,30, 15 ,8986,1877,1620,12483
8/30/2017,2017,8,30, 16 ,8475,1839,1584,11898
8/30/2017,2017,8,30, 17 ,8450,1751,1515,11716
8/30/2017,2017,8,30, 18 ,8395,1783,1561,11739
8/30/2017,2017,8,30, 19 ,8582,1828,1590,12000
8/30/2017,2017,8,30, 20 ,8538,1759,1533,11830
8/30/2017,2017,8,30, 21 ,8354,1707,1460,11521
8/30/2017,2017,8,30, 22 ,7990,1580,1339,10909
8/30/2017,2017,8,30, 23 ,7477,1469,1228,10174
8/30/2017,2017,8,30, 24 ,7125,1386,1122,9633
8/31/2017,2017,8,31, 1 ,6829,1327,1092,9248
8/31/2017,2017,8,31, 2 ,6619,1283,1054,8956
8/31/2017,2017,8,31, 3 ,6407,1250,1026,8683
8/31/2017,2017,8,31, 4 ,6346,1233,1007,8586
8/31/2017,2017,8,31, 5 ,6447,1257,1057,8761
8/31/2017,2017,8,31, 6 ,6491,1286,1095,8872
8/31/2017,2017,8,31, 7 ,6667,1257,1031,8955
8/31/2017,2017,8,31, 8 ,7447,1465,1217,10129
8/31/2017,2017,8,31, 9 ,8288,1667,1437,11392
8/31/2017,2017,8,31, 10 ,8609,1788,1553,11950
8/31/2017,2017,8,31, 11 ,8952,1871,1626,12449
8/31/2017,2017,8,31, 12 ,8743,1809,1609,12161
8/31/2017,2017,8,31, 13 ,8767,1800,1640,12207
8/31/2017,2017,8,31, 14 ,9020,1886,1672,12578
8/31/2017,2017,8,31, 15 ,8917,1881,1638,12436
8/31/2017,2017,8,31, 16 ,8656,1831,1590,12077
8/31/2017,2017,8,31, 17 ,8379,1712,1506,11597
8/31/2017,2017,8,31, 18 ,8326,1771,1565,11662
8/31/2017,2017,8,31, 19 ,8458,1820,1565,11843
8/31/2017,2017,8,31, 20 ,8317,1747,1517,11581
8/31/2017,2017,8,31, 21 ,8127,1693,1452,11272
8/31/2017,2017,8,31, 22 ,7685,1565,1339,10589
8/31/2017,2017,8,31, 23 ,7296,1468,1220,9984
8/31/2017,2017,8,31, 24 ,6996,1384,1137,9517
9/1/2017,2017,9,1, 1 ,6625,1330,1084,9039
9/1/2017,2017,9,1, 2 ,6507,1284,1051,8842
9/1/2017,2017,9,1, 3 ,6291,1251,1018,8560
9/1/2017,2017,9,1, 4 ,6133,1222,992,8347
9/1/2017,2017,9,1, 5 ,6078,1226,1004,8308
9/1/2017,2017,9,1, 6 ,5973,1203,1016,8192
9/1/2017,2017,9,1, 7 ,6154,1213,986,8353
9/1/2017,2017,9,1, 8 ,6608,1353,1072,9033
9/1/2017,2017,9,1, 9 ,7131,1523,1209,9863
9/1/2017,2017,9,1, 10 ,7729,1636,1335,10700
9/1/2017,2017,9,1, 11 ,7953,1694,1401,11048
9/1/2017,2017,9,1, 12 ,7854,1656,1412,10922
9/1/2017,2017,9,1, 13 ,7874,1695,1440,11009
9/1/2017,2017,9,1, 14 ,8068,1747,1506,11321
9/1/2017,2017,9,1, 15 ,8039,1744,1491,11274
9/1/2017,2017,9,1, 16 ,7773,1701,1466,10940
9/1/2017,2017,9,1, 17 ,7572,1624,1399,10595
9/1/2017,2017,9,1, 18 ,7637,1684,1516,10837
9/1/2017,2017,9,1, 19 ,8061,1812,1539,11412
9/1/2017,2017,9,1, 20 ,8086,1785,1504,11375
9/1/2017,2017,9,1, 21 ,8008,1743,1471,11222
9/1/2017,2017,9,1, 22 ,7657,1632,1323,10612
9/1/2017,2017,9,1, 23 ,7230,1522,1235,9987
9/1/2017,2017,9,1, 24 ,6908,1434,1136,9478
9/2/2017,2017,9,2, 1 ,6679,1369,1106,9154
9/2/2017,2017,9,2, 2 ,6430,1309,1065,8804
9/2/2017,2017,9,2, 3 ,6230,1281,1033,8544
9/2/2017,2017,9,2, 4 ,6055,1248,1016,8319
9/2/2017,2017,9,2, 5 ,6039,1242,1025,8306
9/2/2017,2017,9,2, 6 ,5923,1235,1034,8192
9/2/2017,2017,9,2, 7 ,6097,1247,1029,8373
9/2/2017,2017,9,2, 8 ,6711,1376,1139,9226
9/2/2017,2017,9,2, 9 ,7380,1554,1300,10234
9/2/2017,2017,9,2, 10 ,8027,1651,1442,11120
9/2/2017,2017,9,2, 11 ,8250,1716,1520,11486
9/2/2017,2017,9,2, 12 ,8154,1680,1498,11332
9/2/2017,2017,9,2, 13 ,8163,1712,1508,11383
9/2/2017,2017,9,2, 14 ,8377,1766,1560,11703
9/2/2017,2017,9,2, 15 ,8322,1761,1544,11627
9/2/2017,2017,9,2, 16 ,8104,1707,1490,11301
9/2/2017,2017,9,2, 17 ,7749,1627,1421,10797
9/2/2017,2017,9,2, 18 ,7685,1677,1501,10863
9/2/2017,2017,9,2, 19 ,8297,1759,1543,11599
9/2/2017,2017,9,2, 20 ,8300,1724,1508,11532
9/2/2017,2017,9,2, 21 ,8239,1683,1450,11372
9/2/2017,2017,9,2, 22 ,8023,1615,1358,10996
9/2/2017,2017,9,2, 23 ,7598,1499,1237,10334
9/2/2017,2017,9,2, 24 ,7243,1399,1158,9800
9/3/2017,2017,9,3, 1 ,6917,1341,1104,9362
9/3/2017,2017,9,3, 2 ,6682,1288,1067,9037
9/3/2017,2017,9,3, 3 ,6431,1251,1045,8727
9/3/2017,2017,9,3, 4 ,6236,1226,1013,8475
9/3/2017,2017,9,3, 5 ,6140,1212,1007,8359
9/3/2017,2017,9,3, 6 ,5912,1177,993,8082
9/3/2017,2017,9,3, 7 ,5943,1187,987,8117
9/3/2017,2017,9,3, 8 ,6270,1255,1021,8546
9/3/2017,2017,9,3, 9 ,6780,1362,1127,9269
9/3/2017,2017,9,3, 10 ,7245,1458,1223,9926
9/3/2017,2017,9,3, 11 ,7560,1498,1296,10354
9/3/2017,2017,9,3, 12 ,7563,1507,1312,10382
9/3/2017,2017,9,3, 13 ,7558,1524,1331,10413
9/3/2017,2017,9,3, 14 ,7740,1557,1346,10643
9/3/2017,2017,9,3, 15 ,7611,1528,1299,10438
9/3/2017,2017,9,3, 16 ,7449,1502,1243,10194
9/3/2017,2017,9,3, 17 ,7265,1479,1231,9975
9/3/2017,2017,9,3, 18 ,7369,1603,1319,10291
9/3/2017,2017,9,3, 19 ,8085,1740,1404,11229
9/3/2017,2017,9,3, 20 ,8137,1718,1381,11236
9/3/2017,2017,9,3, 21 ,8114,1661,1308,11083
9/3/2017,2017,9,3, 22 ,7932,1556,1228,10716
9/3/2017,2017,9,3, 23 ,7469,1451,1126,10046
9/3/2017,2017,9,3, 24 ,7126,1371,1148,9645
9/4/2017,2017,9,4, 1 ,6821,1301,1004,9126
9/4/2017,2017,9,4, 2 ,6484,1273,985,8742
9/4/2017,2017,9,4, 3 ,6286,1215,956,8457
9/4/2017,2017,9,4, 4 ,6163,1212,945,8320
9/4/2017,2017,9,4, 5 ,6309,1247,999,8555
9/4/2017,2017,9,4, 6 ,6432,1272,1054,8758
9/4/2017,2017,9,4, 7 ,6634,1220,992,8846
9/4/2017,2017,9,4, 8 ,7535,1398,1140,10073
9/4/2017,2017,9,4, 9 ,8514,1671,1383,11568
9/4/2017,2017,9,4, 10 ,9034,1808,1531,12373
9/4/2017,2017,9,4, 11 ,9432,1875,1597,12904
9/4/2017,2017,9,4, 12 ,9205,1819,1589,12613
9/4/2017,2017,9,4, 13 ,9233,1829,1592,12654
9/4/2017,2017,9,4, 14 ,9497,1893,1610,13000
9/4/2017,2017,9,4, 15 ,9365,1872,1577,12814
9/4/2017,2017,9,4, 16 ,9172,1829,1537,12538
9/4/2017,2017,9,4, 17 ,8843,1759,1472,12074
9/4/2017,2017,9,4, 18 ,8771,1814,1533,12118
9/4/2017,2017,9,4, 19 ,8972,1835,1549,12356
9/4/2017,2017,9,4, 20 ,8864,1782,1498,12144
9/4/2017,2017,9,4, 21 ,8506,1694,1419,11619
9/4/2017,2017,9,4, 22 ,8130,1568,1283,10981
9/4/2017,2017,9,4, 23 ,7713,1446,1181,10340
9/4/2017,2017,9,4, 24 ,7301,1370,1100,9771
9/5/2017,2017,9,5, 1 ,7016,1307,1060,9383
9/5/2017,2017,9,5, 2 ,6759,1272,1017,9048
9/5/2017,2017,9,5, 3 ,6582,1243,992,8817
9/5/2017,2017,9,5, 4 ,6478,1225,975,8678
9/5/2017,2017,9,5, 5 ,6631,1241,1034,8906
9/5/2017,2017,9,5, 6 ,6728,1278,1062,9068
9/5/2017,2017,9,5, 7 ,6827,1232,1000,9059
9/5/2017,2017,9,5, 8 ,7571,1425,1168,10164
9/5/2017,2017,9,5, 9 ,8334,1696,1368,11398
9/5/2017,2017,9,5, 10 ,8628,1784,1504,11916
9/5/2017,2017,9,5, 11 ,8930,1846,1584,12360
9/5/2017,2017,9,5, 12 ,8768,1810,1588,12166
9/5/2017,2017,9,5, 13 ,8718,1805,1599,12122
9/5/2017,2017,9,5, 14 ,8936,1787,1653,12376
9/5/2017,2017,9,5, 15 ,8818,1750,1575,12143
9/5/2017,2017,9,5, 16 ,8743,1768,1577,12088
9/5/2017,2017,9,5, 17 ,8493,1690,1523,11706
9/5/2017,2017,9,5, 18 ,8408,1771,1594,11773
9/5/2017,2017,9,5, 19 ,8458,1752,1512,11722
9/5/2017,2017,9,5, 20 ,8321,1696,1494,11511
9/5/2017,2017,9,5, 21 ,8128,1650,1446,11224
9/5/2017,2017,9,5, 22 ,7754,1518,1245,10517
9/5/2017,2017,9,5, 23 ,7265,1413,1178,9856
9/5/2017,2017,9,5, 24 ,6906,1339,1121,9366
9/6/2017,2017,9,6, 1 ,6635,1289,1080,9004
9/6/2017,2017,9,6, 2 ,6416,1246,1045,8707
9/6/2017,2017,9,6, 3 ,6226,1219,1018,8463
9/6/2017,2017,9,6, 4 ,6118,1203,1014,8335
9/6/2017,2017,9,6, 5 ,6284,1253,1070,8607
9/6/2017,2017,9,6, 6 ,6365,1285,1094,8744
9/6/2017,2017,9,6, 7 ,6528,1241,1029,8798
9/6/2017,2017,9,6, 8 ,7518,1446,1197,10161
9/6/2017,2017,9,6, 9 ,8331,1696,1413,11440
9/6/2017,2017,9,6, 10 ,8905,1804,1541,12250
9/6/2017,2017,9,6, 11 ,9260,1870,1599,12729
9/6/2017,2017,9,6, 12 ,9135,1838,1592,12565
9/6/2017,2017,9,6, 13 ,9117,1848,1613,12578
9/6/2017,2017,9,6, 14 ,9494,1914,1681,13089
9/6/2017,2017,9,6, 15 ,9442,1894,1597,12933
9/6/2017,2017,9,6, 16 ,9210,1832,1599,12641
9/6/2017,2017,9,6, 17 ,8869,1757,1511,12137
9/6/2017,2017,9,6, 18 ,8686,1828,1592,12106
9/6/2017,2017,9,6, 19 ,8955,1876,1500,12331
9/6/2017,2017,9,6, 20 ,8801,1820,1547,12168
9/6/2017,2017,9,6, 21 ,8596,1746,1472,11814
9/6/2017,2017,9,6, 22 ,8163,1614,1330,11107
9/6/2017,2017,9,6, 23 ,7767,1495,1227,10489
9/6/2017,2017,9,6, 24 ,7308,1407,1155,9870
9/7/2017,2017,9,7, 1 ,6989,1323,1092,9404
9/7/2017,2017,9,7, 2 ,6711,1287,1064,9062
9/7/2017,2017,9,7, 3 ,6515,1260,1032,8807
9/7/2017,2017,9,7, 4 ,6379,1233,1030,8642
9/7/2017,2017,9,7, 5 ,6507,1267,1082,8856
9/7/2017,2017,9,7, 6 ,6503,1287,1096,8886
9/7/2017,2017,9,7, 7 ,6645,1251,1032,8928
9/7/2017,2017,9,7, 8 ,7589,1465,1202,10256
9/7/2017,2017,9,7, 9 ,8501,1723,1435,11659
9/7/2017,2017,9,7, 10 ,9054,1841,1543,12438
9/7/2017,2017,9,7, 11 ,9415,1904,1592,12911
9/7/2017,2017,9,7, 12 ,9209,1867,1588,12664
9/7/2017,2017,9,7, 13 ,9346,1858,1588,12792
9/7/2017,2017,9,7, 14 ,9725,1936,1635,13296
9/7/2017,2017,9,7, 15 ,9702,1935,1631,13268
9/7/2017,2017,9,7, 16 ,9507,1862,1579,12948
9/7/2017,2017,9,7, 17 ,9032,1793,1530,12355
9/7/2017,2017,9,7, 18 ,8726,1840,1581,12147
9/7/2017,2017,9,7, 19 ,9050,1868,1545,12463
9/7/2017,2017,9,7, 20 ,8963,1824,1498,12285
9/7/2017,2017,9,7, 21 ,8882,1785,1439,12106
9/7/2017,2017,9,7, 22 ,8527,1636,1282,11445
9/7/2017,2017,9,7, 23 ,8150,1503,1180,10833
9/7/2017,2017,9,7, 24 ,7668,1431,1114,10213
9/8/2017,2017,9,8, 1 ,7293,1368,1071,9732
9/8/2017,2017,9,8, 2 ,7114,1331,1049,9494
9/8/2017,2017,9,8, 3 ,6861,1295,1009,9165
9/8/2017,2017,9,8, 4 ,6771,1278,1019,9068
9/8/2017,2017,9,8, 5 ,6825,1301,1067,9193
9/8/2017,2017,9,8, 6 ,6707,1313,1091,9111
9/8/2017,2017,9,8, 7 ,6887,1298,1044,9229
9/8/2017,2017,9,8, 8 ,7825,1485,1193,10503
9/8/2017,2017,9,8, 9 ,8715,1725,1399,11839
9/8/2017,2017,9,8, 10 ,9206,1816,1528,12550
9/8/2017,2017,9,8, 11 ,9531,1864,1567,12962
9/8/2017,2017,9,8, 12 ,9345,1831,1547,12723
9/8/2017,2017,9,8, 13 ,9413,1859,1567,12839
9/8/2017,2017,9,8, 14 ,9806,1913,1657,13376
9/8/2017,2017,9,8, 15 ,9728,1883,1637,13248
9/8/2017,2017,9,8, 16 ,9583,1861,1586,13030
9/8/2017,2017,9,8, 17 ,9042,1781,1520,12343
9/8/2017,2017,9,8, 18 ,8739,1813,1565,12117
9/8/2017,2017,9,8, 19 ,9087,1878,1558,12523
9/8/2017,2017,9,8, 20 ,9035,1826,1514,12375
9/8/2017,2017,9,8, 21 ,8940,1760,1454,12154
9/8/2017,2017,9,8, 22 ,8639,1647,1343,11629
9/8/2017,2017,9,8, 23 ,8249,1515,1119,10883
9/8/2017,2017,9,8, 24 ,7771,1338,1054,10163
9/9/2017,2017,9,9, 1 ,7488,1247,1121,9856
9/9/2017,2017,9,9, 2 ,7250,1257,1085,9592
9/9/2017,2017,9,9, 3 ,6895,1192,1056,9143
9/9/2017,2017,9,9, 4 ,6830,1173,1035,9038
9/9/2017,2017,9,9, 5 ,6731,1199,1051,8981
9/9/2017,2017,9,9, 6 ,6552,1178,1051,8781
9/9/2017,2017,9,9, 7 ,6716,1162,1044,8922
9/9/2017,2017,9,9, 8 ,7293,1278,1152,9723
9/9/2017,2017,9,9, 9 ,8004,1462,1298,10764
9/9/2017,2017,9,9, 10 ,8584,1584,1421,11589
9/9/2017,2017,9,9, 11 ,9006,1651,1488,12145
9/9/2017,2017,9,9, 12 ,8838,1614,1483,11935
9/9/2017,2017,9,9, 13 ,8869,1613,1503,11985
9/9/2017,2017,9,9, 14 ,9098,1614,1558,12270
9/9/2017,2017,9,9, 15 ,9001,1520,1520,12041
9/9/2017,2017,9,9, 16 ,8765,1536,1482,11783
9/9/2017,2017,9,9, 17 ,8350,1547,1422,11319
9/9/2017,2017,9,9, 18 ,8227,1662,1506,11395
9/9/2017,2017,9,9, 19 ,8666,1690,1523,11879
9/9/2017,2017,9,9, 20 ,8724,1651,1495,11870
9/9/2017,2017,9,9, 21 ,8606,1574,1446,11626
9/9/2017,2017,9,9, 22 ,8454,1520,1349,11323
9/9/2017,2017,9,9, 23 ,8122,1396,1210,10728
9/9/2017,2017,9,9, 24 ,7704,1331,1132,10167
9/10/2017,2017,9,10, 1 ,7371,1275,1042,9688
9/10/2017,2017,9,10, 2 ,7170,1226,1041,9437
9/10/2017,2017,9,10, 3 ,6952,1197,1006,9155
9/10/2017,2017,9,10, 4 ,6770,1178,995,8943
9/10/2017,2017,9,10, 5 ,6626,1165,998,8789
9/10/2017,2017,9,10, 6 ,6272,1143,988,8403
9/10/2017,2017,9,10, 7 ,6260,1159,988,8407
9/10/2017,2017,9,10, 8 ,6553,1234,1031,8818
9/10/2017,2017,9,10, 9 ,7088,1326,1133,9547
9/10/2017,2017,9,10, 10 ,7582,1431,1227,10240
9/10/2017,2017,9,10, 11 ,7867,1491,1284,10642
9/10/2017,2017,9,10, 12 ,7829,1494,1268,10591
9/10/2017,2017,9,10, 13 ,7907,1514,1269,10690
9/10/2017,2017,9,10, 14 ,8084,1476,1273,10833
9/10/2017,2017,9,10, 15 ,7948,1496,1244,10688
9/10/2017,2017,9,10, 16 ,7728,1434,1220,10382
9/10/2017,2017,9,10, 17 ,7540,1421,1231,10192
9/10/2017,2017,9,10, 18 ,7643,1598,1408,10649
9/10/2017,2017,9,10, 19 ,8186,1650,1413,11249
9/10/2017,2017,9,10, 20 ,8354,1603,1399,11356
9/10/2017,2017,9,10, 21 ,8275,1521,1305,11101
9/10/2017,2017,9,10, 22 ,8091,1426,1215,10732
9/10/2017,2017,9,10, 23 ,7767,1320,1105,10192
9/10/2017,2017,9,10, 24 ,7492,1256,1101,9849
9/11/2017,2017,9,11, 1 ,7082,1217,998,9297
9/11/2017,2017,9,11, 2 ,6815,1169,968,8952
9/11/2017,2017,9,11, 3 ,6593,1140,956,8689
9/11/2017,2017,9,11, 4 ,6523,1145,946,8614
9/11/2017,2017,9,11, 5 ,6637,1192,1011,8840
9/11/2017,2017,9,11, 6 ,6664,1244,1054,8962
9/11/2017,2017,9,11, 7 ,6827,1199,980,9006
9/11/2017,2017,9,11, 8 ,7705,1367,1161,10233
9/11/2017,2017,9,11, 9 ,8460,1562,1381,11403
9/11/2017,2017,9,11, 10 ,8873,1722,1523,12118
9/11/2017,2017,9,11, 11 ,9087,1793,1582,12462
9/11/2017,2017,9,11, 12 ,8757,1743,1556,12056
9/11/2017,2017,9,11, 13 ,8645,1723,1578,11946
9/11/2017,2017,9,11, 14 ,8915,1717,1604,12236
9/11/2017,2017,9,11, 15 ,8847,1724,1578,12149
9/11/2017,2017,9,11, 16 ,8801,1698,1558,12057
9/11/2017,2017,9,11, 17 ,8622,1671,1507,11800
9/11/2017,2017,9,11, 18 ,8542,1762,1572,11876
9/11/2017,2017,9,11, 19 ,8640,1744,1549,11933
9/11/2017,2017,9,11, 20 ,8536,1679,1471,11686
9/11/2017,2017,9,11, 21 ,8258,1585,1393,11236
9/11/2017,2017,9,11, 22 ,7816,1431,1201,10448
9/11/2017,2017,9,11, 23 ,7333,1334,1142,9809
9/11/2017,2017,9,11, 24 ,7012,1267,1077,9356
9/12/2017,2017,9,12, 1 ,6682,1222,1030,8934
9/12/2017,2017,9,12, 2 ,6419,1194,998,8611
9/12/2017,2017,9,12, 3 ,6182,1159,974,8315
9/12/2017,2017,9,12, 4 ,6145,1157,983,8285
9/12/2017,2017,9,12, 5 ,6223,1196,1030,8449
9/12/2017,2017,9,12, 6 ,6220,1250,1083,8553
9/12/2017,2017,9,12, 7 ,6401,1201,998,8600
9/12/2017,2017,9,12, 8 ,7005,1359,1140,9504
9/12/2017,2017,9,12, 9 ,7646,1548,1371,10565
9/12/2017,2017,9,12, 10 ,8033,1675,1480,11188
9/12/2017,2017,9,12, 11 ,8291,1724,1528,11543
9/12/2017,2017,9,12, 12 ,7896,1663,1372,10931
9/12/2017,2017,9,12, 13 ,7760,1642,1400,10802
9/12/2017,2017,9,12, 14 ,7797,1706,1448,10951
9/12/2017,2017,9,12, 15 ,7527,1692,1491,10710
9/12/2017,2017,9,12, 16 ,7290,1674,1491,10455
9/12/2017,2017,9,12, 17 ,7159,1624,1438,10221
9/12/2017,2017,9,12, 18 ,7497,1744,1544,10785
9/12/2017,2017,9,12, 19 ,7690,1745,1529,10964
9/12/2017,2017,9,12, 20 ,7608,1677,1475,10760
9/12/2017,2017,9,12, 21 ,7473,1568,1330,10371
9/12/2017,2017,9,12, 22 ,7021,1421,1273,9715
9/12/2017,2017,9,12, 23 ,6686,1334,1175,9195
9/12/2017,2017,9,12, 24 ,6366,1250,1137,8753
9/13/2017,2017,9,13, 1 ,6146,1226,1062,8434
9/13/2017,2017,9,13, 2 ,5974,1189,1028,8191
9/13/2017,2017,9,13, 3 ,5904,1173,1004,8081
9/13/2017,2017,9,13, 4 ,5855,1170,1003,8028
9/13/2017,2017,9,13, 5 ,5992,1213,1063,8268
9/13/2017,2017,9,13, 6 ,6208,1255,1144,8607
9/13/2017,2017,9,13, 7 ,6489,1196,1073,8758
9/13/2017,2017,9,13, 8 ,7388,1391,1234,10013
9/13/2017,2017,9,13, 9 ,8275,1619,1442,11336
9/13/2017,2017,9,13, 10 ,8844,1742,1520,12106
9/13/2017,2017,9,13, 11 ,9152,1794,1557,12503
9/13/2017,2017,9,13, 12 ,8977,1754,1517,12248
9/13/2017,2017,9,13, 13 ,8923,1738,1498,12159
9/13/2017,2017,9,13, 14 ,9253,1788,1561,12602
9/13/2017,2017,9,13, 15 ,9199,1797,1544,12540
9/13/2017,2017,9,13, 16 ,9076,1748,1518,12342
9/13/2017,2017,9,13, 17 ,8666,1682,1481,11829
9/13/2017,2017,9,13, 18 ,8637,1801,1607,12045
9/13/2017,2017,9,13, 19 ,8736,1782,1568,12086
9/13/2017,2017,9,13, 20 ,8636,1721,1501,11858
9/13/2017,2017,9,13, 21 ,8302,1631,1417,11350
9/13/2017,2017,9,13, 22 ,7970,1494,1287,10751
9/13/2017,2017,9,13, 23 ,7541,1387,1187,10115
9/13/2017,2017,9,13, 24 ,7171,1302,1122,9595
9/14/2017,2017,9,14, 1 ,6857,1248,1085,9190
9/14/2017,2017,9,14, 2 ,6649,1210,1040,8899
9/14/2017,2017,9,14, 3 ,6508,1181,1021,8710
9/14/2017,2017,9,14, 4 ,6345,1174,1027,8546
9/14/2017,2017,9,14, 5 ,6559,1216,1083,8858
9/14/2017,2017,9,14, 6 ,6544,1251,1125,8920
9/14/2017,2017,9,14, 7 ,6708,1202,1049,8959
9/14/2017,2017,9,14, 8 ,7637,1393,1172,10202
9/14/2017,2017,9,14, 9 ,8545,1639,1374,11558
9/14/2017,2017,9,14, 10 ,9096,1747,1495,12338
9/14/2017,2017,9,14, 11 ,9403,1794,1519,12716
9/14/2017,2017,9,14, 12 ,9208,1732,1503,12443
9/14/2017,2017,9,14, 13 ,9129,1706,1554,12389
9/14/2017,2017,9,14, 14 ,9356,1785,1583,12724
9/14/2017,2017,9,14, 15 ,9196,1772,1598,12566
9/14/2017,2017,9,14, 16 ,9028,1729,1548,12305
9/14/2017,2017,9,14, 17 ,8690,1667,1520,11877
9/14/2017,2017,9,14, 18 ,8729,1788,1592,12109
9/14/2017,2017,9,14, 19 ,8861,1780,1550,12191
9/14/2017,2017,9,14, 20 ,8820,1716,1469,12005
9/14/2017,2017,9,14, 21 ,8645,1637,1385,11667
9/14/2017,2017,9,14, 22 ,8189,1508,1254,10951
9/14/2017,2017,9,14, 23 ,7757,1390,1161,10308
9/14/2017,2017,9,14, 24 ,7436,1315,1171,9922
9/15/2017,2017,9,15, 1 ,7118,1274,1054,9446
9/15/2017,2017,9,15, 2 ,6674,1230,1012,8916
9/15/2017,2017,9,15, 3 ,6534,1203,982,8719
9/15/2017,2017,9,15, 4 ,6454,1187,979,8620
9/15/2017,2017,9,15, 5 ,6556,1227,1032,8815
9/15/2017,2017,9,15, 6 ,6587,1243,1065,8895
9/15/2017,2017,9,15, 7 ,6689,1214,1028,8931
9/15/2017,2017,9,15, 8 ,7540,1411,1161,10112
9/15/2017,2017,9,15, 9 ,8487,1637,1379,11503
9/15/2017,2017,9,15, 10 ,9035,1744,1489,12268
9/15/2017,2017,9,15, 11 ,9344,1805,1545,12694
9/15/2017,2017,9,15, 12 ,9112,1723,1546,12381
9/15/2017,2017,9,15, 13 ,9134,1727,1539,12400
9/15/2017,2017,9,15, 14 ,9449,1801,1615,12865
9/15/2017,2017,9,15, 15 ,9295,1762,1555,12612
9/15/2017,2017,9,15, 16 ,9123,1749,1522,12394
9/15/2017,2017,9,15, 17 ,8607,1661,1480,11748
9/15/2017,2017,9,15, 18 ,8611,1760,1582,11953
9/15/2017,2017,9,15, 19 ,8664,1751,1539,11954
9/15/2017,2017,9,15, 20 ,8663,1668,1475,11806
9/15/2017,2017,9,15, 21 ,8580,1625,1405,11610
9/15/2017,2017,9,15, 22 ,8178,1499,1285,10962
9/15/2017,2017,9,15, 23 ,7757,1387,1185,10329
9/15/2017,2017,9,15, 24 ,7442,1311,1119,9872
9/16/2017,2017,9,16, 1 ,7124,1262,1054,9440
9/16/2017,2017,9,16, 2 ,6898,1231,1031,9160
9/16/2017,2017,9,16, 3 ,6702,1207,1000,8909
9/16/2017,2017,9,16, 4 ,6513,1187,981,8681
9/16/2017,2017,9,16, 5 ,6402,1201,1003,8606
9/16/2017,2017,9,16, 6 ,6335,1205,1032,8572
9/16/2017,2017,9,16, 7 ,6564,1194,993,8751
9/16/2017,2017,9,16, 8 ,7199,1332,1094,9625
9/16/2017,2017,9,16, 9 ,7859,1520,1254,10633
9/16/2017,2017,9,16, 10 ,8410,1635,1385,11430
9/16/2017,2017,9,16, 11 ,8777,1696,1468,11941
9/16/2017,2017,9,16, 12 ,8564,1642,1457,11663
9/16/2017,2017,9,16, 13 ,8577,1622,1421,11620
9/16/2017,2017,9,16, 14 ,8850,1695,1494,12039
9/16/2017,2017,9,16, 15 ,8751,1678,1446,11875
9/16/2017,2017,9,16, 16 ,8439,1636,1420,11495
9/16/2017,2017,9,16, 17 ,8056,1578,1367,11001
9/16/2017,2017,9,16, 18 ,8072,1689,1555,11316
9/16/2017,2017,9,16, 19 ,8353,1725,1532,11610
9/16/2017,2017,9,16, 20 ,8343,1686,1408,11437
9/16/2017,2017,9,16, 21 ,8295,1574,1378,11247
9/16/2017,2017,9,16, 22 ,8077,1510,1295,10882
9/16/2017,2017,9,16, 23 ,7764,1402,1219,10385
9/16/2017,2017,9,16, 24 ,7348,1299,1200,9847
9/17/2017,2017,9,17, 1 ,7058,1239,1053,9350
9/17/2017,2017,9,17, 2 ,6771,1201,1025,8997
9/17/2017,2017,9,17, 3 ,6638,1168,993,8799
9/17/2017,2017,9,17, 4 ,6491,1147,972,8610
9/17/2017,2017,9,17, 5 ,6354,1145,985,8484
9/17/2017,2017,9,17, 6 ,6170,1112,969,8251
9/17/2017,2017,9,17, 7 ,6180,1112,972,8264
9/17/2017,2017,9,17, 8 ,6392,1189,1022,8603
9/17/2017,2017,9,17, 9 ,6893,1323,1116,9332
9/17/2017,2017,9,17, 10 ,7387,1373,1217,9977
9/17/2017,2017,9,17, 11 ,7631,1446,1279,10356
9/17/2017,2017,9,17, 12 ,7679,1443,1309,10431
9/17/2017,2017,9,17, 13 ,7723,1423,1296,10442
9/17/2017,2017,9,17, 14 ,7774,1410,1310,10494
9/17/2017,2017,9,17, 15 ,7644,1399,1281,10324
9/17/2017,2017,9,17, 16 ,7434,1366,1263,10063
9/17/2017,2017,9,17, 17 ,7247,1374,1260,9881
9/17/2017,2017,9,17, 18 ,7565,1570,1406,10541
9/17/2017,2017,9,17, 19 ,7966,1616,1357,10939
9/17/2017,2017,9,17, 20 ,8059,1610,1350,11019
9/17/2017,2017,9,17, 21 ,8005,1548,1279,10832
9/17/2017,2017,9,17, 22 ,7712,1447,1206,10365
9/17/2017,2017,9,17, 23 ,7361,1347,1097,9805
9/17/2017,2017,9,17, 24 ,7000,1272,1022,9294
9/18/2017,2017,9,18, 1 ,6692,1213,976,8881
9/18/2017,2017,9,18, 2 ,6428,1171,941,8540
9/18/2017,2017,9,18, 3 ,6251,1138,919,8308
9/18/2017,2017,9,18, 4 ,6142,1123,919,8184
9/18/2017,2017,9,18, 5 ,6368,1179,967,8514
9/18/2017,2017,9,18, 6 ,6388,1222,1051,8661
9/18/2017,2017,9,18, 7 ,6649,1183,989,8821
9/18/2017,2017,9,18, 8 ,7657,1373,1106,10136
9/18/2017,2017,9,18, 9 ,8573,1604,1303,11480
9/18/2017,2017,9,18, 10 ,9112,1706,1477,12295
9/18/2017,2017,9,18, 11 ,9506,1781,1562,12849
9/18/2017,2017,9,18, 12 ,9347,1713,1540,12600
9/18/2017,2017,9,18, 13 ,9385,1698,1530,12613
9/18/2017,2017,9,18, 14 ,9658,1751,1591,13000
9/18/2017,2017,9,18, 15 ,9333,1730,1565,12628
9/18/2017,2017,9,18, 16 ,9157,1701,1524,12382
9/18/2017,2017,9,18, 17 ,8765,1660,1496,11921
9/18/2017,2017,9,18, 18 ,8711,1762,1585,12058
9/18/2017,2017,9,18, 19 ,8834,1741,1556,12131
9/18/2017,2017,9,18, 20 ,8828,1680,1478,11986
9/18/2017,2017,9,18, 21 ,8675,1590,1394,11659
9/18/2017,2017,9,18, 22 ,8245,1464,1262,10971
9/18/2017,2017,9,18, 23 ,7838,1344,1161,10343
9/18/2017,2017,9,18, 24 ,7417,1281,1057,9755
9/19/2017,2017,9,19, 1 ,7057,1227,1056,9340
9/19/2017,2017,9,19, 2 ,6856,1197,1026,9079
9/19/2017,2017,9,19, 3 ,6606,1173,1003,8782
9/19/2017,2017,9,19, 4 ,6550,1163,995,8708
9/19/2017,2017,9,19, 5 ,6660,1217,1046,8923
9/19/2017,2017,9,19, 6 ,6676,1244,1085,9005
9/19/2017,2017,9,19, 7 ,6810,1196,1027,9033
9/19/2017,2017,9,19, 8 ,7669,1371,1183,10223
9/19/2017,2017,9,19, 9 ,8650,1595,1413,11658
9/19/2017,2017,9,19, 10 ,9149,1708,1534,12391
9/19/2017,2017,9,19, 11 ,9461,1767,1590,12818
9/19/2017,2017,9,19, 12 ,9301,1710,1571,12582
9/19/2017,2017,9,19, 13 ,9371,1714,1559,12644
9/19/2017,2017,9,19, 14 ,9644,1824,1589,13057
9/19/2017,2017,9,19, 15 ,9527,1760,1552,12839
9/19/2017,2017,9,19, 16 ,9249,1703,1513,12465
9/19/2017,2017,9,19, 17 ,8749,1656,1501,11906
9/19/2017,2017,9,19, 18 ,8732,1763,1531,12026
9/19/2017,2017,9,19, 19 ,8634,1760,1494,11888
9/19/2017,2017,9,19, 20 ,8649,1672,1466,11787
9/19/2017,2017,9,19, 21 ,8515,1604,1409,11528
9/19/2017,2017,9,19, 22 ,8123,1464,1232,10819
9/19/2017,2017,9,19, 23 ,7713,1349,1126,10188
9/19/2017,2017,9,19, 24 ,7309,1277,1062,9648
9/20/2017,2017,9,20, 1 ,7004,1223,1059,9286
9/20/2017,2017,9,20, 2 ,6762,1182,1035,8979
9/20/2017,2017,9,20, 3 ,6588,1151,1009,8748
9/20/2017,2017,9,20, 4 ,6437,1145,997,8579
9/20/2017,2017,9,20, 5 ,6589,1190,1065,8844
9/20/2017,2017,9,20, 6 ,6668,1236,1121,9025
9/20/2017,2017,9,20, 7 ,6820,1176,1031,9027
9/20/2017,2017,9,20, 8 ,7747,1334,1200,10281
9/20/2017,2017,9,20, 9 ,8554,1569,1391,11514
9/20/2017,2017,9,20, 10 ,9105,1684,1525,12314
9/20/2017,2017,9,20, 11 ,9349,1731,1541,12621
9/20/2017,2017,9,20, 12 ,9228,1690,1563,12481
9/20/2017,2017,9,20, 13 ,9228,1681,1567,12476
9/20/2017,2017,9,20, 14 ,9507,1740,1623,12870
9/20/2017,2017,9,20, 15 ,9315,1732,1603,12650
9/20/2017,2017,9,20, 16 ,9084,1685,1548,12317
9/20/2017,2017,9,20, 17 ,8774,1662,1491,11927
9/20/2017,2017,9,20, 18 ,8707,1745,1588,12040
9/20/2017,2017,9,20, 19 ,8718,1712,1525,11955
9/20/2017,2017,9,20, 20 ,8615,1660,1480,11755
9/20/2017,2017,9,20, 21 ,8424,1590,1389,11403
9/20/2017,2017,9,20, 22 ,8093,1446,1275,10814
9/20/2017,2017,9,20, 23 ,7671,1337,1177,10185
9/20/2017,2017,9,20, 24 ,7217,1262,1098,9577
9/21/2017,2017,9,21, 1 ,6930,1220,1055,9205
9/21/2017,2017,9,21, 2 ,6818,1178,1024,9020
9/21/2017,2017,9,21, 3 ,6589,1147,997,8733
9/21/2017,2017,9,21, 4 ,6464,1131,976,8571
9/21/2017,2017,9,21, 5 ,6526,1147,1013,8686
9/21/2017,2017,9,21, 6 ,6508,1175,1046,8729
9/21/2017,2017,9,21, 7 ,6710,1176,1035,8921
9/21/2017,2017,9,21, 8 ,7498,1316,1147,9961
9/21/2017,2017,9,21, 9 ,8329,1533,1257,11119
9/21/2017,2017,9,21, 10 ,8843,1625,1383,11851
9/21/2017,2017,9,21, 11 ,9202,1706,1441,12349
9/21/2017,2017,9,21, 12 ,9028,1679,1410,12117
9/21/2017,2017,9,21, 13 ,9075,1691,1382,12148
9/21/2017,2017,9,21, 14 ,9426,1753,1426,12605
9/21/2017,2017,9,21, 15 ,9329,1743,1426,12498
9/21/2017,2017,9,21, 16 ,9063,1708,1398,12169
9/21/2017,2017,9,21, 17 ,8780,1641,1412,11833
9/21/2017,2017,9,21, 18 ,8785,1749,1561,12095
9/21/2017,2017,9,21, 19 ,8978,1722,1517,12217
9/21/2017,2017,9,21, 20 ,8854,1660,1408,11922
9/21/2017,2017,9,21, 21 ,8752,1577,1351,11680
9/21/2017,2017,9,21, 22 ,8339,1453,1226,11018
9/21/2017,2017,9,21, 23 ,7893,1339,1114,10346
9/21/2017,2017,9,21, 24 ,7538,1263,1077,9878
9/22/2017,2017,9,22, 1 ,7144,1222,1040,9406
9/22/2017,2017,9,22, 2 ,6984,1201,1012,9197
9/22/2017,2017,9,22, 3 ,6759,1163,994,8916
9/22/2017,2017,9,22, 4 ,6631,1158,994,8783
9/22/2017,2017,9,22, 5 ,6767,1208,1031,9006
9/22/2017,2017,9,22, 6 ,6798,1239,1094,9131
9/22/2017,2017,9,22, 7 ,6920,1196,1011,9127
9/22/2017,2017,9,22, 8 ,7737,1346,1153,10236
9/22/2017,2017,9,22, 9 ,8621,1563,1317,11501
9/22/2017,2017,9,22, 10 ,9084,1688,1445,12217
9/22/2017,2017,9,22, 11 ,9348,1740,1521,12609
9/22/2017,2017,9,22, 12 ,9192,1665,1502,12359
9/22/2017,2017,9,22, 13 ,9131,1652,1496,12279
9/22/2017,2017,9,22, 14 ,9414,1680,1527,12621
9/22/2017,2017,9,22, 15 ,9226,1611,1479,12316
9/22/2017,2017,9,22, 16 ,8992,1622,1460,12074
9/22/2017,2017,9,22, 17 ,8601,1604,1455,11660
9/22/2017,2017,9,22, 18 ,8617,1659,1555,11831
9/22/2017,2017,9,22, 19 ,8669,1605,1480,11754
9/22/2017,2017,9,22, 20 ,8591,1531,1381,11503
9/22/2017,2017,9,22, 21 ,8450,1429,1320,11199
9/22/2017,2017,9,22, 22 ,8153,1321,1215,10689
9/22/2017,2017,9,22, 23 ,7761,1220,1151,10132
9/22/2017,2017,9,22, 24 ,7330,1147,1067,9544
9/23/2017,2017,9,23, 1 ,7002,1104,1018,9124
9/23/2017,2017,9,23, 2 ,6854,1073,1016,8943
9/23/2017,2017,9,23, 3 ,6576,1054,983,8613
9/23/2017,2017,9,23, 4 ,6377,1048,977,8402
9/23/2017,2017,9,23, 5 ,6330,1062,980,8372
9/23/2017,2017,9,23, 6 ,6312,1087,1007,8406
9/23/2017,2017,9,23, 7 ,6432,1111,974,8517
9/23/2017,2017,9,23, 8 ,6930,1235,1047,9212
9/23/2017,2017,9,23, 9 ,7449,1402,1182,10033
9/23/2017,2017,9,23, 10 ,7917,1494,1308,10719
9/23/2017,2017,9,23, 11 ,8225,1559,1377,11161
9/23/2017,2017,9,23, 12 ,7973,1520,1361,10854
9/23/2017,2017,9,23, 13 ,7831,1539,1377,10747
9/23/2017,2017,9,23, 14 ,8011,1606,1425,11042
9/23/2017,2017,9,23, 15 ,7940,1595,1403,10938
9/23/2017,2017,9,23, 16 ,7758,1557,1384,10699
9/23/2017,2017,9,23, 17 ,7606,1520,1334,10460
9/23/2017,2017,9,23, 18 ,7866,1663,1533,11062
9/23/2017,2017,9,23, 19 ,8040,1683,1466,11189
9/23/2017,2017,9,23, 20 ,8038,1630,1481,11149
9/23/2017,2017,9,23, 21 ,7905,1561,1442,10908
9/23/2017,2017,9,23, 22 ,7653,1459,1313,10425
9/23/2017,2017,9,23, 23 ,7245,1328,1217,9790
9/23/2017,2017,9,23, 24 ,6911,1241,1105,9257
9/24/2017,2017,9,24, 1 ,6529,1185,1077,8791
9/24/2017,2017,9,24, 2 ,6349,1132,1019,8500
9/24/2017,2017,9,24, 3 ,6172,1101,1002,8275
9/24/2017,2017,9,24, 4 ,6005,1088,983,8076
9/24/2017,2017,9,24, 5 ,5937,1090,985,8012
9/24/2017,2017,9,24, 6 ,5745,1086,982,7813
9/24/2017,2017,9,24, 7 ,5763,1106,986,7855
9/24/2017,2017,9,24, 8 ,6182,1179,1023,8384
9/24/2017,2017,9,24, 9 ,6655,1261,1106,9022
9/24/2017,2017,9,24, 10 ,7176,1369,1211,9756
9/24/2017,2017,9,24, 11 ,7443,1424,1283,10150
9/24/2017,2017,9,24, 12 ,7426,1426,1270,10122
9/24/2017,2017,9,24, 13 ,7479,1448,1272,10199
9/24/2017,2017,9,24, 14 ,7603,1450,1266,10319
9/24/2017,2017,9,24, 15 ,7554,1429,1250,10233
9/24/2017,2017,9,24, 16 ,7403,1413,1210,10026
9/24/2017,2017,9,24, 17 ,7265,1419,1231,9915
9/24/2017,2017,9,24, 18 ,7569,1624,1406,10599
9/24/2017,2017,9,24, 19 ,8089,1633,1376,11098
9/24/2017,2017,9,24, 20 ,8131,1583,1335,11049
9/24/2017,2017,9,24, 21 ,8107,1493,1261,10861
9/24/2017,2017,9,24, 22 ,7808,1394,1158,10360
9/24/2017,2017,9,24, 23 ,7456,1308,1069,9833
9/24/2017,2017,9,24, 24 ,7025,1221,1027,9273
9/25/2017,2017,9,25, 1 ,6638,1163,949,8750
9/25/2017,2017,9,25, 2 ,6394,1122,936,8452
9/25/2017,2017,9,25, 3 ,6256,1090,920,8266
9/25/2017,2017,9,25, 4 ,6159,1081,919,8159
9/25/2017,2017,9,25, 5 ,6241,1138,978,8357
9/25/2017,2017,9,25, 6 ,6392,1192,1022,8606
9/25/2017,2017,9,25, 7 ,6500,1155,977,8632
9/25/2017,2017,9,25, 8 ,7558,1325,1112,9995
9/25/2017,2017,9,25, 9 ,8486,1526,1316,11328
9/25/2017,2017,9,25, 10 ,9038,1626,1451,12115
9/25/2017,2017,9,25, 11 ,9368,1662,1438,12468
9/25/2017,2017,9,25, 12 ,9103,1609,1456,12168
9/25/2017,2017,9,25, 13 ,8878,1606,1475,11959
9/25/2017,2017,9,25, 14 ,9049,1641,1548,12238
9/25/2017,2017,9,25, 15 ,8851,1624,1518,11993
9/25/2017,2017,9,25, 16 ,8759,1619,1504,11882
9/25/2017,2017,9,25, 17 ,8540,1602,1450,11592
9/25/2017,2017,9,25, 18 ,8705,1720,1545,11970
9/25/2017,2017,9,25, 19 ,8737,1675,1515,11927
9/25/2017,2017,9,25, 20 ,8591,1589,1449,11629
9/25/2017,2017,9,25, 21 ,8409,1501,1380,11290
9/25/2017,2017,9,25, 22 ,7965,1364,1143,10472
9/25/2017,2017,9,25, 23 ,7516,1263,1084,9863
9/25/2017,2017,9,25, 24 ,7113,1189,1020,9322
9/26/2017,2017,9,26, 1 ,6792,1145,1027,8964
9/26/2017,2017,9,26, 2 ,6570,1125,999,8694
9/26/2017,2017,9,26, 3 ,6369,1100,975,8444
9/26/2017,2017,9,26, 4 ,6269,1091,976,8336
9/26/2017,2017,9,26, 5 ,6442,1146,1051,8639
9/26/2017,2017,9,26, 6 ,6517,1205,1088,8810
9/26/2017,2017,9,26, 7 ,6658,1148,1006,8812
9/26/2017,2017,9,26, 8 ,7456,1324,1117,9897
9/26/2017,2017,9,26, 9 ,8303,1535,1369,11207
9/26/2017,2017,9,26, 10 ,8785,1642,1476,11903
9/26/2017,2017,9,26, 11 ,8993,1691,1543,12227
9/26/2017,2017,9,26, 12 ,8689,1699,1528,11916
9/26/2017,2017,9,26, 13 ,8608,1696,1542,11846
9/26/2017,2017,9,26, 14 ,8841,1737,1598,12176
9/26/2017,2017,9,26, 15 ,8782,1742,1620,12144
9/26/2017,2017,9,26, 16 ,8622,1723,1536,11881
9/26/2017,2017,9,26, 17 ,8519,1657,1480,11656
9/26/2017,2017,9,26, 18 ,8594,1798,1611,12003
9/26/2017,2017,9,26, 19 ,8531,1778,1551,11860
9/26/2017,2017,9,26, 20 ,8388,1720,1509,11617
9/26/2017,2017,9,26, 21 ,8264,1639,1420,11323
9/26/2017,2017,9,26, 22 ,7750,1493,1289,10532
9/26/2017,2017,9,26, 23 ,7383,1377,1189,9949
9/26/2017,2017,9,26, 24 ,6989,1290,1115,9394
9/27/2017,2017,9,27, 1 ,6694,1237,1058,8989
9/27/2017,2017,9,27, 2 ,6445,1203,1025,8673
9/27/2017,2017,9,27, 3 ,6348,1169,1006,8523
9/27/2017,2017,9,27, 4 ,6248,1159,965,8372
9/27/2017,2017,9,27, 5 ,6351,1212,1048,8611
9/27/2017,2017,9,27, 6 ,6484,1238,1109,8831
9/27/2017,2017,9,27, 7 ,6648,1185,1022,8855
9/27/2017,2017,9,27, 8 ,7555,1369,1147,10071
9/27/2017,2017,9,27, 9 ,8380,1597,1354,11331
9/27/2017,2017,9,27, 10 ,8943,1728,1451,12122
9/27/2017,2017,9,27, 11 ,9191,1754,1519,12464
9/27/2017,2017,9,27, 12 ,9056,1703,1502,12261
9/27/2017,2017,9,27, 13 ,9134,1754,1513,12401
9/27/2017,2017,9,27, 14 ,9422,1773,1582,12777
9/27/2017,2017,9,27, 15 ,9361,1804,1534,12699
9/27/2017,2017,9,27, 16 ,9209,1754,1519,12482
9/27/2017,2017,9,27, 17 ,8817,1692,1489,11998
9/27/2017,2017,9,27, 18 ,8865,1828,1647,12340
9/27/2017,2017,9,27, 19 ,8959,1827,1579,12365
9/27/2017,2017,9,27, 20 ,8849,1779,1508,12136
9/27/2017,2017,9,27, 21 ,8690,1726,1439,11855
9/27/2017,2017,9,27, 22 ,8257,1564,1299,11120
9/27/2017,2017,9,27, 23 ,7862,1435,1211,10508
9/27/2017,2017,9,27, 24 ,7506,1341,1140,9987
9/28/2017,2017,9,28, 1 ,7178,1274,1086,9538
9/28/2017,2017,9,28, 2 ,6908,1231,1042,9181
9/28/2017,2017,9,28, 3 ,6718,1193,1025,8936
9/28/2017,2017,9,28, 4 ,6661,1179,978,8818
9/28/2017,2017,9,28, 5 ,6756,1209,1056,9021
9/28/2017,2017,9,28, 6 ,6780,1252,1099,9131
9/28/2017,2017,9,28, 7 ,6891,1194,1036,9121
9/28/2017,2017,9,28, 8 ,7655,1382,1137,10174
9/28/2017,2017,9,28, 9 ,8526,1589,1384,11499
9/28/2017,2017,9,28, 10 ,8981,1711,1510,12202
9/28/2017,2017,9,28, 11 ,9234,1748,1581,12563
9/28/2017,2017,9,28, 12 ,9036,1706,1555,12297
9/28/2017,2017,9,28, 13 ,9047,1685,1556,12288
9/28/2017,2017,9,28, 14 ,9354,1755,1603,12712
9/28/2017,2017,9,28, 15 ,9230,1741,1540,12511
9/28/2017,2017,9,28, 16 ,9074,1709,1551,12334
9/28/2017,2017,9,28, 17 ,8697,1681,1527,11905
9/28/2017,2017,9,28, 18 ,8868,1774,1620,12262
9/28/2017,2017,9,28, 19 ,8816,1742,1565,12123
9/28/2017,2017,9,28, 20 ,8716,1690,1498,11904
9/28/2017,2017,9,28, 21 ,8602,1606,1425,11633
9/28/2017,2017,9,28, 22 ,8219,1481,1275,10975
9/28/2017,2017,9,28, 23 ,7738,1378,1179,10295
9/28/2017,2017,9,28, 24 ,7350,1299,1114,9763
9/29/2017,2017,9,29, 1 ,7021,1250,1074,9345
9/29/2017,2017,9,29, 2 ,6819,1219,1042,9080
9/29/2017,2017,9,29, 3 ,6597,1180,1012,8789
9/29/2017,2017,9,29, 4 ,6534,1158,1002,8694
9/29/2017,2017,9,29, 5 ,6598,1202,1050,8850
9/29/2017,2017,9,29, 6 ,6622,1222,1078,8922
9/29/2017,2017,9,29, 7 ,6728,1197,1034,8959
9/29/2017,2017,9,29, 8 ,7564,1366,1183,10113
9/29/2017,2017,9,29, 9 ,8368,1594,1399,11361
9/29/2017,2017,9,29, 10 ,8842,1697,1492,12031
9/29/2017,2017,9,29, 11 ,8989,1716,1537,12242
9/29/2017,2017,9,29, 12 ,8735,1668,1488,11891
9/29/2017,2017,9,29, 13 ,8666,1666,1513,11845
9/29/2017,2017,9,29, 14 ,8945,1722,1544,12211
9/29/2017,2017,9,29, 15 ,8953,1699,1448,12100
9/29/2017,2017,9,29, 16 ,8794,1684,1428,11906
9/29/2017,2017,9,29, 17 ,8515,1645,1440,11600
9/29/2017,2017,9,29, 18 ,8659,1752,1559,11970
9/29/2017,2017,9,29, 19 ,8673,1707,1491,11871
9/29/2017,2017,9,29, 20 ,8577,1659,1448,11684
9/29/2017,2017,9,29, 21 ,8386,1582,1350,11318
9/29/2017,2017,9,29, 22 ,8138,1451,1230,10819
9/29/2017,2017,9,29, 23 ,7675,1351,1155,10181
9/29/2017,2017,9,29, 24 ,7284,1274,1066,9624
9/30/2017,2017,9,30, 1 ,6975,1220,1025,9220
9/30/2017,2017,9,30, 2 ,6719,1180,1000,8899
9/30/2017,2017,9,30, 3 ,6514,1148,971,8633
9/30/2017,2017,9,30, 4 ,6343,1138,956,8437
9/30/2017,2017,9,30, 5 ,6285,1149,988,8422
9/30/2017,2017,9,30, 6 ,6252,1164,1006,8422
9/30/2017,2017,9,30, 7 ,6356,1176,999,8531
9/30/2017,2017,9,30, 8 ,6883,1299,1102,9284
9/30/2017,2017,9,30, 9 ,7518,1486,1220,10224
9/30/2017,2017,9,30, 10 ,8112,1583,1346,11041
9/30/2017,2017,9,30, 11 ,8458,1630,1417,11505
9/30/2017,2017,9,30, 12 ,8314,1577,1405,11296
9/30/2017,2017,9,30, 13 ,8251,1590,1439,11280
9/30/2017,2017,9,30, 14 ,8336,1631,1493,11460
9/30/2017,2017,9,30, 15 ,8041,1586,1462,11089
9/30/2017,2017,9,30, 16 ,7844,1556,1435,10835
9/30/2017,2017,9,30, 17 ,7566,1535,1387,10488
9/30/2017,2017,9,30, 18 ,7889,1703,1509,11101
9/30/2017,2017,9,30, 19 ,8020,1678,1442,11140
9/30/2017,2017,9,30, 20 ,8055,1624,1439,11118
9/30/2017,2017,9,30, 21 ,7950,1547,1377,10874
9/30/2017,2017,9,30, 22 ,7660,1441,1286,10387
9/30/2017,2017,9,30, 23 ,7228,1335,1175,9738
9/30/2017,2017,9,30, 24 ,6895,1253,1093,9241
10/1/2017,2017,10,1, 1 ,6510,1187,1013,8710
10/1/2017,2017,10,1, 2 ,6348,1147,1001,8496
10/1/2017,2017,10,1, 3 ,6155,1121,981,8257
10/1/2017,2017,10,1, 4 ,5964,1101,961,8026
10/1/2017,2017,10,1, 5 ,5968,1105,960,8033
10/1/2017,2017,10,1, 6 ,5728,1093,971,7792
10/1/2017,2017,10,1, 7 ,5739,1110,954,7803
10/1/2017,2017,10,1, 8 ,6027,1186,1010,8223
10/1/2017,2017,10,1, 9 ,6451,1297,1085,8833
10/1/2017,2017,10,1, 10 ,6948,1401,1209,9558
10/1/2017,2017,10,1, 11 ,7171,1474,1282,9927
10/1/2017,2017,10,1, 12 ,7145,1446,1298,9889
10/1/2017,2017,10,1, 13 ,7118,1449,1306,9873
10/1/2017,2017,10,1, 14 ,7038,1468,1335,9841
10/1/2017,2017,10,1, 15 ,6998,1442,1311,9751
10/1/2017,2017,10,1, 16 ,6847,1406,1261,9514
10/1/2017,2017,10,1, 17 ,6819,1478,1267,9564
10/1/2017,2017,10,1, 18 ,7437,1610,1442,10489
10/1/2017,2017,10,1, 19 ,7709,1624,1448,10781
10/1/2017,2017,10,1, 20 ,7721,1599,1426,10746
10/1/2017,2017,10,1, 21 ,7546,1526,1347,10419
10/1/2017,2017,10,1, 22 ,7292,1427,1243,9962
10/1/2017,2017,10,1, 23 ,6930,1324,879,9133
10/1/2017,2017,10,1, 24 ,6532,1250,856,8638
10/2/2017,2017,10,2, 1 ,6182,1189,846,8217
10/2/2017,2017,10,2, 2 ,6018,1154,898,8070
10/2/2017,2017,10,2, 3 ,5841,1123,918,7882
10/2/2017,2017,10,2, 4 ,5792,1105,942,7839
10/2/2017,2017,10,2, 5 ,5982,1165,1013,8160
10/2/2017,2017,10,2, 6 ,6153,1209,1070,8432
10/2/2017,2017,10,2, 7 ,6371,1154,990,8515
10/2/2017,2017,10,2, 8 ,7263,1326,1191,9780
10/2/2017,2017,10,2, 9 ,8171,1575,1430,11176
10/2/2017,2017,10,2, 10 ,8655,1715,1551,11921
10/2/2017,2017,10,2, 11 ,8861,1788,1629,12278
10/2/2017,2017,10,2, 12 ,8750,1780,1613,12143
10/2/2017,2017,10,2, 13 ,8790,1789,1604,12183
10/2/2017,2017,10,2, 14 ,9060,1824,1654,12538
10/2/2017,2017,10,2, 15 ,8985,1773,1554,12312
10/2/2017,2017,10,2, 16 ,8806,1734,1515,12055
10/2/2017,2017,10,2, 17 ,8490,1698,1487,11675
10/2/2017,2017,10,2, 18 ,8617,1824,1577,12018
10/2/2017,2017,10,2, 19 ,8637,1761,1519,11917
10/2/2017,2017,10,2, 20 ,8510,1699,1496,11705
10/2/2017,2017,10,2, 21 ,8226,1615,1410,11251
10/2/2017,2017,10,2, 22 ,7882,1503,1277,10662
10/2/2017,2017,10,2, 23 ,7422,1391,1152,9965
10/2/2017,2017,10,2, 24 ,7017,1304,1071,9392
10/3/2017,2017,10,3, 1 ,6702,1256,1063,9021
10/3/2017,2017,10,3, 2 ,6484,1216,1048,8748
10/3/2017,2017,10,3, 3 ,6271,1183,1017,8471
10/3/2017,2017,10,3, 4 ,6219,1166,1005,8390
10/3/2017,2017,10,3, 5 ,6326,1221,1063,8610
10/3/2017,2017,10,3, 6 ,6438,1253,1099,8790
10/3/2017,2017,10,3, 7 ,6578,1209,1025,8812
10/3/2017,2017,10,3, 8 ,7331,1393,1196,9920
10/3/2017,2017,10,3, 9 ,8127,1629,1419,11175
10/3/2017,2017,10,3, 10 ,8684,1733,1550,11967
10/3/2017,2017,10,3, 11 ,9097,1797,1602,12496
10/3/2017,2017,10,3, 12 ,8932,1741,1561,12234
10/3/2017,2017,10,3, 13 ,8888,1755,1553,12196
10/3/2017,2017,10,3, 14 ,9239,1824,1618,12681
10/3/2017,2017,10,3, 15 ,9088,1793,1588,12469
10/3/2017,2017,10,3, 16 ,8828,1760,1551,12139
10/3/2017,2017,10,3, 17 ,8511,1702,1517,11730
10/3/2017,2017,10,3, 18 ,8694,1846,1626,12166
10/3/2017,2017,10,3, 19 ,8685,1792,1560,12037
10/3/2017,2017,10,3, 20 ,8575,1730,1514,11819
10/3/2017,2017,10,3, 21 ,8363,1647,1433,11443
10/3/2017,2017,10,3, 22 ,7895,1505,1286,10686
10/3/2017,2017,10,3, 23 ,7490,1400,1188,10078
10/3/2017,2017,10,3, 24 ,7086,1311,1183,9580
10/4/2017,2017,10,4, 1 ,6755,1252,1043,9050
10/4/2017,2017,10,4, 2 ,6556,1219,1015,8790
10/4/2017,2017,10,4, 3 ,6321,1193,989,8503
10/4/2017,2017,10,4, 4 ,6271,1178,985,8434
10/4/2017,2017,10,4, 5 ,6341,1228,1033,8602
10/4/2017,2017,10,4, 6 ,6482,1261,1058,8801
10/4/2017,2017,10,4, 7 ,6562,1216,1014,8792
10/4/2017,2017,10,4, 8 ,7402,1384,1182,9968
10/4/2017,2017,10,4, 9 ,8299,1627,1419,11345
10/4/2017,2017,10,4, 10 ,8881,1743,1510,12134
10/4/2017,2017,10,4, 11 ,9170,1817,1584,12571
10/4/2017,2017,10,4, 12 ,8940,1767,1575,12282
10/4/2017,2017,10,4, 13 ,8981,1742,1610,12333
10/4/2017,2017,10,4, 14 ,9310,1783,1640,12733
10/4/2017,2017,10,4, 15 ,9140,1759,1634,12533
10/4/2017,2017,10,4, 16 ,9072,1722,1595,12389
10/4/2017,2017,10,4, 17 ,8706,1683,1533,11922
10/4/2017,2017,10,4, 18 ,8860,1833,1643,12336
10/4/2017,2017,10,4, 19 ,8901,1790,1604,12295
10/4/2017,2017,10,4, 20 ,8824,1747,1529,12100
10/4/2017,2017,10,4, 21 ,8529,1666,1461,11656
10/4/2017,2017,10,4, 22 ,8260,1529,1292,11081
10/4/2017,2017,10,4, 23 ,7826,1429,1219,10474
10/4/2017,2017,10,4, 24 ,7438,1335,1142,9915
10/5/2017,2017,10,5, 1 ,7165,1265,1078,9508
10/5/2017,2017,10,5, 2 ,6907,1222,1041,9170
10/5/2017,2017,10,5, 3 ,6739,1198,1011,8948
10/5/2017,2017,10,5, 4 ,6619,1191,1001,8811
10/5/2017,2017,10,5, 5 ,6700,1228,1049,8977
10/5/2017,2017,10,5, 6 ,6705,1250,1076,9031
10/5/2017,2017,10,5, 7 ,6792,1220,1031,9043
10/5/2017,2017,10,5, 8 ,7556,1434,1200,10190
10/5/2017,2017,10,5, 9 ,8265,1668,1422,11355
10/5/2017,2017,10,5, 10 ,8707,1799,1517,12023
10/5/2017,2017,10,5, 11 ,9045,1872,1624,12541
10/5/2017,2017,10,5, 12 ,8871,1809,1587,12267
10/5/2017,2017,10,5, 13 ,8847,1833,1607,12287
10/5/2017,2017,10,5, 14 ,9123,1878,1649,12650
10/5/2017,2017,10,5, 15 ,8970,1848,1599,12417
10/5/2017,2017,10,5, 16 ,8872,1808,1574,12254
10/5/2017,2017,10,5, 17 ,8605,1742,1530,11877
10/5/2017,2017,10,5, 18 ,8873,1896,1637,12406
10/5/2017,2017,10,5, 19 ,8829,1846,1538,12213
10/5/2017,2017,10,5, 20 ,8776,1767,1444,11987
10/5/2017,2017,10,5, 21 ,8463,1681,1417,11561
10/5/2017,2017,10,5, 22 ,8049,1557,1282,10888
10/5/2017,2017,10,5, 23 ,7621,1447,1189,10257
10/5/2017,2017,10,5, 24 ,7192,1366,1126,9684
10/6/2017,2017,10,6, 1 ,6846,1306,1060,9212
10/6/2017,2017,10,6, 2 ,6651,1258,1031,8940
10/6/2017,2017,10,6, 3 ,6458,1221,1007,8686
10/6/2017,2017,10,6, 4 ,6407,1203,997,8607
10/6/2017,2017,10,6, 5 ,6503,1238,1048,8789
10/6/2017,2017,10,6, 6 ,6517,1249,1085,8851
10/6/2017,2017,10,6, 7 ,6699,1203,1030,8932
10/6/2017,2017,10,6, 8 ,7642,1392,1199,10233
10/6/2017,2017,10,6, 9 ,8329,1588,1420,11337
10/6/2017,2017,10,6, 10 ,8863,1715,1562,12140
10/6/2017,2017,10,6, 11 ,9123,1758,1623,12504
10/6/2017,2017,10,6, 12 ,9006,1735,1579,12320
10/6/2017,2017,10,6, 13 ,8983,1750,1596,12329
10/6/2017,2017,10,6, 14 ,9377,1768,1662,12807
10/6/2017,2017,10,6, 15 ,9172,1733,1623,12528
10/6/2017,2017,10,6, 16 ,9003,1725,1575,12303
10/6/2017,2017,10,6, 17 ,8576,1678,1514,11768
10/6/2017,2017,10,6, 18 ,8712,1825,1645,12182
10/6/2017,2017,10,6, 19 ,8753,1760,1570,12083
10/6/2017,2017,10,6, 20 ,8714,1711,1521,11946
10/6/2017,2017,10,6, 21 ,8533,1639,1451,11623
10/6/2017,2017,10,6, 22 ,8062,1507,1318,10887
10/6/2017,2017,10,6, 23 ,7636,1397,1216,10249
10/6/2017,2017,10,6, 24 ,7267,1324,1105,9696
10/7/2017,2017,10,7, 1 ,6953,1265,1101,9319
10/7/2017,2017,10,7, 2 ,6698,1227,1062,8987
10/7/2017,2017,10,7, 3 ,6438,1187,1025,8650
10/7/2017,2017,10,7, 4 ,6329,1168,1011,8508
10/7/2017,2017,10,7, 5 ,6292,1164,1029,8485
10/7/2017,2017,10,7, 6 ,6277,1171,1044,8492
10/7/2017,2017,10,7, 7 ,6354,1158,1043,8555
10/7/2017,2017,10,7, 8 ,6976,1272,1144,9392
10/7/2017,2017,10,7, 9 ,7737,1482,1282,10501
10/7/2017,2017,10,7, 10 ,8358,1595,1413,11366
10/7/2017,2017,10,7, 11 ,8551,1645,1478,11674
10/7/2017,2017,10,7, 12 ,8342,1598,1457,11397
10/7/2017,2017,10,7, 13 ,8216,1614,1476,11306
10/7/2017,2017,10,7, 14 ,8470,1673,1486,11629
10/7/2017,2017,10,7, 15 ,8316,1655,1406,11377
10/7/2017,2017,10,7, 16 ,8023,1574,1391,10988
10/7/2017,2017,10,7, 17 ,7884,1580,1432,10896
10/7/2017,2017,10,7, 18 ,8120,1731,1588,11439
10/7/2017,2017,10,7, 19 ,8160,1713,1547,11420
10/7/2017,2017,10,7, 20 ,8157,1675,1520,11352
10/7/2017,2017,10,7, 21 ,8022,1618,1453,11093
10/7/2017,2017,10,7, 22 ,7690,1520,1379,10589
10/7/2017,2017,10,7, 23 ,7393,1399,1247,10039
10/7/2017,2017,10,7, 24 ,6971,1316,1155,9442
10/8/2017,2017,10,8, 1 ,6633,1255,1104,8992
10/8/2017,2017,10,8, 2 ,6461,1216,1068,8745
10/8/2017,2017,10,8, 3 ,6317,1178,1032,8527
10/8/2017,2017,10,8, 4 ,6066,1159,1015,8240
10/8/2017,2017,10,8, 5 ,6049,1165,1016,8230
10/8/2017,2017,10,8, 6 ,5877,1145,1003,8025
10/8/2017,2017,10,8, 7 ,5905,1135,970,8010
10/8/2017,2017,10,8, 8 ,6103,1217,1042,8362
10/8/2017,2017,10,8, 9 ,6479,1312,1098,8889
10/8/2017,2017,10,8, 10 ,6929,1431,1133,9493
10/8/2017,2017,10,8, 11 ,7055,1471,1209,9735
10/8/2017,2017,10,8, 12 ,7059,1473,1259,9791
10/8/2017,2017,10,8, 13 ,7030,1480,1313,9823
10/8/2017,2017,10,8, 14 ,6940,1474,1336,9750
10/8/2017,2017,10,8, 15 ,6881,1441,1262,9584
10/8/2017,2017,10,8, 16 ,6803,1427,1263,9493
10/8/2017,2017,10,8, 17 ,6790,1472,1287,9549
10/8/2017,2017,10,8, 18 ,7430,1694,1461,10585
10/8/2017,2017,10,8, 19 ,7703,1688,1316,10707
10/8/2017,2017,10,8, 20 ,7674,1660,1416,10750
10/8/2017,2017,10,8, 21 ,7569,1590,1343,10502
10/8/2017,2017,10,8, 22 ,7226,1478,1221,9925
10/8/2017,2017,10,8, 23 ,6851,1376,1142,9369
10/8/2017,2017,10,8, 24 ,6509,1297,1055,8861
10/9/2017,2017,10,9, 1 ,6248,1234,1001,8483
10/9/2017,2017,10,9, 2 ,6042,1196,960,8198
10/9/2017,2017,10,9, 3 ,5810,1169,932,7911
10/9/2017,2017,10,9, 4 ,5741,1158,934,7833
10/9/2017,2017,10,9, 5 ,5978,1213,1002,8193
10/9/2017,2017,10,9, 6 ,6188,1266,1047,8501
10/9/2017,2017,10,9, 7 ,6374,1218,990,8582
10/9/2017,2017,10,9, 8 ,7259,1377,1159,9795
10/9/2017,2017,10,9, 9 ,7953,1600,1384,10937
10/9/2017,2017,10,9, 10 ,8427,1698,1501,11626
10/9/2017,2017,10,9, 11 ,8649,1754,1590,11993
10/9/2017,2017,10,9, 12 ,8463,1725,1528,11716
10/9/2017,2017,10,9, 13 ,8378,1735,1535,11648
10/9/2017,2017,10,9, 14 ,8677,1804,1607,12088
10/9/2017,2017,10,9, 15 ,8590,1785,1566,11941
10/9/2017,2017,10,9, 16 ,8475,1754,1547,11776
10/9/2017,2017,10,9, 17 ,8275,1733,1495,11503
10/9/2017,2017,10,9, 18 ,8583,1884,1565,12032
10/9/2017,2017,10,9, 19 ,8418,1826,1520,11764
10/9/2017,2017,10,9, 20 ,8243,1767,1491,11501
10/9/2017,2017,10,9, 21 ,7989,1684,1393,11066
10/9/2017,2017,10,9, 22 ,7539,1533,1258,10330
10/9/2017,2017,10,9, 23 ,7131,1415,1183,9729
10/9/2017,2017,10,9, 24 ,6724,1328,1115,9167
10/10/2017,2017,10,10, 1 ,6490,1268,1051,8809
10/10/2017,2017,10,10, 2 ,6284,1238,1031,8553
10/10/2017,2017,10,10, 3 ,6190,1208,1010,8408
10/10/2017,2017,10,10, 4 ,6073,1194,989,8256
10/10/2017,2017,10,10, 5 ,6310,1231,1052,8593
10/10/2017,2017,10,10, 6 ,6411,1260,1103,8774
10/10/2017,2017,10,10, 7 ,6573,1227,1023,8823
10/10/2017,2017,10,10, 8 ,7363,1423,1215,10001
10/10/2017,2017,10,10, 9 ,8216,1676,1430,11322
10/10/2017,2017,10,10, 10 ,8803,1806,1562,12171
10/10/2017,2017,10,10, 11 ,9078,1864,1629,12571
10/10/2017,2017,10,10, 12 ,8834,1819,1605,12258
10/10/2017,2017,10,10, 13 ,8831,1821,1629,12281
10/10/2017,2017,10,10, 14 ,9080,1880,1672,12632
10/10/2017,2017,10,10, 15 ,8925,1840,1659,12424
10/10/2017,2017,10,10, 16 ,8776,1816,1634,12226
10/10/2017,2017,10,10, 17 ,8539,1752,1554,11845
10/10/2017,2017,10,10, 18 ,8691,1909,1689,12289
10/10/2017,2017,10,10, 19 ,8560,1868,1546,11974
10/10/2017,2017,10,10, 20 ,8483,1797,1450,11730
10/10/2017,2017,10,10, 21 ,8147,1688,1344,11179
10/10/2017,2017,10,10, 22 ,7766,1555,1224,10545
10/10/2017,2017,10,10, 23 ,7224,1452,1123,9799
10/10/2017,2017,10,10, 24 ,6887,1374,1032,9293
10/11/2017,2017,10,11, 1 ,6577,1301,1111,8989
10/11/2017,2017,10,11, 2 ,6420,1263,1066,8749
10/11/2017,2017,10,11, 3 ,6280,1234,1037,8551
10/11/2017,2017,10,11, 4 ,6158,1222,1029,8409
10/11/2017,2017,10,11, 5 ,6305,1270,1080,8655
10/11/2017,2017,10,11, 6 ,6464,1294,1049,8807
10/11/2017,2017,10,11, 7 ,6570,1262,1043,8875
10/11/2017,2017,10,11, 8 ,7420,1448,1216,10084
10/11/2017,2017,10,11, 9 ,8279,1700,1436,11415
10/11/2017,2017,10,11, 10 ,8842,1799,1574,12215
10/11/2017,2017,10,11, 11 ,9175,1869,1628,12672
10/11/2017,2017,10,11, 12 ,9030,1836,1618,12484
10/11/2017,2017,10,11, 13 ,9015,1847,1632,12494
10/11/2017,2017,10,11, 14 ,9343,1932,1665,12940
10/11/2017,2017,10,11, 15 ,9092,1892,1659,12643
10/11/2017,2017,10,11, 16 ,8923,1868,1601,12392
10/11/2017,2017,10,11, 17 ,8638,1788,1553,11979
10/11/2017,2017,10,11, 18 ,8744,1948,1677,12369
10/11/2017,2017,10,11, 19 ,8677,1889,1630,12196
10/11/2017,2017,10,11, 20 ,8556,1832,1589,11977
10/11/2017,2017,10,11, 21 ,8321,1750,1508,11579
10/11/2017,2017,10,11, 22 ,7954,1614,1366,10934
10/11/2017,2017,10,11, 23 ,7530,1499,1272,10301
10/11/2017,2017,10,11, 24 ,7074,1409,1193,9676
10/12/2017,2017,10,12, 1 ,6839,1351,1136,9326
10/12/2017,2017,10,12, 2 ,6632,1314,1104,9050
10/12/2017,2017,10,12, 3 ,6466,1288,1061,8815
10/12/2017,2017,10,12, 4 ,6355,1273,1055,8683
10/12/2017,2017,10,12, 5 ,6544,1318,1083,8945
10/12/2017,2017,10,12, 6 ,6649,1342,1092,9083
10/12/2017,2017,10,12, 7 ,6820,1296,1063,9179
10/12/2017,2017,10,12, 8 ,7642,1448,1231,10321
10/12/2017,2017,10,12, 9 ,8489,1666,1448,11603
10/12/2017,2017,10,12, 10 ,8977,1757,1573,12307
10/12/2017,2017,10,12, 11 ,9256,1772,1624,12652
10/12/2017,2017,10,12, 12 ,9021,1730,1595,12346
10/12/2017,2017,10,12, 13 ,8904,1723,1636,12263
10/12/2017,2017,10,12, 14 ,9299,1795,1678,12772
10/12/2017,2017,10,12, 15 ,9198,1781,1644,12623
10/12/2017,2017,10,12, 16 ,9027,1756,1537,12320
10/12/2017,2017,10,12, 17 ,8787,1708,1546,12041
10/12/2017,2017,10,12, 18 ,9010,1878,1687,12575
10/12/2017,2017,10,12, 19 ,8810,1824,1609,12243
10/12/2017,2017,10,12, 20 ,8617,1776,1580,11973
10/12/2017,2017,10,12, 21 ,8441,1688,1490,11619
10/12/2017,2017,10,12, 22 ,8073,1549,1368,10990
10/12/2017,2017,10,12, 23 ,7539,1434,1261,10234
10/12/2017,2017,10,12, 24 ,7202,1358,1211,9771
10/13/2017,2017,10,13, 1 ,6837,1299,1155,9291
10/13/2017,2017,10,13, 2 ,6696,1271,1100,9067
10/13/2017,2017,10,13, 3 ,6521,1249,1070,8840
10/13/2017,2017,10,13, 4 ,6465,1234,1070,8769
10/13/2017,2017,10,13, 5 ,6537,1267,1117,8921
10/13/2017,2017,10,13, 6 ,6647,1294,1149,9090
10/13/2017,2017,10,13, 7 ,6834,1268,1102,9204
10/13/2017,2017,10,13, 8 ,7704,1435,1238,10377
10/13/2017,2017,10,13, 9 ,8607,1626,1479,11712
10/13/2017,2017,10,13, 10 ,9017,1701,1561,12279
10/13/2017,2017,10,13, 11 ,9101,1760,1639,12500
10/13/2017,2017,10,13, 12 ,8815,1701,1596,12112
10/13/2017,2017,10,13, 13 ,8758,1713,1614,12085
10/13/2017,2017,10,13, 14 ,8972,1794,1652,12418
10/13/2017,2017,10,13, 15 ,8953,1777,1623,12353
10/13/2017,2017,10,13, 16 ,8793,1723,1597,12113
10/13/2017,2017,10,13, 17 ,8574,1688,1551,11813
10/13/2017,2017,10,13, 18 ,8715,1820,1676,12211
10/13/2017,2017,10,13, 19 ,8463,1772,1591,11826
10/13/2017,2017,10,13, 20 ,8371,1710,1544,11625
10/13/2017,2017,10,13, 21 ,8150,1626,1470,11246
10/13/2017,2017,10,13, 22 ,7773,1491,1324,10588
10/13/2017,2017,10,13, 23 ,7294,1371,1248,9913
10/13/2017,2017,10,13, 24 ,6933,1305,1179,9417
10/14/2017,2017,10,14, 1 ,6639,1247,1120,9006
10/14/2017,2017,10,14, 2 ,6450,1223,1096,8769
10/14/2017,2017,10,14, 3 ,6263,1192,1061,8516
10/14/2017,2017,10,14, 4 ,6188,1184,1015,8387
10/14/2017,2017,10,14, 5 ,6163,1176,1047,8386
10/14/2017,2017,10,14, 6 ,6222,1186,1064,8472
10/14/2017,2017,10,14, 7 ,6321,1215,1044,8580
10/14/2017,2017,10,14, 8 ,6804,1305,1136,9245
10/14/2017,2017,10,14, 9 ,7387,1463,1283,10133
10/14/2017,2017,10,14, 10 ,7811,1552,1383,10746
10/14/2017,2017,10,14, 11 ,8068,1590,1435,11093
10/14/2017,2017,10,14, 12 ,7871,1561,1392,10824
10/14/2017,2017,10,14, 13 ,7768,1571,1398,10737
10/14/2017,2017,10,14, 14 ,7922,1613,1414,10949
10/14/2017,2017,10,14, 15 ,7699,1597,1354,10650
10/14/2017,2017,10,14, 16 ,7674,1559,1330,10563
10/14/2017,2017,10,14, 17 ,7554,1579,1373,10506
10/14/2017,2017,10,14, 18 ,7927,1745,1525,11197
10/14/2017,2017,10,14, 19 ,7942,1667,1471,11080
10/14/2017,2017,10,14, 20 ,7822,1614,1431,10867
10/14/2017,2017,10,14, 21 ,7728,1526,1368,10622
10/14/2017,2017,10,14, 22 ,7313,1433,1273,10019
10/14/2017,2017,10,14, 23 ,7032,1343,1167,9542
10/14/2017,2017,10,14, 24 ,6612,1251,1181,9044
10/15/2017,2017,10,15, 1 ,6312,1204,1043,8559
10/15/2017,2017,10,15, 2 ,6120,1172,1011,8303
10/15/2017,2017,10,15, 3 ,5921,1132,956,8009
10/15/2017,2017,10,15, 4 ,5874,1109,932,7915
10/15/2017,2017,10,15, 5 ,5815,1089,953,7857
10/15/2017,2017,10,15, 6 ,5633,1098,968,7699
10/15/2017,2017,10,15, 7 ,5696,1110,972,7778
10/15/2017,2017,10,15, 8 ,6036,1183,1009,8228
10/15/2017,2017,10,15, 9 ,6475,1301,1076,8852
10/15/2017,2017,10,15, 10 ,7003,1384,1140,9527
10/15/2017,2017,10,15, 11 ,7249,1441,1210,9900
10/15/2017,2017,10,15, 12 ,7189,1434,1200,9823
10/15/2017,2017,10,15, 13 ,7128,1437,1176,9741
10/15/2017,2017,10,15, 14 ,7126,1409,1179,9714
10/15/2017,2017,10,15, 15 ,7123,1379,1182,9684
10/15/2017,2017,10,15, 16 ,6980,1325,1214,9519
10/15/2017,2017,10,15, 17 ,6884,1379,1246,9509
10/15/2017,2017,10,15, 18 ,7493,1585,1393,10471
10/15/2017,2017,10,15, 19 ,7630,1559,1274,10463
10/15/2017,2017,10,15, 20 ,7616,1530,1244,10390
10/15/2017,2017,10,15, 21 ,7558,1437,1224,10219
10/15/2017,2017,10,15, 22 ,7299,1336,1154,9789
10/15/2017,2017,10,15, 23 ,6962,1250,1051,9263
10/15/2017,2017,10,15, 24 ,6620,1182,981,8783
10/16/2017,2017,10,16, 1 ,6358,1131,961,8450
10/16/2017,2017,10,16, 2 ,6013,1083,928,8024
10/16/2017,2017,10,16, 3 ,5874,1072,891,7837
10/16/2017,2017,10,16, 4 ,5836,1062,886,7784
10/16/2017,2017,10,16, 5 ,5830,1088,923,7841
10/16/2017,2017,10,16, 6 ,5693,1126,978,7797
10/16/2017,2017,10,16, 7 ,6290,1158,975,8423
10/16/2017,2017,10,16, 8 ,7043,1308,1084,9435
10/16/2017,2017,10,16, 9 ,7877,1522,1261,10660
10/16/2017,2017,10,16, 10 ,8401,1652,1343,11396
10/16/2017,2017,10,16, 11 ,8889,1698,1405,11992
10/16/2017,2017,10,16, 12 ,8782,1658,1397,11837
10/16/2017,2017,10,16, 13 ,8642,1647,1389,11678
10/16/2017,2017,10,16, 14 ,8914,1705,1388,12007
10/16/2017,2017,10,16, 15 ,8872,1681,1388,11941
10/16/2017,2017,10,16, 16 ,8737,1640,1415,11792
10/16/2017,2017,10,16, 17 ,8367,1623,1416,11406
10/16/2017,2017,10,16, 18 ,8792,1783,1544,12119
10/16/2017,2017,10,16, 19 ,8727,1719,1458,11904
10/16/2017,2017,10,16, 20 ,8596,1651,1424,11671
10/16/2017,2017,10,16, 21 ,8389,1547,1334,11270
10/16/2017,2017,10,16, 22 ,7925,1434,1224,10583
10/16/2017,2017,10,16, 23 ,7341,1320,1156,9817
10/16/2017,2017,10,16, 24 ,7148,1233,1070,9451
10/17/2017,2017,10,17, 1 ,6839,1189,1035,9063
10/17/2017,2017,10,17, 2 ,6593,1165,996,8754
10/17/2017,2017,10,17, 3 ,6405,1137,973,8515
10/17/2017,2017,10,17, 4 ,6295,1135,974,8404
10/17/2017,2017,10,17, 5 ,6395,1187,1037,8619
10/17/2017,2017,10,17, 6 ,6416,1223,1054,8693
10/17/2017,2017,10,17, 7 ,6624,1184,1014,8822
10/17/2017,2017,10,17, 8 ,7276,1321,1125,9722
10/17/2017,2017,10,17, 9 ,8043,1540,1274,10857
10/17/2017,2017,10,17, 10 ,8525,1639,1396,11560
10/17/2017,2017,10,17, 11 ,8883,1708,1456,12047
10/17/2017,2017,10,17, 12 ,8719,1657,1418,11794
10/17/2017,2017,10,17, 13 ,8654,1657,1294,11605
10/17/2017,2017,10,17, 14 ,8885,1726,1424,12035
10/17/2017,2017,10,17, 15 ,8870,1687,1419,11976
10/17/2017,2017,10,17, 16 ,8703,1675,1420,11798
10/17/2017,2017,10,17, 17 ,8443,1647,1447,11537
10/17/2017,2017,10,17, 18 ,8863,1836,1561,12260
10/17/2017,2017,10,17, 19 ,8815,1785,1476,12076
10/17/2017,2017,10,17, 20 ,8690,1729,1423,11842
10/17/2017,2017,10,17, 21 ,8552,1638,1314,11504
10/17/2017,2017,10,17, 22 ,8162,1497,1193,10852
10/17/2017,2017,10,17, 23 ,7744,1378,1103,10225
10/17/2017,2017,10,17, 24 ,7304,1307,1041,9652
10/18/2017,2017,10,18, 1 ,7077,1236,999,9312
10/18/2017,2017,10,18, 2 ,6790,1206,965,8961
10/18/2017,2017,10,18, 3 ,6589,1179,952,8720
10/18/2017,2017,10,18, 4 ,6497,1179,947,8623
10/18/2017,2017,10,18, 5 ,6629,1225,1009,8863
10/18/2017,2017,10,18, 6 ,6640,1271,1057,8968
10/18/2017,2017,10,18, 7 ,6714,1218,1017,8949
10/18/2017,2017,10,18, 8 ,7607,1369,1117,10093
10/18/2017,2017,10,18, 9 ,8486,1586,1311,11383
10/18/2017,2017,10,18, 10 ,8954,1693,1361,12008
10/18/2017,2017,10,18, 11 ,9232,1757,1416,12405
10/18/2017,2017,10,18, 12 ,9042,1723,1411,12176
10/18/2017,2017,10,18, 13 ,9059,1710,1393,12162
10/18/2017,2017,10,18, 14 ,9428,1768,1393,12589
10/18/2017,2017,10,18, 15 ,9302,1741,1399,12442
10/18/2017,2017,10,18, 16 ,9139,1720,1383,12242
10/18/2017,2017,10,18, 17 ,8728,1711,1388,11827
10/18/2017,2017,10,18, 18 ,8975,1819,1502,12296
10/18/2017,2017,10,18, 19 ,8792,1752,1432,11976
10/18/2017,2017,10,18, 20 ,8754,1668,1373,11795
10/18/2017,2017,10,18, 21 ,8504,1555,1296,11355
10/18/2017,2017,10,18, 22 ,8104,1409,1211,10724
10/18/2017,2017,10,18, 23 ,7613,1328,1101,10042
10/18/2017,2017,10,18, 24 ,7200,1242,1034,9476
10/19/2017,2017,10,19, 1 ,6880,1199,955,9034
10/19/2017,2017,10,19, 2 ,6700,1150,942,8792
10/19/2017,2017,10,19, 3 ,6486,1134,928,8548
10/19/2017,2017,10,19, 4 ,6403,1137,914,8454
10/19/2017,2017,10,19, 5 ,6493,1189,981,8663
10/19/2017,2017,10,19, 6 ,6551,1237,1054,8842
10/19/2017,2017,10,19, 7 ,6645,1208,988,8841
10/19/2017,2017,10,19, 8 ,7392,1330,1111,9833
10/19/2017,2017,10,19, 9 ,8236,1519,1316,11071
10/19/2017,2017,10,19, 10 ,8687,1618,1373,11678
10/19/2017,2017,10,19, 11 ,8967,1672,1466,12105
10/19/2017,2017,10,19, 12 ,8734,1595,1427,11756
10/19/2017,2017,10,19, 13 ,8642,1579,1427,11648
10/19/2017,2017,10,19, 14 ,8916,1659,1457,12032
10/19/2017,2017,10,19, 15 ,8841,1653,1445,11939
10/19/2017,2017,10,19, 16 ,8711,1626,1481,11818
10/19/2017,2017,10,19, 17 ,8491,1635,1447,11573
10/19/2017,2017,10,19, 18 ,8792,1765,1551,12108
10/19/2017,2017,10,19, 19 ,8610,1716,1485,11811
10/19/2017,2017,10,19, 20 ,8509,1634,1434,11577
10/19/2017,2017,10,19, 21 ,8219,1513,1360,11092
10/19/2017,2017,10,19, 22 ,7880,1380,1245,10505
10/19/2017,2017,10,19, 23 ,7420,1297,1153,9870
10/19/2017,2017,10,19, 24 ,7009,1235,965,9209
10/20/2017,2017,10,20, 1 ,6744,1197,1026,8967
10/20/2017,2017,10,20, 2 ,6510,1182,1014,8706
10/20/2017,2017,10,20, 3 ,6374,1162,988,8524
10/20/2017,2017,10,20, 4 ,6284,1154,993,8431
10/20/2017,2017,10,20, 5 ,6397,1202,1030,8629
10/20/2017,2017,10,20, 6 ,6472,1259,1063,8794
10/20/2017,2017,10,20, 7 ,6605,1224,1001,8830
10/20/2017,2017,10,20, 8 ,7402,1348,1155,9905
10/20/2017,2017,10,20, 9 ,7710,1553,1343,10606
10/20/2017,2017,10,20, 10 ,8534,1635,1404,11573
10/20/2017,2017,10,20, 11 ,9010,1656,1507,12173
10/20/2017,2017,10,20, 12 ,8854,1594,1447,11895
10/20/2017,2017,10,20, 13 ,8944,1573,1462,11979
10/20/2017,2017,10,20, 14 ,9313,1561,1491,12365
10/20/2017,2017,10,20, 15 ,9140,1573,1524,12237
10/20/2017,2017,10,20, 16 ,9028,1595,1499,12122
10/20/2017,2017,10,20, 17 ,8596,1591,1457,11644
10/20/2017,2017,10,20, 18 ,8877,1648,1563,12088
10/20/2017,2017,10,20, 19 ,8772,1591,1511,11874
10/20/2017,2017,10,20, 20 ,8605,1547,1470,11622
10/20/2017,2017,10,20, 21 ,8488,1501,1405,11394
10/20/2017,2017,10,20, 22 ,8124,1356,1249,10729
10/20/2017,2017,10,20, 23 ,7762,1263,1184,10209
10/20/2017,2017,10,20, 24 ,7372,1208,1109,9689
10/21/2017,2017,10,21, 1 ,7078,1169,1076,9323
10/21/2017,2017,10,21, 2 ,6901,1139,1026,9066
10/21/2017,2017,10,21, 3 ,6695,1129,983,8807
10/21/2017,2017,10,21, 4 ,6569,1130,972,8671
10/21/2017,2017,10,21, 5 ,6505,1150,993,8648
10/21/2017,2017,10,21, 6 ,6463,1151,986,8600
10/21/2017,2017,10,21, 7 ,6523,1195,969,8687
10/21/2017,2017,10,21, 8 ,7090,1304,1058,9452
10/21/2017,2017,10,21, 9 ,7803,1475,1187,10465
10/21/2017,2017,10,21, 10 ,8388,1559,1302,11249
10/21/2017,2017,10,21, 11 ,8707,1624,1322,11653
10/21/2017,2017,10,21, 12 ,8445,1575,1299,11319
10/21/2017,2017,10,21, 13 ,8356,1565,1282,11203
10/21/2017,2017,10,21, 14 ,8530,1613,1266,11409
10/21/2017,2017,10,21, 15 ,8354,1555,1204,11113
10/21/2017,2017,10,21, 16 ,8138,1540,1188,10866
10/21/2017,2017,10,21, 17 ,7811,1524,1274,10609
10/21/2017,2017,10,21, 18 ,8176,1683,1444,11303
10/21/2017,2017,10,21, 19 ,8188,1631,1408,11227
10/21/2017,2017,10,21, 20 ,8078,1592,1363,11033
10/21/2017,2017,10,21, 21 ,8115,1550,1303,10968
10/21/2017,2017,10,21, 22 ,7893,1464,1153,10510
10/21/2017,2017,10,21, 23 ,7407,1362,1101,9870
10/21/2017,2017,10,21, 24 ,7137,1297,1031,9465
10/22/2017,2017,10,22, 1 ,6833,1235,993,9061
10/22/2017,2017,10,22, 2 ,6639,1198,963,8800
10/22/2017,2017,10,22, 3 ,6451,1181,951,8583
10/22/2017,2017,10,22, 4 ,6250,1157,938,8345
10/22/2017,2017,10,22, 5 ,6136,1160,960,8256
10/22/2017,2017,10,22, 6 ,5936,1153,979,8068
10/22/2017,2017,10,22, 7 ,5998,1150,949,8097
10/22/2017,2017,10,22, 8 ,6279,1223,979,8481
10/22/2017,2017,10,22, 9 ,6739,1333,1064,9136
10/22/2017,2017,10,22, 10 ,7259,1397,1176,9832
10/22/2017,2017,10,22, 11 ,7476,1430,1251,10157
10/22/2017,2017,10,22, 12 ,7465,1441,1260,10166
10/22/2017,2017,10,22, 13 ,7490,1445,1246,10181
10/22/2017,2017,10,22, 14 ,7574,1448,1201,10223
10/22/2017,2017,10,22, 15 ,7492,1431,1212,10135
10/22/2017,2017,10,22, 16 ,7304,1405,1217,9926
10/22/2017,2017,10,22, 17 ,7217,1418,1257,9892
10/22/2017,2017,10,22, 18 ,7781,1647,1448,10876
10/22/2017,2017,10,22, 19 ,7918,1592,1442,10952
10/22/2017,2017,10,22, 20 ,7976,1547,1410,10933
10/22/2017,2017,10,22, 21 ,7873,1479,1324,10676
10/22/2017,2017,10,22, 22 ,7608,1406,1218,10232
10/22/2017,2017,10,22, 23 ,7288,1329,1132,9749
10/22/2017,2017,10,22, 24 ,6949,1261,1082,9292
10/23/2017,2017,10,23, 1 ,6637,1214,1025,8876
10/23/2017,2017,10,23, 2 ,6415,1174,991,8580
10/23/2017,2017,10,23, 3 ,6212,1144,973,8329
10/23/2017,2017,10,23, 4 ,6056,1138,966,8160
10/23/2017,2017,10,23, 5 ,6164,1161,999,8324
10/23/2017,2017,10,23, 6 ,6259,1195,1032,8486
10/23/2017,2017,10,23, 7 ,6606,1219,1022,8847
10/23/2017,2017,10,23, 8 ,7449,1415,1202,10066
10/23/2017,2017,10,23, 9 ,8288,1609,1438,11335
10/23/2017,2017,10,23, 10 ,8759,1734,1554,12047
10/23/2017,2017,10,23, 11 ,9149,1785,1615,12549
10/23/2017,2017,10,23, 12 ,8972,1738,1583,12293
10/23/2017,2017,10,23, 13 ,8877,1739,1521,12137
10/23/2017,2017,10,23, 14 ,9032,1796,1608,12436
10/23/2017,2017,10,23, 15 ,8932,1786,1583,12301
10/23/2017,2017,10,23, 16 ,8735,1733,1554,12022
10/23/2017,2017,10,23, 17 ,8542,1723,1477,11742
10/23/2017,2017,10,23, 18 ,8779,1838,1607,12224
10/23/2017,2017,10,23, 19 ,8590,1796,1547,11933
10/23/2017,2017,10,23, 20 ,8429,1750,1485,11664
10/23/2017,2017,10,23, 21 ,8299,1653,1390,11342
10/23/2017,2017,10,23, 22 ,7881,1525,1251,10657
10/23/2017,2017,10,23, 23 ,7438,1421,1198,10057
10/23/2017,2017,10,23, 24 ,7089,1347,1123,9559
10/24/2017,2017,10,24, 1 ,6804,1284,1058,9146
10/24/2017,2017,10,24, 2 ,6567,1250,1025,8842
10/24/2017,2017,10,24, 3 ,6463,1227,1003,8693
10/24/2017,2017,10,24, 4 ,6329,1222,990,8541
10/24/2017,2017,10,24, 5 ,6474,1306,1044,8824
10/24/2017,2017,10,24, 6 ,6532,1328,1064,8924
10/24/2017,2017,10,24, 7 ,6800,1302,1063,9165
10/24/2017,2017,10,24, 8 ,7539,1443,1197,10179
10/24/2017,2017,10,24, 9 ,8209,1671,1394,11274
10/24/2017,2017,10,24, 10 ,8765,1766,1511,12042
10/24/2017,2017,10,24, 11 ,9049,1815,1631,12495
10/24/2017,2017,10,24, 12 ,8827,1754,1576,12157
10/24/2017,2017,10,24, 13 ,8795,1719,1585,12099
10/24/2017,2017,10,24, 14 ,9058,1778,1618,12454
10/24/2017,2017,10,24, 15 ,8953,1763,1595,12311
10/24/2017,2017,10,24, 16 ,8768,1741,1572,12081
10/24/2017,2017,10,24, 17 ,8449,1726,1548,11723
10/24/2017,2017,10,24, 18 ,8803,1862,1617,12282
10/24/2017,2017,10,24, 19 ,8570,1802,1534,11906
10/24/2017,2017,10,24, 20 ,8521,1720,1471,11712
10/24/2017,2017,10,24, 21 ,8326,1641,1391,11358
10/24/2017,2017,10,24, 22 ,7912,1516,1260,10688
10/24/2017,2017,10,24, 23 ,7478,1422,1164,10064
10/24/2017,2017,10,24, 24 ,7091,1341,1099,9531
10/25/2017,2017,10,25, 1 ,6721,1297,1058,9076
10/25/2017,2017,10,25, 2 ,6516,1257,1028,8801
10/25/2017,2017,10,25, 3 ,6277,1226,1003,8506
10/25/2017,2017,10,25, 4 ,6198,1208,995,8401
10/25/2017,2017,10,25, 5 ,6314,1228,1029,8571
10/25/2017,2017,10,25, 6 ,6352,1264,1051,8667
10/25/2017,2017,10,25, 7 ,6617,1253,1018,8888
10/25/2017,2017,10,25, 8 ,7453,1410,1177,10040
10/25/2017,2017,10,25, 9 ,8230,1633,1375,11238
10/25/2017,2017,10,25, 10 ,8749,1729,1522,12000
10/25/2017,2017,10,25, 11 ,9032,1803,1571,12406
10/25/2017,2017,10,25, 12 ,8828,1719,1542,12089
10/25/2017,2017,10,25, 13 ,8786,1709,1519,12014
10/25/2017,2017,10,25, 14 ,9029,1752,1552,12333
10/25/2017,2017,10,25, 15 ,8928,1742,1521,12191
10/25/2017,2017,10,25, 16 ,8682,1712,1539,11933
10/25/2017,2017,10,25, 17 ,8396,1681,1527,11604
10/25/2017,2017,10,25, 18 ,8697,1852,1621,12170
10/25/2017,2017,10,25, 19 ,8529,1777,1548,11854
10/25/2017,2017,10,25, 20 ,8438,1711,1468,11617
10/25/2017,2017,10,25, 21 ,8183,1640,1358,11181
10/25/2017,2017,10,25, 22 ,7799,1523,1271,10593
10/25/2017,2017,10,25, 23 ,7378,1388,1177,9943
10/25/2017,2017,10,25, 24 ,6955,1313,1100,9368
10/26/2017,2017,10,26, 1 ,6644,1262,1057,8963
10/26/2017,2017,10,26, 2 ,6454,1227,1027,8708
10/26/2017,2017,10,26, 3 ,6312,1187,997,8496
10/26/2017,2017,10,26, 4 ,6217,1181,989,8387
10/26/2017,2017,10,26, 5 ,6263,1197,1016,8476
10/26/2017,2017,10,26, 6 ,6336,1217,1055,8608
10/26/2017,2017,10,26, 7 ,6555,1227,1055,8837
10/26/2017,2017,10,26, 8 ,7406,1383,1240,10029
10/26/2017,2017,10,26, 9 ,8204,1582,1348,11134
10/26/2017,2017,10,26, 10 ,8640,1679,1522,11841
10/26/2017,2017,10,26, 11 ,8907,1752,1581,12240
10/26/2017,2017,10,26, 12 ,8720,1715,1541,11976
10/26/2017,2017,10,26, 13 ,8376,1714,1544,11634
10/26/2017,2017,10,26, 14 ,8928,1766,1609,12303
10/26/2017,2017,10,26, 15 ,8905,1769,1585,12259
10/26/2017,2017,10,26, 16 ,8719,1731,1565,12015
10/26/2017,2017,10,26, 17 ,8489,1670,1511,11670
10/26/2017,2017,10,26, 18 ,8866,1857,1633,12356
10/26/2017,2017,10,26, 19 ,8633,1791,1552,11976
10/26/2017,2017,10,26, 20 ,8452,1738,1495,11685
10/26/2017,2017,10,26, 21 ,8349,1655,1426,11430
10/26/2017,2017,10,26, 22 ,7983,1551,1300,10834
10/26/2017,2017,10,26, 23 ,7533,1434,1198,10165
10/26/2017,2017,10,26, 24 ,7115,1361,1116,9592
10/27/2017,2017,10,27, 1 ,6878,1294,1069,9241
10/27/2017,2017,10,27, 2 ,6654,1262,1036,8952
10/27/2017,2017,10,27, 3 ,6452,1227,1007,8686
10/27/2017,2017,10,27, 4 ,6364,1215,994,8573
10/27/2017,2017,10,27, 5 ,6391,1239,1029,8659
10/27/2017,2017,10,27, 6 ,6473,1266,1048,8787
10/27/2017,2017,10,27, 7 ,6598,1267,1047,8912
10/27/2017,2017,10,27, 8 ,7427,1432,1203,10062
10/27/2017,2017,10,27, 9 ,8270,1655,1401,11326
10/27/2017,2017,10,27, 10 ,8589,1752,1518,11859
10/27/2017,2017,10,27, 11 ,8925,1832,1591,12348
10/27/2017,2017,10,27, 12 ,8728,1766,1550,12044
10/27/2017,2017,10,27, 13 ,8699,1780,1562,12041
10/27/2017,2017,10,27, 14 ,9077,1856,1607,12540
10/27/2017,2017,10,27, 15 ,8958,1806,1566,12330
10/27/2017,2017,10,27, 16 ,8821,1772,1548,12141
10/27/2017,2017,10,27, 17 ,8485,1737,1511,11733
10/27/2017,2017,10,27, 18 ,8786,1879,1611,12276
10/27/2017,2017,10,27, 19 ,8640,1804,1537,11981
10/27/2017,2017,10,27, 20 ,8514,1754,1477,11745
10/27/2017,2017,10,27, 21 ,8282,1677,1403,11362
10/27/2017,2017,10,27, 22 ,8027,1556,1310,10893
10/27/2017,2017,10,27, 23 ,7694,1430,1211,10335
10/27/2017,2017,10,27, 24 ,7196,1357,1123,9676
10/28/2017,2017,10,28, 1 ,6937,1294,1098,9329
10/28/2017,2017,10,28, 2 ,6738,1265,1033,9036
10/28/2017,2017,10,28, 3 ,6499,1227,1004,8730
10/28/2017,2017,10,28, 4 ,6380,1211,992,8583
10/28/2017,2017,10,28, 5 ,6355,1220,1012,8587
10/28/2017,2017,10,28, 6 ,6289,1223,1029,8541
10/28/2017,2017,10,28, 7 ,6375,1241,1009,8625
10/28/2017,2017,10,28, 8 ,6935,1365,1114,9414
10/28/2017,2017,10,28, 9 ,7609,1548,1288,10445
10/28/2017,2017,10,28, 10 ,8146,1611,1406,11163
10/28/2017,2017,10,28, 11 ,8434,1680,1468,11582
10/28/2017,2017,10,28, 12 ,8315,1624,1422,11361
10/28/2017,2017,10,28, 13 ,8292,1639,1453,11384
10/28/2017,2017,10,28, 14 ,8502,1670,1472,11644
10/28/2017,2017,10,28, 15 ,8413,1663,1456,11532
10/28/2017,2017,10,28, 16 ,8160,1608,1412,11180
10/28/2017,2017,10,28, 17 ,7890,1607,1395,10892
10/28/2017,2017,10,28, 18 ,8309,1771,1505,11585
10/28/2017,2017,10,28, 19 ,8318,1733,1402,11453
10/28/2017,2017,10,28, 20 ,8310,1676,1387,11373
10/28/2017,2017,10,28, 21 ,8177,1568,1311,11056
10/28/2017,2017,10,28, 22 ,7873,1502,1244,10619
10/28/2017,2017,10,28, 23 ,7544,1391,1147,10082
10/28/2017,2017,10,28, 24 ,7111,1302,1098,9511
10/29/2017,2017,10,29, 1 ,6914,1254,1032,9200
10/29/2017,2017,10,29, 2 ,6637,1218,1001,8856
10/29/2017,2017,10,29, 3 ,6396,1186,966,8548
10/29/2017,2017,10,29, 4 ,6281,1168,954,8403
10/29/2017,2017,10,29, 5 ,6215,1176,973,8364
10/29/2017,2017,10,29, 6 ,6068,1162,983,8213
10/29/2017,2017,10,29, 7 ,6066,1177,984,8227
10/29/2017,2017,10,29, 8 ,6367,1261,1042,8670
10/29/2017,2017,10,29, 9 ,6792,1376,1066,9234
10/29/2017,2017,10,29, 10 ,7245,1462,1165,9872
10/29/2017,2017,10,29, 11 ,7450,1518,1266,10234
10/29/2017,2017,10,29, 12 ,7495,1505,1281,10281
10/29/2017,2017,10,29, 13 ,7493,1514,1279,10286
10/29/2017,2017,10,29, 14 ,7557,1522,1237,10316
10/29/2017,2017,10,29, 15 ,7472,1499,1220,10191
10/29/2017,2017,10,29, 16 ,7330,1469,1203,10002
10/29/2017,2017,10,29, 17 ,7205,1485,1313,10003
10/29/2017,2017,10,29, 18 ,7713,1698,1469,10880
10/29/2017,2017,10,29, 19 ,7798,1684,1427,10909
10/29/2017,2017,10,29, 20 ,7797,1650,1377,10824
10/29/2017,2017,10,29, 21 ,7617,1556,1289,10462
10/29/2017,2017,10,29, 22 ,7473,1471,1196,10140
10/29/2017,2017,10,29, 23 ,7132,1372,1116,9620
10/29/2017,2017,10,29, 24 ,6717,1294,1096,9107
10/30/2017,2017,10,30, 1 ,6455,1251,1013,8719
10/30/2017,2017,10,30, 2 ,6302,1199,973,8474
10/30/2017,2017,10,30, 3 ,6126,1179,944,8249
10/30/2017,2017,10,30, 4 ,6014,1162,927,8103
10/30/2017,2017,10,30, 5 ,5994,1182,967,8143
10/30/2017,2017,10,30, 6 ,6061,1202,1011,8274
10/30/2017,2017,10,30, 7 ,6300,1222,1012,8534
10/30/2017,2017,10,30, 8 ,7076,1387,1147,9610
10/30/2017,2017,10,30, 9 ,7855,1607,1365,10827
10/30/2017,2017,10,30, 10 ,8299,1710,1490,11499
10/30/2017,2017,10,30, 11 ,8608,1779,1557,11944
10/30/2017,2017,10,30, 12 ,8530,1734,1550,11814
10/30/2017,2017,10,30, 13 ,8470,1733,1540,11743
10/30/2017,2017,10,30, 14 ,8623,1784,1595,12002
10/30/2017,2017,10,30, 15 ,8537,1760,1564,11861
10/30/2017,2017,10,30, 16 ,8295,1723,1531,11549
10/30/2017,2017,10,30, 17 ,7968,1675,1493,11136
10/30/2017,2017,10,30, 18 ,8261,1825,1564,11650
10/30/2017,2017,10,30, 19 ,8083,1755,1470,11308
10/30/2017,2017,10,30, 20 ,7983,1690,1422,11095
10/30/2017,2017,10,30, 21 ,7775,1596,1332,10703
10/30/2017,2017,10,30, 22 ,7437,1482,1217,10136
10/30/2017,2017,10,30, 23 ,6988,1378,1103,9469
10/30/2017,2017,10,30, 24 ,6640,1303,1042,8985
10/31/2017,2017,10,31, 1 ,6367,1258,1018,8643
10/31/2017,2017,10,31, 2 ,6195,1238,961,8394
10/31/2017,2017,10,31, 3 ,6034,1197,940,8171
10/31/2017,2017,10,31, 4 ,5859,1178,882,7919
10/31/2017,2017,10,31, 5 ,5860,1184,910,7954
10/31/2017,2017,10,31, 6 ,5649,1182,922,7753
10/31/2017,2017,10,31, 7 ,5685,1197,979,7861
10/31/2017,2017,10,31, 8 ,5939,1248,1063,8250
10/31/2017,2017,10,31, 9 ,6293,1358,1165,8816
10/31/2017,2017,10,31, 10 ,6822,1428,1288,9538
10/31/2017,2017,10,31, 11 ,7020,1460,1340,9820
10/31/2017,2017,10,31, 12 ,6845,1431,1312,9588
10/31/2017,2017,10,31, 13 ,6703,1423,1343,9469
10/31/2017,2017,10,31, 14 ,6730,1426,1375,9531
10/31/2017,2017,10,31, 15 ,6592,1406,1356,9354
10/31/2017,2017,10,31, 16 ,6462,1401,1304,9167
10/31/2017,2017,10,31, 17 ,6380,1458,1336,9174
10/31/2017,2017,10,31, 18 ,6957,1616,1479,10052
10/31/2017,2017,10,31, 19 ,6993,1560,1442,9995
10/31/2017,2017,10,31, 20 ,6878,1496,1388,9762
10/31/2017,2017,10,31, 21 ,6565,1405,1338,9308
10/31/2017,2017,10,31, 22 ,6297,1293,1220,8810
10/31/2017,2017,10,31, 23 ,5917,1210,1024,8151
10/31/2017,2017,10,31, 24 ,5637,1139,1040,7816
11/1/2017,2017,11,1, 1 ,5483,1104,1012,7599
11/1/2017,2017,11,1, 2 ,5241,1083,949,7273
11/1/2017,2017,11,1, 3 ,5096,1059,927,7082
11/1/2017,2017,11,1, 4 ,5054,1050,908,7012
11/1/2017,2017,11,1, 5 ,4997,1080,931,7008
11/1/2017,2017,11,1, 6 ,4990,1090,936,7016
11/1/2017,2017,11,1, 7 ,4938,1090,937,6965
11/1/2017,2017,11,1, 8 ,4932,1127,958,7017
11/1/2017,2017,11,1, 9 ,5100,1189,1025,7314
11/1/2017,2017,11,1, 10 ,5375,1237,1125,7737
11/1/2017,2017,11,1, 11 ,5530,1300,1162,7992
11/1/2017,2017,11,1, 12 ,5618,1324,1187,8129
11/1/2017,2017,11,1, 13 ,5522,1328,1193,8043
11/1/2017,2017,11,1, 14 ,5521,1316,1157,7994
11/1/2017,2017,11,1, 15 ,5435,1312,1127,7874
11/1/2017,2017,11,1, 16 ,5397,1291,1128,7816
11/1/2017,2017,11,1, 17 ,5552,1317,1168,8037
11/1/2017,2017,11,1, 18 ,6157,1534,1308,8999
11/1/2017,2017,11,1, 19 ,6150,1507,1293,8950
11/1/2017,2017,11,1, 20 ,6136,1485,1234,8855
11/1/2017,2017,11,1, 21 ,5910,1418,1205,8533
11/1/2017,2017,11,1, 22 ,5654,1316,1089,8059
11/1/2017,2017,11,1, 23 ,5359,1237,1001,7597
11/1/2017,2017,11,1, 24 ,5139,1187,952,7278
11/2/2017,2017,11,2, 1 ,4984,1139,904,7027
11/2/2017,2017,11,2, 2 ,4808,1106,888,6802
11/2/2017,2017,11,2, 3 ,4678,1084,869,6631
11/2/2017,2017,11,2, 4 ,4710,1068,858,6636
11/2/2017,2017,11,2, 5 ,4866,1088,893,6847
11/2/2017,2017,11,2, 6 ,5063,1116,926,7105
11/2/2017,2017,11,2, 7 ,5447,1136,921,7504
11/2/2017,2017,11,2, 8 ,6212,1288,1068,8568
11/2/2017,2017,11,2, 9 ,7013,1463,1235,9711
11/2/2017,2017,11,2, 10 ,7554,1559,1351,10464
11/2/2017,2017,11,2, 11 ,7795,1622,1368,10785
11/2/2017,2017,11,2, 12 ,7736,1614,1396,10746
11/2/2017,2017,11,2, 13 ,7569,1610,1417,10596
11/2/2017,2017,11,2, 14 ,7786,1637,1442,10865
11/2/2017,2017,11,2, 15 ,7670,1635,1426,10731
11/2/2017,2017,11,2, 16 ,7617,1596,1402,10615
11/2/2017,2017,11,2, 17 ,7584,1566,1381,10531
11/2/2017,2017,11,2, 18 ,7912,1738,1530,11180
11/2/2017,2017,11,2, 19 ,7733,1680,1460,10873
11/2/2017,2017,11,2, 20 ,7541,1612,1401,10554
11/2/2017,2017,11,2, 21 ,7320,1548,1330,10198
11/2/2017,2017,11,2, 22 ,6871,1432,1211,9514
11/2/2017,2017,11,2, 23 ,6522,1336,1131,8989
11/2/2017,2017,11,2, 24 ,6122,1277,1055,8454
11/3/2017,2017,11,3, 1 ,5912,1230,1015,8157
11/3/2017,2017,11,3, 2 ,5748,1194,978,7920
11/3/2017,2017,11,3, 3 ,5695,1163,953,7811
11/3/2017,2017,11,3, 4 ,5670,1149,944,7763
11/3/2017,2017,11,3, 5 ,5743,1173,980,7896
11/3/2017,2017,11,3, 6 ,5927,1191,1007,8125
11/3/2017,2017,11,3, 7 ,6116,1197,1001,8314
11/3/2017,2017,11,3, 8 ,7010,1360,1135,9505
11/3/2017,2017,11,3, 9 ,7903,1601,1398,10902
11/3/2017,2017,11,3, 10 ,8299,1694,1523,11516
11/3/2017,2017,11,3, 11 ,8641,1792,1590,12023
11/3/2017,2017,11,3, 12 ,8518,1736,1558,11812
11/3/2017,2017,11,3, 13 ,8462,1757,1573,11792
11/3/2017,2017,11,3, 14 ,8812,1797,1620,12229
11/3/2017,2017,11,3, 15 ,8690,1791,1590,12071
11/3/2017,2017,11,3, 16 ,8494,1738,1553,11785
11/3/2017,2017,11,3, 17 ,8217,1719,1496,11432
11/3/2017,2017,11,3, 18 ,8523,1836,1592,11951
11/3/2017,2017,11,3, 19 ,8328,1759,1537,11624
11/3/2017,2017,11,3, 20 ,8149,1728,1478,11355
11/3/2017,2017,11,3, 21 ,7901,1644,1413,10958
11/3/2017,2017,11,3, 22 ,7525,1531,1287,10343
11/3/2017,2017,11,3, 23 ,7138,1425,1183,9746
11/3/2017,2017,11,3, 24 ,6721,1342,1043,9106
11/4/2017,2017,11,4, 1 ,6426,1283,1062,8771
11/4/2017,2017,11,4, 2 ,6249,1239,1027,8515
11/4/2017,2017,11,4, 3 ,5982,1225,1002,8209
11/4/2017,2017,11,4, 4 ,5920,1204,989,8113
11/4/2017,2017,11,4, 5 ,5964,1211,998,8173
11/4/2017,2017,11,4, 6 ,5937,1212,1022,8171
11/4/2017,2017,11,4, 7 ,6091,1235,1024,8350
11/4/2017,2017,11,4, 8 ,6695,1358,1152,9205
11/4/2017,2017,11,4, 9 ,7213,1536,1295,10044
11/4/2017,2017,11,4, 10 ,7759,1660,1400,10819
11/4/2017,2017,11,4, 11 ,8057,1710,1503,11270
11/4/2017,2017,11,4, 12 ,7849,1698,1480,11027
11/4/2017,2017,11,4, 13 ,7643,1680,1496,10819
11/4/2017,2017,11,4, 14 ,7819,1733,1553,11105
11/4/2017,2017,11,4, 15 ,7718,1701,1532,10951
11/4/2017,2017,11,4, 16 ,7535,1658,1471,10664
11/4/2017,2017,11,4, 17 ,7506,1640,1448,10594
11/4/2017,2017,11,4, 18 ,7965,1842,1596,11403
11/4/2017,2017,11,4, 19 ,7899,1798,1526,11223
11/4/2017,2017,11,4, 20 ,7724,1742,1486,10952
11/4/2017,2017,11,4, 21 ,7541,1667,1419,10627
11/4/2017,2017,11,4, 22 ,7139,1569,1307,10015
11/4/2017,2017,11,4, 23 ,6851,1453,1210,9514
11/4/2017,2017,11,4, 24 ,6409,1363,1146,8918
11/5/2017,2017,11,5, 1 ,6262,1303,1098,8663
11/5/2017,2017,11,5, 2 ,6059,1266,1060,8385
11/5/2017,2017,11,5, 3 ,5907,1234,1031,8172
11/5/2017,2017,11,5, 4 ,5820,1218,1014,8052
11/5/2017,2017,11,5, 5 ,5775,1216,1027,8018
11/5/2017,2017,11,5, 6 ,5687,1188,1012,7887
11/5/2017,2017,11,5, 7 ,5759,1201,1018,7978
11/5/2017,2017,11,5, 8 ,6013,1279,1081,8373
11/5/2017,2017,11,5, 9 ,6380,1411,1158,8949
11/5/2017,2017,11,5, 10 ,6774,1515,1264,9553
11/5/2017,2017,11,5, 11 ,7010,1562,1345,9917
11/5/2017,2017,11,5, 12 ,6964,1543,1345,9852
11/5/2017,2017,11,5, 13 ,6910,1560,1359,9829
11/5/2017,2017,11,5, 14 ,6874,1560,1373,9807
11/5/2017,2017,11,5, 15 ,6735,1543,1351,9629
11/5/2017,2017,11,5, 16 ,6759,1515,1318,9592
11/5/2017,2017,11,5, 17 ,6818,1517,1350,9685
11/5/2017,2017,11,5, 18 ,7411,1772,1543,10726
11/5/2017,2017,11,5, 19 ,7473,1757,1513,10743
11/5/2017,2017,11,5, 20 ,7467,1716,1463,10646
11/5/2017,2017,11,5, 21 ,7231,1644,1381,10256
11/5/2017,2017,11,5, 22 ,6930,1557,1234,9721
11/5/2017,2017,11,5, 23 ,6677,1450,1179,9306
11/5/2017,2017,11,5, 24 ,6164,1358,1133,8655
11/6/2017,2017,11,6, 1 ,5907,1301,1065,8273
11/6/2017,2017,11,6, 2 ,5679,1260,1024,7963
11/6/2017,2017,11,6, 3 ,5638,1224,1000,7862
11/6/2017,2017,11,6, 4 ,5561,1208,990,7759
11/6/2017,2017,11,6, 5 ,5773,1260,1064,8097
11/6/2017,2017,11,6, 6 ,6009,1303,1092,8404
11/6/2017,2017,11,6, 7 ,6274,1245,1027,8546
11/6/2017,2017,11,6, 8 ,7232,1420,1187,9839
11/6/2017,2017,11,6, 9 ,8073,1663,1387,11123
11/6/2017,2017,11,6, 10 ,8563,1768,1524,11855
11/6/2017,2017,11,6, 11 ,8985,1843,1544,12372
11/6/2017,2017,11,6, 12 ,8902,1836,1542,12280
11/6/2017,2017,11,6, 13 ,8888,1824,1593,12305
11/6/2017,2017,11,6, 14 ,9183,1891,1631,12705
11/6/2017,2017,11,6, 15 ,9085,1869,1569,12523
11/6/2017,2017,11,6, 16 ,8914,1828,1540,12282
11/6/2017,2017,11,6, 17 ,8551,1782,1528,11861
11/6/2017,2017,11,6, 18 ,8797,1943,1643,12383
11/6/2017,2017,11,6, 19 ,8664,1880,1551,12095
11/6/2017,2017,11,6, 20 ,8482,1813,1510,11805
11/6/2017,2017,11,6, 21 ,8242,1727,1428,11397
11/6/2017,2017,11,6, 22 ,7881,1592,1311,10784
11/6/2017,2017,11,6, 23 ,7425,1484,1201,10110
11/6/2017,2017,11,6, 24 ,7058,1412,1152,9622
11/7/2017,2017,11,7, 1 ,6748,1357,1113,9218
11/7/2017,2017,11,7, 2 ,6528,1298,1073,8899
11/7/2017,2017,11,7, 3 ,6383,1269,1040,8692
11/7/2017,2017,11,7, 4 ,6263,1256,1033,8552
11/7/2017,2017,11,7, 5 ,6449,1304,1092,8845
11/7/2017,2017,11,7, 6 ,6561,1318,1121,9000
11/7/2017,2017,11,7, 7 ,6604,1281,1057,8942
11/7/2017,2017,11,7, 8 ,7350,1434,1196,9980
11/7/2017,2017,11,7, 9 ,8322,1647,1413,11382
11/7/2017,2017,11,7, 10 ,8795,1723,1513,12031
11/7/2017,2017,11,7, 11 ,9058,1773,1585,12416
11/7/2017,2017,11,7, 12 ,8860,1740,1552,12152
11/7/2017,2017,11,7, 13 ,8821,1730,1566,12117
11/7/2017,2017,11,7, 14 ,9144,1794,1624,12562
11/7/2017,2017,11,7, 15 ,9020,1776,1630,12426
11/7/2017,2017,11,7, 16 ,8853,1747,1596,12196
11/7/2017,2017,11,7, 17 ,8524,1721,1594,11839
11/7/2017,2017,11,7, 18 ,8919,1868,1642,12429
11/7/2017,2017,11,7, 19 ,8754,1794,1596,12144
11/7/2017,2017,11,7, 20 ,8687,1738,1559,11984
11/7/2017,2017,11,7, 21 ,8427,1642,1456,11525
11/7/2017,2017,11,7, 22 ,8026,1530,1331,10887
11/7/2017,2017,11,7, 23 ,7522,1387,1218,10127
11/7/2017,2017,11,7, 24 ,7152,1318,1128,9598
11/8/2017,2017,11,8, 1 ,6785,1265,1087,9137
11/8/2017,2017,11,8, 2 ,6552,1232,1057,8841
11/8/2017,2017,11,8, 3 ,6381,1202,1033,8616
11/8/2017,2017,11,8, 4 ,6336,1190,1043,8569
11/8/2017,2017,11,8, 5 ,6453,1235,1087,8775
11/8/2017,2017,11,8, 6 ,6562,1270,1125,8957
11/8/2017,2017,11,8, 7 ,6658,1237,1062,8957
11/8/2017,2017,11,8, 8 ,7551,1388,1218,10157
11/8/2017,2017,11,8, 9 ,8413,1593,1439,11445
11/8/2017,2017,11,8, 10 ,8953,1723,1546,12222
11/8/2017,2017,11,8, 11 ,9358,1756,1607,12721
11/8/2017,2017,11,8, 12 ,9157,1711,1580,12448
11/8/2017,2017,11,8, 13 ,9139,1732,1572,12443
11/8/2017,2017,11,8, 14 ,9438,1774,1628,12840
11/8/2017,2017,11,8, 15 ,9346,1764,1591,12701
11/8/2017,2017,11,8, 16 ,9111,1716,1580,12407
11/8/2017,2017,11,8, 17 ,8689,1668,1583,11940
11/8/2017,2017,11,8, 18 ,9005,1807,1630,12442
11/8/2017,2017,11,8, 19 ,8865,1762,1590,12217
11/8/2017,2017,11,8, 20 ,8696,1694,1499,11889
11/8/2017,2017,11,8, 21 ,8504,1664,1426,11594
11/8/2017,2017,11,8, 22 ,8069,1531,1315,10915
11/8/2017,2017,11,8, 23 ,7704,1425,1227,10356
11/8/2017,2017,11,8, 24 ,7290,1329,1183,9802
11/9/2017,2017,11,9, 1 ,6984,1279,1093,9356
11/9/2017,2017,11,9, 2 ,6693,1240,1063,8996
11/9/2017,2017,11,9, 3 ,6480,1213,1038,8731
11/9/2017,2017,11,9, 4 ,6404,1194,1038,8636
11/9/2017,2017,11,9, 5 ,6557,1234,1103,8894
11/9/2017,2017,11,9, 6 ,6616,1274,1145,9035
11/9/2017,2017,11,9, 7 ,6616,1213,1071,8900
11/9/2017,2017,11,9, 8 ,7311,1367,1211,9889
11/9/2017,2017,11,9, 9 ,8125,1565,1373,11063
11/9/2017,2017,11,9, 10 ,8439,1675,1453,11567
11/9/2017,2017,11,9, 11 ,8583,1718,1556,11857
11/9/2017,2017,11,9, 12 ,8287,1685,1527,11499
11/9/2017,2017,11,9, 13 ,8161,1670,1542,11373
11/9/2017,2017,11,9, 14 ,8381,1720,1615,11716
11/9/2017,2017,11,9, 15 ,8259,1762,1595,11616
11/9/2017,2017,11,9, 16 ,8097,1726,1577,11400
11/9/2017,2017,11,9, 17 ,8020,1717,1539,11276
11/9/2017,2017,11,9, 18 ,8252,1870,1616,11738
11/9/2017,2017,11,9, 19 ,8022,1790,1553,11365
11/9/2017,2017,11,9, 20 ,7797,1723,1533,11053
11/9/2017,2017,11,9, 21 ,7374,1628,1474,10476
11/9/2017,2017,11,9, 22 ,6885,1495,1342,9722
11/9/2017,2017,11,9, 23 ,6414,1401,1224,9039
11/9/2017,2017,11,9, 24 ,6061,1322,1155,8538
11/10/2017,2017,11,10, 1 ,5830,1261,1133,8224
11/10/2017,2017,11,10, 2 ,5601,1221,1081,7903
11/10/2017,2017,11,10, 3 ,5520,1196,1058,7774
11/10/2017,2017,11,10, 4 ,5550,1182,1034,7766
11/10/2017,2017,11,10, 5 ,5730,1226,1099,8055
11/10/2017,2017,11,10, 6 ,6012,1268,1126,8406
11/10/2017,2017,11,10, 7 ,6332,1234,1063,8629
11/10/2017,2017,11,10, 8 ,6969,1413,1275,9657
11/10/2017,2017,11,10, 9 ,7767,1655,1414,10836
11/10/2017,2017,11,10, 10 ,8262,1769,1557,11588
11/10/2017,2017,11,10, 11 ,8606,1815,1661,12082
11/10/2017,2017,11,10, 12 ,8406,1770,1631,11807
11/10/2017,2017,11,10, 13 ,8463,1782,1628,11873
11/10/2017,2017,11,10, 14 ,8819,1829,1673,12321
11/10/2017,2017,11,10, 15 ,8667,1822,1615,12104
11/10/2017,2017,11,10, 16 ,8585,1786,1583,11954
11/10/2017,2017,11,10, 17 ,8339,1739,1558,11636
11/10/2017,2017,11,10, 18 ,8579,1892,1647,12118
11/10/2017,2017,11,10, 19 ,8313,1826,1565,11704
11/10/2017,2017,11,10, 20 ,8245,1767,1518,11530
11/10/2017,2017,11,10, 21 ,8013,1686,1426,11125
11/10/2017,2017,11,10, 22 ,7642,1554,1314,10510
11/10/2017,2017,11,10, 23 ,7266,1442,1213,9921
11/10/2017,2017,11,10, 24 ,6865,1356,1137,9358
11/11/2017,2017,11,11, 1 ,6612,1294,1076,8982
11/11/2017,2017,11,11, 2 ,6410,1245,1053,8708
11/11/2017,2017,11,11, 3 ,6203,1216,1018,8437
11/11/2017,2017,11,11, 4 ,6104,1202,1020,8326
11/11/2017,2017,11,11, 5 ,6066,1218,1043,8327
11/11/2017,2017,11,11, 6 ,6018,1223,1068,8309
11/11/2017,2017,11,11, 7 ,6300,1241,1038,8579
11/11/2017,2017,11,11, 8 ,6833,1364,1120,9317
11/11/2017,2017,11,11, 9 ,7646,1561,1241,10448
11/11/2017,2017,11,11, 10 ,8190,1670,1362,11222
11/11/2017,2017,11,11, 11 ,8524,1704,1416,11644
11/11/2017,2017,11,11, 12 ,8361,1658,1395,11414
11/11/2017,2017,11,11, 13 ,8285,1651,1355,11291
11/11/2017,2017,11,11, 14 ,8550,1654,1424,11628
11/11/2017,2017,11,11, 15 ,8379,1623,1412,11414
11/11/2017,2017,11,11, 16 ,8049,1583,1396,11028
11/11/2017,2017,11,11, 17 ,7839,1566,1413,10818
11/11/2017,2017,11,11, 18 ,8366,1769,1563,11698
11/11/2017,2017,11,11, 19 ,8289,1725,1492,11506
11/11/2017,2017,11,11, 20 ,8207,1682,1438,11327
11/11/2017,2017,11,11, 21 ,8061,1581,1369,11011
11/11/2017,2017,11,11, 22 ,7749,1469,1245,10463
11/11/2017,2017,11,11, 23 ,7342,1356,1150,9848
11/11/2017,2017,11,11, 24 ,6897,1276,1076,9249
11/12/2017,2017,11,12, 1 ,6616,1222,1033,8871
11/12/2017,2017,11,12, 2 ,6404,1188,998,8590
11/12/2017,2017,11,12, 3 ,6210,1169,957,8336
11/12/2017,2017,11,12, 4 ,6073,1152,947,8172
11/12/2017,2017,11,12, 5 ,5910,1156,963,8029
11/12/2017,2017,11,12, 6 ,5818,1156,975,7949
11/12/2017,2017,11,12, 7 ,5813,1148,976,7937
11/12/2017,2017,11,12, 8 ,6182,1208,994,8384
11/12/2017,2017,11,12, 9 ,6633,1311,1072,9016
11/12/2017,2017,11,12, 10 ,7150,1409,1169,9728
11/12/2017,2017,11,12, 11 ,7447,1452,1206,10105
11/12/2017,2017,11,12, 12 ,7384,1454,1202,10040
11/12/2017,2017,11,12, 13 ,7375,1443,1185,10003
11/12/2017,2017,11,12, 14 ,7417,1433,1201,10051
11/12/2017,2017,11,12, 15 ,7349,1401,1192,9942
11/12/2017,2017,11,12, 16 ,7094,1390,1174,9658
11/12/2017,2017,11,12, 17 ,7036,1448,1234,9718
11/12/2017,2017,11,12, 18 ,7644,1666,1344,10654
11/12/2017,2017,11,12, 19 ,7677,1652,1362,10691
11/12/2017,2017,11,12, 20 ,7717,1608,1322,10647
11/12/2017,2017,11,12, 21 ,7508,1521,1243,10272
11/12/2017,2017,11,12, 22 ,7212,1419,1158,9789
11/12/2017,2017,11,12, 23 ,6897,1323,1070,9290
11/12/2017,2017,11,12, 24 ,6570,1260,1064,8894
11/13/2017,2017,11,13, 1 ,6234,1205,968,8407
11/13/2017,2017,11,13, 2 ,6033,1182,938,8153
11/13/2017,2017,11,13, 3 ,5877,1157,916,7950
11/13/2017,2017,11,13, 4 ,5798,1150,932,7880
11/13/2017,2017,11,13, 5 ,5840,1216,989,8045
11/13/2017,2017,11,13, 6 ,5990,1264,1056,8310
11/13/2017,2017,11,13, 7 ,6091,1222,983,8296
11/13/2017,2017,11,13, 8 ,6703,1407,1148,9258
11/13/2017,2017,11,13, 9 ,7565,1656,1386,10607
11/13/2017,2017,11,13, 10 ,8125,1796,1510,11431
11/13/2017,2017,11,13, 11 ,8375,1850,1580,11805
11/13/2017,2017,11,13, 12 ,8245,1814,1558,11617
11/13/2017,2017,11,13, 13 ,8231,1812,1521,11564
11/13/2017,2017,11,13, 14 ,8479,1861,1608,11948
11/13/2017,2017,11,13, 15 ,8384,1847,1599,11830
11/13/2017,2017,11,13, 16 ,8220,1811,1589,11620
11/13/2017,2017,11,13, 17 ,8048,1769,1554,11371
11/13/2017,2017,11,13, 18 ,8497,1939,1677,12113
11/13/2017,2017,11,13, 19 ,8456,1871,1601,11928
11/13/2017,2017,11,13, 20 ,8449,1800,1558,11807
11/13/2017,2017,11,13, 21 ,8175,1730,1463,11368
11/13/2017,2017,11,13, 22 ,7878,1600,1307,10785
11/13/2017,2017,11,13, 23 ,7515,1472,1214,10201
11/13/2017,2017,11,13, 24 ,7056,1380,1033,9469
11/14/2017,2017,11,14, 1 ,6802,1337,1088,9227
11/14/2017,2017,11,14, 2 ,6600,1298,1054,8952
11/14/2017,2017,11,14, 3 ,6396,1265,1026,8687
11/14/2017,2017,11,14, 4 ,6281,1249,1008,8538
11/14/2017,2017,11,14, 5 ,6374,1286,1073,8733
11/14/2017,2017,11,14, 6 ,6395,1327,1114,8836
11/14/2017,2017,11,14, 7 ,6390,1288,1038,8716
11/14/2017,2017,11,14, 8 ,7104,1466,1213,9783
11/14/2017,2017,11,14, 9 ,7879,1740,1442,11061
11/14/2017,2017,11,14, 10 ,8354,1845,1560,11759
11/14/2017,2017,11,14, 11 ,8593,1884,1626,12103
11/14/2017,2017,11,14, 12 ,8467,1836,1598,11901
11/14/2017,2017,11,14, 13 ,8416,1870,1607,11893
11/14/2017,2017,11,14, 14 ,8667,1919,1666,12252
11/14/2017,2017,11,14, 15 ,8593,1883,1639,12115
11/14/2017,2017,11,14, 16 ,8442,1851,1618,11911
11/14/2017,2017,11,14, 17 ,8152,1812,1579,11543
11/14/2017,2017,11,14, 18 ,8572,1975,1685,12232
11/14/2017,2017,11,14, 19 ,8498,1914,1595,12007
11/14/2017,2017,11,14, 20 ,8430,1840,1543,11813
11/14/2017,2017,11,14, 21 ,8292,1724,1464,11480
11/14/2017,2017,11,14, 22 ,7861,1602,1336,10799
11/14/2017,2017,11,14, 23 ,7509,1505,1239,10253
11/14/2017,2017,11,14, 24 ,7063,1399,1143,9605
11/15/2017,2017,11,15, 1 ,6846,1336,1102,9284
11/15/2017,2017,11,15, 2 ,6646,1303,1049,8998
11/15/2017,2017,11,15, 3 ,6468,1270,1040,8778
11/15/2017,2017,11,15, 4 ,6313,1251,1046,8610
11/15/2017,2017,11,15, 5 ,6371,1296,1084,8751
11/15/2017,2017,11,15, 6 ,6364,1337,1137,8838
11/15/2017,2017,11,15, 7 ,6496,1292,1048,8836
11/15/2017,2017,11,15, 8 ,7053,1481,1205,9739
11/15/2017,2017,11,15, 9 ,7902,1704,1420,11026
11/15/2017,2017,11,15, 10 ,8428,1835,1518,11781
11/15/2017,2017,11,15, 11 ,8742,1886,1578,12206
11/15/2017,2017,11,15, 12 ,8586,1841,1533,11960
11/15/2017,2017,11,15, 13 ,8658,1860,1435,11953
11/15/2017,2017,11,15, 14 ,8895,1924,1574,12393
11/15/2017,2017,11,15, 15 ,8866,1888,1567,12321
11/15/2017,2017,11,15, 16 ,8570,1832,1541,11943
11/15/2017,2017,11,15, 17 ,8260,1768,1527,11555
11/15/2017,2017,11,15, 18 ,8818,1939,1639,12396
11/15/2017,2017,11,15, 19 ,8683,1869,1596,12148
11/15/2017,2017,11,15, 20 ,8679,1830,1523,12032
11/15/2017,2017,11,15, 21 ,8521,1733,1443,11697
11/15/2017,2017,11,15, 22 ,8179,1606,1293,11078
11/15/2017,2017,11,15, 23 ,7665,1485,1201,10351
11/15/2017,2017,11,15, 24 ,7294,1402,1136,9832
11/16/2017,2017,11,16, 1 ,6938,1350,1081,9369
11/16/2017,2017,11,16, 2 ,6716,1312,1042,9070
11/16/2017,2017,11,16, 3 ,6472,1274,1011,8757
11/16/2017,2017,11,16, 4 ,6394,1266,1008,8668
11/16/2017,2017,11,16, 5 ,6484,1301,1063,8848
11/16/2017,2017,11,16, 6 ,6577,1333,1116,9026
11/16/2017,2017,11,16, 7 ,6650,1290,1044,8984
11/16/2017,2017,11,16, 8 ,7522,1423,1129,10074
11/16/2017,2017,11,16, 9 ,8423,1601,1285,11309
11/16/2017,2017,11,16, 10 ,8824,1705,1420,11949
11/16/2017,2017,11,16, 11 ,9215,1774,1468,12457
11/16/2017,2017,11,16, 12 ,9035,1736,1431,12202
11/16/2017,2017,11,16, 13 ,8996,1709,1421,12126
11/16/2017,2017,11,16, 14 ,9262,1751,1475,12488
11/16/2017,2017,11,16, 15 ,9103,1716,1455,12274
11/16/2017,2017,11,16, 16 ,8887,1704,1439,12030
11/16/2017,2017,11,16, 17 ,8690,1717,1471,11878
11/16/2017,2017,11,16, 18 ,8943,1842,1577,12362
11/16/2017,2017,11,16, 19 ,8730,1763,1480,11973
11/16/2017,2017,11,16, 20 ,8644,1698,1413,11755
11/16/2017,2017,11,16, 21 ,8421,1613,1307,11341
11/16/2017,2017,11,16, 22 ,8020,1469,1170,10659
11/16/2017,2017,11,16, 23 ,7585,1357,1078,10020
11/16/2017,2017,11,16, 24 ,7078,1264,1129,9471
11/17/2017,2017,11,17, 1 ,6806,1205,988,8999
11/17/2017,2017,11,17, 2 ,6620,1179,965,8764
11/17/2017,2017,11,17, 3 ,6448,1153,943,8544
11/17/2017,2017,11,17, 4 ,6302,1142,944,8388
11/17/2017,2017,11,17, 5 ,6448,1188,1004,8640
11/17/2017,2017,11,17, 6 ,6508,1253,1071,8832
11/17/2017,2017,11,17, 7 ,6650,1226,1014,8890
11/17/2017,2017,11,17, 8 ,7508,1370,1135,10013
11/17/2017,2017,11,17, 9 ,8256,1571,1316,11143
11/17/2017,2017,11,17, 10 ,8776,1688,1357,11821
11/17/2017,2017,11,17, 11 ,9053,1761,1495,12309
11/17/2017,2017,11,17, 12 ,8679,1699,1471,11849
11/17/2017,2017,11,17, 13 ,8548,1690,1499,11737
11/17/2017,2017,11,17, 14 ,8888,1752,1572,12212
11/17/2017,2017,11,17, 15 ,8799,1760,1553,12112
11/17/2017,2017,11,17, 16 ,8703,1715,1528,11946
11/17/2017,2017,11,17, 17 ,8463,1675,1495,11633
11/17/2017,2017,11,17, 18 ,8767,1843,1633,12243
11/17/2017,2017,11,17, 19 ,8527,1771,1565,11863
11/17/2017,2017,11,17, 20 ,8378,1715,1497,11590
11/17/2017,2017,11,17, 21 ,8200,1633,1432,11265
11/17/2017,2017,11,17, 22 ,7832,1504,1297,10633
11/17/2017,2017,11,17, 23 ,7426,1387,1188,10001
11/17/2017,2017,11,17, 24 ,6996,1314,1108,9418
11/18/2017,2017,11,18, 1 ,6712,1266,1062,9040
11/18/2017,2017,11,18, 2 ,6511,1224,1027,8762
11/18/2017,2017,11,18, 3 ,6354,1199,988,8541
11/18/2017,2017,11,18, 4 ,6200,1187,986,8373
11/18/2017,2017,11,18, 5 ,6238,1204,997,8439
11/18/2017,2017,11,18, 6 ,6230,1211,1015,8456
11/18/2017,2017,11,18, 7 ,6305,1232,1016,8553
11/18/2017,2017,11,18, 8 ,6973,1362,1112,9447
11/18/2017,2017,11,18, 9 ,7667,1507,1235,10409
11/18/2017,2017,11,18, 10 ,8275,1603,1353,11231
11/18/2017,2017,11,18, 11 ,8581,1664,1418,11663
11/18/2017,2017,11,18, 12 ,8458,1636,1368,11462
11/18/2017,2017,11,18, 13 ,8437,1643,1417,11497
11/18/2017,2017,11,18, 14 ,8660,1709,1449,11818
11/18/2017,2017,11,18, 15 ,8582,1659,1405,11646
11/18/2017,2017,11,18, 16 ,8383,1618,1373,11374
11/18/2017,2017,11,18, 17 ,8085,1604,1417,11106
11/18/2017,2017,11,18, 18 ,8504,1802,1525,11831
11/18/2017,2017,11,18, 19 ,8447,1760,1479,11686
11/18/2017,2017,11,18, 20 ,8412,1735,1440,11587
11/18/2017,2017,11,18, 21 ,8059,1652,1394,11105
11/18/2017,2017,11,18, 22 ,8056,1558,1309,10923
11/18/2017,2017,11,18, 23 ,7624,1442,1180,10246
11/18/2017,2017,11,18, 24 ,7236,1348,1090,9674
11/19/2017,2017,11,19, 1 ,6952,1283,1031,9266
11/19/2017,2017,11,19, 2 ,6718,1239,1004,8961
11/19/2017,2017,11,19, 3 ,6536,1210,962,8708
11/19/2017,2017,11,19, 4 ,6330,1193,953,8476
11/19/2017,2017,11,19, 5 ,6280,1177,964,8421
11/19/2017,2017,11,19, 6 ,6084,1174,972,8230
11/19/2017,2017,11,19, 7 ,6109,1178,970,8257
11/19/2017,2017,11,19, 8 ,6465,1267,1031,8763
11/19/2017,2017,11,19, 9 ,6993,1376,1106,9475
11/19/2017,2017,11,19, 10 ,7499,1476,1219,10194
11/19/2017,2017,11,19, 11 ,7793,1532,1277,10602
11/19/2017,2017,11,19, 12 ,7689,1522,1282,10493
11/19/2017,2017,11,19, 13 ,7716,1538,1274,10528
11/19/2017,2017,11,19, 14 ,7755,1548,1284,10587
11/19/2017,2017,11,19, 15 ,7609,1535,1270,10414
11/19/2017,2017,11,19, 16 ,7404,1484,1208,10096
11/19/2017,2017,11,19, 17 ,7229,1510,1207,9946
11/19/2017,2017,11,19, 18 ,7941,1745,1478,11164
11/19/2017,2017,11,19, 19 ,8006,1731,1432,11169
11/19/2017,2017,11,19, 20 ,8051,1698,1408,11157
11/19/2017,2017,11,19, 21 ,7990,1620,1341,10951
11/19/2017,2017,11,19, 22 ,7737,1496,1229,10462
11/19/2017,2017,11,19, 23 ,7338,1409,1128,9875
11/19/2017,2017,11,19, 24 ,6935,1312,1093,9340
11/20/2017,2017,11,20, 1 ,6610,1262,1008,8880
11/20/2017,2017,11,20, 2 ,6401,1230,971,8602
11/20/2017,2017,11,20, 3 ,6175,1208,945,8328
11/20/2017,2017,11,20, 4 ,6091,1197,938,8226
11/20/2017,2017,11,20, 5 ,6277,1247,1004,8528
11/20/2017,2017,11,20, 6 ,6462,1284,1057,8803
11/20/2017,2017,11,20, 7 ,6611,1249,983,8843
11/20/2017,2017,11,20, 8 ,7461,1439,1136,10036
11/20/2017,2017,11,20, 9 ,8376,1672,1315,11363
11/20/2017,2017,11,20, 10 ,8845,1798,1470,12113
11/20/2017,2017,11,20, 11 ,9236,1857,1538,12631
11/20/2017,2017,11,20, 12 ,8142,1833,1513,11488
11/20/2017,2017,11,20, 13 ,9152,1824,1516,12492
11/20/2017,2017,11,20, 14 ,9526,1907,1550,12983
11/20/2017,2017,11,20, 15 ,9439,1874,1534,12847
11/20/2017,2017,11,20, 16 ,9181,1834,1539,12554
11/20/2017,2017,11,20, 17 ,8828,1770,1541,12139
11/20/2017,2017,11,20, 18 ,9124,1946,1628,12698
11/20/2017,2017,11,20, 19 ,8904,1885,1560,12349
11/20/2017,2017,11,20, 20 ,8821,1805,1497,12123
11/20/2017,2017,11,20, 21 ,8599,1739,1394,11732
11/20/2017,2017,11,20, 22 ,8247,1606,1263,11116
11/20/2017,2017,11,20, 23 ,7815,1488,1160,10463
11/20/2017,2017,11,20, 24 ,7347,1412,987,9746
11/21/2017,2017,11,21, 1 ,6959,1363,1031,9353
11/21/2017,2017,11,21, 2 ,6753,1310,990,9053
11/21/2017,2017,11,21, 3 ,6624,1267,938,8829
11/21/2017,2017,11,21, 4 ,6518,1261,939,8718
11/21/2017,2017,11,21, 5 ,6682,1294,1015,8991
11/21/2017,2017,11,21, 6 ,6757,1344,1046,9147
11/21/2017,2017,11,21, 7 ,6834,1284,1039,9157
11/21/2017,2017,11,21, 8 ,7705,1453,1157,10315
11/21/2017,2017,11,21, 9 ,8569,1680,1370,11619
11/21/2017,2017,11,21, 10 ,9040,1770,1467,12277
11/21/2017,2017,11,21, 11 ,9310,1823,1513,12646
11/21/2017,2017,11,21, 12 ,9092,1803,1456,12351
11/21/2017,2017,11,21, 13 ,9139,1784,1467,12390
11/21/2017,2017,11,21, 14 ,9494,1848,1532,12874
11/21/2017,2017,11,21, 15 ,9431,1835,1515,12781
11/21/2017,2017,11,21, 16 ,9204,1796,1477,12477
11/21/2017,2017,11,21, 17 ,8939,1762,1504,12205
11/21/2017,2017,11,21, 18 ,9183,1926,1633,12742
11/21/2017,2017,11,21, 19 ,8891,1861,1546,12298
11/21/2017,2017,11,21, 20 ,8751,1796,1500,12047
11/21/2017,2017,11,21, 21 ,8554,1695,1437,11686
11/21/2017,2017,11,21, 22 ,8168,1559,1311,11038
11/21/2017,2017,11,21, 23 ,7688,1441,1169,10298
11/21/2017,2017,11,21, 24 ,7310,1350,1090,9750
11/22/2017,2017,11,22, 1 ,6967,1303,1049,9319
11/22/2017,2017,11,22, 2 ,6719,1275,1014,9008
11/22/2017,2017,11,22, 3 ,6578,1241,984,8803
11/22/2017,2017,11,22, 4 ,6469,1227,978,8674
11/22/2017,2017,11,22, 5 ,6608,1267,1045,8920
11/22/2017,2017,11,22, 6 ,6747,1317,1110,9174
11/22/2017,2017,11,22, 7 ,6741,1267,1029,9037
11/22/2017,2017,11,22, 8 ,7670,1460,1179,10309
11/22/2017,2017,11,22, 9 ,8630,1689,1396,11715
11/22/2017,2017,11,22, 10 ,9015,1826,1512,12353
11/22/2017,2017,11,22, 11 ,9342,1881,1603,12826
11/22/2017,2017,11,22, 12 ,9124,1843,1567,12534
11/22/2017,2017,11,22, 13 ,9125,1831,1596,12552
11/22/2017,2017,11,22, 14 ,9452,1906,1644,13002
11/22/2017,2017,11,22, 15 ,9267,1875,1631,12773
11/22/2017,2017,11,22, 16 ,9143,1846,1582,12571
11/22/2017,2017,11,22, 17 ,8763,1775,1529,12067
11/22/2017,2017,11,22, 18 ,9081,1964,1710,12755
11/22/2017,2017,11,22, 19 ,8882,1896,1609,12387
11/22/2017,2017,11,22, 20 ,8696,1839,1561,12096
11/22/2017,2017,11,22, 21 ,8487,1732,1482,11701
11/22/2017,2017,11,22, 22 ,8170,1596,1336,11102
11/22/2017,2017,11,22, 23 ,7741,1473,1243,10457
11/22/2017,2017,11,22, 24 ,7268,1383,1150,9801
11/23/2017,2017,11,23, 1 ,6995,1334,1065,9394
11/23/2017,2017,11,23, 2 ,6796,1288,1059,9143
11/23/2017,2017,11,23, 3 ,6491,1259,1030,8780
11/23/2017,2017,11,23, 4 ,6429,1249,1028,8706
11/23/2017,2017,11,23, 5 ,6576,1290,1089,8955
11/23/2017,2017,11,23, 6 ,6643,1323,1132,9098
11/23/2017,2017,11,23, 7 ,6744,1275,1034,9053
11/23/2017,2017,11,23, 8 ,7569,1442,1215,10226
11/23/2017,2017,11,23, 9 ,8335,1667,1427,11429
11/23/2017,2017,11,23, 10 ,8773,1812,1544,12129
11/23/2017,2017,11,23, 11 ,9055,1886,1590,12531
11/23/2017,2017,11,23, 12 ,8867,1849,1580,12296
11/23/2017,2017,11,23, 13 ,8791,1861,1589,12241
11/23/2017,2017,11,23, 14 ,9149,1915,1672,12736
11/23/2017,2017,11,23, 15 ,9055,1906,1651,12612
11/23/2017,2017,11,23, 16 ,8811,1833,1612,12256
11/23/2017,2017,11,23, 17 ,8547,1759,1563,11869
11/23/2017,2017,11,23, 18 ,8949,1968,1720,12637
11/23/2017,2017,11,23, 19 ,8774,1883,1632,12289
11/23/2017,2017,11,23, 20 ,8737,1823,1588,12148
11/23/2017,2017,11,23, 21 ,8501,1735,1497,11733
11/23/2017,2017,11,23, 22 ,8136,1592,1347,11075
11/23/2017,2017,11,23, 23 ,7716,1496,1227,10439
11/23/2017,2017,11,23, 24 ,7271,1424,1153,9848
11/24/2017,2017,11,24, 1 ,6989,1356,1131,9476
11/24/2017,2017,11,24, 2 ,6777,1316,1097,9190
11/24/2017,2017,11,24, 3 ,6577,1284,1065,8926
11/24/2017,2017,11,24, 4 ,6477,1270,1019,8766
11/24/2017,2017,11,24, 5 ,6573,1304,1121,8998
11/24/2017,2017,11,24, 6 ,6686,1338,1146,9170
11/24/2017,2017,11,24, 7 ,6808,1292,1073,9173
11/24/2017,2017,11,24, 8 ,7554,1457,1225,10236
11/24/2017,2017,11,24, 9 ,8470,1699,1441,11610
11/24/2017,2017,11,24, 10 ,8908,1808,1553,12269
11/24/2017,2017,11,24, 11 ,9233,1862,1632,12727
11/24/2017,2017,11,24, 12 ,9029,1828,1621,12478
11/24/2017,2017,11,24, 13 ,8790,1823,1623,12236
11/24/2017,2017,11,24, 14 ,8982,1888,1705,12575
11/24/2017,2017,11,24, 15 ,8813,1858,1678,12349
11/24/2017,2017,11,24, 16 ,8697,1829,1632,12158
11/24/2017,2017,11,24, 17 ,8483,1740,1563,11786
11/24/2017,2017,11,24, 18 ,8806,1921,1694,12421
11/24/2017,2017,11,24, 19 ,8579,1857,1622,12058
11/24/2017,2017,11,24, 20 ,8378,1799,1579,11756
11/24/2017,2017,11,24, 21 ,8172,1719,1495,11386
11/24/2017,2017,11,24, 22 ,7822,1584,1372,10778
11/24/2017,2017,11,24, 23 ,7344,1470,1249,10063
11/24/2017,2017,11,24, 24 ,6976,1375,1160,9511
11/25/2017,2017,11,25, 1 ,6726,1331,1132,9189
11/25/2017,2017,11,25, 2 ,6497,1292,1098,8887
11/25/2017,2017,11,25, 3 ,6368,1264,1070,8702
11/25/2017,2017,11,25, 4 ,6279,1249,1048,8576
11/25/2017,2017,11,25, 5 ,6233,1265,1058,8556
11/25/2017,2017,11,25, 6 ,6224,1250,1083,8557
11/25/2017,2017,11,25, 7 ,6395,1246,1072,8713
11/25/2017,2017,11,25, 8 ,6854,1373,1164,9391
11/25/2017,2017,11,25, 9 ,7526,1559,1281,10366
11/25/2017,2017,11,25, 10 ,8053,1654,1412,11119
11/25/2017,2017,11,25, 11 ,8479,1704,1473,11656
11/25/2017,2017,11,25, 12 ,8275,1660,1444,11379
11/25/2017,2017,11,25, 13 ,8174,1644,1425,11243
11/25/2017,2017,11,25, 14 ,8409,1683,1463,11555
11/25/2017,2017,11,25, 15 ,8330,1661,1451,11442
11/25/2017,2017,11,25, 16 ,8172,1651,1419,11242
11/25/2017,2017,11,25, 17 ,7908,1636,1435,10979
11/25/2017,2017,11,25, 18 ,8382,1839,1604,11825
11/25/2017,2017,11,25, 19 ,8289,1794,1526,11609
11/25/2017,2017,11,25, 20 ,8208,1749,1498,11455
11/25/2017,2017,11,25, 21 ,8099,1685,1414,11198
11/25/2017,2017,11,25, 22 ,7841,1571,1326,10738
11/25/2017,2017,11,25, 23 ,7417,1468,1213,10098
11/25/2017,2017,11,25, 24 ,7044,1377,1138,9559
11/26/2017,2017,11,26, 1 ,6732,1324,1068,9124
11/26/2017,2017,11,26, 2 ,6555,1283,1039,8877
11/26/2017,2017,11,26, 3 ,6327,1249,993,8569
11/26/2017,2017,11,26, 4 ,6210,1219,982,8411
11/26/2017,2017,11,26, 5 ,6149,1212,995,8356
11/26/2017,2017,11,26, 6 ,5957,1179,1001,8137
11/26/2017,2017,11,26, 7 ,5974,1187,983,8144
11/26/2017,2017,11,26, 8 ,6332,1263,1013,8608
11/26/2017,2017,11,26, 9 ,6794,1370,1093,9257
11/26/2017,2017,11,26, 10 ,7336,1438,1178,9952
11/26/2017,2017,11,26, 11 ,7482,1496,1230,10208
11/26/2017,2017,11,26, 12 ,7428,1476,1213,10117
11/26/2017,2017,11,26, 13 ,7402,1509,1194,10105
11/26/2017,2017,11,26, 14 ,7399,1498,1210,10107
11/26/2017,2017,11,26, 15 ,7342,1484,1198,10024
11/26/2017,2017,11,26, 16 ,7251,1465,1193,9909
11/26/2017,2017,11,26, 17 ,7129,1496,1235,9860
11/26/2017,2017,11,26, 18 ,7703,1740,1436,10879
11/26/2017,2017,11,26, 19 ,7845,1721,1414,10980
11/26/2017,2017,11,26, 20 ,7840,1686,1383,10909
11/26/2017,2017,11,26, 21 ,7736,1637,1299,10672
11/26/2017,2017,11,26, 22 ,7438,1538,1194,10170
11/26/2017,2017,11,26, 23 ,7058,1431,1098,9587
11/26/2017,2017,11,26, 24 ,6597,1341,1018,8956
11/27/2017,2017,11,27, 1 ,6331,1287,975,8593
11/27/2017,2017,11,27, 2 ,6106,1248,957,8311
11/27/2017,2017,11,27, 3 ,5859,1221,942,8022
11/27/2017,2017,11,27, 4 ,5755,1206,941,7902
11/27/2017,2017,11,27, 5 ,5890,1251,998,8139
11/27/2017,2017,11,27, 6 ,6184,1308,1079,8571
11/27/2017,2017,11,27, 7 ,6328,1262,998,8588
11/27/2017,2017,11,27, 8 ,7265,1467,1160,9892
11/27/2017,2017,11,27, 9 ,8276,1710,1383,11369
11/27/2017,2017,11,27, 10 ,8878,1831,1503,12212
11/27/2017,2017,11,27, 11 ,9234,1889,1588,12711
11/27/2017,2017,11,27, 12 ,8922,1800,1571,12293
11/27/2017,2017,11,27, 13 ,8918,1804,1577,12299
11/27/2017,2017,11,27, 14 ,9258,1857,1630,12745
11/27/2017,2017,11,27, 15 ,9152,1829,1592,12573
11/27/2017,2017,11,27, 16 ,8982,1803,1551,12336
11/27/2017,2017,11,27, 17 ,8716,1769,1466,11951
11/27/2017,2017,11,27, 18 ,8964,1946,1656,12566
11/27/2017,2017,11,27, 19 ,8776,1852,1585,12213
11/27/2017,2017,11,27, 20 ,8686,1792,1522,12000
11/27/2017,2017,11,27, 21 ,8494,1718,1445,11657
11/27/2017,2017,11,27, 22 ,8101,1580,1317,10998
11/27/2017,2017,11,27, 23 ,7592,1456,1184,10232
11/27/2017,2017,11,27, 24 ,7102,1370,1044,9516
11/28/2017,2017,11,28, 1 ,6741,1311,1078,9130
11/28/2017,2017,11,28, 2 ,6592,1271,1047,8910
11/28/2017,2017,11,28, 3 ,6408,1229,1019,8656
11/28/2017,2017,11,28, 4 ,6304,1222,1063,8589
11/28/2017,2017,11,28, 5 ,6463,1264,1106,8833
11/28/2017,2017,11,28, 6 ,6567,1315,1133,9015
11/28/2017,2017,11,28, 7 ,6634,1267,1035,8936
11/28/2017,2017,11,28, 8 ,7445,1441,1180,10066
11/28/2017,2017,11,28, 9 ,8382,1664,1393,11439
11/28/2017,2017,11,28, 10 ,8879,1783,1511,12173
11/28/2017,2017,11,28, 11 ,9226,1837,1584,12647
11/28/2017,2017,11,28, 12 ,9057,1793,1568,12418
11/28/2017,2017,11,28, 13 ,9065,1800,1577,12442
11/28/2017,2017,11,28, 14 ,9407,1872,1648,12927
11/28/2017,2017,11,28, 15 ,9359,1848,1617,12824
11/28/2017,2017,11,28, 16 ,9215,1793,1588,12596
11/28/2017,2017,11,28, 17 ,8846,1752,1532,12130
11/28/2017,2017,11,28, 18 ,9147,1939,1712,12798
11/28/2017,2017,11,28, 19 ,8943,1876,1619,12438
11/28/2017,2017,11,28, 20 ,8794,1769,1540,12103
11/28/2017,2017,11,28, 21 ,8619,1727,1479,11825
11/28/2017,2017,11,28, 22 ,8209,1625,1349,11183
11/28/2017,2017,11,28, 23 ,7743,1496,1221,10460
11/28/2017,2017,11,28, 24 ,7302,1426,1129,9857
11/29/2017,2017,11,29, 1 ,6971,1379,1107,9457
11/29/2017,2017,11,29, 2 ,6763,1337,1077,9177
11/29/2017,2017,11,29, 3 ,6562,1301,1051,8914
11/29/2017,2017,11,29, 4 ,6454,1286,1030,8770
11/29/2017,2017,11,29, 5 ,6575,1330,1075,8980
11/29/2017,2017,11,29, 6 ,6535,1378,1121,9034
11/29/2017,2017,11,29, 7 ,6687,1320,1050,9057
11/29/2017,2017,11,29, 8 ,7485,1456,1189,10130
11/29/2017,2017,11,29, 9 ,8363,1651,1385,11399
11/29/2017,2017,11,29, 10 ,8835,1751,1502,12088
11/29/2017,2017,11,29, 11 ,9110,1808,1562,12480
11/29/2017,2017,11,29, 12 ,8953,1755,1544,12252
11/29/2017,2017,11,29, 13 ,8894,1765,1574,12233
11/29/2017,2017,11,29, 14 ,9254,1826,1620,12700
11/29/2017,2017,11,29, 15 ,9131,1824,1586,12541
11/29/2017,2017,11,29, 16 ,8969,1775,1546,12290
11/29/2017,2017,11,29, 17 ,8634,1752,1522,11908
11/29/2017,2017,11,29, 18 ,9024,1924,1642,12590
11/29/2017,2017,11,29, 19 ,8813,1855,1589,12257
11/29/2017,2017,11,29, 20 ,8701,1785,1532,12018
11/29/2017,2017,11,29, 21 ,8547,1709,1467,11723
11/29/2017,2017,11,29, 22 ,8129,1595,1328,11052
11/29/2017,2017,11,29, 23 ,7672,1471,1235,10378
11/29/2017,2017,11,29, 24 ,7329,1388,1148,9865
11/30/2017,2017,11,30, 1 ,6954,1341,1109,9404
11/30/2017,2017,11,30, 2 ,6802,1300,1071,9173
11/30/2017,2017,11,30, 3 ,6610,1251,1040,8901
11/30/2017,2017,11,30, 4 ,6425,1232,1021,8678
11/30/2017,2017,11,30, 5 ,6401,1247,1027,8675
11/30/2017,2017,11,30, 6 ,6349,1250,1051,8650
11/30/2017,2017,11,30, 7 ,6281,1252,1036,8569
11/30/2017,2017,11,30, 8 ,6686,1353,1085,9124
11/30/2017,2017,11,30, 9 ,7027,1511,1226,9764
11/30/2017,2017,11,30, 10 ,7718,1621,1380,10719
11/30/2017,2017,11,30, 11 ,8115,1706,1444,11265
11/30/2017,2017,11,30, 12 ,7925,1672,1443,11040
11/30/2017,2017,11,30, 13 ,7821,1679,1450,10950
11/30/2017,2017,11,30, 14 ,7969,1732,1480,11181
11/30/2017,2017,11,30, 15 ,7803,1720,1457,10980
11/30/2017,2017,11,30, 16 ,7663,1670,1416,10749
11/30/2017,2017,11,30, 17 ,7637,1642,1389,10668
11/30/2017,2017,11,30, 18 ,8236,1864,1581,11681
11/30/2017,2017,11,30, 19 ,8273,1815,1551,11639
11/30/2017,2017,11,30, 20 ,8141,1788,1508,11437
11/30/2017,2017,11,30, 21 ,8102,1710,1444,11256
11/30/2017,2017,11,30, 22 ,7745,1606,1324,10675
11/30/2017,2017,11,30, 23 ,7247,1482,1204,9933
11/30/2017,2017,11,30, 24 ,6821,1378,1159,9358
12/1/2017,2017,12,1, 1 ,6603,1323,1071,8997
12/1/2017,2017,12,1, 2 ,6372,1281,1030,8683
12/1/2017,2017,12,1, 3 ,6138,1245,1006,8389
12/1/2017,2017,12,1, 4 ,6099,1224,995,8318
12/1/2017,2017,12,1, 5 ,6266,1263,1039,8568
12/1/2017,2017,12,1, 6 ,6362,1306,1086,8754
12/1/2017,2017,12,1, 7 ,6527,1267,1030,8824
12/1/2017,2017,12,1, 8 ,7431,1425,1195,10051
12/1/2017,2017,12,1, 9 ,8336,1665,1410,11411
12/1/2017,2017,12,1, 10 ,8852,1777,1541,12170
12/1/2017,2017,12,1, 11 ,9194,1838,1631,12663
12/1/2017,2017,12,1, 12 ,8906,1785,1589,12280
12/1/2017,2017,12,1, 13 ,8868,1810,1610,12288
12/1/2017,2017,12,1, 14 ,9186,1874,1672,12732
12/1/2017,2017,12,1, 15 ,9177,1857,1649,12683
12/1/2017,2017,12,1, 16 ,8981,1833,1577,12391
12/1/2017,2017,12,1, 17 ,8562,1749,1515,11826
12/1/2017,2017,12,1, 18 ,8974,1938,1667,12579
12/1/2017,2017,12,1, 19 ,8741,1873,1623,12237
12/1/2017,2017,12,1, 20 ,8582,1816,1580,11978
12/1/2017,2017,12,1, 21 ,8368,1740,1509,11617
12/1/2017,2017,12,1, 22 ,8071,1625,1379,11075
12/1/2017,2017,12,1, 23 ,7616,1506,1256,10378
12/1/2017,2017,12,1, 24 ,7188,1409,1203,9800
12/2/2017,2017,12,2, 1 ,6851,1356,1142,9349
12/2/2017,2017,12,2, 2 ,6657,1311,1105,9073
12/2/2017,2017,12,2, 3 ,6391,1273,1074,8738
12/2/2017,2017,12,2, 4 ,6196,1257,1055,8508
12/2/2017,2017,12,2, 5 ,6283,1239,1069,8591
12/2/2017,2017,12,2, 6 ,6271,1259,1076,8606
12/2/2017,2017,12,2, 7 ,6353,1268,1049,8670
12/2/2017,2017,12,2, 8 ,6907,1363,1134,9404
12/2/2017,2017,12,2, 9 ,7671,1547,1310,10528
12/2/2017,2017,12,2, 10 ,8128,1652,1419,11199
12/2/2017,2017,12,2, 11 ,8516,1721,1489,11726
12/2/2017,2017,12,2, 12 ,8419,1693,1488,11600
12/2/2017,2017,12,2, 13 ,8332,1705,1488,11525
12/2/2017,2017,12,2, 14 ,8623,1748,1549,11920
12/2/2017,2017,12,2, 15 ,8487,1713,1479,11679
12/2/2017,2017,12,2, 16 ,8315,1632,1444,11391
12/2/2017,2017,12,2, 17 ,7945,1571,1428,10944
12/2/2017,2017,12,2, 18 ,8496,1786,1574,11856
12/2/2017,2017,12,2, 19 ,8412,1805,1525,11742
12/2/2017,2017,12,2, 20 ,8415,1766,1485,11666
12/2/2017,2017,12,2, 21 ,8213,1708,1456,11377
12/2/2017,2017,12,2, 22 ,8075,1647,1366,11088
12/2/2017,2017,12,2, 23 ,7646,1514,1264,10424
12/2/2017,2017,12,2, 24 ,7187,1411,1149,9747
12/3/2017,2017,12,3, 1 ,6908,1342,1084,9334
12/3/2017,2017,12,3, 2 ,6629,1305,1024,8958
12/3/2017,2017,12,3, 3 ,6462,1268,1015,8745
12/3/2017,2017,12,3, 4 ,6276,1239,986,8501
12/3/2017,2017,12,3, 5 ,6149,1228,997,8374
12/3/2017,2017,12,3, 6 ,6037,1204,1000,8241
12/3/2017,2017,12,3, 7 ,6010,1171,985,8166
12/3/2017,2017,12,3, 8 ,6366,1222,1005,8593
12/3/2017,2017,12,3, 9 ,6871,1333,1132,9336
12/3/2017,2017,12,3, 10 ,7340,1419,1232,9991
12/3/2017,2017,12,3, 11 ,7543,1498,1296,10337
12/3/2017,2017,12,3, 12 ,7492,1488,1309,10289
12/3/2017,2017,12,3, 13 ,7556,1487,1313,10356
12/3/2017,2017,12,3, 14 ,7642,1505,1341,10488
12/3/2017,2017,12,3, 15 ,7943,1491,1319,10753
12/3/2017,2017,12,3, 16 ,7282,1460,1280,10022
12/3/2017,2017,12,3, 17 ,7239,1466,1299,10004
12/3/2017,2017,12,3, 18 ,8024,1720,1503,11247
12/3/2017,2017,12,3, 19 ,8104,1716,1480,11300
12/3/2017,2017,12,3, 20 ,8097,1696,1455,11248
12/3/2017,2017,12,3, 21 ,8050,1636,1404,11090
12/3/2017,2017,12,3, 22 ,7746,1533,1284,10563
12/3/2017,2017,12,3, 23 ,7340,1424,1173,9937
12/3/2017,2017,12,3, 24 ,6896,1342,1113,9351
12/4/2017,2017,12,4, 1 ,6609,1286,1047,8942
12/4/2017,2017,12,4, 2 ,6334,1234,1003,8571
12/4/2017,2017,12,4, 3 ,6152,1208,971,8331
12/4/2017,2017,12,4, 4 ,6003,1185,969,8157
12/4/2017,2017,12,4, 5 ,6158,1241,1010,8409
12/4/2017,2017,12,4, 6 ,6365,1285,1067,8717
12/4/2017,2017,12,4, 7 ,6498,1240,998,8736
12/4/2017,2017,12,4, 8 ,7404,1417,1177,9998
12/4/2017,2017,12,4, 9 ,8340,1672,1406,11418
12/4/2017,2017,12,4, 10 ,8879,1823,1550,12252
12/4/2017,2017,12,4, 11 ,9248,1871,1625,12744
12/4/2017,2017,12,4, 12 ,9104,1842,1590,12536
12/4/2017,2017,12,4, 13 ,9058,1863,1632,12553
12/4/2017,2017,12,4, 14 ,9403,1947,1696,13046
12/4/2017,2017,12,4, 15 ,9282,1899,1681,12862
12/4/2017,2017,12,4, 16 ,9094,1854,1618,12566
12/4/2017,2017,12,4, 17 ,8759,1776,1552,12087
12/4/2017,2017,12,4, 18 ,9130,1957,1684,12771
12/4/2017,2017,12,4, 19 ,8970,1891,1616,12477
12/4/2017,2017,12,4, 20 ,8841,1838,1586,12265
12/4/2017,2017,12,4, 21 ,8657,1756,1532,11945
12/4/2017,2017,12,4, 22 ,8241,1632,1385,11258
12/4/2017,2017,12,4, 23 ,7623,1501,1263,10387
12/4/2017,2017,12,4, 24 ,7260,1407,1183,9850
12/5/2017,2017,12,5, 1 ,6934,1347,1130,9411
12/5/2017,2017,12,5, 2 ,6710,1304,1093,9107
12/5/2017,2017,12,5, 3 ,6484,1284,1056,8824
12/5/2017,2017,12,5, 4 ,6443,1266,1051,8760
12/5/2017,2017,12,5, 5 ,6579,1308,1092,8979
12/5/2017,2017,12,5, 6 ,6704,1345,1123,9172
12/5/2017,2017,12,5, 7 ,6816,1286,1030,9132
12/5/2017,2017,12,5, 8 ,7638,1461,1186,10285
12/5/2017,2017,12,5, 9 ,8394,1706,1432,11532
12/5/2017,2017,12,5, 10 ,8849,1814,1578,12241
12/5/2017,2017,12,5, 11 ,9169,1856,1640,12665
12/5/2017,2017,12,5, 12 ,8961,1826,1599,12386
12/5/2017,2017,12,5, 13 ,8844,1817,1679,12340
12/5/2017,2017,12,5, 14 ,9090,1910,1700,12700
12/5/2017,2017,12,5, 15 ,8900,1881,1682,12463
12/5/2017,2017,12,5, 16 ,8763,1838,1637,12238
12/5/2017,2017,12,5, 17 ,8531,1797,1585,11913
12/5/2017,2017,12,5, 18 ,8895,1956,1737,12588
12/5/2017,2017,12,5, 19 ,8658,1894,1652,12204
12/5/2017,2017,12,5, 20 ,8558,1821,1592,11971
12/5/2017,2017,12,5, 21 ,8341,1735,1522,11598
12/5/2017,2017,12,5, 22 ,7943,1598,1372,10913
12/5/2017,2017,12,5, 23 ,7438,1485,1244,10167
12/5/2017,2017,12,5, 24 ,7021,1392,1148,9561
12/6/2017,2017,12,6, 1 ,6707,1327,1105,9139
12/6/2017,2017,12,6, 2 ,6505,1282,1087,8874
12/6/2017,2017,12,6, 3 ,6276,1248,1055,8579
12/6/2017,2017,12,6, 4 ,6199,1238,1046,8483
12/6/2017,2017,12,6, 5 ,6386,1286,1086,8758
12/6/2017,2017,12,6, 6 ,6485,1343,1081,8909
12/6/2017,2017,12,6, 7 ,6551,1282,1055,8888
12/6/2017,2017,12,6, 8 ,7356,1432,1231,10019
12/6/2017,2017,12,6, 9 ,8201,1648,1417,11266
12/6/2017,2017,12,6, 10 ,8630,1752,1554,11936
12/6/2017,2017,12,6, 11 ,8921,1848,1623,12392
12/6/2017,2017,12,6, 12 ,8735,1810,1610,12155
12/6/2017,2017,12,6, 13 ,8692,1821,1620,12133
12/6/2017,2017,12,6, 14 ,8987,1881,1673,12541
12/6/2017,2017,12,6, 15 ,8929,1859,1676,12464
12/6/2017,2017,12,6, 16 ,8745,1817,1624,12186
12/6/2017,2017,12,6, 17 ,8495,1760,1539,11794
12/6/2017,2017,12,6, 18 ,8856,1935,1705,12496
12/6/2017,2017,12,6, 19 ,8730,1874,1631,12235
12/6/2017,2017,12,6, 20 ,8609,1821,1575,12005
12/6/2017,2017,12,6, 21 ,8432,1746,1517,11695
12/6/2017,2017,12,6, 22 ,8032,1590,1357,10979
12/6/2017,2017,12,6, 23 ,7840,1471,1227,10538
12/6/2017,2017,12,6, 24 ,7000,1378,1154,9532
12/7/2017,2017,12,7, 1 ,6722,1322,1112,9156
12/7/2017,2017,12,7, 2 ,6519,1287,1072,8878
12/7/2017,2017,12,7, 3 ,6360,1250,1037,8647
12/7/2017,2017,12,7, 4 ,6267,1244,1031,8542
12/7/2017,2017,12,7, 5 ,6403,1281,1075,8759
12/7/2017,2017,12,7, 6 ,6570,1318,1114,9002
12/7/2017,2017,12,7, 7 ,6658,1246,1043,8947
12/7/2017,2017,12,7, 8 ,7349,1404,1195,9948
12/7/2017,2017,12,7, 9 ,8184,1644,1419,11247
12/7/2017,2017,12,7, 10 ,8617,1762,1551,11930
12/7/2017,2017,12,7, 11 ,9002,1810,1614,12426
12/7/2017,2017,12,7, 12 ,8765,1799,1588,12152
12/7/2017,2017,12,7, 13 ,8755,1787,1612,12154
12/7/2017,2017,12,7, 14 ,9130,1884,1707,12721
12/7/2017,2017,12,7, 15 ,8964,1885,1632,12481
12/7/2017,2017,12,7, 16 ,8812,1848,1630,12290
12/7/2017,2017,12,7, 17 ,8567,1770,1577,11914
12/7/2017,2017,12,7, 18 ,8899,1944,1713,12556
12/7/2017,2017,12,7, 19 ,8733,1882,1635,12250
12/7/2017,2017,12,7, 20 ,8584,1811,1592,11987
12/7/2017,2017,12,7, 21 ,8492,1734,1533,11759
12/7/2017,2017,12,7, 22 ,8032,1608,1400,11040
12/7/2017,2017,12,7, 23 ,7566,1471,1279,10316
12/7/2017,2017,12,7, 24 ,7063,1391,1178,9632
12/8/2017,2017,12,8, 1 ,6827,1331,1128,9286
12/8/2017,2017,12,8, 2 ,6520,1288,1090,8898
12/8/2017,2017,12,8, 3 ,6360,1256,1061,8677
12/8/2017,2017,12,8, 4 ,6295,1235,1041,8571
12/8/2017,2017,12,8, 5 ,6382,1269,1071,8722
12/8/2017,2017,12,8, 6 ,6441,1298,1111,8850
12/8/2017,2017,12,8, 7 ,6596,1263,1051,8910
12/8/2017,2017,12,8, 8 ,7210,1430,1193,9833
12/8/2017,2017,12,8, 9 ,8024,1669,1423,11116
12/8/2017,2017,12,8, 10 ,8497,1763,1562,11822
12/8/2017,2017,12,8, 11 ,8839,1845,1622,12306
12/8/2017,2017,12,8, 12 ,8607,1817,1573,11997
12/8/2017,2017,12,8, 13 ,8490,1840,1601,11931
12/8/2017,2017,12,8, 14 ,8752,1879,1675,12306
12/8/2017,2017,12,8, 15 ,8610,1876,1653,12139
12/8/2017,2017,12,8, 16 ,8463,1826,1587,11876
12/8/2017,2017,12,8, 17 ,8227,1763,1526,11516
12/8/2017,2017,12,8, 18 ,8580,1926,1646,12152
12/8/2017,2017,12,8, 19 ,8399,1873,1605,11877
12/8/2017,2017,12,8, 20 ,8310,1821,1548,11679
12/8/2017,2017,12,8, 21 ,8170,1752,1481,11403
12/8/2017,2017,12,8, 22 ,7861,1618,1367,10846
12/8/2017,2017,12,8, 23 ,7441,1502,1231,10174
12/8/2017,2017,12,8, 24 ,6978,1427,1175,9580
12/9/2017,2017,12,9, 1 ,6688,1357,1098,9143
12/9/2017,2017,12,9, 2 ,6481,1307,1063,8851
12/9/2017,2017,12,9, 3 ,6278,1265,952,8495
12/9/2017,2017,12,9, 4 ,6201,1254,1022,8477
12/9/2017,2017,12,9, 5 ,6158,1260,1037,8455
12/9/2017,2017,12,9, 6 ,6271,1257,1051,8579
12/9/2017,2017,12,9, 7 ,6316,1262,1052,8630
12/9/2017,2017,12,9, 8 ,6917,1372,1138,9427
12/9/2017,2017,12,9, 9 ,7543,1546,1306,10395
12/9/2017,2017,12,9, 10 ,8045,1669,1430,11144
12/9/2017,2017,12,9, 11 ,8352,1733,1502,11587
12/9/2017,2017,12,9, 12 ,8180,1708,1487,11375
12/9/2017,2017,12,9, 13 ,8120,1725,1501,11346
12/9/2017,2017,12,9, 14 ,8316,1759,1529,11604
12/9/2017,2017,12,9, 15 ,8172,1730,1510,11412
12/9/2017,2017,12,9, 16 ,7934,1683,1469,11086
12/9/2017,2017,12,9, 17 ,7717,1654,1452,10823
12/9/2017,2017,12,9, 18 ,8206,1849,1609,11664
12/9/2017,2017,12,9, 19 ,8205,1821,1559,11585
12/9/2017,2017,12,9, 20 ,8137,1776,1428,11341
12/9/2017,2017,12,9, 21 ,7995,1710,1354,11059
12/9/2017,2017,12,9, 22 ,7735,1607,1250,10592
12/9/2017,2017,12,9, 23 ,7456,1498,1129,10083
12/9/2017,2017,12,9, 24 ,6916,1402,1051,9369
12/10/2017,2017,12,10, 1 ,6618,1331,1052,9001
12/10/2017,2017,12,10, 2 ,6435,1288,1031,8754
12/10/2017,2017,12,10, 3 ,6184,1236,1014,8434
12/10/2017,2017,12,10, 4 ,6077,1208,1002,8287
12/10/2017,2017,12,10, 5 ,6007,1207,1010,8224
12/10/2017,2017,12,10, 6 ,5854,1195,986,8035
12/10/2017,2017,12,10, 7 ,5792,1207,987,7986
12/10/2017,2017,12,10, 8 ,6072,1283,1013,8368
12/10/2017,2017,12,10, 9 ,6473,1384,1142,8999
12/10/2017,2017,12,10, 10 ,6949,1475,1234,9658
12/10/2017,2017,12,10, 11 ,7249,1550,1285,10084
12/10/2017,2017,12,10, 12 ,7205,1548,1309,10062
12/10/2017,2017,12,10, 13 ,7247,1558,1275,10080
12/10/2017,2017,12,10, 14 ,7279,1554,1280,10113
12/10/2017,2017,12,10, 15 ,7057,1525,1271,9853
12/10/2017,2017,12,10, 16 ,6980,1505,1279,9764
12/10/2017,2017,12,10, 17 ,7033,1523,1320,9876
12/10/2017,2017,12,10, 18 ,7761,1774,1511,11046
12/10/2017,2017,12,10, 19 ,7857,1778,1498,11133
12/10/2017,2017,12,10, 20 ,7830,1746,1457,11033
12/10/2017,2017,12,10, 21 ,7799,1683,1362,10844
12/10/2017,2017,12,10, 22 ,7508,1563,1294,10365
12/10/2017,2017,12,10, 23 ,7163,1458,1196,9817
12/10/2017,2017,12,10, 24 ,6554,1363,1103,9020
12/11/2017,2017,12,11, 1 ,6378,1307,1040,8725
12/11/2017,2017,12,11, 2 ,6146,1269,1002,8417
12/11/2017,2017,12,11, 3 ,6040,1237,992,8269
12/11/2017,2017,12,11, 4 ,5968,1220,987,8175
12/11/2017,2017,12,11, 5 ,6155,1268,1048,8471
12/11/2017,2017,12,11, 6 ,6349,1305,1043,8697
12/11/2017,2017,12,11, 7 ,6541,1261,1027,8829
12/11/2017,2017,12,11, 8 ,7223,1429,1147,9799
12/11/2017,2017,12,11, 9 ,8053,1697,1377,11127
12/11/2017,2017,12,11, 10 ,8552,1798,1502,11852
12/11/2017,2017,12,11, 11 ,8833,1881,1570,12284
12/11/2017,2017,12,11, 12 ,8579,1842,1539,11960
12/11/2017,2017,12,11, 13 ,8560,1813,1516,11889
12/11/2017,2017,12,11, 14 ,8810,1847,1563,12220
12/11/2017,2017,12,11, 15 ,8761,1808,1508,12077
12/11/2017,2017,12,11, 16 ,8671,1792,1513,11976
12/11/2017,2017,12,11, 17 ,8354,1745,1509,11608
12/11/2017,2017,12,11, 18 ,8790,1887,1626,12303
12/11/2017,2017,12,11, 19 ,8631,1839,1572,12042
12/11/2017,2017,12,11, 20 ,8526,1781,1532,11839
12/11/2017,2017,12,11, 21 ,8281,1686,1432,11399
12/11/2017,2017,12,11, 22 ,7894,1568,1286,10748
12/11/2017,2017,12,11, 23 ,7407,1439,1177,10023
12/11/2017,2017,12,11, 24 ,6970,1364,1098,9432
12/12/2017,2017,12,12, 1 ,6716,1308,1066,9090
12/12/2017,2017,12,12, 2 ,6441,1270,1033,8744
12/12/2017,2017,12,12, 3 ,6265,1235,1014,8514
12/12/2017,2017,12,12, 4 ,6121,1220,1006,8347
12/12/2017,2017,12,12, 5 ,6300,1266,1069,8635
12/12/2017,2017,12,12, 6 ,6486,1325,1135,8946
12/12/2017,2017,12,12, 7 ,6563,1260,1057,8880
12/12/2017,2017,12,12, 8 ,7195,1397,1173,9765
12/12/2017,2017,12,12, 9 ,7923,1634,1405,10962
12/12/2017,2017,12,12, 10 ,8374,1730,1525,11629
12/12/2017,2017,12,12, 11 ,8687,1778,1586,12051
12/12/2017,2017,12,12, 12 ,8471,1717,1534,11722
12/12/2017,2017,12,12, 13 ,8410,1691,1527,11628
12/12/2017,2017,12,12, 14 ,8717,1743,1566,12026
12/12/2017,2017,12,12, 15 ,8685,1730,1542,11957
12/12/2017,2017,12,12, 16 ,8620,1717,1514,11851
12/12/2017,2017,12,12, 17 ,8337,1699,1517,11553
12/12/2017,2017,12,12, 18 ,8754,1872,1632,12258
12/12/2017,2017,12,12, 19 ,8602,1808,1567,11977
12/12/2017,2017,12,12, 20 ,8434,1723,1507,11664
12/12/2017,2017,12,12, 21 ,8245,1641,1426,11312
12/12/2017,2017,12,12, 22 ,7785,1520,1296,10601
12/12/2017,2017,12,12, 23 ,7309,1383,1181,9873
12/12/2017,2017,12,12, 24 ,6938,1309,1108,9355
12/13/2017,2017,12,13, 1 ,6552,1262,1063,8877
12/13/2017,2017,12,13, 2 ,6376,1226,1025,8627
12/13/2017,2017,12,13, 3 ,6201,1210,1011,8422
12/13/2017,2017,12,13, 4 ,6141,1196,1005,8342
12/13/2017,2017,12,13, 5 ,6312,1241,1061,8614
12/13/2017,2017,12,13, 6 ,6478,1299,1044,8821
12/13/2017,2017,12,13, 7 ,6524,1256,1038,8818
12/13/2017,2017,12,13, 8 ,7251,1383,1139,9773
12/13/2017,2017,12,13, 9 ,7940,1598,1344,10882
12/13/2017,2017,12,13, 10 ,8497,1702,1443,11642
12/13/2017,2017,12,13, 11 ,8780,1731,1504,12015
12/13/2017,2017,12,13, 12 ,8531,1679,1481,11691
12/13/2017,2017,12,13, 13 ,8458,1665,1462,11585
12/13/2017,2017,12,13, 14 ,8807,1722,1486,12015
12/13/2017,2017,12,13, 15 ,8725,1693,1458,11876
12/13/2017,2017,12,13, 16 ,8582,1684,1458,11724
12/13/2017,2017,12,13, 17 ,8369,1708,1484,11561
12/13/2017,2017,12,13, 18 ,8784,1836,1610,12230
12/13/2017,2017,12,13, 19 ,8538,1770,1549,11857
12/13/2017,2017,12,13, 20 ,8391,1696,1497,11584
12/13/2017,2017,12,13, 21 ,8140,1603,1400,11143
12/13/2017,2017,12,13, 22 ,7742,1468,1282,10492
12/13/2017,2017,12,13, 23 ,7239,1346,1158,9743
12/13/2017,2017,12,13, 24 ,6838,1284,1094,9216
12/14/2017,2017,12,14, 1 ,6563,1228,1024,8815
12/14/2017,2017,12,14, 2 ,6374,1175,1003,8552
12/14/2017,2017,12,14, 3 ,6212,1148,966,8326
12/14/2017,2017,12,14, 4 ,6127,1144,976,8247
12/14/2017,2017,12,14, 5 ,6309,1186,1038,8533
12/14/2017,2017,12,14, 6 ,6487,1264,1105,8856
12/14/2017,2017,12,14, 7 ,6495,1244,1036,8775
12/14/2017,2017,12,14, 8 ,7159,1342,1137,9638
12/14/2017,2017,12,14, 9 ,7869,1526,1326,10721
12/14/2017,2017,12,14, 10 ,8243,1614,1412,11269
12/14/2017,2017,12,14, 11 ,8556,1652,1447,11655
12/14/2017,2017,12,14, 12 ,8352,1595,1412,11359
12/14/2017,2017,12,14, 13 ,8335,1571,1398,11304
12/14/2017,2017,12,14, 14 ,8573,1610,1436,11619
12/14/2017,2017,12,14, 15 ,8509,1604,1444,11557
12/14/2017,2017,12,14, 16 ,8409,1612,1455,11476
12/14/2017,2017,12,14, 17 ,8181,1636,1474,11291
12/14/2017,2017,12,14, 18 ,8483,1745,1555,11783
12/14/2017,2017,12,14, 19 ,8252,1684,1500,11436
12/14/2017,2017,12,14, 20 ,8145,1616,1451,11212
12/14/2017,2017,12,14, 21 ,7836,1520,1325,10681
12/14/2017,2017,12,14, 22 ,7464,1395,1220,10079
12/14/2017,2017,12,14, 23 ,6914,1281,1119,9314
12/14/2017,2017,12,14, 24 ,6504,1215,1052,8771
12/15/2017,2017,12,15, 1 ,6191,1164,1003,8358
12/15/2017,2017,12,15, 2 ,6070,1124,969,8163
12/15/2017,2017,12,15, 3 ,5845,1093,936,7874
12/15/2017,2017,12,15, 4 ,5740,1087,942,7769
12/15/2017,2017,12,15, 5 ,5954,1131,971,8056
12/15/2017,2017,12,15, 6 ,6158,1181,1067,8406
12/15/2017,2017,12,15, 7 ,6154,1188,1026,8368
12/15/2017,2017,12,15, 8 ,6813,1272,1121,9206
12/15/2017,2017,12,15, 9 ,7538,1439,1248,10225
12/15/2017,2017,12,15, 10 ,8014,1495,1351,10860
12/15/2017,2017,12,15, 11 ,8210,1514,1429,11153
12/15/2017,2017,12,15, 12 ,8026,1457,1398,10881
12/15/2017,2017,12,15, 13 ,7904,1430,1391,10725
12/15/2017,2017,12,15, 14 ,8178,1461,1442,11081
12/15/2017,2017,12,15, 15 ,8116,1464,1460,11040
12/15/2017,2017,12,15, 16 ,7997,1464,1441,10902
12/15/2017,2017,12,15, 17 ,7750,1501,1457,10708
12/15/2017,2017,12,15, 18 ,8109,1602,1573,11284
12/15/2017,2017,12,15, 19 ,7888,1538,1542,10968
12/15/2017,2017,12,15, 20 ,7622,1445,1469,10536
12/15/2017,2017,12,15, 21 ,7425,1364,1410,10199
12/15/2017,2017,12,15, 22 ,7048,1261,1298,9607
12/15/2017,2017,12,15, 23 ,6551,1159,1162,8872
12/15/2017,2017,12,15, 24 ,6150,1080,1083,8313
12/16/2017,2017,12,16, 1 ,5827,1020,1010,7857
12/16/2017,2017,12,16, 2 ,5613,992,971,7576
12/16/2017,2017,12,16, 3 ,5451,971,947,7369
12/16/2017,2017,12,16, 4 ,5415,972,946,7333
12/16/2017,2017,12,16, 5 ,5404,990,963,7357
12/16/2017,2017,12,16, 6 ,5465,1027,1008,7500
12/16/2017,2017,12,16, 7 ,5636,1074,1019,7729
12/16/2017,2017,12,16, 8 ,6042,1145,1091,8278
12/16/2017,2017,12,16, 9 ,6647,1239,1213,9099
12/16/2017,2017,12,16, 10 ,7031,1293,1321,9645
12/16/2017,2017,12,16, 11 ,7209,1310,1362,9881
12/16/2017,2017,12,16, 12 ,7036,1273,1356,9665
12/16/2017,2017,12,16, 13 ,6884,1244,1362,9490
12/16/2017,2017,12,16, 14 ,7003,1255,1396,9654
12/16/2017,2017,12,16, 15 ,6912,1249,1386,9547
12/16/2017,2017,12,16, 16 ,6866,1252,1339,9457
12/16/2017,2017,12,16, 17 ,6903,1307,1350,9560
12/16/2017,2017,12,16, 18 ,7341,1439,1528,10308
12/16/2017,2017,12,16, 19 ,7248,1396,1484,10128
12/16/2017,2017,12,16, 20 ,7117,1345,1435,9897
12/16/2017,2017,12,16, 21 ,6888,1268,1365,9521
12/16/2017,2017,12,16, 22 ,6622,1194,1290,9106
12/16/2017,2017,12,16, 23 ,6251,1105,1159,8515
12/16/2017,2017,12,16, 24 ,5853,1016,1098,7967
12/17/2017,2017,12,17, 1 ,5554,965,1037,7556
12/17/2017,2017,12,17, 2 ,5415,946,992,7353
12/17/2017,2017,12,17, 3 ,5251,936,969,7156
12/17/2017,2017,12,17, 4 ,5215,935,962,7112
12/17/2017,2017,12,17, 5 ,5197,936,963,7096
12/17/2017,2017,12,17, 6 ,5247,955,968,7170
12/17/2017,2017,12,17, 7 ,5213,996,984,7193
12/17/2017,2017,12,17, 8 ,5504,1060,1032,7596
12/17/2017,2017,12,17, 9 ,5853,1148,1114,8115
12/17/2017,2017,12,17, 10 ,6148,1219,1223,8590
12/17/2017,2017,12,17, 11 ,6379,1261,1271,8911
12/17/2017,2017,12,17, 12 ,6261,1260,1269,8790
12/17/2017,2017,12,17, 13 ,6190,1264,1264,8718
12/17/2017,2017,12,17, 14 ,6128,1268,1302,8698
12/17/2017,2017,12,17, 15 ,6088,1267,1280,8635
12/17/2017,2017,12,17, 16 ,6073,1265,1265,8603
12/17/2017,2017,12,17, 17 ,6264,1321,1283,8868
12/17/2017,2017,12,17, 18 ,6937,1528,1500,9965
12/17/2017,2017,12,17, 19 ,6923,1505,1493,9921
12/17/2017,2017,12,17, 20 ,6864,1468,1457,9789
12/17/2017,2017,12,17, 21 ,6641,1391,1373,9405
12/17/2017,2017,12,17, 22 ,6401,1282,1258,8941
12/17/2017,2017,12,17, 23 ,6049,1202,1154,8405
12/17/2017,2017,12,17, 24 ,5667,1117,1079,7863
12/18/2017,2017,12,18, 1 ,5445,1070,1015,7530
12/18/2017,2017,12,18, 2 ,5257,1038,983,7278
12/18/2017,2017,12,18, 3 ,5176,1028,958,7162
12/18/2017,2017,12,18, 4 ,5149,1028,949,7126
12/18/2017,2017,12,18, 5 ,5364,1063,974,7401
12/18/2017,2017,12,18, 6 ,5632,1138,1047,7817
12/18/2017,2017,12,18, 7 ,5936,1149,1002,8087
12/18/2017,2017,12,18, 8 ,6542,1257,1132,8931
12/18/2017,2017,12,18, 9 ,7245,1476,1351,10072
12/18/2017,2017,12,18, 10 ,7678,1592,1506,10776
12/18/2017,2017,12,18, 11 ,7916,1655,1588,11159
12/18/2017,2017,12,18, 12 ,7704,1638,1556,10898
12/18/2017,2017,12,18, 13 ,7518,1635,1576,10729
12/18/2017,2017,12,18, 14 ,7687,1709,1640,11036
12/18/2017,2017,12,18, 15 ,7662,1702,1605,10969
12/18/2017,2017,12,18, 16 ,7691,1665,1601,10957
12/18/2017,2017,12,18, 17 ,7594,1604,1529,10727
12/18/2017,2017,12,18, 18 ,8009,1800,1670,11479
12/18/2017,2017,12,18, 19 ,7809,1752,1628,11189
12/18/2017,2017,12,18, 20 ,7585,1689,1603,10877
12/18/2017,2017,12,18, 21 ,7350,1621,1500,10471
12/18/2017,2017,12,18, 22 ,6992,1484,1343,9819
12/18/2017,2017,12,18, 23 ,6462,1340,1218,9020
12/18/2017,2017,12,18, 24 ,6117,1248,1106,8471
12/19/2017,2017,12,19, 1 ,5829,1191,1093,8113
12/19/2017,2017,12,19, 2 ,5613,1147,1066,7826
12/19/2017,2017,12,19, 3 ,5524,1127,1036,7687
12/19/2017,2017,12,19, 4 ,5525,1117,1037,7679
12/19/2017,2017,12,19, 5 ,5652,1141,1054,7847
12/19/2017,2017,12,19, 6 ,5994,1194,1104,8292
12/19/2017,2017,12,19, 7 ,6123,1181,1060,8364
12/19/2017,2017,12,19, 8 ,6762,1304,1188,9254
12/19/2017,2017,12,19, 9 ,7502,1531,1415,10448
12/19/2017,2017,12,19, 10 ,8002,1655,1545,11202
12/19/2017,2017,12,19, 11 ,8307,1709,1592,11608
12/19/2017,2017,12,19, 12 ,8071,1676,1560,11307
12/19/2017,2017,12,19, 13 ,8095,1699,1571,11365
12/19/2017,2017,12,19, 14 ,8251,1770,1622,11643
12/19/2017,2017,12,19, 15 ,8126,1726,1532,11384
12/19/2017,2017,12,19, 16 ,8011,1716,1502,11229
12/19/2017,2017,12,19, 17 ,7914,1669,1510,11093
12/19/2017,2017,12,19, 18 ,8253,1824,1626,11703
12/19/2017,2017,12,19, 19 ,8062,1784,1553,11399
12/19/2017,2017,12,19, 20 ,7894,1723,1456,11073
12/19/2017,2017,12,19, 21 ,7599,1664,1399,10662
12/19/2017,2017,12,19, 22 ,7233,1543,1288,10064
12/19/2017,2017,12,19, 23 ,6719,1415,1190,9324
12/19/2017,2017,12,19, 24 ,6315,1337,1110,8762
12/20/2017,2017,12,20, 1 ,5998,1276,1065,8339
12/20/2017,2017,12,20, 2 ,5854,1235,1033,8122
12/20/2017,2017,12,20, 3 ,5687,1214,1007,7908
12/20/2017,2017,12,20, 4 ,5675,1205,1005,7885
12/20/2017,2017,12,20, 5 ,5739,1220,1024,7983
12/20/2017,2017,12,20, 6 ,5999,1263,1080,8342
12/20/2017,2017,12,20, 7 ,6253,1252,1037,8542
12/20/2017,2017,12,20, 8 ,6799,1404,1145,9348
12/20/2017,2017,12,20, 9 ,7582,1604,1322,10508
12/20/2017,2017,12,20, 10 ,8121,1693,1492,11306
12/20/2017,2017,12,20, 11 ,8411,1765,1592,11768
12/20/2017,2017,12,20, 12 ,8283,1729,1555,11567
12/20/2017,2017,12,20, 13 ,8135,1737,1585,11457
12/20/2017,2017,12,20, 14 ,8387,1782,1651,11820
12/20/2017,2017,12,20, 15 ,8292,1786,1588,11666
12/20/2017,2017,12,20, 16 ,8256,1753,1552,11561
12/20/2017,2017,12,20, 17 ,7985,1691,1504,11180
12/20/2017,2017,12,20, 18 ,8328,1885,1618,11831
12/20/2017,2017,12,20, 19 ,8123,1841,1575,11539
12/20/2017,2017,12,20, 20 ,7930,1799,1530,11259
12/20/2017,2017,12,20, 21 ,7733,1710,1470,10913
12/20/2017,2017,12,20, 22 ,7337,1576,1348,10261
12/20/2017,2017,12,20, 23 ,6874,1431,1229,9534
12/20/2017,2017,12,20, 24 ,6462,1375,1147,8984
12/21/2017,2017,12,21, 1 ,6156,1306,1107,8569
12/21/2017,2017,12,21, 2 ,5947,1272,1064,8283
12/21/2017,2017,12,21, 3 ,5843,1245,1039,8127
12/21/2017,2017,12,21, 4 ,5738,1232,1023,7993
12/21/2017,2017,12,21, 5 ,5811,1238,1036,8085
12/21/2017,2017,12,21, 6 ,5959,1270,1093,8322
12/21/2017,2017,12,21, 7 ,6213,1252,1077,8542
12/21/2017,2017,12,21, 8 ,6788,1403,1181,9372
12/21/2017,2017,12,21, 9 ,7457,1581,1369,10407
12/21/2017,2017,12,21, 10 ,7863,1718,1484,11065
12/21/2017,2017,12,21, 11 ,8164,1774,1521,11459
12/21/2017,2017,12,21, 12 ,7999,1734,1489,11222
12/21/2017,2017,12,21, 13 ,7927,1743,1482,11152
12/21/2017,2017,12,21, 14 ,8171,1786,1513,11470
12/21/2017,2017,12,21, 15 ,8010,1766,1499,11275
12/21/2017,2017,12,21, 16 ,7992,1740,1463,11195
12/21/2017,2017,12,21, 17 ,7759,1691,1436,10886
12/21/2017,2017,12,21, 18 ,8160,1858,1561,11579
12/21/2017,2017,12,21, 19 ,7929,1798,1486,11213
12/21/2017,2017,12,21, 20 ,7772,1738,1437,10947
12/21/2017,2017,12,21, 21 ,7558,1645,1340,10543
12/21/2017,2017,12,21, 22 ,7164,1509,1203,9876
12/21/2017,2017,12,21, 23 ,6789,1382,1118,9289
12/21/2017,2017,12,21, 24 ,6305,1307,1025,8637
12/22/2017,2017,12,22, 1 ,5940,1256,992,8188
12/22/2017,2017,12,22, 2 ,5792,1219,943,7954
12/22/2017,2017,12,22, 3 ,5672,1197,921,7790
12/22/2017,2017,12,22, 4 ,5582,1170,896,7648
12/22/2017,2017,12,22, 5 ,5591,1190,907,7688
12/22/2017,2017,12,22, 6 ,5790,1246,943,7979
12/22/2017,2017,12,22, 7 ,6015,1274,937,8226
12/22/2017,2017,12,22, 8 ,6645,1356,1002,9003
12/22/2017,2017,12,22, 9 ,7424,1508,1137,10069
12/22/2017,2017,12,22, 10 ,7821,1563,1195,10579
12/22/2017,2017,12,22, 11 ,8142,1576,1216,10934
12/22/2017,2017,12,22, 12 ,7945,1559,1206,10710
12/22/2017,2017,12,22, 13 ,7828,1539,1197,10564
12/22/2017,2017,12,22, 14 ,8039,1595,1237,10871
12/22/2017,2017,12,22, 15 ,7983,1569,1216,10768
12/22/2017,2017,12,22, 16 ,7832,1586,1214,10632
12/22/2017,2017,12,22, 17 ,7595,1599,1211,10405
12/22/2017,2017,12,22, 18 ,7933,1759,1274,10966
12/22/2017,2017,12,22, 19 ,7861,1698,1241,10800
12/22/2017,2017,12,22, 20 ,7668,1634,1215,10517
12/22/2017,2017,12,22, 21 ,7471,1558,1205,10234
12/22/2017,2017,12,22, 22 ,7103,1437,1117,9657
12/22/2017,2017,12,22, 23 ,6708,1305,1000,9013
12/22/2017,2017,12,22, 24 ,6282,1229,936,8447
12/23/2017,2017,12,23, 1 ,5865,1176,878,7919
12/23/2017,2017,12,23, 2 ,5718,1146,856,7720
12/23/2017,2017,12,23, 3 ,5594,1125,836,7555
12/23/2017,2017,12,23, 4 ,5491,1120,832,7443
12/23/2017,2017,12,23, 5 ,5507,1131,841,7479
12/23/2017,2017,12,23, 6 ,5569,1172,890,7631
12/23/2017,2017,12,23, 7 ,5596,1200,918,7714
12/23/2017,2017,12,23, 8 ,5981,1282,983,8246
12/23/2017,2017,12,23, 9 ,6536,1423,1092,9051
12/23/2017,2017,12,23, 10 ,7050,1532,1201,9783
12/23/2017,2017,12,23, 11 ,7274,1586,1258,10118
12/23/2017,2017,12,23, 12 ,7076,1556,1260,9892
12/23/2017,2017,12,23, 13 ,7024,1536,1255,9815
12/23/2017,2017,12,23, 14 ,7079,1584,1281,9944
12/23/2017,2017,12,23, 15 ,6941,1547,1281,9769
12/23/2017,2017,12,23, 16 ,6884,1526,1254,9664
12/23/2017,2017,12,23, 17 ,6758,1521,1279,9558
12/23/2017,2017,12,23, 18 ,7289,1719,1392,10400
12/23/2017,2017,12,23, 19 ,7269,1704,1391,10364
12/23/2017,2017,12,23, 20 ,7239,1666,1359,10264
12/23/2017,2017,12,23, 21 ,7165,1597,1322,10084
12/23/2017,2017,12,23, 22 ,6800,1505,1224,9529
12/23/2017,2017,12,23, 23 ,6477,1398,1117,8992
12/23/2017,2017,12,23, 24 ,6059,1298,955,8312
12/24/2017,2017,12,24, 1 ,5737,1220,989,7946
12/24/2017,2017,12,24, 2 ,5518,1189,956,7663
12/24/2017,2017,12,24, 3 ,5346,1162,937,7445
12/24/2017,2017,12,24, 4 ,5274,1132,923,7329
12/24/2017,2017,12,24, 5 ,5193,1124,909,7226
12/24/2017,2017,12,24, 6 ,5239,1127,901,7267
12/24/2017,2017,12,24, 7 ,5151,1126,934,7211
12/24/2017,2017,12,24, 8 ,5389,1194,988,7571
12/24/2017,2017,12,24, 9 ,5901,1270,1072,8243
12/24/2017,2017,12,24, 10 ,6284,1367,1138,8789
12/24/2017,2017,12,24, 11 ,6426,1428,1147,9001
12/24/2017,2017,12,24, 12 ,6392,1433,1198,9023
12/24/2017,2017,12,24, 13 ,6435,1434,1205,9074
12/24/2017,2017,12,24, 14 ,6510,1432,1222,9164
12/24/2017,2017,12,24, 15 ,6470,1430,1209,9109
12/24/2017,2017,12,24, 16 ,6344,1414,1179,8937
12/24/2017,2017,12,24, 17 ,6293,1435,1220,8948
12/24/2017,2017,12,24, 18 ,6932,1649,1374,9955
12/24/2017,2017,12,24, 19 ,6903,1631,1343,9877
12/24/2017,2017,12,24, 20 ,6551,1542,1274,9367
12/24/2017,2017,12,24, 21 ,6294,1472,1217,8983
12/24/2017,2017,12,24, 22 ,6104,1415,1169,8688
12/24/2017,2017,12,24, 23 ,5963,1351,1123,8437
12/24/2017,2017,12,24, 24 ,5759,1315,1087,8161
12/25/2017,2017,12,25, 1 ,5555,1259,1037,7851
12/25/2017,2017,12,25, 2 ,5368,1198,986,7552
12/25/2017,2017,12,25, 3 ,5181,1167,939,7287
12/25/2017,2017,12,25, 4 ,5026,1130,908,7064
12/25/2017,2017,12,25, 5 ,4952,1113,897,6962
12/25/2017,2017,12,25, 6 ,4899,1090,888,6877
12/25/2017,2017,12,25, 7 ,4783,1089,886,6758
12/25/2017,2017,12,25, 8 ,4868,1121,928,6917
12/25/2017,2017,12,25, 9 ,5079,1191,978,7248
12/25/2017,2017,12,25, 10 ,5403,1263,1057,7723
12/25/2017,2017,12,25, 11 ,5630,1334,1076,8040
12/25/2017,2017,12,25, 12 ,5794,1344,1139,8277
12/25/2017,2017,12,25, 13 ,5800,1354,1155,8309
12/25/2017,2017,12,25, 14 ,5845,1374,1176,8395
12/25/2017,2017,12,25, 15 ,5847,1370,1185,8402
12/25/2017,2017,12,25, 16 ,5769,1359,1160,8288
12/25/2017,2017,12,25, 17 ,5716,1353,1161,8230
12/25/2017,2017,12,25, 18 ,6324,1593,1353,9270
12/25/2017,2017,12,25, 19 ,6492,1610,1374,9476
12/25/2017,2017,12,25, 20 ,6472,1569,1337,9378
12/25/2017,2017,12,25, 21 ,6397,1513,1281,9191
12/25/2017,2017,12,25, 22 ,6255,1417,1170,8842
12/25/2017,2017,12,25, 23 ,5925,1317,1091,8333
12/25/2017,2017,12,25, 24 ,5639,1254,1063,7956
12/26/2017,2017,12,26, 1 ,5407,1204,986,7597
12/26/2017,2017,12,26, 2 ,5248,1166,939,7353
12/26/2017,2017,12,26, 3 ,5089,1137,913,7139
12/26/2017,2017,12,26, 4 ,4979,1120,901,7000
12/26/2017,2017,12,26, 5 ,4998,1119,910,7027
12/26/2017,2017,12,26, 6 ,5196,1141,951,7288
12/26/2017,2017,12,26, 7 ,5375,1143,944,7462
12/26/2017,2017,12,26, 8 ,5897,1260,1057,8214
12/26/2017,2017,12,26, 9 ,6532,1450,1225,9207
12/26/2017,2017,12,26, 10 ,6984,1565,1355,9904
12/26/2017,2017,12,26, 11 ,7338,1615,1425,10378
12/26/2017,2017,12,26, 12 ,7295,1593,1402,10290
12/26/2017,2017,12,26, 13 ,7263,1600,1401,10264
12/26/2017,2017,12,26, 14 ,7400,1642,1430,10472
12/26/2017,2017,12,26, 15 ,7353,1653,1417,10423
12/26/2017,2017,12,26, 16 ,7248,1624,1401,10273
12/26/2017,2017,12,26, 17 ,7155,1592,1376,10123
12/26/2017,2017,12,26, 18 ,7618,1796,1549,10963
12/26/2017,2017,12,26, 19 ,7603,1786,1522,10911
12/26/2017,2017,12,26, 20 ,7445,1737,1482,10664
12/26/2017,2017,12,26, 21 ,7286,1657,1427,10370
12/26/2017,2017,12,26, 22 ,7079,1543,1311,9933
12/26/2017,2017,12,26, 23 ,6646,1427,1202,9275
12/26/2017,2017,12,26, 24 ,6307,1352,1126,8785
12/27/2017,2017,12,27, 1 ,5963,1301,1069,8333
12/27/2017,2017,12,27, 2 ,5852,1259,1026,8137
12/27/2017,2017,12,27, 3 ,5677,1216,1015,7908
12/27/2017,2017,12,27, 4 ,5622,1194,989,7805
12/27/2017,2017,12,27, 5 ,5633,1200,999,7832
12/27/2017,2017,12,27, 6 ,5746,1224,1027,7997
12/27/2017,2017,12,27, 7 ,5996,1221,1041,8258
12/27/2017,2017,12,27, 8 ,6509,1350,1147,9006
12/27/2017,2017,12,27, 9 ,7232,1571,1298,10101
12/27/2017,2017,12,27, 10 ,7607,1669,1395,10671
12/27/2017,2017,12,27, 11 ,7860,1754,1462,11076
12/27/2017,2017,12,27, 12 ,7659,1712,1446,10817
12/27/2017,2017,12,27, 13 ,7518,1705,1457,10680
12/27/2017,2017,12,27, 14 ,7643,1762,1456,10861
12/27/2017,2017,12,27, 15 ,7580,1757,1475,10812
12/27/2017,2017,12,27, 16 ,7532,1716,1476,10724
12/27/2017,2017,12,27, 17 ,7425,1676,1467,10568
12/27/2017,2017,12,27, 18 ,7814,1851,1564,11229
12/27/2017,2017,12,27, 19 ,7747,1801,1513,11061
12/27/2017,2017,12,27, 20 ,7610,1737,1461,10808
12/27/2017,2017,12,27, 21 ,7565,1652,1396,10613
12/27/2017,2017,12,27, 22 ,7183,1531,1270,9984
12/27/2017,2017,12,27, 23 ,6801,1421,1172,9394
12/27/2017,2017,12,27, 24 ,6379,1347,1103,8829
12/28/2017,2017,12,28, 1 ,5907,1286,1054,8247
12/28/2017,2017,12,28, 2 ,5864,1246,1009,8119
12/28/2017,2017,12,28, 3 ,5745,1219,986,7950
12/28/2017,2017,12,28, 4 ,5670,1204,968,7842
12/28/2017,2017,12,28, 5 ,5654,1213,971,7838
12/28/2017,2017,12,28, 6 ,5790,1216,1011,8017
12/28/2017,2017,12,28, 7 ,5895,1237,1007,8139
12/28/2017,2017,12,28, 8 ,6432,1345,1094,8871
12/28/2017,2017,12,28, 9 ,7185,1541,1345,10071
12/28/2017,2017,12,28, 10 ,7667,1656,1466,10789
12/28/2017,2017,12,28, 11 ,7953,1700,1523,11176
12/28/2017,2017,12,28, 12 ,7743,1673,1497,10913
12/28/2017,2017,12,28, 13 ,7786,1610,1503,10899
12/28/2017,2017,12,28, 14 ,7966,1678,1551,11195
12/28/2017,2017,12,28, 15 ,7873,1669,1536,11078
12/28/2017,2017,12,28, 16 ,7705,1634,1519,10858
12/28/2017,2017,12,28, 17 ,7428,1635,1479,10542
12/28/2017,2017,12,28, 18 ,7814,1774,1611,11199
12/28/2017,2017,12,28, 19 ,7779,1740,1557,11076
12/28/2017,2017,12,28, 20 ,7586,1683,1486,10755
12/28/2017,2017,12,28, 21 ,7339,1572,1431,10342
12/28/2017,2017,12,28, 22 ,7044,1455,1308,9807
12/28/2017,2017,12,28, 23 ,6631,1363,1193,9187
12/28/2017,2017,12,28, 24 ,6219,1285,1112,8616
12/29/2017,2017,12,29, 1 ,5977,1231,1062,8270
12/29/2017,2017,12,29, 2 ,5722,1196,1017,7935
12/29/2017,2017,12,29, 3 ,5658,1170,997,7825
12/29/2017,2017,12,29, 4 ,5470,1147,950,7567
12/29/2017,2017,12,29, 5 ,5471,1162,981,7614
12/29/2017,2017,12,29, 6 ,5579,1177,1000,7756
12/29/2017,2017,12,29, 7 ,5736,1200,1019,7955
12/29/2017,2017,12,29, 8 ,6277,1298,1139,8714
12/29/2017,2017,12,29, 9 ,7004,1507,1322,9833
12/29/2017,2017,12,29, 10 ,7435,1594,1435,10464
12/29/2017,2017,12,29, 11 ,7759,1655,1510,10924
12/29/2017,2017,12,29, 12 ,7529,1637,1481,10647
12/29/2017,2017,12,29, 13 ,7472,1635,1490,10597
12/29/2017,2017,12,29, 14 ,7550,1686,1527,10763
12/29/2017,2017,12,29, 15 ,7472,1674,1515,10661
12/29/2017,2017,12,29, 16 ,7198,1638,1481,10317
12/29/2017,2017,12,29, 17 ,7020,1565,1409,9994
12/29/2017,2017,12,29, 18 ,7348,1741,1549,10638
12/29/2017,2017,12,29, 19 ,7347,1712,1522,10581
12/29/2017,2017,12,29, 20 ,7229,1650,1477,10356
12/29/2017,2017,12,29, 21 ,6932,1569,1418,9919
12/29/2017,2017,12,29, 22 ,6582,1461,1286,9329
12/29/2017,2017,12,29, 23 ,6158,1351,1181,8690
12/29/2017,2017,12,29, 24 ,5739,1268,1087,8094
12/30/2017,2017,12,30, 1 ,5490,1208,1037,7735
12/30/2017,2017,12,30, 2 ,5249,1163,990,7402
12/30/2017,2017,12,30, 3 ,5196,1136,955,7287
12/30/2017,2017,12,30, 4 ,6130,1118,942,8190
12/30/2017,2017,12,30, 5 ,5068,1121,944,7133
12/30/2017,2017,12,30, 6 ,5080,1134,935,7149
12/30/2017,2017,12,30, 7 ,5011,1135,979,7125
12/30/2017,2017,12,30, 8 ,5280,1184,997,7461
12/30/2017,2017,12,30, 9 ,5692,1275,1170,8137
12/30/2017,2017,12,30, 10 ,6135,1342,1253,8730
12/30/2017,2017,12,30, 11 ,6395,1371,1311,9077
12/30/2017,2017,12,30, 12 ,6302,1350,1314,8966
12/30/2017,2017,12,30, 13 ,6303,1355,1334,8992
12/30/2017,2017,12,30, 14 ,6282,1376,1355,9013
12/30/2017,2017,12,30, 15 ,6226,1346,1354,8926
12/30/2017,2017,12,30, 16 ,6110,1343,1322,8775
12/30/2017,2017,12,30, 17 ,6069,1353,1299,8721
12/30/2017,2017,12,30, 18 ,6590,1544,1474,9608
12/30/2017,2017,12,30, 19 ,6702,1550,1487,9739
12/30/2017,2017,12,30, 20 ,6528,1498,1445,9471
12/30/2017,2017,12,30, 21 ,5866,1446,1401,8713
12/30/2017,2017,12,30, 22 ,6053,1359,1297,8709
12/30/2017,2017,12,30, 23 ,5695,1254,1212,8161
12/30/2017,2017,12,30, 24 ,5269,1182,1125,7576
12/31/2017,2017,12,31, 1 ,5013,1113,1033,7159
12/31/2017,2017,12,31, 2 ,4813,1079,1010,6902
12/31/2017,2017,12,31, 3 ,4702,1059,981,6742
12/31/2017,2017,12,31, 4 ,4587,1037,959,6583
12/31/2017,2017,12,31, 5 ,4618,1057,953,6628
12/31/2017,2017,12,31, 6 ,4599,1070,948,6617
12/31/2017,2017,12,31, 7 ,4667,1089,971,6727
12/31/2017,2017,12,31, 8 ,4889,1138,1023,7050
12/31/2017,2017,12,31, 9 ,5309,1258,1108,7675
12/31/2017,2017,12,31, 10 ,5672,1301,1160,8133
12/31/2017,2017,12,31, 11 ,5940,1347,1221,8508
12/31/2017,2017,12,31, 12 ,5888,1343,1243,8474
12/31/2017,2017,12,31, 13 ,5835,1342,1262,8439
12/31/2017,2017,12,31, 14 ,5864,1311,1249,8424
12/31/2017,2017,12,31, 15 ,5784,1324,1246,8354
12/31/2017,2017,12,31, 16 ,5700,1323,1228,8251
12/31/2017,2017,12,31, 17 ,5700,1355,1251,8306
12/31/2017,2017,12,31, 18 ,6233,1558,1403,9194
12/31/2017,2017,12,31, 19 ,6243,1558,1395,9196
12/31/2017,2017,12,31, 20 ,5896,1470,1330,8696
12/31/2017,2017,12,31, 21 ,5700,1408,1275,8383
12/31/2017,2017,12,31, 22 ,5497,1371,1246,8114
12/31/2017,2017,12,31, 23 ,5337,1334,1215,7886
12/31/2017,2017,12,31, 24 ,5196,1350,1097,7643
1/1/2018,2018,1,1, 1 ,5067,1272,1159,7498
1/1/2018,2018,1,1, 2 ,4766,1150,1064,6980
1/1/2018,2018,1,1, 3 ,4531,1080,1007,6618
1/1/2018,2018,1,1, 4 ,4378,1040,964,6382
1/1/2018,2018,1,1, 5 ,4335,1000,932,6267
1/1/2018,2018,1,1, 6 ,4238,968,900,6106
1/1/2018,2018,1,1, 7 ,4117,953,882,5952
1/1/2018,2018,1,1, 8 ,4224,972,900,6096
1/1/2018,2018,1,1, 9 ,4385,997,902,6284
1/1/2018,2018,1,1, 10 ,4561,1019,934,6514
1/1/2018,2018,1,1, 11 ,4790,1068,981,6839
1/1/2018,2018,1,1, 12 ,5044,1126,1004,7174
1/1/2018,2018,1,1, 13 ,5043,1138,1007,7188
1/1/2018,2018,1,1, 14 ,5066,1134,1022,7222
1/1/2018,2018,1,1, 15 ,5053,1129,1037,7219
1/1/2018,2018,1,1, 16 ,5009,1139,1020,7168
1/1/2018,2018,1,1, 17 ,5036,1196,1065,7297
1/1/2018,2018,1,1, 18 ,5736,1366,1216,8318
1/1/2018,2018,1,1, 19 ,5889,1356,1230,8475
1/1/2018,2018,1,1, 20 ,5827,1291,1197,8315
1/1/2018,2018,1,1, 21 ,5740,1212,1138,8090
1/1/2018,2018,1,1, 22 ,5489,1126,1047,7662
1/1/2018,2018,1,1, 23 ,5203,1052,973,7228
1/1/2018,2018,1,1, 24 ,4973,995,909,6877
1/2/2018,2018,1,2, 1 ,4809,959,881,6649
1/2/2018,2018,1,2, 2 ,4594,933,848,6375
1/2/2018,2018,1,2, 3 ,4492,908,831,6231
1/2/2018,2018,1,2, 4 ,4442,890,815,6147
1/2/2018,2018,1,2, 5 ,4493,892,829,6214
1/2/2018,2018,1,2, 6 ,4738,934,865,6537
1/2/2018,2018,1,2, 7 ,4992,993,899,6884
1/2/2018,2018,1,2, 8 ,5506,1069,953,7528
1/2/2018,2018,1,2, 9 ,6122,1214,1119,8455
1/2/2018,2018,1,2, 10 ,6503,1299,1248,9050
1/2/2018,2018,1,2, 11 ,6841,1346,1320,9507
1/2/2018,2018,1,2, 12 ,6802,1342,1336,9480
1/2/2018,2018,1,2, 13 ,6674,1340,1336,9350
1/2/2018,2018,1,2, 14 ,6759,1360,1385,9504
1/2/2018,2018,1,2, 15 ,6641,1364,1371,9376
1/2/2018,2018,1,2, 16 ,6649,1371,1350,9370
1/2/2018,2018,1,2, 17 ,6626,1385,1319,9330
1/2/2018,2018,1,2, 18 ,7048,1598,1469,10115
1/2/2018,2018,1,2, 19 ,7070,1571,1425,10066
1/2/2018,2018,1,2, 20 ,6907,1506,1389,9802
1/2/2018,2018,1,2, 21 ,6710,1409,1328,9447
1/2/2018,2018,1,2, 22 ,6370,1296,1220,8886
1/2/2018,2018,1,2, 23 ,5972,1206,1124,8302
1/2/2018,2018,1,2, 24 ,5663,1143,1046,7852
1/3/2018,2018,1,3, 1 ,5403,1101,1002,7506
1/3/2018,2018,1,3, 2 ,5304,1067,970,7341
1/3/2018,2018,1,3, 3 ,5143,1049,943,7135
1/3/2018,2018,1,3, 4 ,5138,1039,924,7101
1/3/2018,2018,1,3, 5 ,5285,1078,959,7322
1/3/2018,2018,1,3, 6 ,5570,1143,1018,7731
1/3/2018,2018,1,3, 7 ,5847,1136,989,7972
1/3/2018,2018,1,3, 8 ,6408,1265,1132,8805
1/3/2018,2018,1,3, 9 ,7183,1487,1357,10027
1/3/2018,2018,1,3, 10 ,7665,1594,1484,10743
1/3/2018,2018,1,3, 11 ,8023,1669,1568,11260
1/3/2018,2018,1,3, 12 ,7824,1629,1550,11003
1/3/2018,2018,1,3, 13 ,7680,1648,1555,10883
1/3/2018,2018,1,3, 14 ,7914,1712,1615,11241
1/3/2018,2018,1,3, 15 ,7807,1696,1589,11092
1/3/2018,2018,1,3, 16 ,7765,1676,1572,11013
1/3/2018,2018,1,3, 17 ,7503,1624,1486,10613
1/3/2018,2018,1,3, 18 ,7778,1771,1596,11145
1/3/2018,2018,1,3, 19 ,7661,1733,1547,10941
1/3/2018,2018,1,3, 20 ,7491,1659,1505,10655
1/3/2018,2018,1,3, 21 ,7491,1560,1418,10469
1/3/2018,2018,1,3, 22 ,6815,1430,1180,9425
1/3/2018,2018,1,3, 23 ,6383,1316,1084,8783
1/3/2018,2018,1,3, 24 ,6124,1236,1014,8374
1/4/2018,2018,1,4, 1 ,5972,1190,1066,8228
1/4/2018,2018,1,4, 2 ,5776,1154,1038,7968
1/4/2018,2018,1,4, 3 ,5551,1122,1003,7676
1/4/2018,2018,1,4, 4 ,5504,1105,1003,7612
1/4/2018,2018,1,4, 5 ,5688,1144,1044,7876
1/4/2018,2018,1,4, 6 ,5969,1198,1089,8256
1/4/2018,2018,1,4, 7 ,6087,1180,985,8252
1/4/2018,2018,1,4, 8 ,6779,1306,1055,9140
1/4/2018,2018,1,4, 9 ,7588,1553,1247,10388
1/4/2018,2018,1,4, 10 ,8041,1659,1419,11119
1/4/2018,2018,1,4, 11 ,8417,1722,1480,11619
1/4/2018,2018,1,4, 12 ,8237,1693,1437,11367
1/4/2018,2018,1,4, 13 ,8261,1691,1459,11411
1/4/2018,2018,1,4, 14 ,8452,1755,1518,11725
1/4/2018,2018,1,4, 15 ,8395,1738,1515,11648
1/4/2018,2018,1,4, 16 ,8338,1717,1500,11555
1/4/2018,2018,1,4, 17 ,8011,1644,1461,11116
1/4/2018,2018,1,4, 18 ,8295,1758,1562,11615
1/4/2018,2018,1,4, 19 ,8205,1761,1535,11501
1/4/2018,2018,1,4, 20 ,8009,1690,1461,11160
1/4/2018,2018,1,4, 21 ,7751,1600,1410,10761
1/4/2018,2018,1,4, 22 ,7252,1466,1303,10021
1/4/2018,2018,1,4, 23 ,6802,1359,1219,9380
1/4/2018,2018,1,4, 24 ,6438,1281,1110,8829
1/5/2018,2018,1,5, 1 ,6166,1211,1063,8440
1/5/2018,2018,1,5, 2 ,6014,1195,1008,8217
1/5/2018,2018,1,5, 3 ,5869,1174,985,8028
1/5/2018,2018,1,5, 4 ,5872,1161,963,7996
1/5/2018,2018,1,5, 5 ,6038,1191,996,8225
1/5/2018,2018,1,5, 6 ,6176,1236,1055,8467
1/5/2018,2018,1,5, 7 ,6337,1212,1013,8562
1/5/2018,2018,1,5, 8 ,7025,1346,1136,9507
1/5/2018,2018,1,5, 9 ,7824,1571,1322,10717
1/5/2018,2018,1,5, 10 ,8416,1666,1481,11563
1/5/2018,2018,1,5, 11 ,8719,1724,1537,11980
1/5/2018,2018,1,5, 12 ,8512,1662,1462,11636
1/5/2018,2018,1,5, 13 ,8519,1669,1483,11671
1/5/2018,2018,1,5, 14 ,8822,1739,1543,12104
1/5/2018,2018,1,5, 15 ,8731,1726,1504,11961
1/5/2018,2018,1,5, 16 ,8529,1687,1464,11680
1/5/2018,2018,1,5, 17 ,8218,1665,1349,11232
1/5/2018,2018,1,5, 18 ,8447,1798,1477,11722
1/5/2018,2018,1,5, 19 ,8379,1749,1530,11658
1/5/2018,2018,1,5, 20 ,8227,1675,1478,11380
1/5/2018,2018,1,5, 21 ,7980,1588,1395,10963
1/5/2018,2018,1,5, 22 ,7654,1468,1249,10371
1/5/2018,2018,1,5, 23 ,7164,1352,1166,9682
1/5/2018,2018,1,5, 24 ,6788,1279,1083,9150
1/6/2018,2018,1,6, 1 ,6530,1234,1040,8804
1/6/2018,2018,1,6, 2 ,6329,1187,1018,8534
1/6/2018,2018,1,6, 3 ,6153,1161,975,8289
1/6/2018,2018,1,6, 4 ,6086,1149,973,8208
1/6/2018,2018,1,6, 5 ,6069,1157,990,8216
1/6/2018,2018,1,6, 6 ,6041,1186,1017,8244
1/6/2018,2018,1,6, 7 ,6145,1211,1023,8379
1/6/2018,2018,1,6, 8 ,6675,1301,1096,9072
1/6/2018,2018,1,6, 9 ,7387,1474,1239,10100
1/6/2018,2018,1,6, 10 ,7949,1588,1353,10890
1/6/2018,2018,1,6, 11 ,8252,1639,1412,11303
1/6/2018,2018,1,6, 12 ,7983,1607,1363,10953
1/6/2018,2018,1,6, 13 ,7967,1606,1367,10940
1/6/2018,2018,1,6, 14 ,8188,1653,1416,11257
1/6/2018,2018,1,6, 15 ,8121,1630,1404,11155
1/6/2018,2018,1,6, 16 ,7941,1596,1396,10933
1/6/2018,2018,1,6, 17 ,7622,1561,1382,10565
1/6/2018,2018,1,6, 18 ,8038,1720,1527,11285
1/6/2018,2018,1,6, 19 ,8044,1724,1499,11267
1/6/2018,2018,1,6, 20 ,8001,1658,1445,11104
1/6/2018,2018,1,6, 21 ,7778,1592,1373,10743
1/6/2018,2018,1,6, 22 ,7455,1481,1268,10204
1/6/2018,2018,1,6, 23 ,7052,1373,1165,9590
1/6/2018,2018,1,6, 24 ,6682,1297,1092,9071
1/7/2018,2018,1,7, 1 ,6340,1249,1041,8630
1/7/2018,2018,1,7, 2 ,6181,1204,1003,8388
1/7/2018,2018,1,7, 3 ,5964,1171,977,8112
1/7/2018,2018,1,7, 4 ,5843,1147,957,7947
1/7/2018,2018,1,7, 5 ,5808,1148,959,7915
1/7/2018,2018,1,7, 6 ,5782,1154,980,7916
1/7/2018,2018,1,7, 7 ,5692,1153,965,7810
1/7/2018,2018,1,7, 8 ,5974,1212,1006,8192
1/7/2018,2018,1,7, 9 ,6407,1296,1086,8789
1/7/2018,2018,1,7, 10 ,6887,1383,1180,9450
1/7/2018,2018,1,7, 11 ,7212,1447,1234,9893
1/7/2018,2018,1,7, 12 ,7119,1453,1251,9823
1/7/2018,2018,1,7, 13 ,7179,1450,1262,9891
1/7/2018,2018,1,7, 14 ,7255,1425,1291,9971
1/7/2018,2018,1,7, 15 ,7181,1392,1266,9839
1/7/2018,2018,1,7, 16 ,7086,1377,1245,9708
1/7/2018,2018,1,7, 17 ,6984,1394,1235,9613
1/7/2018,2018,1,7, 18 ,7598,1609,1428,10635
1/7/2018,2018,1,7, 19 ,7716,1628,1439,10783
1/7/2018,2018,1,7, 20 ,7697,1581,1403,10681
1/7/2018,2018,1,7, 21 ,7480,1499,1347,10326
1/7/2018,2018,1,7, 22 ,7244,1387,1126,9757
1/7/2018,2018,1,7, 23 ,6822,1296,1051,9169
1/7/2018,2018,1,7, 24 ,6451,1214,984,8649
1/8/2018,2018,1,8, 1 ,6114,1163,1012,8289
1/8/2018,2018,1,8, 2 ,5857,1128,977,7962
1/8/2018,2018,1,8, 3 ,5773,1094,945,7812
1/8/2018,2018,1,8, 4 ,5703,1087,940,7730
1/8/2018,2018,1,8, 5 ,5879,1136,996,8011
1/8/2018,2018,1,8, 6 ,6163,1206,1002,8371
1/8/2018,2018,1,8, 7 ,6297,1168,1021,8486
1/8/2018,2018,1,8, 8 ,7001,1304,1099,9404
1/8/2018,2018,1,8, 9 ,8016,1547,1315,10878
1/8/2018,2018,1,8, 10 ,8592,1655,1426,11673
1/8/2018,2018,1,8, 11 ,8924,1693,1468,12085
1/8/2018,2018,1,8, 12 ,8784,1695,1463,11942
1/8/2018,2018,1,8, 13 ,8773,1709,1476,11958
1/8/2018,2018,1,8, 14 ,9125,1763,1540,12428
1/8/2018,2018,1,8, 15 ,9101,1751,1511,12363
1/8/2018,2018,1,8, 16 ,8904,1732,1497,12133
1/8/2018,2018,1,8, 17 ,8530,1666,1468,11664
1/8/2018,2018,1,8, 18 ,8769,1815,1555,12139
1/8/2018,2018,1,8, 19 ,8671,1781,1510,11962
1/8/2018,2018,1,8, 20 ,8534,1712,1457,11703
1/8/2018,2018,1,8, 21 ,8320,1644,1387,11351
1/8/2018,2018,1,8, 22 ,7876,1504,1237,10617
1/8/2018,2018,1,8, 23 ,7357,1393,1145,9895
1/8/2018,2018,1,8, 24 ,7001,1323,1065,9389
1/9/2018,2018,1,9, 1 ,6697,1243,1022,8962
1/9/2018,2018,1,9, 2 ,6406,1202,993,8601
1/9/2018,2018,1,9, 3 ,6236,1172,966,8374
1/9/2018,2018,1,9, 4 ,6198,1158,957,8313
1/9/2018,2018,1,9, 5 ,6328,1210,995,8533
1/9/2018,2018,1,9, 6 ,6522,1218,1093,8833
1/9/2018,2018,1,9, 7 ,6632,1230,1012,8874
1/9/2018,2018,1,9, 8 ,7202,1359,1116,9677
1/9/2018,2018,1,9, 9 ,8120,1581,1324,11025
1/9/2018,2018,1,9, 10 ,8672,1695,1430,11797
1/9/2018,2018,1,9, 11 ,8952,1761,1472,12185
1/9/2018,2018,1,9, 12 ,8796,1735,1444,11975
1/9/2018,2018,1,9, 13 ,8713,1743,1428,11884
1/9/2018,2018,1,9, 14 ,9083,1794,1474,12351
1/9/2018,2018,1,9, 15 ,9043,1772,1458,12273
1/9/2018,2018,1,9, 16 ,8917,1745,1440,12102
1/9/2018,2018,1,9, 17 ,8783,1689,1430,11902
1/9/2018,2018,1,9, 18 ,8600,1840,1527,11967
1/9/2018,2018,1,9, 19 ,8586,1795,1464,11845
1/9/2018,2018,1,9, 20 ,8489,1726,1400,11615
1/9/2018,2018,1,9, 21 ,8285,1645,1340,11270
1/9/2018,2018,1,9, 22 ,7866,1515,1189,10570
1/9/2018,2018,1,9, 23 ,7480,1385,1099,9964
1/9/2018,2018,1,9, 24 ,7045,1313,1069,9427
1/10/2018,2018,1,10, 1 ,6707,1279,982,8968
1/10/2018,2018,1,10, 2 ,6538,1222,961,8721
1/10/2018,2018,1,10, 3 ,6366,1188,936,8490
1/10/2018,2018,1,10, 4 ,6228,1181,928,8337
1/10/2018,2018,1,10, 5 ,6416,1223,976,8615
1/10/2018,2018,1,10, 6 ,6574,1289,1080,8943
1/10/2018,2018,1,10, 7 ,6564,1266,1009,8839
1/10/2018,2018,1,10, 8 ,7275,1349,1071,9695
1/10/2018,2018,1,10, 9 ,8091,1555,1279,10925
1/10/2018,2018,1,10, 10 ,8517,1657,1406,11580
1/10/2018,2018,1,10, 11 ,8962,1714,1480,12156
1/10/2018,2018,1,10, 12 ,8695,1667,1470,11832
1/10/2018,2018,1,10, 13 ,8660,1651,1455,11766
1/10/2018,2018,1,10, 14 ,9051,1711,1535,12297
1/10/2018,2018,1,10, 15 ,8996,1704,1539,12239
1/10/2018,2018,1,10, 16 ,8882,1679,1507,12068
1/10/2018,2018,1,10, 17 ,8494,1598,1457,11549
1/10/2018,2018,1,10, 18 ,8606,1752,1574,11932
1/10/2018,2018,1,10, 19 ,8592,1719,1565,11876
1/10/2018,2018,1,10, 20 ,8402,1647,1477,11526
1/10/2018,2018,1,10, 21 ,8170,1624,1416,11210
1/10/2018,2018,1,10, 22 ,7780,1465,1279,10524
1/10/2018,2018,1,10, 23 ,7331,1362,1181,9874
1/10/2018,2018,1,10, 24 ,6800,1296,1098,9194
1/11/2018,2018,1,11, 1 ,6614,1229,1051,8894
1/11/2018,2018,1,11, 2 ,6464,1199,1008,8671
1/11/2018,2018,1,11, 3 ,6216,1170,988,8374
1/11/2018,2018,1,11, 4 ,6165,1151,976,8292
1/11/2018,2018,1,11, 5 ,6273,1198,1016,8487
1/11/2018,2018,1,11, 6 ,6480,1261,1099,8840
1/11/2018,2018,1,11, 7 ,6538,1212,1026,8776
1/11/2018,2018,1,11, 8 ,7140,1339,1141,9620
1/11/2018,2018,1,11, 9 ,7950,1569,1335,10854
1/11/2018,2018,1,11, 10 ,8388,1695,1480,11563
1/11/2018,2018,1,11, 11 ,8728,1735,1554,12017
1/11/2018,2018,1,11, 12 ,8419,1699,1544,11662
1/11/2018,2018,1,11, 13 ,8306,1694,1561,11561
1/11/2018,2018,1,11, 14 ,8621,1765,1630,12016
1/11/2018,2018,1,11, 15 ,8512,1765,1612,11889
1/11/2018,2018,1,11, 16 ,8352,1725,1580,11657
1/11/2018,2018,1,11, 17 ,8041,1652,1498,11191
1/11/2018,2018,1,11, 18 ,8278,1789,1614,11681
1/11/2018,2018,1,11, 19 ,8202,1774,1590,11566
1/11/2018,2018,1,11, 20 ,7984,1703,1542,11229
1/11/2018,2018,1,11, 21 ,7699,1606,1468,10773
1/11/2018,2018,1,11, 22 ,7286,1457,1316,10059
1/11/2018,2018,1,11, 23 ,6859,1346,1217,9422
1/11/2018,2018,1,11, 24 ,6540,1271,1143,8954
1/12/2018,2018,1,12, 1 ,6220,1217,1086,8523
1/12/2018,2018,1,12, 2 ,6074,1175,1043,8292
1/12/2018,2018,1,12, 3 ,5907,1147,1010,8064
1/12/2018,2018,1,12, 4 ,5871,1127,1010,8008
1/12/2018,2018,1,12, 5 ,6006,1173,1051,8230
1/12/2018,2018,1,12, 6 ,6257,1234,1108,8599
1/12/2018,2018,1,12, 7 ,6325,1202,1034,8561
1/12/2018,2018,1,12, 8 ,6934,1337,1156,9427
1/12/2018,2018,1,12, 9 ,7648,1575,1380,10603
1/12/2018,2018,1,12, 10 ,8043,1674,1520,11237
1/12/2018,2018,1,12, 11 ,8282,1735,1601,11618
1/12/2018,2018,1,12, 12 ,8031,1670,1559,11260
1/12/2018,2018,1,12, 13 ,7945,1666,1572,11183
1/12/2018,2018,1,12, 14 ,8215,1731,1592,11538
1/12/2018,2018,1,12, 15 ,8072,1734,1607,11413
1/12/2018,2018,1,12, 16 ,7951,1684,1583,11218
1/12/2018,2018,1,12, 17 ,7630,1615,1505,10750
1/12/2018,2018,1,12, 18 ,7795,1744,1600,11139
1/12/2018,2018,1,12, 19 ,7767,1719,1584,11070
1/12/2018,2018,1,12, 20 ,7506,1640,1542,10688
1/12/2018,2018,1,12, 21 ,7281,1552,1473,10306
1/12/2018,2018,1,12, 22 ,6777,1436,1345,9558
1/12/2018,2018,1,12, 23 ,6338,1324,1236,8898
1/12/2018,2018,1,12, 24 ,6114,1242,1165,8521
1/13/2018,2018,1,13, 1 ,5748,1187,1111,8046
1/13/2018,2018,1,13, 2 ,5651,1150,1077,7878
1/13/2018,2018,1,13, 3 ,5584,1130,1042,7756
1/13/2018,2018,1,13, 4 ,5477,1116,1011,7604
1/13/2018,2018,1,13, 5 ,5571,1132,1022,7725
1/13/2018,2018,1,13, 6 ,5673,1157,1131,7961
1/13/2018,2018,1,13, 7 ,5846,1172,1052,8070
1/13/2018,2018,1,13, 8 ,6413,1281,1121,8815
1/13/2018,2018,1,13, 9 ,6880,1438,1277,9595
1/13/2018,2018,1,13, 10 ,7437,1529,1397,10363
1/13/2018,2018,1,13, 11 ,7686,1573,1465,10724
1/13/2018,2018,1,13, 12 ,7430,1535,1448,10413
1/13/2018,2018,1,13, 13 ,7351,1499,1453,10303
1/13/2018,2018,1,13, 14 ,7501,1545,1480,10526
1/13/2018,2018,1,13, 15 ,7443,1519,1433,10395
1/13/2018,2018,1,13, 16 ,7300,1495,1403,10198
1/13/2018,2018,1,13, 17 ,7001,1478,1400,9879
1/13/2018,2018,1,13, 18 ,7287,1624,1503,10414
1/13/2018,2018,1,13, 19 ,7409,1605,1475,10489
1/13/2018,2018,1,13, 20 ,7223,1520,1430,10173
1/13/2018,2018,1,13, 21 ,6980,1459,1362,9801
1/13/2018,2018,1,13, 22 ,6629,1336,1252,9217
1/13/2018,2018,1,13, 23 ,6236,1236,1151,8623
1/13/2018,2018,1,13, 24 ,5848,1160,1081,8089
1/14/2018,2018,1,14, 1 ,5630,1135,1036,7801
1/14/2018,2018,1,14, 2 ,5498,1111,1001,7610
1/14/2018,2018,1,14, 3 ,5393,1079,963,7435
1/14/2018,2018,1,14, 4 ,5303,1057,944,7304
1/14/2018,2018,1,14, 5 ,5299,1064,960,7323
1/14/2018,2018,1,14, 6 ,5336,1081,990,7407
1/14/2018,2018,1,14, 7 ,5358,1116,999,7473
1/14/2018,2018,1,14, 8 ,5600,1156,1021,7777
1/14/2018,2018,1,14, 9 ,6040,1234,1085,8359
1/14/2018,2018,1,14, 10 ,6452,1304,1166,8922
1/14/2018,2018,1,14, 11 ,6674,1341,1203,9218
1/14/2018,2018,1,14, 12 ,6566,1357,1181,9104
1/14/2018,2018,1,14, 13 ,6532,1318,1153,9003
1/14/2018,2018,1,14, 14 ,6544,1329,1151,9024
1/14/2018,2018,1,14, 15 ,6479,1313,1136,8928
1/14/2018,2018,1,14, 16 ,6371,1316,1144,8831
1/14/2018,2018,1,14, 17 ,6385,1336,1198,8919
1/14/2018,2018,1,14, 18 ,6896,1532,1333,9761
1/14/2018,2018,1,14, 19 ,7082,1528,1324,9934
1/14/2018,2018,1,14, 20 ,7046,1455,1297,9798
1/14/2018,2018,1,14, 21 ,6770,1365,1199,9334
1/14/2018,2018,1,14, 22 ,6427,1276,1103,8806
1/14/2018,2018,1,14, 23 ,6016,1176,1016,8208
1/14/2018,2018,1,14, 24 ,5734,1102,948,7784
1/15/2018,2018,1,15, 1 ,5486,1060,903,7449
1/15/2018,2018,1,15, 2 ,5283,1024,877,7184
1/15/2018,2018,1,15, 3 ,5181,1023,857,7061
1/15/2018,2018,1,15, 4 ,5145,1023,858,7026
1/15/2018,2018,1,15, 5 ,5431,1080,922,7433
1/15/2018,2018,1,15, 6 ,5738,1169,1029,7936
1/15/2018,2018,1,15, 7 ,5967,1164,979,8110
1/15/2018,2018,1,15, 8 ,6609,1233,1047,8889
1/15/2018,2018,1,15, 9 ,7492,1409,1187,10088
1/15/2018,2018,1,15, 10 ,8055,1495,1345,10895
1/15/2018,2018,1,15, 11 ,8319,1541,1392,11252
1/15/2018,2018,1,15, 12 ,8110,1497,1365,10972
1/15/2018,2018,1,15, 13 ,8113,1470,1371,10954
1/15/2018,2018,1,15, 14 ,8353,1530,1464,11347
1/15/2018,2018,1,15, 15 ,8323,1519,1454,11296
1/15/2018,2018,1,15, 16 ,8157,1514,1392,11063
1/15/2018,2018,1,15, 17 ,7847,1515,1394,10756
1/15/2018,2018,1,15, 18 ,8066,1645,1466,11177
1/15/2018,2018,1,15, 19 ,8075,1603,1426,11104
1/15/2018,2018,1,15, 20 ,7825,1524,1370,10719
1/15/2018,2018,1,15, 21 ,7528,1423,1294,10245
1/15/2018,2018,1,15, 22 ,7142,1277,1167,9586
1/15/2018,2018,1,15, 23 ,6646,1194,1080,8920
1/15/2018,2018,1,15, 24 ,6270,1121,1023,8414
1/16/2018,2018,1,16, 1 ,6025,1081,984,8090
1/16/2018,2018,1,16, 2 ,5847,1045,962,7854
1/16/2018,2018,1,16, 3 ,5679,1026,934,7639
1/16/2018,2018,1,16, 4 ,5660,1032,943,7635
1/16/2018,2018,1,16, 5 ,5876,1080,988,7944
1/16/2018,2018,1,16, 6 ,6195,1182,1094,8471
1/16/2018,2018,1,16, 7 ,6319,1161,1028,8508
1/16/2018,2018,1,16, 8 ,6897,1253,1100,9250
1/16/2018,2018,1,16, 9 ,7617,1464,1291,10372
1/16/2018,2018,1,16, 10 ,8168,1557,1388,11113
1/16/2018,2018,1,16, 11 ,8407,1597,1436,11440
1/16/2018,2018,1,16, 12 ,8181,1540,1397,11118
1/16/2018,2018,1,16, 13 ,8078,1499,1398,10975
1/16/2018,2018,1,16, 14 ,8430,1524,1440,11394
1/16/2018,2018,1,16, 15 ,8297,1520,1417,11234
1/16/2018,2018,1,16, 16 ,8202,1510,1432,11144
1/16/2018,2018,1,16, 17 ,7967,1521,1418,10906
1/16/2018,2018,1,16, 18 ,8216,1606,1517,11339
1/16/2018,2018,1,16, 19 ,8128,1559,1490,11177
1/16/2018,2018,1,16, 20 ,7931,1469,1420,10820
1/16/2018,2018,1,16, 21 ,7622,1359,1317,10298
1/16/2018,2018,1,16, 22 ,7200,1240,1173,9613
1/16/2018,2018,1,16, 23 ,6748,1145,1078,8971
1/16/2018,2018,1,16, 24 ,6382,1087,1030,8499
1/17/2018,2018,1,17, 1 ,6144,1053,977,8174
1/17/2018,2018,1,17, 2 ,5961,1031,948,7940
1/17/2018,2018,1,17, 3 ,5742,1018,939,7699
1/17/2018,2018,1,17, 4 ,5726,1023,936,7685
1/17/2018,2018,1,17, 5 ,5935,1081,996,8012
1/17/2018,2018,1,17, 6 ,6297,1176,1103,8576
1/17/2018,2018,1,17, 7 ,6406,1164,1024,8594
1/17/2018,2018,1,17, 8 ,6878,1250,1117,9245
1/17/2018,2018,1,17, 9 ,7665,1454,1317,10436
1/17/2018,2018,1,17, 10 ,8044,1567,1425,11036
1/17/2018,2018,1,17, 11 ,8237,1614,1470,11321
1/17/2018,2018,1,17, 12 ,7903,1576,1464,10943
1/17/2018,2018,1,17, 13 ,7766,1596,1458,10820
1/17/2018,2018,1,17, 14 ,8050,1663,1530,11243
1/17/2018,2018,1,17, 15 ,7988,1648,1512,11148
1/17/2018,2018,1,17, 16 ,7976,1628,1485,11089
1/17/2018,2018,1,17, 17 ,7770,1591,1449,10810
1/17/2018,2018,1,17, 18 ,8010,1739,1530,11279
1/17/2018,2018,1,17, 19 ,8030,1723,1509,11262
1/17/2018,2018,1,17, 20 ,7836,1643,1449,10928
1/17/2018,2018,1,17, 21 ,7461,1536,1368,10365
1/17/2018,2018,1,17, 22 ,7015,1400,1223,9638
1/17/2018,2018,1,17, 23 ,6562,1292,1121,8975
1/17/2018,2018,1,17, 24 ,6257,1218,1056,8531
1/18/2018,2018,1,18, 1 ,6000,1162,1006,8168
1/18/2018,2018,1,18, 2 ,5795,1134,980,7909
1/18/2018,2018,1,18, 3 ,5749,1111,957,7817
1/18/2018,2018,1,18, 4 ,5686,1106,958,7750
1/18/2018,2018,1,18, 5 ,5956,1148,1012,8116
1/18/2018,2018,1,18, 6 ,6248,1216,1109,8573
1/18/2018,2018,1,18, 7 ,6375,1190,1031,8596
1/18/2018,2018,1,18, 8 ,6948,1325,1121,9394
1/18/2018,2018,1,18, 9 ,7700,1552,1306,10558
1/18/2018,2018,1,18, 10 ,8282,1675,1422,11379
1/18/2018,2018,1,18, 11 ,8561,1716,1469,11746
1/18/2018,2018,1,18, 12 ,8356,1679,1419,11454
1/18/2018,2018,1,18, 13 ,8340,1688,1425,11453
1/18/2018,2018,1,18, 14 ,8740,1750,1483,11973
1/18/2018,2018,1,18, 15 ,8715,1727,1464,11906
1/18/2018,2018,1,18, 16 ,8651,1690,1439,11780
1/18/2018,2018,1,18, 17 ,8322,1649,1437,11408
1/18/2018,2018,1,18, 18 ,8382,1782,1454,11618
1/18/2018,2018,1,18, 19 ,8441,1737,1439,11617
1/18/2018,2018,1,18, 20 ,8189,1690,1344,11223
1/18/2018,2018,1,18, 21 ,7910,1594,1328,10832
1/18/2018,2018,1,18, 22 ,7510,1451,1180,10141
1/18/2018,2018,1,18, 23 ,7060,1348,1076,9484
1/18/2018,2018,1,18, 24 ,6669,1267,1016,8952
1/19/2018,2018,1,19, 1 ,6445,1209,974,8628
1/19/2018,2018,1,19, 2 ,6202,1181,951,8334
1/19/2018,2018,1,19, 3 ,6035,1159,920,8114
1/19/2018,2018,1,19, 4 ,6008,1138,951,8097
1/19/2018,2018,1,19, 5 ,6142,1186,1000,8328
1/19/2018,2018,1,19, 6 ,6393,1253,986,8632
1/19/2018,2018,1,19, 7 ,6485,1250,994,8729
1/19/2018,2018,1,19, 8 ,7190,1339,1097,9626
1/19/2018,2018,1,19, 9 ,7878,1537,1313,10728
1/19/2018,2018,1,19, 10 ,8328,1637,1438,11403
1/19/2018,2018,1,19, 11 ,8519,1715,1480,11714
1/19/2018,2018,1,19, 12 ,8275,1680,1420,11375
1/19/2018,2018,1,19, 13 ,8168,1681,1451,11300
1/19/2018,2018,1,19, 14 ,8399,1748,1474,11621
1/19/2018,2018,1,19, 15 ,8238,1730,1524,11492
1/19/2018,2018,1,19, 16 ,8139,1698,1484,11321
1/19/2018,2018,1,19, 17 ,7847,1633,1439,10919
1/19/2018,2018,1,19, 18 ,8004,1737,1523,11264
1/19/2018,2018,1,19, 19 ,8011,1728,1533,11272
1/19/2018,2018,1,19, 20 ,7814,1664,1435,10913
1/19/2018,2018,1,19, 21 ,7543,1582,1392,10517
1/19/2018,2018,1,19, 22 ,7172,1478,1267,9917
1/19/2018,2018,1,19, 23 ,6734,1368,1179,9281
1/19/2018,2018,1,19, 24 ,6422,1295,973,8690
1/20/2018,2018,1,20, 1 ,6127,1237,1070,8434
1/20/2018,2018,1,20, 2 ,5959,1208,1038,8205
1/20/2018,2018,1,20, 3 ,5844,1177,1012,8033
1/20/2018,2018,1,20, 4 ,5745,1157,992,7894
1/20/2018,2018,1,20, 5 ,5822,1174,1014,8010
1/20/2018,2018,1,20, 6 ,5956,1206,1026,8188
1/20/2018,2018,1,20, 7 ,6006,1209,1056,8271
1/20/2018,2018,1,20, 8 ,6374,1295,1111,8780
1/20/2018,2018,1,20, 9 ,7084,1458,1272,9814
1/20/2018,2018,1,20, 10 ,7564,1560,1385,10509
1/20/2018,2018,1,20, 11 ,7941,1605,1448,10994
1/20/2018,2018,1,20, 12 ,7747,1588,1440,10775
1/20/2018,2018,1,20, 13 ,7703,1572,1434,10709
1/20/2018,2018,1,20, 14 ,7945,1595,1481,11021
1/20/2018,2018,1,20, 15 ,7844,1580,1470,10894
1/20/2018,2018,1,20, 16 ,7702,1545,1431,10678
1/20/2018,2018,1,20, 17 ,7377,1526,1399,10302
1/20/2018,2018,1,20, 18 ,7571,1688,1497,10756
1/20/2018,2018,1,20, 19 ,7827,1689,1466,10982
1/20/2018,2018,1,20, 20 ,7676,1616,1402,10694
1/20/2018,2018,1,20, 21 ,7554,1535,1345,10434
1/20/2018,2018,1,20, 22 ,7173,1413,1234,9820
1/20/2018,2018,1,20, 23 ,6882,1306,1147,9335
1/20/2018,2018,1,20, 24 ,6488,1240,1083,8811
1/21/2018,2018,1,21, 1 ,6222,1198,1026,8446
1/21/2018,2018,1,21, 2 ,6001,1141,1003,8145
1/21/2018,2018,1,21, 3 ,5776,1091,971,7838
1/21/2018,2018,1,21, 4 ,5737,1070,962,7769
1/21/2018,2018,1,21, 5 ,5688,1086,960,7734
1/21/2018,2018,1,21, 6 ,5649,1096,987,7732
1/21/2018,2018,1,21, 7 ,5612,1101,998,7711
1/21/2018,2018,1,21, 8 ,5889,1139,1003,8031
1/21/2018,2018,1,21, 9 ,6293,1202,1088,8583
1/21/2018,2018,1,21, 10 ,6783,1294,1150,9227
1/21/2018,2018,1,21, 11 ,6992,1327,1179,9498
1/21/2018,2018,1,21, 12 ,6926,1311,1195,9432
1/21/2018,2018,1,21, 13 ,6884,1294,1170,9348
1/21/2018,2018,1,21, 14 ,6904,1297,1177,9378
1/21/2018,2018,1,21, 15 ,6891,1279,1180,9350
1/21/2018,2018,1,21, 16 ,6741,1278,1162,9181
1/21/2018,2018,1,21, 17 ,6696,1313,1183,9192
1/21/2018,2018,1,21, 18 ,7210,1485,1321,10016
1/21/2018,2018,1,21, 19 ,7505,1518,1342,10365
1/21/2018,2018,1,21, 20 ,7470,1476,1284,10230
1/21/2018,2018,1,21, 21 ,7197,1400,1228,9825
1/21/2018,2018,1,21, 22 ,6946,1298,1118,9362
1/21/2018,2018,1,21, 23 ,6542,1193,1049,8784
1/21/2018,2018,1,21, 24 ,6204,1126,1047,8377
1/22/2018,2018,1,22, 1 ,5952,1090,936,7978
1/22/2018,2018,1,22, 2 ,5710,1056,908,7674
1/22/2018,2018,1,22, 3 ,5563,1037,879,7479
1/22/2018,2018,1,22, 4 ,5534,1036,881,7451
1/22/2018,2018,1,22, 5 ,5788,1095,946,7829
1/22/2018,2018,1,22, 6 ,6098,1180,1054,8332
1/22/2018,2018,1,22, 7 ,6219,1166,985,8370
1/22/2018,2018,1,22, 8 ,6923,1265,1065,9253
1/22/2018,2018,1,22, 9 ,7915,1467,1254,10636
1/22/2018,2018,1,22, 10 ,8488,1605,1368,11461
1/22/2018,2018,1,22, 11 ,8751,1673,1445,11869
1/22/2018,2018,1,22, 12 ,8564,1630,1407,11601
1/22/2018,2018,1,22, 13 ,8526,1627,1394,11547
1/22/2018,2018,1,22, 14 ,8833,1681,1460,11974
1/22/2018,2018,1,22, 15 ,8739,1675,1446,11860
1/22/2018,2018,1,22, 16 ,8551,1647,1435,11633
1/22/2018,2018,1,22, 17 ,8268,1596,1418,11282
1/22/2018,2018,1,22, 18 ,8272,1736,1525,11533
1/22/2018,2018,1,22, 19 ,8448,1733,1481,11662
1/22/2018,2018,1,22, 20 ,8229,1650,1405,11284
1/22/2018,2018,1,22, 21 ,8005,1555,1342,10902
1/22/2018,2018,1,22, 22 ,7584,1414,1207,10205
1/22/2018,2018,1,22, 23 ,7088,1317,1094,9499
1/22/2018,2018,1,22, 24 ,6704,1224,1029,8957
1/23/2018,2018,1,23, 1 ,6435,1189,985,8609
1/23/2018,2018,1,23, 2 ,6191,1150,963,8304
1/23/2018,2018,1,23, 3 ,6021,1136,932,8089
1/23/2018,2018,1,23, 4 ,5936,1130,942,8008
1/23/2018,2018,1,23, 5 ,6105,1170,1003,8278
1/23/2018,2018,1,23, 6 ,6365,1248,1107,8720
1/23/2018,2018,1,23, 7 ,6434,1218,1029,8681
1/23/2018,2018,1,23, 8 ,7118,1347,1101,9566
1/23/2018,2018,1,23, 9 ,7892,1567,1297,10756
1/23/2018,2018,1,23, 10 ,8498,1698,1387,11583
1/23/2018,2018,1,23, 11 ,8776,1758,1479,12013
1/23/2018,2018,1,23, 12 ,8468,1727,1463,11658
1/23/2018,2018,1,23, 13 ,8461,1735,1476,11672
1/23/2018,2018,1,23, 14 ,8816,1806,1526,12148
1/23/2018,2018,1,23, 15 ,8716,1785,1514,12015
1/23/2018,2018,1,23, 16 ,8565,1739,1490,11794
1/23/2018,2018,1,23, 17 ,8208,1668,1465,11341
1/23/2018,2018,1,23, 18 ,8309,1780,1539,11628
1/23/2018,2018,1,23, 19 ,8484,1800,1524,11808
1/23/2018,2018,1,23, 20 ,8207,1731,1461,11399
1/23/2018,2018,1,23, 21 ,7983,1638,1381,11002
1/23/2018,2018,1,23, 22 ,7541,1511,1242,10294
1/23/2018,2018,1,23, 23 ,7102,1391,1137,9630
1/23/2018,2018,1,23, 24 ,6685,1304,1020,9009
1/24/2018,2018,1,24, 1 ,6397,1237,1022,8656
1/24/2018,2018,1,24, 2 ,6150,1209,985,8344
1/24/2018,2018,1,24, 3 ,6079,1183,971,8233
1/24/2018,2018,1,24, 4 ,5933,1167,973,8073
1/24/2018,2018,1,24, 5 ,6154,1218,1025,8397
1/24/2018,2018,1,24, 6 ,6365,1286,1118,8769
1/24/2018,2018,1,24, 7 ,6430,1252,1030,8712
1/24/2018,2018,1,24, 8 ,7125,1360,1122,9607
1/24/2018,2018,1,24, 9 ,7904,1592,1352,10848
1/24/2018,2018,1,24, 10 ,8419,1686,1454,11559
1/24/2018,2018,1,24, 11 ,8696,1737,1510,11943
1/24/2018,2018,1,24, 12 ,8452,1688,1474,11614
1/24/2018,2018,1,24, 13 ,8429,1706,1484,11619
1/24/2018,2018,1,24, 14 ,8637,1772,1554,11963
1/24/2018,2018,1,24, 15 ,8557,1752,1542,11851
1/24/2018,2018,1,24, 16 ,8410,1715,1515,11640
1/24/2018,2018,1,24, 17 ,8201,1686,1481,11368
1/24/2018,2018,1,24, 18 ,8277,1788,1556,11621
1/24/2018,2018,1,24, 19 ,8352,1796,1542,11690
1/24/2018,2018,1,24, 20 ,8151,1716,1488,11355
1/24/2018,2018,1,24, 21 ,7886,1628,1408,10922
1/24/2018,2018,1,24, 22 ,7423,1472,1249,10144
1/24/2018,2018,1,24, 23 ,6981,1380,1132,9493
1/24/2018,2018,1,24, 24 ,6606,1299,1088,8993
1/25/2018,2018,1,25, 1 ,6330,1252,1031,8613
1/25/2018,2018,1,25, 2 ,6148,1212,998,8358
1/25/2018,2018,1,25, 3 ,6054,1179,963,8196
1/25/2018,2018,1,25, 4 ,5990,1186,965,8141
1/25/2018,2018,1,25, 5 ,6213,1226,1020,8459
1/25/2018,2018,1,25, 6 ,6407,1302,1051,8760
1/25/2018,2018,1,25, 7 ,6527,1255,1039,8821
1/25/2018,2018,1,25, 8 ,7127,1382,1122,9631
1/25/2018,2018,1,25, 9 ,7962,1609,1368,10939
1/25/2018,2018,1,25, 10 ,8508,1749,1488,11745
1/25/2018,2018,1,25, 11 ,8773,1797,1554,12124
1/25/2018,2018,1,25, 12 ,8505,1780,1518,11803
1/25/2018,2018,1,25, 13 ,8511,1791,1558,11860
1/25/2018,2018,1,25, 14 ,8897,1866,1630,12393
1/25/2018,2018,1,25, 15 ,8816,1862,1587,12265
1/25/2018,2018,1,25, 16 ,8692,1829,1542,12063
1/25/2018,2018,1,25, 17 ,8328,1739,1516,11583
1/25/2018,2018,1,25, 18 ,8350,1842,1586,11778
1/25/2018,2018,1,25, 19 ,8445,1870,1578,11893
1/25/2018,2018,1,25, 20 ,8315,1783,1530,11628
1/25/2018,2018,1,25, 21 ,8023,1681,1452,11156
1/25/2018,2018,1,25, 22 ,7605,1546,1300,10451
1/25/2018,2018,1,25, 23 ,7217,1460,1203,9880
1/25/2018,2018,1,25, 24 ,6794,1359,1118,9271
1/26/2018,2018,1,26, 1 ,6511,1301,1059,8871
1/26/2018,2018,1,26, 2 ,6295,1273,1032,8600
1/26/2018,2018,1,26, 3 ,6084,1235,999,8318
1/26/2018,2018,1,26, 4 ,6022,1214,988,8224
1/26/2018,2018,1,26, 5 ,6194,1265,1024,8483
1/26/2018,2018,1,26, 6 ,6479,1320,1103,8902
1/26/2018,2018,1,26, 7 ,6500,1275,1030,8805
1/26/2018,2018,1,26, 8 ,7225,1425,1148,9798
1/26/2018,2018,1,26, 9 ,8159,1660,1379,11198
1/26/2018,2018,1,26, 10 ,8602,1793,1525,11920
1/26/2018,2018,1,26, 11 ,8875,1861,1598,12334
1/26/2018,2018,1,26, 12 ,8660,1834,1573,12067
1/26/2018,2018,1,26, 13 ,8664,1778,1578,12020
1/26/2018,2018,1,26, 14 ,8890,1849,1624,12363
1/26/2018,2018,1,26, 15 ,8888,1832,1611,12331
1/26/2018,2018,1,26, 16 ,8772,1793,1572,12137
1/26/2018,2018,1,26, 17 ,8478,1711,1517,11706
1/26/2018,2018,1,26, 18 ,8403,1806,1551,11760
1/26/2018,2018,1,26, 19 ,8647,1840,1580,12067
1/26/2018,2018,1,26, 20 ,8482,1763,1515,11760
1/26/2018,2018,1,26, 21 ,8213,1696,1432,11341
1/26/2018,2018,1,26, 22 ,7767,1559,1308,10634
1/26/2018,2018,1,26, 23 ,7342,1451,1209,10002
1/26/2018,2018,1,26, 24 ,6969,1357,1124,9450
1/27/2018,2018,1,27, 1 ,6641,1299,1068,9008
1/27/2018,2018,1,27, 2 ,6464,1259,1040,8763
1/27/2018,2018,1,27, 3 ,6227,1234,1017,8478
1/27/2018,2018,1,27, 4 ,6175,1218,1006,8399
1/27/2018,2018,1,27, 5 ,6108,1222,1019,8349
1/27/2018,2018,1,27, 6 ,6228,1245,1053,8526
1/27/2018,2018,1,27, 7 ,6334,1251,1052,8637
1/27/2018,2018,1,27, 8 ,6770,1330,1138,9238
1/27/2018,2018,1,27, 9 ,7211,1508,1285,10004
1/27/2018,2018,1,27, 10 ,7691,1613,1418,10722
1/27/2018,2018,1,27, 11 ,7882,1673,1481,11036
1/27/2018,2018,1,27, 12 ,7602,1650,1452,10704
1/27/2018,2018,1,27, 13 ,7383,1646,1479,10508
1/27/2018,2018,1,27, 14 ,7534,1665,1524,10723
1/27/2018,2018,1,27, 15 ,7468,1637,1509,10614
1/27/2018,2018,1,27, 16 ,7323,1583,1456,10362
1/27/2018,2018,1,27, 17 ,7214,1564,1403,10181
1/27/2018,2018,1,27, 18 ,7596,1691,1477,10764
1/27/2018,2018,1,27, 19 ,7699,1698,1524,10921
1/27/2018,2018,1,27, 20 ,7597,1638,1475,10710
1/27/2018,2018,1,27, 21 ,7428,1578,1403,10409
1/27/2018,2018,1,27, 22 ,7032,1456,1291,9779
1/27/2018,2018,1,27, 23 ,6696,1365,1182,9243
1/27/2018,2018,1,27, 24 ,6217,1289,1070,8576
1/28/2018,2018,1,28, 1 ,5996,1234,1064,8294
1/28/2018,2018,1,28, 2 ,5789,1197,1016,8002
1/28/2018,2018,1,28, 3 ,5657,1172,988,7817
1/28/2018,2018,1,28, 4 ,5544,1150,976,7670
1/28/2018,2018,1,28, 5 ,5515,1150,977,7642
1/28/2018,2018,1,28, 6 ,5525,1160,986,7671
1/28/2018,2018,1,28, 7 ,5576,1156,975,7707
1/28/2018,2018,1,28, 8 ,5848,1195,981,8024
1/28/2018,2018,1,28, 9 ,6197,1252,1061,8510
1/28/2018,2018,1,28, 10 ,6644,1322,1145,9111
1/28/2018,2018,1,28, 11 ,6820,1345,1211,9376
1/28/2018,2018,1,28, 12 ,6733,1333,1219,9285
1/28/2018,2018,1,28, 13 ,6620,1315,1230,9165
1/28/2018,2018,1,28, 14 ,6574,1318,1238,9130
1/28/2018,2018,1,28, 15 ,6420,1303,1241,8964
1/28/2018,2018,1,28, 16 ,6302,1309,1213,8824
1/28/2018,2018,1,28, 17 ,6414,1349,1202,8965
1/28/2018,2018,1,28, 18 ,6877,1526,1344,9747
1/28/2018,2018,1,28, 19 ,7121,1554,1448,10123
1/28/2018,2018,1,28, 20 ,7071,1504,1413,9988
1/28/2018,2018,1,28, 21 ,6869,1423,1365,9657
1/28/2018,2018,1,28, 22 ,6509,1330,1240,9079
1/28/2018,2018,1,28, 23 ,6110,1246,1141,8497
1/28/2018,2018,1,28, 24 ,5775,1179,1075,8029
1/29/2018,2018,1,29, 1 ,5535,1125,1024,7684
1/29/2018,2018,1,29, 2 ,5319,1088,984,7391
1/29/2018,2018,1,29, 3 ,5186,1069,959,7214
1/29/2018,2018,1,29, 4 ,5224,1066,953,7243
1/29/2018,2018,1,29, 5 ,5468,1121,1004,7593
1/29/2018,2018,1,29, 6 ,5818,1204,1030,8052
1/29/2018,2018,1,29, 7 ,6013,1181,1020,8214
1/29/2018,2018,1,29, 8 ,6815,1314,1135,9264
1/29/2018,2018,1,29, 9 ,7692,1536,1315,10543
1/29/2018,2018,1,29, 10 ,8214,1663,1480,11357
1/29/2018,2018,1,29, 11 ,8498,1757,1555,11810
1/29/2018,2018,1,29, 12 ,8363,1701,1535,11599
1/29/2018,2018,1,29, 13 ,8332,1713,1553,11598
1/29/2018,2018,1,29, 14 ,8674,1792,1614,12080
1/29/2018,2018,1,29, 15 ,8564,1776,1626,11966
1/29/2018,2018,1,29, 16 ,8368,1746,1512,11626
1/29/2018,2018,1,29, 17 ,8063,1663,1458,11184
1/29/2018,2018,1,29, 18 ,8097,1757,1531,11385
1/29/2018,2018,1,29, 19 ,8271,1793,1578,11642
1/29/2018,2018,1,29, 20 ,8042,1716,1414,11172
1/29/2018,2018,1,29, 21 ,7821,1615,1404,10840
1/29/2018,2018,1,29, 22 ,7322,1474,1310,10106
1/29/2018,2018,1,29, 23 ,6915,1362,1199,9476
1/29/2018,2018,1,29, 24 ,6496,1278,1021,8795
1/30/2018,2018,1,30, 1 ,6249,1229,1047,8525
1/30/2018,2018,1,30, 2 ,6042,1190,1009,8241
1/30/2018,2018,1,30, 3 ,5919,1160,1014,8093
1/30/2018,2018,1,30, 4 ,5852,1147,985,7984
1/30/2018,2018,1,30, 5 ,6070,1190,1030,8290
1/30/2018,2018,1,30, 6 ,6392,1265,1116,8773
1/30/2018,2018,1,30, 7 ,6472,1207,1049,8728
1/30/2018,2018,1,30, 8 ,7096,1335,1144,9575
1/30/2018,2018,1,30, 9 ,7887,1556,1328,10771
1/30/2018,2018,1,30, 10 ,8389,1685,1462,11536
1/30/2018,2018,1,30, 11 ,8710,1723,1513,11946
1/30/2018,2018,1,30, 12 ,8412,1707,1492,11611
1/30/2018,2018,1,30, 13 ,8284,1716,1497,11497
1/30/2018,2018,1,30, 14 ,8565,1791,1580,11936
1/30/2018,2018,1,30, 15 ,8510,1762,1569,11841
1/30/2018,2018,1,30, 16 ,8333,1729,1554,11616
1/30/2018,2018,1,30, 17 ,8063,1648,1482,11193
1/30/2018,2018,1,30, 18 ,8056,1765,1536,11357
1/30/2018,2018,1,30, 19 ,8223,1813,1583,11619
1/30/2018,2018,1,30, 20 ,7966,1733,1529,11228
1/30/2018,2018,1,30, 21 ,7687,1641,1461,10789
1/30/2018,2018,1,30, 22 ,7243,1505,1310,10058
1/30/2018,2018,1,30, 23 ,6858,1414,1202,9474
1/30/2018,2018,1,30, 24 ,6442,1323,1110,8875
1/31/2018,2018,1,31, 1 ,6175,1288,1066,8529
1/31/2018,2018,1,31, 2 ,6011,1231,1009,8251
1/31/2018,2018,1,31, 3 ,5811,1180,993,7984
1/31/2018,2018,1,31, 4 ,5803,1151,980,7934
1/31/2018,2018,1,31, 5 ,6070,1197,1024,8291
1/31/2018,2018,1,31, 6 ,6275,1279,1117,8671
1/31/2018,2018,1,31, 7 ,6310,1220,1024,8554
1/31/2018,2018,1,31, 8 ,7036,1352,1128,9516
1/31/2018,2018,1,31, 9 ,7732,1588,1328,10648
1/31/2018,2018,1,31, 10 ,8209,1710,1444,11363
1/31/2018,2018,1,31, 11 ,8445,1820,1513,11778
1/31/2018,2018,1,31, 12 ,8172,1764,1481,11417
1/31/2018,2018,1,31, 13 ,8142,1782,1461,11385
1/31/2018,2018,1,31, 14 ,8430,1866,1529,11825
1/31/2018,2018,1,31, 15 ,8418,1850,1525,11793
1/31/2018,2018,1,31, 16 ,8308,1780,1474,11562
1/31/2018,2018,1,31, 17 ,7992,1696,1450,11138
1/31/2018,2018,1,31, 18 ,8045,1792,1536,11373
1/31/2018,2018,1,31, 19 ,8258,1823,1533,11614
1/31/2018,2018,1,31, 20 ,7973,1750,1475,11198
1/31/2018,2018,1,31, 21 ,7654,1660,1408,10722
1/31/2018,2018,1,31, 22 ,7300,1535,1263,10098
1/31/2018,2018,1,31, 23 ,6864,1425,1147,9436
1/31/2018,2018,1,31, 24 ,6473,1342,1078,8893
2/1/2018,2018,2,1, 1 ,6214,1283,1028,8525
2/1/2018,2018,2,1, 2 ,6077,1251,1005,8333
2/1/2018,2018,2,1, 3 ,5887,1221,969,8077
2/1/2018,2018,2,1, 4 ,5834,1213,968,8015
2/1/2018,2018,2,1, 5 ,6011,1253,1024,8288
2/1/2018,2018,2,1, 6 ,6268,1318,1121,8707
2/1/2018,2018,2,1, 7 ,6224,1270,994,8488
2/1/2018,2018,2,1, 8 ,6866,1395,1120,9381
2/1/2018,2018,2,1, 9 ,7702,1628,1318,10648
2/1/2018,2018,2,1, 10 ,8214,1731,1448,11393
2/1/2018,2018,2,1, 11 ,8494,1805,1535,11834
2/1/2018,2018,2,1, 12 ,8318,1761,1508,11587
2/1/2018,2018,2,1, 13 ,8343,1771,1518,11632
2/1/2018,2018,2,1, 14 ,8699,1832,1583,12114
2/1/2018,2018,2,1, 15 ,8649,1833,1583,12065
2/1/2018,2018,2,1, 16 ,8816,1783,1543,12142
2/1/2018,2018,2,1, 17 ,8223,1707,1487,11417
2/1/2018,2018,2,1, 18 ,8228,1801,1538,11567
2/1/2018,2018,2,1, 19 ,8425,1836,1573,11834
2/1/2018,2018,2,1, 20 ,8182,1761,1511,11454
2/1/2018,2018,2,1, 21 ,7912,1686,1446,11044
2/1/2018,2018,2,1, 22 ,7489,1538,1309,10336
2/1/2018,2018,2,1, 23 ,7032,1422,1204,9658
2/1/2018,2018,2,1, 24 ,6603,1332,1111,9046
2/2/2018,2018,2,2, 1 ,6362,1285,1066,8713
2/2/2018,2018,2,2, 2 ,6185,1256,1042,8483
2/2/2018,2018,2,2, 3 ,6034,1229,1025,8288
2/2/2018,2018,2,2, 4 ,6001,1216,1005,8222
2/2/2018,2018,2,2, 5 ,6100,1244,1059,8403
2/2/2018,2018,2,2, 6 ,6381,1296,1128,8805
2/2/2018,2018,2,2, 7 ,6435,1275,1062,8772
2/2/2018,2018,2,2, 8 ,7053,1397,1149,9599
2/2/2018,2018,2,2, 9 ,7868,1611,1364,10843
2/2/2018,2018,2,2, 10 ,8433,1729,1445,11607
2/2/2018,2018,2,2, 11 ,8683,1801,1508,11992
2/2/2018,2018,2,2, 12 ,8407,1742,1502,11651
2/2/2018,2018,2,2, 13 ,8398,1760,1531,11689
2/2/2018,2018,2,2, 14 ,8789,1819,1580,12188
2/2/2018,2018,2,2, 15 ,8672,1783,1554,12009
2/2/2018,2018,2,2, 16 ,8540,1756,1527,11823
2/2/2018,2018,2,2, 17 ,8204,1708,1495,11407
2/2/2018,2018,2,2, 18 ,8069,1780,1537,11386
2/2/2018,2018,2,2, 19 ,8241,1799,1521,11561
2/2/2018,2018,2,2, 20 ,8039,1721,1471,11231
2/2/2018,2018,2,2, 21 ,7729,1638,1369,10736
2/2/2018,2018,2,2, 22 ,7400,1514,1240,10154
2/2/2018,2018,2,2, 23 ,6918,1394,1125,9437
2/2/2018,2018,2,2, 24 ,6607,1308,1065,8980
2/3/2018,2018,2,3, 1 ,6326,1256,1016,8598
2/3/2018,2018,2,3, 2 ,6090,1230,997,8317
2/3/2018,2018,2,3, 3 ,5974,1204,970,8148
2/3/2018,2018,2,3, 4 ,5802,1175,967,7944
2/3/2018,2018,2,3, 5 ,5781,1164,998,7943
2/3/2018,2018,2,3, 6 ,5885,1189,1029,8103
2/3/2018,2018,2,3, 7 ,6010,1222,1047,8279
2/3/2018,2018,2,3, 8 ,6492,1275,1105,8872
2/3/2018,2018,2,3, 9 ,7117,1416,1229,9762
2/3/2018,2018,2,3, 10 ,7555,1495,1353,10403
2/3/2018,2018,2,3, 11 ,7885,1531,1413,10829
2/3/2018,2018,2,3, 12 ,7644,1523,1417,10584
2/3/2018,2018,2,3, 13 ,7551,1504,1409,10464
2/3/2018,2018,2,3, 14 ,7710,1551,1462,10723
2/3/2018,2018,2,3, 15 ,7592,1546,1440,10578
2/3/2018,2018,2,3, 16 ,7453,1526,1404,10383
2/3/2018,2018,2,3, 17 ,7198,1500,1379,10077
2/3/2018,2018,2,3, 18 ,7325,1624,1501,10450
2/3/2018,2018,2,3, 19 ,7595,1660,1505,10760
2/3/2018,2018,2,3, 20 ,7419,1605,1445,10469
2/3/2018,2018,2,3, 21 ,7253,1546,1373,10172
2/3/2018,2018,2,3, 22 ,6919,1430,1269,9618
2/3/2018,2018,2,3, 23 ,6590,1320,1169,9079
2/3/2018,2018,2,3, 24 ,6140,1239,1071,8450
2/4/2018,2018,2,4, 1 ,5899,1177,1037,8113
2/4/2018,2018,2,4, 2 ,5694,1152,1004,7850
2/4/2018,2018,2,4, 3 ,5517,1129,977,7623
2/4/2018,2018,2,4, 4 ,5430,1117,962,7509
2/4/2018,2018,2,4, 5 ,5432,1121,960,7513
2/4/2018,2018,2,4, 6 ,5392,1136,977,7505
2/4/2018,2018,2,4, 7 ,5452,1164,982,7598
2/4/2018,2018,2,4, 8 ,5749,1199,982,7930
2/4/2018,2018,2,4, 9 ,6082,1279,1069,8430
2/4/2018,2018,2,4, 10 ,6557,1364,1196,9117
2/4/2018,2018,2,4, 11 ,6725,1421,1265,9411
2/4/2018,2018,2,4, 12 ,6703,1405,1261,9369
2/4/2018,2018,2,4, 13 ,6639,1404,1277,9320
2/4/2018,2018,2,4, 14 ,6649,1407,1295,9351
2/4/2018,2018,2,4, 15 ,6610,1418,1280,9308
2/4/2018,2018,2,4, 16 ,6510,1412,1258,9180
2/4/2018,2018,2,4, 17 ,6548,1431,1264,9243
2/4/2018,2018,2,4, 18 ,6859,1598,1402,9859
2/4/2018,2018,2,4, 19 ,7298,1659,1457,10414
2/4/2018,2018,2,4, 20 ,7254,1601,1411,10266
2/4/2018,2018,2,4, 21 ,7017,1524,1363,9904
2/4/2018,2018,2,4, 22 ,6698,1419,1258,9375
2/4/2018,2018,2,4, 23 ,6284,1313,1159,8756
2/4/2018,2018,2,4, 24 ,5957,1236,1083,8276
2/5/2018,2018,2,5, 1 ,5644,1185,1022,7851
2/5/2018,2018,2,5, 2 ,5502,1153,985,7640
2/5/2018,2018,2,5, 3 ,5364,1132,958,7454
2/5/2018,2018,2,5, 4 ,5324,1133,954,7411
2/5/2018,2018,2,5, 5 ,5635,1178,1002,7815
2/5/2018,2018,2,5, 6 ,5933,1257,1030,8220
2/5/2018,2018,2,5, 7 ,6117,1235,1024,8376
2/5/2018,2018,2,5, 8 ,6810,1368,1153,9331
2/5/2018,2018,2,5, 9 ,7610,1586,1349,10545
2/5/2018,2018,2,5, 10 ,8100,1694,1501,11295
2/5/2018,2018,2,5, 11 ,8364,1753,1585,11702
2/5/2018,2018,2,5, 12 ,8135,1714,1564,11413
2/5/2018,2018,2,5, 13 ,8067,1696,1555,11318
2/5/2018,2018,2,5, 14 ,8355,1789,1615,11759
2/5/2018,2018,2,5, 15 ,8280,1781,1601,11662
2/5/2018,2018,2,5, 16 ,8138,1753,1552,11443
2/5/2018,2018,2,5, 17 ,7911,1684,1523,11118
2/5/2018,2018,2,5, 18 ,7983,1763,1575,11321
2/5/2018,2018,2,5, 19 ,8033,1803,1574,11410
2/5/2018,2018,2,5, 20 ,7731,1720,1510,10961
2/5/2018,2018,2,5, 21 ,7399,1610,1419,10428
2/5/2018,2018,2,5, 22 ,6890,1471,1293,9654
2/5/2018,2018,2,5, 23 ,6461,1369,1183,9013
2/5/2018,2018,2,5, 24 ,6080,1290,1109,8479
2/6/2018,2018,2,6, 1 ,5850,1234,1072,8156
2/6/2018,2018,2,6, 2 ,5659,1205,1043,7907
2/6/2018,2018,2,6, 3 ,5565,1181,1021,7767
2/6/2018,2018,2,6, 4 ,5570,1172,1000,7742
2/6/2018,2018,2,6, 5 ,5793,1215,1051,8059
2/6/2018,2018,2,6, 6 ,6118,1284,1134,8536
2/6/2018,2018,2,6, 7 ,6185,1250,1060,8495
2/6/2018,2018,2,6, 8 ,6695,1388,1178,9261
2/6/2018,2018,2,6, 9 ,7401,1613,1376,10390
2/6/2018,2018,2,6, 10 ,7825,1713,1493,11031
2/6/2018,2018,2,6, 11 ,8183,1781,1552,11516
2/6/2018,2018,2,6, 12 ,7952,1742,1529,11223
2/6/2018,2018,2,6, 13 ,7885,1722,1531,11138
2/6/2018,2018,2,6, 14 ,8277,1808,1530,11615
2/6/2018,2018,2,6, 15 ,8190,1775,1523,11488
2/6/2018,2018,2,6, 16 ,8084,1748,1525,11357
2/6/2018,2018,2,6, 17 ,7853,1690,1485,11028
2/6/2018,2018,2,6, 18 ,7877,1756,1574,11207
2/6/2018,2018,2,6, 19 ,7943,1793,1580,11316
2/6/2018,2018,2,6, 20 ,7770,1724,1538,11032
2/6/2018,2018,2,6, 21 ,7394,1618,1455,10467
2/6/2018,2018,2,6, 22 ,6962,1475,1316,9753
2/6/2018,2018,2,6, 23 ,6480,1379,1192,9051
2/6/2018,2018,2,6, 24 ,6154,1293,1109,8556
2/7/2018,2018,2,7, 1 ,5864,1242,1075,8181
2/7/2018,2018,2,7, 2 ,5692,1208,1035,7935
2/7/2018,2018,2,7, 3 ,5576,1161,1001,7738
2/7/2018,2018,2,7, 4 ,5585,1142,996,7723
2/7/2018,2018,2,7, 5 ,5782,1222,1045,8049
2/7/2018,2018,2,7, 6 ,6077,1297,1129,8503
2/7/2018,2018,2,7, 7 ,6194,1250,1048,8492
2/7/2018,2018,2,7, 8 ,6704,1382,1141,9227
2/7/2018,2018,2,7, 9 ,7478,1593,1315,10386
2/7/2018,2018,2,7, 10 ,7943,1719,1437,11099
2/7/2018,2018,2,7, 11 ,8252,1783,1502,11537
2/7/2018,2018,2,7, 12 ,7969,1746,1482,11197
2/7/2018,2018,2,7, 13 ,7897,1744,1457,11098
2/7/2018,2018,2,7, 14 ,8240,1817,1544,11601
2/7/2018,2018,2,7, 15 ,8192,1783,1549,11524
2/7/2018,2018,2,7, 16 ,8057,1708,1526,11291
2/7/2018,2018,2,7, 17 ,7879,1679,1478,11036
2/7/2018,2018,2,7, 18 ,7959,1750,1535,11244
2/7/2018,2018,2,7, 19 ,8090,1815,1568,11473
2/7/2018,2018,2,7, 20 ,7825,1743,1498,11066
2/7/2018,2018,2,7, 21 ,7506,1641,1379,10526
2/7/2018,2018,2,7, 22 ,7065,1506,1254,9825
2/7/2018,2018,2,7, 23 ,6634,1375,1177,9186
2/7/2018,2018,2,7, 24 ,6180,1303,1097,8580
2/8/2018,2018,2,8, 1 ,5958,1239,1059,8256
2/8/2018,2018,2,8, 2 ,5812,1206,1018,8036
2/8/2018,2018,2,8, 3 ,5669,1181,1002,7852
2/8/2018,2018,2,8, 4 ,5667,1164,994,7825
2/8/2018,2018,2,8, 5 ,5864,1217,1041,8122
2/8/2018,2018,2,8, 6 ,6145,1292,1116,8553
2/8/2018,2018,2,8, 7 ,6210,1234,1030,8474
2/8/2018,2018,2,8, 8 ,6777,1361,1125,9263
2/8/2018,2018,2,8, 9 ,7463,1582,1369,10414
2/8/2018,2018,2,8, 10 ,7980,1708,1489,11177
2/8/2018,2018,2,8, 11 ,8199,1740,1547,11486
2/8/2018,2018,2,8, 12 ,7988,1700,1531,11219
2/8/2018,2018,2,8, 13 ,7950,1738,1533,11221
2/8/2018,2018,2,8, 14 ,8299,1804,1601,11704
2/8/2018,2018,2,8, 15 ,8255,1796,1615,11666
2/8/2018,2018,2,8, 16 ,8169,1764,1580,11513
2/8/2018,2018,2,8, 17 ,7866,1690,1499,11055
2/8/2018,2018,2,8, 18 ,7905,1741,1570,11216
2/8/2018,2018,2,8, 19 ,8091,1801,1572,11464
2/8/2018,2018,2,8, 20 ,7796,1712,1536,11044
2/8/2018,2018,2,8, 21 ,7498,1621,1459,10578
2/8/2018,2018,2,8, 22 ,7022,1469,1310,9801
2/8/2018,2018,2,8, 23 ,6533,1352,1207,9092
2/8/2018,2018,2,8, 24 ,6163,1267,1118,8548
2/9/2018,2018,2,9, 1 ,5923,1220,1066,8209
2/9/2018,2018,2,9, 2 ,5776,1185,1034,7995
2/9/2018,2018,2,9, 3 ,5553,1156,997,7706
2/9/2018,2018,2,9, 4 ,5551,1131,978,7660
2/9/2018,2018,2,9, 5 ,5772,1166,1035,7973
2/9/2018,2018,2,9, 6 ,6074,1252,1107,8433
2/9/2018,2018,2,9, 7 ,6159,1206,1034,8399
2/9/2018,2018,2,9, 8 ,6771,1327,1151,9249
2/9/2018,2018,2,9, 9 ,7533,1561,1364,10458
2/9/2018,2018,2,9, 10 ,8044,1673,1475,11192
2/9/2018,2018,2,9, 11 ,8343,1742,1486,11571
2/9/2018,2018,2,9, 12 ,8090,1721,1457,11268
2/9/2018,2018,2,9, 13 ,8043,1708,1484,11235
2/9/2018,2018,2,9, 14 ,8434,1806,1594,11834
2/9/2018,2018,2,9, 15 ,8405,1769,1574,11748
2/9/2018,2018,2,9, 16 ,8369,1738,1556,11663
2/9/2018,2018,2,9, 17 ,8083,1653,1464,11200
2/9/2018,2018,2,9, 18 ,8079,1726,1492,11297
2/9/2018,2018,2,9, 19 ,8279,1788,1557,11624
2/9/2018,2018,2,9, 20 ,8025,1719,1507,11251
2/9/2018,2018,2,9, 21 ,7798,1632,1442,10872
2/9/2018,2018,2,9, 22 ,7354,1490,1322,10166
2/9/2018,2018,2,9, 23 ,6887,1375,1210,9472
2/9/2018,2018,2,9, 24 ,6504,1274,1106,8884
2/10/2018,2018,2,10, 1 ,6194,1223,1076,8493
2/10/2018,2018,2,10, 2 ,6055,1190,1039,8284
2/10/2018,2018,2,10, 3 ,5899,1157,1005,8061
2/10/2018,2018,2,10, 4 ,5829,1152,972,7953
2/10/2018,2018,2,10, 5 ,5850,1170,989,8009
2/10/2018,2018,2,10, 6 ,5941,1197,1025,8163
2/10/2018,2018,2,10, 7 ,6109,1211,1023,8343
2/10/2018,2018,2,10, 8 ,6582,1318,1092,8992
2/10/2018,2018,2,10, 9 ,7144,1508,1258,9910
2/10/2018,2018,2,10, 10 ,7674,1613,1372,10659
2/10/2018,2018,2,10, 11 ,7973,1681,1467,11121
2/10/2018,2018,2,10, 12 ,7782,1660,1453,10895
2/10/2018,2018,2,10, 13 ,7755,1649,1484,10888
2/10/2018,2018,2,10, 14 ,8005,1712,1527,11244
2/10/2018,2018,2,10, 15 ,7916,1689,1516,11121
2/10/2018,2018,2,10, 16 ,7797,1654,1475,10926
2/10/2018,2018,2,10, 17 ,7486,1572,1422,10480
2/10/2018,2018,2,10, 18 ,7645,1693,1495,10833
2/10/2018,2018,2,10, 19 ,7995,1786,1544,11325
2/10/2018,2018,2,10, 20 ,7833,1718,1503,11054
2/10/2018,2018,2,10, 21 ,7623,1647,1399,10669
2/10/2018,2018,2,10, 22 ,7360,1537,1318,10215
2/10/2018,2018,2,10, 23 ,6908,1413,1203,9524
2/10/2018,2018,2,10, 24 ,6560,1321,1123,9004
2/11/2018,2018,2,11, 1 ,6298,1250,1063,8611
2/11/2018,2018,2,11, 2 ,6126,1206,1024,8356
2/11/2018,2018,2,11, 3 ,5944,1164,988,8096
2/11/2018,2018,2,11, 4 ,5814,1155,962,7931
2/11/2018,2018,2,11, 5 ,5787,1165,955,7907
2/11/2018,2018,2,11, 6 ,5793,1170,992,7955
2/11/2018,2018,2,11, 7 ,5745,1187,976,7908
2/11/2018,2018,2,11, 8 ,5970,1240,1029,8239
2/11/2018,2018,2,11, 9 ,6469,1336,1084,8889
2/11/2018,2018,2,11, 10 ,6916,1436,1213,9565
2/11/2018,2018,2,11, 11 ,7167,1489,1280,9936
2/11/2018,2018,2,11, 12 ,7129,1492,1300,9921
2/11/2018,2018,2,11, 13 ,7117,1481,1314,9912
2/11/2018,2018,2,11, 14 ,7030,1485,1340,9855
2/11/2018,2018,2,11, 15 ,6928,1474,1335,9737
2/11/2018,2018,2,11, 16 ,6840,1473,1299,9612
2/11/2018,2018,2,11, 17 ,6851,1463,1287,9601
2/11/2018,2018,2,11, 18 ,7184,1599,1346,10129
2/11/2018,2018,2,11, 19 ,7562,1717,1497,10776
2/11/2018,2018,2,11, 20 ,7561,1676,1447,10684
2/11/2018,2018,2,11, 21 ,7410,1599,1401,10410
2/11/2018,2018,2,11, 22 ,7063,1490,1286,9839
2/11/2018,2018,2,11, 23 ,6622,1387,1194,9203
2/11/2018,2018,2,11, 24 ,6301,1301,1124,8726
2/12/2018,2018,2,12, 1 ,6029,1233,1068,8330
2/12/2018,2018,2,12, 2 ,5799,1200,1035,8034
2/12/2018,2018,2,12, 3 ,5603,1178,1001,7782
2/12/2018,2018,2,12, 4 ,5558,1171,1002,7731
2/12/2018,2018,2,12, 5 ,5860,1214,1025,8099
2/12/2018,2018,2,12, 6 ,6210,1318,1029,8557
2/12/2018,2018,2,12, 7 ,6340,1272,1026,8638
2/12/2018,2018,2,12, 8 ,7097,1405,1144,9646
2/12/2018,2018,2,12, 9 ,7996,1641,1339,10976
2/12/2018,2018,2,12, 10 ,8544,1740,1469,11753
2/12/2018,2018,2,12, 11 ,8855,1805,1546,12206
2/12/2018,2018,2,12, 12 ,8605,1753,1515,11873
2/12/2018,2018,2,12, 13 ,8488,1750,1486,11724
2/12/2018,2018,2,12, 14 ,8843,1810,1522,12175
2/12/2018,2018,2,12, 15 ,8732,1799,1470,12001
2/12/2018,2018,2,12, 16 ,8562,1760,1447,11769
2/12/2018,2018,2,12, 17 ,8262,1741,1425,11428
2/12/2018,2018,2,12, 18 ,8203,1793,1488,11484
2/12/2018,2018,2,12, 19 ,8388,1770,1480,11638
2/12/2018,2018,2,12, 20 ,8181,1704,1425,11310
2/12/2018,2018,2,12, 21 ,7902,1594,1334,10830
2/12/2018,2018,2,12, 22 ,7429,1421,1186,10036
2/12/2018,2018,2,12, 23 ,6968,1333,1089,9390
2/12/2018,2018,2,12, 24 ,6616,1256,1030,8902
2/13/2018,2018,2,13, 1 ,6287,1209,1000,8496
2/13/2018,2018,2,13, 2 ,6107,1168,967,8242
2/13/2018,2018,2,13, 3 ,5958,1136,948,8042
2/13/2018,2018,2,13, 4 ,5931,1121,945,7997
2/13/2018,2018,2,13, 5 ,6173,1163,997,8333
2/13/2018,2018,2,13, 6 ,6426,1222,1107,8755
2/13/2018,2018,2,13, 7 ,6430,1253,1041,8724
2/13/2018,2018,2,13, 8 ,7148,1349,1137,9634
2/13/2018,2018,2,13, 9 ,7883,1519,1314,10716
2/13/2018,2018,2,13, 10 ,8406,1600,1402,11408
2/13/2018,2018,2,13, 11 ,8668,1615,1467,11750
2/13/2018,2018,2,13, 12 ,8413,1540,1460,11413
2/13/2018,2018,2,13, 13 ,8360,1513,1456,11329
2/13/2018,2018,2,13, 14 ,8577,1546,1524,11647
2/13/2018,2018,2,13, 15 ,8521,1575,1537,11633
2/13/2018,2018,2,13, 16 ,8370,1567,1507,11444
2/13/2018,2018,2,13, 17 ,8081,1559,1454,11094
2/13/2018,2018,2,13, 18 ,8031,1630,1516,11177
2/13/2018,2018,2,13, 19 ,8193,1610,1528,11331
2/13/2018,2018,2,13, 20 ,7945,1502,1480,10927
2/13/2018,2018,2,13, 21 ,7678,1404,1423,10505
2/13/2018,2018,2,13, 22 ,7288,1267,1296,9851
2/13/2018,2018,2,13, 23 ,6830,1181,1178,9189
2/13/2018,2018,2,13, 24 ,6476,1133,1110,8719
2/14/2018,2018,2,14, 1 ,6136,1097,1065,8298
2/14/2018,2018,2,14, 2 ,5992,1077,1038,8107
2/14/2018,2018,2,14, 3 ,5889,1070,1007,7966
2/14/2018,2018,2,14, 4 ,5852,1067,1001,7920
2/14/2018,2018,2,14, 5 ,6025,1105,1040,8170
2/14/2018,2018,2,14, 6 ,6317,1182,1086,8585
2/14/2018,2018,2,14, 7 ,6353,1201,1046,8600
2/14/2018,2018,2,14, 8 ,6970,1260,1170,9400
2/14/2018,2018,2,14, 9 ,7659,1462,1355,10476
2/14/2018,2018,2,14, 10 ,8080,1548,1467,11095
2/14/2018,2018,2,14, 11 ,8418,1631,1532,11581
2/14/2018,2018,2,14, 12 ,8154,1573,1495,11222
2/14/2018,2018,2,14, 13 ,8128,1573,1507,11208
2/14/2018,2018,2,14, 14 ,8499,1618,1574,11691
2/14/2018,2018,2,14, 15 ,8375,1627,1568,11570
2/14/2018,2018,2,14, 16 ,8245,1610,1537,11392
2/14/2018,2018,2,14, 17 ,8016,1570,1473,11059
2/14/2018,2018,2,14, 18 ,7957,1642,1498,11097
2/14/2018,2018,2,14, 19 ,8083,1673,1540,11296
2/14/2018,2018,2,14, 20 ,7926,1589,1484,10999
2/14/2018,2018,2,14, 21 ,7603,1521,1415,10539
2/14/2018,2018,2,14, 22 ,7290,1407,1316,10013
2/14/2018,2018,2,14, 23 ,6907,1300,1225,9432
2/14/2018,2018,2,14, 24 ,6589,1229,1134,8952
2/15/2018,2018,2,15, 1 ,6293,1181,1094,8568
2/15/2018,2018,2,15, 2 ,6094,1153,1064,8311
2/15/2018,2018,2,15, 3 ,5998,1131,1033,8162
2/15/2018,2018,2,15, 4 ,5902,1127,1019,8048
2/15/2018,2018,2,15, 5 ,6149,1164,1054,8367
2/15/2018,2018,2,15, 6 ,6346,1235,1071,8652
2/15/2018,2018,2,15, 7 ,6402,1217,1043,8662
2/15/2018,2018,2,15, 8 ,7139,1340,1177,9656
2/15/2018,2018,2,15, 9 ,7937,1570,1387,10894
2/15/2018,2018,2,15, 10 ,8468,1656,1522,11646
2/15/2018,2018,2,15, 11 ,8728,1742,1568,12038
2/15/2018,2018,2,15, 12 ,8565,1719,1576,11860
2/15/2018,2018,2,15, 13 ,8592,1729,1578,11899
2/15/2018,2018,2,15, 14 ,8841,1787,1643,12271
2/15/2018,2018,2,15, 15 ,8818,1764,1589,12171
2/15/2018,2018,2,15, 16 ,8650,1741,1571,11962
2/15/2018,2018,2,15, 17 ,8380,1669,1514,11563
2/15/2018,2018,2,15, 18 ,8216,1716,1557,11489
2/15/2018,2018,2,15, 19 ,8569,1786,1586,11941
2/15/2018,2018,2,15, 20 ,8371,1695,1513,11579
2/15/2018,2018,2,15, 21 ,8112,1615,1445,11172
2/15/2018,2018,2,15, 22 ,7678,1490,1259,10427
2/15/2018,2018,2,15, 23 ,7287,1385,1145,9817
2/15/2018,2018,2,15, 24 ,6884,1306,1093,9283
2/16/2018,2018,2,16, 1 ,6603,1239,1085,8927
2/16/2018,2018,2,16, 2 ,6350,1201,1050,8601
2/16/2018,2018,2,16, 3 ,6227,1168,1016,8411
2/16/2018,2018,2,16, 4 ,6083,1154,1002,8239
2/16/2018,2018,2,16, 5 ,6046,1165,1004,8215
2/16/2018,2018,2,16, 6 ,6054,1184,1033,8271
2/16/2018,2018,2,16, 7 ,6087,1184,1032,8303
2/16/2018,2018,2,16, 8 ,6535,1271,1089,8895
2/16/2018,2018,2,16, 9 ,7128,1458,1222,9808
2/16/2018,2018,2,16, 10 ,7745,1562,1371,10678
2/16/2018,2018,2,16, 11 ,8027,1642,1448,11117
2/16/2018,2018,2,16, 12 ,8019,1621,1430,11070
2/16/2018,2018,2,16, 13 ,8059,1627,1456,11142
2/16/2018,2018,2,16, 14 ,8294,1690,1503,11487
2/16/2018,2018,2,16, 15 ,8258,1668,1507,11433
2/16/2018,2018,2,16, 16 ,8140,1632,1482,11254
2/16/2018,2018,2,16, 17 ,7951,1573,1429,10953
2/16/2018,2018,2,16, 18 ,7907,1654,1477,11038
2/16/2018,2018,2,16, 19 ,8455,1761,1569,11785
2/16/2018,2018,2,16, 20 ,8342,1695,1483,11520
2/16/2018,2018,2,16, 21 ,8215,1624,1468,11307
2/16/2018,2018,2,16, 22 ,7963,1504,1330,10797
2/16/2018,2018,2,16, 23 ,7526,1386,1219,10131
2/16/2018,2018,2,16, 24 ,7047,1305,1211,9563
2/17/2018,2018,2,17, 1 ,6831,1259,1091,9181
2/17/2018,2018,2,17, 2 ,6599,1221,1055,8875
2/17/2018,2018,2,17, 3 ,6378,1176,1023,8577
2/17/2018,2018,2,17, 4 ,6290,1161,935,8386
2/17/2018,2018,2,17, 5 ,6268,1182,1011,8461
2/17/2018,2018,2,17, 6 ,6301,1211,1040,8552
2/17/2018,2018,2,17, 7 ,6304,1184,1064,8552
2/17/2018,2018,2,17, 8 ,6761,1309,1141,9211
2/17/2018,2018,2,17, 9 ,7423,1475,1270,10168
2/17/2018,2018,2,17, 10 ,8030,1556,1401,10987
2/17/2018,2018,2,17, 11 ,8364,1607,1483,11454
2/17/2018,2018,2,17, 12 ,8220,1573,1461,11254
2/17/2018,2018,2,17, 13 ,8210,1574,1464,11248
2/17/2018,2018,2,17, 14 ,8491,1611,1514,11616
2/17/2018,2018,2,17, 15 ,8447,1570,1506,11523
2/17/2018,2018,2,17, 16 ,8235,1532,1485,11252
2/17/2018,2018,2,17, 17 ,7819,1495,1447,10761
2/17/2018,2018,2,17, 18 ,7825,1618,1518,10961
2/17/2018,2018,2,17, 19 ,8228,1713,1589,11530
2/17/2018,2018,2,17, 20 ,8167,1642,1505,11314
2/17/2018,2018,2,17, 21 ,8010,1569,1506,11085
2/17/2018,2018,2,17, 22 ,7640,1463,1384,10487
2/17/2018,2018,2,17, 23 ,7339,1354,1272,9965
2/17/2018,2018,2,17, 24 ,6909,1254,1165,9328
2/18/2018,2018,2,18, 1 ,6602,1205,1114,8921
2/18/2018,2018,2,18, 2 ,6338,1160,1061,8559
2/18/2018,2018,2,18, 3 ,6165,1131,1027,8323
2/18/2018,2018,2,18, 4 ,6060,1113,1009,8182
2/18/2018,2018,2,18, 5 ,5948,1120,1007,8075
2/18/2018,2018,2,18, 6 ,5937,1146,1011,8094
2/18/2018,2018,2,18, 7 ,5866,1135,992,7993
2/18/2018,2018,2,18, 8 ,6179,1214,1051,8444
2/18/2018,2018,2,18, 9 ,6636,1307,1102,9045
2/18/2018,2018,2,18, 10 ,7130,1400,1198,9728
2/18/2018,2018,2,18, 11 ,7420,1472,1270,10162
2/18/2018,2018,2,18, 12 ,7346,1473,1265,10084
2/18/2018,2018,2,18, 13 ,7365,1487,1267,10119
2/18/2018,2018,2,18, 14 ,7437,1491,1253,10181
2/18/2018,2018,2,18, 15 ,7411,1452,1234,10097
2/18/2018,2018,2,18, 16 ,7274,1404,1217,9895
2/18/2018,2018,2,18, 17 ,7166,1408,1245,9819
2/18/2018,2018,2,18, 18 ,7254,1553,1366,10173
2/18/2018,2018,2,18, 19 ,7837,1682,1435,10954
2/18/2018,2018,2,18, 20 ,7865,1630,1393,10888
2/18/2018,2018,2,18, 21 ,7703,1593,1363,10659
2/18/2018,2018,2,18, 22 ,7484,1486,1221,10191
2/18/2018,2018,2,18, 23 ,7114,1385,1123,9622
2/18/2018,2018,2,18, 24 ,6697,1273,1050,9020
2/19/2018,2018,2,19, 1 ,6333,1199,996,8528
2/19/2018,2018,2,19, 2 ,6121,1161,959,8241
2/19/2018,2018,2,19, 3 ,6105,1131,946,8182
2/19/2018,2018,2,19, 4 ,5907,1123,943,7973
2/19/2018,2018,2,19, 5 ,5979,1165,993,8137
2/19/2018,2018,2,19, 6 ,6202,1243,1034,8479
2/19/2018,2018,2,19, 7 ,6318,1201,1003,8522
2/19/2018,2018,2,19, 8 ,7121,1337,1131,9589
2/19/2018,2018,2,19, 9 ,8096,1566,1359,11021
2/19/2018,2018,2,19, 10 ,8653,1683,1491,11827
2/19/2018,2018,2,19, 11 ,8946,1765,1593,12304
2/19/2018,2018,2,19, 12 ,8753,1779,1565,12097
2/19/2018,2018,2,19, 13 ,8818,1775,1573,12166
2/19/2018,2018,2,19, 14 ,9263,1841,1629,12733
2/19/2018,2018,2,19, 15 ,9248,1827,1630,12705
2/19/2018,2018,2,19, 16 ,9137,1801,1582,12520
2/19/2018,2018,2,19, 17 ,8690,1719,1540,11949
2/19/2018,2018,2,19, 18 ,8467,1770,1560,11797
2/19/2018,2018,2,19, 19 ,8727,1819,1619,12165
2/19/2018,2018,2,19, 20 ,8574,1753,1558,11885
2/19/2018,2018,2,19, 21 ,8243,1666,1494,11403
2/19/2018,2018,2,19, 22 ,7846,1530,1354,10730
2/19/2018,2018,2,19, 23 ,7451,1425,1238,10114
2/19/2018,2018,2,19, 24 ,7003,1336,1149,9488
2/20/2018,2018,2,20, 1 ,6717,1282,1113,9112
2/20/2018,2018,2,20, 2 ,6435,1249,1079,8763
2/20/2018,2018,2,20, 3 ,6255,1215,1041,8511
2/20/2018,2018,2,20, 4 ,6166,1205,1035,8406
2/20/2018,2018,2,20, 5 ,6312,1235,1093,8640
2/20/2018,2018,2,20, 6 ,6583,1293,1164,9040
2/20/2018,2018,2,20, 7 ,6564,1242,1057,8863
2/20/2018,2018,2,20, 8 ,7238,1365,1192,9795
2/20/2018,2018,2,20, 9 ,8211,1587,1398,11196
2/20/2018,2018,2,20, 10 ,8744,1711,1519,11974
2/20/2018,2018,2,20, 11 ,9095,1793,1595,12483
2/20/2018,2018,2,20, 12 ,8981,1736,1600,12317
2/20/2018,2018,2,20, 13 ,9034,1734,1609,12377
2/20/2018,2018,2,20, 14 ,9412,1819,1690,12921
2/20/2018,2018,2,20, 15 ,9364,1794,1675,12833
2/20/2018,2018,2,20, 16 ,9160,1779,1639,12578
2/20/2018,2018,2,20, 17 ,8763,1723,1563,12049
2/20/2018,2018,2,20, 18 ,8533,1743,1591,11867
2/20/2018,2018,2,20, 19 ,8763,1816,1612,12191
2/20/2018,2018,2,20, 20 ,8631,1736,1588,11955
2/20/2018,2018,2,20, 21 ,8400,1669,1524,11593
2/20/2018,2018,2,20, 22 ,8059,1535,1385,10979
2/20/2018,2018,2,20, 23 ,7652,1434,1229,10315
2/20/2018,2018,2,20, 24 ,7254,1349,1170,9773
2/21/2018,2018,2,21, 1 ,6897,1274,1120,9291
2/21/2018,2018,2,21, 2 ,6628,1239,1083,8950
2/21/2018,2018,2,21, 3 ,6456,1214,1048,8718
2/21/2018,2018,2,21, 4 ,6365,1194,1037,8596
2/21/2018,2018,2,21, 5 ,6540,1238,1072,8850
2/21/2018,2018,2,21, 6 ,6770,1306,1155,9231
2/21/2018,2018,2,21, 7 ,6769,1251,1064,9084
2/21/2018,2018,2,21, 8 ,7495,1417,1201,10113
2/21/2018,2018,2,21, 9 ,8348,1634,1417,11399
2/21/2018,2018,2,21, 10 ,8833,1742,1561,12136
2/21/2018,2018,2,21, 11 ,9157,1818,1609,12584
2/21/2018,2018,2,21, 12 ,8901,1783,1598,12282
2/21/2018,2018,2,21, 13 ,8929,1794,1573,12296
2/21/2018,2018,2,21, 14 ,9325,1865,1641,12831
2/21/2018,2018,2,21, 15 ,9265,1864,1666,12795
2/21/2018,2018,2,21, 16 ,9101,1840,1632,12573
2/21/2018,2018,2,21, 17 ,8771,1754,1572,12097
2/21/2018,2018,2,21, 18 ,8607,1764,1610,11981
2/21/2018,2018,2,21, 19 ,8908,1884,1678,12470
2/21/2018,2018,2,21, 20 ,8756,1814,1608,12178
2/21/2018,2018,2,21, 21 ,8532,1712,1542,11786
2/21/2018,2018,2,21, 22 ,8103,1596,1396,11095
2/21/2018,2018,2,21, 23 ,7724,1461,1274,10459
2/21/2018,2018,2,21, 24 ,7330,1374,1188,9892
2/22/2018,2018,2,22, 1 ,7002,1320,1136,9458
2/22/2018,2018,2,22, 2 ,6759,1271,1102,9132
2/22/2018,2018,2,22, 3 ,6516,1225,1069,8810
2/22/2018,2018,2,22, 4 ,6417,1208,1051,8676
2/22/2018,2018,2,22, 5 ,6573,1254,1093,8920
2/22/2018,2018,2,22, 6 ,6800,1312,1165,9277
2/22/2018,2018,2,22, 7 ,6769,1258,1057,9084
2/22/2018,2018,2,22, 8 ,7626,1411,1203,10240
2/22/2018,2018,2,22, 9 ,8497,1629,1409,11535
2/22/2018,2018,2,22, 10 ,9032,1747,1508,12287
2/22/2018,2018,2,22, 11 ,9316,1830,1610,12756
2/22/2018,2018,2,22, 12 ,9024,1779,1590,12393
2/22/2018,2018,2,22, 13 ,9094,1781,1585,12460
2/22/2018,2018,2,22, 14 ,9518,1878,1629,13025
2/22/2018,2018,2,22, 15 ,9458,1848,1618,12924
2/22/2018,2018,2,22, 16 ,9267,1810,1609,12686
2/22/2018,2018,2,22, 17 ,8918,1722,1558,12198
2/22/2018,2018,2,22, 18 ,8600,1780,1580,11960
2/22/2018,2018,2,22, 19 ,8940,1860,1644,12444
2/22/2018,2018,2,22, 20 ,8695,1783,1594,12072
2/22/2018,2018,2,22, 21 ,8471,1704,1509,11684
2/22/2018,2018,2,22, 22 ,8096,1570,1392,11058
2/22/2018,2018,2,22, 23 ,7669,1459,1233,10361
2/22/2018,2018,2,22, 24 ,7265,1366,1200,9831
2/23/2018,2018,2,23, 1 ,6840,1320,1133,9293
2/23/2018,2018,2,23, 2 ,6608,1284,1108,9000
2/23/2018,2018,2,23, 3 ,6462,1260,1070,8792
2/23/2018,2018,2,23, 4 ,6377,1233,1054,8664
2/23/2018,2018,2,23, 5 ,6497,1276,1101,8874
2/23/2018,2018,2,23, 6 ,6617,1331,1163,9111
2/23/2018,2018,2,23, 7 ,6704,1282,1076,9062
2/23/2018,2018,2,23, 8 ,7399,1393,1205,9997
2/23/2018,2018,2,23, 9 ,8266,1623,1451,11340
2/23/2018,2018,2,23, 10 ,8811,1743,1567,12121
2/23/2018,2018,2,23, 11 ,9102,1815,1639,12556
2/23/2018,2018,2,23, 12 ,8905,1788,1608,12301
2/23/2018,2018,2,23, 13 ,8967,1794,1624,12385
2/23/2018,2018,2,23, 14 ,9268,1838,1668,12774
2/23/2018,2018,2,23, 15 ,9228,1831,1649,12708
2/23/2018,2018,2,23, 16 ,9038,1796,1629,12463
2/23/2018,2018,2,23, 17 ,8608,1710,1535,11853
2/23/2018,2018,2,23, 18 ,8349,1736,1564,11649
2/23/2018,2018,2,23, 19 ,8639,1829,1635,12103
2/23/2018,2018,2,23, 20 ,8486,1761,1557,11804
2/23/2018,2018,2,23, 21 ,8262,1692,1517,11471
2/23/2018,2018,2,23, 22 ,7925,1570,1364,10859
2/23/2018,2018,2,23, 23 ,7510,1454,1262,10226
2/23/2018,2018,2,23, 24 ,7102,1380,1232,9714
2/24/2018,2018,2,24, 1 ,6854,1302,1135,9291
2/24/2018,2018,2,24, 2 ,6602,1265,1101,8968
2/24/2018,2018,2,24, 3 ,6366,1247,1066,8679
2/24/2018,2018,2,24, 4 ,6236,1217,1041,8494
2/24/2018,2018,2,24, 5 ,6191,1238,1039,8468
2/24/2018,2018,2,24, 6 ,6256,1274,1093,8623
2/24/2018,2018,2,24, 7 ,6324,1254,1095,8673
2/24/2018,2018,2,24, 8 ,6820,1318,1158,9296
2/24/2018,2018,2,24, 9 ,7531,1457,1252,10240
2/24/2018,2018,2,24, 10 ,8098,1556,1318,10972
2/24/2018,2018,2,24, 11 ,8314,1597,1363,11274
2/24/2018,2018,2,24, 12 ,8216,1567,1336,11119
2/24/2018,2018,2,24, 13 ,8226,1585,1336,11147
2/24/2018,2018,2,24, 14 ,8450,1621,1373,11444
2/24/2018,2018,2,24, 15 ,8421,1589,1343,11353
2/24/2018,2018,2,24, 16 ,8213,1579,1328,11120
2/24/2018,2018,2,24, 17 ,7851,1535,1364,10750
2/24/2018,2018,2,24, 18 ,7787,1650,1402,10839
2/24/2018,2018,2,24, 19 ,8244,1707,1464,11415
2/24/2018,2018,2,24, 20 ,8143,1661,1415,11219
2/24/2018,2018,2,24, 21 ,8019,1591,1357,10967
2/24/2018,2018,2,24, 22 ,7780,1509,1239,10528
2/24/2018,2018,2,24, 23 ,7438,1393,1134,9965
2/24/2018,2018,2,24, 24 ,7024,1282,1044,9350
2/25/2018,2018,2,25, 1 ,6681,1226,1013,8920
2/25/2018,2018,2,25, 2 ,6461,1196,979,8636
2/25/2018,2018,2,25, 3 ,6283,1154,954,8391
2/25/2018,2018,2,25, 4 ,6083,1138,914,8135
2/25/2018,2018,2,25, 5 ,6025,1137,894,8056
2/25/2018,2018,2,25, 6 ,5938,1140,912,7990
2/25/2018,2018,2,25, 7 ,5851,1146,946,7943
2/25/2018,2018,2,25, 8 ,6118,1174,945,8237
2/25/2018,2018,2,25, 9 ,6507,1264,1001,8772
2/25/2018,2018,2,25, 10 ,7022,1343,1121,9486
2/25/2018,2018,2,25, 11 ,7198,1388,1186,9772
2/25/2018,2018,2,25, 12 ,7175,1381,1201,9757
2/25/2018,2018,2,25, 13 ,7096,1377,1222,9695
2/25/2018,2018,2,25, 14 ,7189,1374,1275,9838
2/25/2018,2018,2,25, 15 ,7115,1363,1255,9733
2/25/2018,2018,2,25, 16 ,6996,1347,1224,9567
2/25/2018,2018,2,25, 17 ,6860,1374,1241,9475
2/25/2018,2018,2,25, 18 ,7067,1535,1349,9951
2/25/2018,2018,2,25, 19 ,7601,1605,1455,10661
2/25/2018,2018,2,25, 20 ,7650,1563,1414,10627
2/25/2018,2018,2,25, 21 ,7548,1491,1335,10374
2/25/2018,2018,2,25, 22 ,7237,1388,1218,9843
2/25/2018,2018,2,25, 23 ,6918,1296,1108,9322
2/25/2018,2018,2,25, 24 ,6575,1212,1094,8881
2/26/2018,2018,2,26, 1 ,6257,1161,995,8413
2/26/2018,2018,2,26, 2 ,6052,1126,934,8112
2/26/2018,2018,2,26, 3 ,5856,1112,929,7897
2/26/2018,2018,2,26, 4 ,5748,1102,899,7749
2/26/2018,2018,2,26, 5 ,5974,1148,968,8090
2/26/2018,2018,2,26, 6 ,6248,1232,1062,8542
2/26/2018,2018,2,26, 7 ,6422,1198,986,8606
2/26/2018,2018,2,26, 8 ,7247,1330,1112,9689
2/26/2018,2018,2,26, 9 ,8143,1557,1349,11049
2/26/2018,2018,2,26, 10 ,8799,1705,1496,12000
2/26/2018,2018,2,26, 11 ,9113,1781,1570,12464
2/26/2018,2018,2,26, 12 ,8968,1745,1538,12251
2/26/2018,2018,2,26, 13 ,8936,1760,1558,12254
2/26/2018,2018,2,26, 14 ,9335,1802,1621,12758
2/26/2018,2018,2,26, 15 ,9298,1834,1636,12768
2/26/2018,2018,2,26, 16 ,9113,1787,1574,12474
2/26/2018,2018,2,26, 17 ,8967,1703,1543,12213
2/26/2018,2018,2,26, 18 ,8475,1761,1573,11809
2/26/2018,2018,2,26, 19 ,8672,1819,1648,12139
2/26/2018,2018,2,26, 20 ,8538,1739,1576,11853
2/26/2018,2018,2,26, 21 ,8376,1663,1517,11556
2/26/2018,2018,2,26, 22 ,7960,1538,1337,10835
2/26/2018,2018,2,26, 23 ,7597,1425,1253,10275
2/26/2018,2018,2,26, 24 ,7190,1337,1167,9694
2/27/2018,2018,2,27, 1 ,6889,1285,1115,9289
2/27/2018,2018,2,27, 2 ,6663,1249,1090,9002
2/27/2018,2018,2,27, 3 ,6466,1212,1060,8738
2/27/2018,2018,2,27, 4 ,6363,1209,1032,8604
2/27/2018,2018,2,27, 5 ,6531,1249,1080,8860
2/27/2018,2018,2,27, 6 ,6730,1317,1155,9202
2/27/2018,2018,2,27, 7 ,6776,1261,1053,9090
2/27/2018,2018,2,27, 8 ,7568,1422,1201,10191
2/27/2018,2018,2,27, 9 ,8399,1631,1419,11449
2/27/2018,2018,2,27, 10 ,8878,1774,1560,12212
2/27/2018,2018,2,27, 11 ,9163,1826,1638,12627
2/27/2018,2018,2,27, 12 ,8851,1785,1556,12192
2/27/2018,2018,2,27, 13 ,8911,1810,1573,12294
2/27/2018,2018,2,27, 14 ,9182,1862,1662,12706
2/27/2018,2018,2,27, 15 ,9106,1848,1638,12592
2/27/2018,2018,2,27, 16 ,8971,1808,1604,12383
2/27/2018,2018,2,27, 17 ,8608,1735,1533,11876
2/27/2018,2018,2,27, 18 ,8398,1787,1588,11773
2/27/2018,2018,2,27, 19 ,8677,1876,1590,12143
2/27/2018,2018,2,27, 20 ,8452,1789,1487,11728
2/27/2018,2018,2,27, 21 ,8260,1713,1470,11443
2/27/2018,2018,2,27, 22 ,7828,1564,1325,10717
2/27/2018,2018,2,27, 23 ,7492,1442,1222,10156
2/27/2018,2018,2,27, 24 ,7112,1346,1196,9654
2/28/2018,2018,2,28, 1 ,6789,1300,1099,9188
2/28/2018,2018,2,28, 2 ,6562,1266,1077,8905
2/28/2018,2018,2,28, 3 ,6354,1241,1040,8635
2/28/2018,2018,2,28, 4 ,6316,1215,1017,8548
2/28/2018,2018,2,28, 5 ,6436,1265,1066,8767
2/28/2018,2018,2,28, 6 ,6663,1325,1144,9132
2/28/2018,2018,2,28, 7 ,6661,1268,1036,8965
2/28/2018,2018,2,28, 8 ,7435,1407,1176,10018
2/28/2018,2018,2,28, 9 ,8172,1641,1391,11204
2/28/2018,2018,2,28, 10 ,8729,1774,1544,12047
2/28/2018,2018,2,28, 11 ,9015,1836,1610,12461
2/28/2018,2018,2,28, 12 ,8907,1801,1549,12257
2/28/2018,2018,2,28, 13 ,8922,1799,1576,12297
2/28/2018,2018,2,28, 14 ,9323,1895,1606,12824
2/28/2018,2018,2,28, 15 ,9313,1886,1601,12800
2/28/2018,2018,2,28, 16 ,9200,1840,1553,12593
2/28/2018,2018,2,28, 17 ,8767,1755,1532,12054
2/28/2018,2018,2,28, 18 ,8563,1776,1571,11910
2/28/2018,2018,2,28, 19 ,8933,1870,1621,12424
2/28/2018,2018,2,28, 20 ,8768,1811,1556,12135
2/28/2018,2018,2,28, 21 ,8558,1734,1504,11796
2/28/2018,2018,2,28, 22 ,8247,1599,1369,11215
2/28/2018,2018,2,28, 23 ,7717,1486,1263,10466
2/28/2018,2018,2,28, 24 ,7363,1396,1154,9913
3/1/2018,2018,3,1, 1 ,7052,1338,1079,9469
3/1/2018,2018,3,1, 2 ,6782,1301,1077,9160
3/1/2018,2018,3,1, 3 ,6597,1259,1040,8896
3/1/2018,2018,3,1, 4 ,6475,1252,1028,8755
3/1/2018,2018,3,1, 5 ,6569,1290,1081,8940
3/1/2018,2018,3,1, 6 ,6759,1338,1162,9259
3/1/2018,2018,3,1, 7 ,6764,1287,1059,9110
3/1/2018,2018,3,1, 8 ,7584,1416,1149,10149
3/1/2018,2018,3,1, 9 ,8500,1649,1414,11563
3/1/2018,2018,3,1, 10 ,9010,1805,1542,12357
3/1/2018,2018,3,1, 11 ,9377,1849,1642,12868
3/1/2018,2018,3,1, 12 ,9140,1830,1609,12579
3/1/2018,2018,3,1, 13 ,9212,1822,1628,12662
3/1/2018,2018,3,1, 14 ,9627,1894,1689,13210
3/1/2018,2018,3,1, 15 ,9537,1879,1666,13082
3/1/2018,2018,3,1, 16 ,9330,1855,1621,12806
3/1/2018,2018,3,1, 17 ,8914,1778,1543,12235
3/1/2018,2018,3,1, 18 ,8659,1774,1614,12047
3/1/2018,2018,3,1, 19 ,8946,1884,1668,12498
3/1/2018,2018,3,1, 20 ,8800,1820,1584,12204
3/1/2018,2018,3,1, 21 ,8592,1734,1505,11831
3/1/2018,2018,3,1, 22 ,8223,1611,1368,11202
3/1/2018,2018,3,1, 23 ,7852,1492,1263,10607
3/1/2018,2018,3,1, 24 ,7448,1389,1189,10026
3/2/2018,2018,3,2, 1 ,7181,1335,1150,9666
3/2/2018,2018,3,2, 2 ,6965,1276,1079,9320
3/2/2018,2018,3,2, 3 ,6753,1250,1072,9075
3/2/2018,2018,3,2, 4 ,6621,1232,1050,8903
3/2/2018,2018,3,2, 5 ,6711,1275,1096,9082
3/2/2018,2018,3,2, 6 ,6860,1323,1139,9322
3/2/2018,2018,3,2, 7 ,6904,1255,1077,9236
3/2/2018,2018,3,2, 8 ,7666,1414,1204,10284
3/2/2018,2018,3,2, 9 ,8563,1643,1397,11603
3/2/2018,2018,3,2, 10 ,9075,1793,1552,12420
3/2/2018,2018,3,2, 11 ,9440,1863,1639,12942
3/2/2018,2018,3,2, 12 ,9139,1817,1603,12559
3/2/2018,2018,3,2, 13 ,9200,1827,1590,12617
3/2/2018,2018,3,2, 14 ,9573,1892,1665,13130
3/2/2018,2018,3,2, 15 ,9478,1869,1625,12972
3/2/2018,2018,3,2, 16 ,9299,1820,1490,12609
3/2/2018,2018,3,2, 17 ,8873,1735,1439,12047
3/2/2018,2018,3,2, 18 ,8587,1779,1507,11873
3/2/2018,2018,3,2, 19 ,8920,1868,1582,12370
3/2/2018,2018,3,2, 20 ,8748,1796,1528,12072
3/2/2018,2018,3,2, 21 ,8609,1732,1454,11795
3/2/2018,2018,3,2, 22 ,8307,1619,1359,11285
3/2/2018,2018,3,2, 23 ,7838,1497,1245,10580
3/2/2018,2018,3,2, 24 ,7528,1417,1126,10071
3/3/2018,2018,3,3, 1 ,7171,1349,1107,9627
3/3/2018,2018,3,3, 2 ,6969,1311,1070,9350
3/3/2018,2018,3,3, 3 ,6775,1264,1027,9066
3/3/2018,2018,3,3, 4 ,6541,1250,995,8786
3/3/2018,2018,3,3, 5 ,6521,1258,1036,8815
3/3/2018,2018,3,3, 6 ,6561,1277,1067,8905
3/3/2018,2018,3,3, 7 ,6603,1261,1013,8877
3/3/2018,2018,3,3, 8 ,7143,1369,1113,9625
3/3/2018,2018,3,3, 9 ,7872,1534,1257,10663
3/3/2018,2018,3,3, 10 ,8476,1642,1391,11509
3/3/2018,2018,3,3, 11 ,8749,1707,1473,11929
3/3/2018,2018,3,3, 12 ,8582,1681,1455,11718
3/3/2018,2018,3,3, 13 ,8548,1666,1493,11707
3/3/2018,2018,3,3, 14 ,8818,1716,1552,12086
3/3/2018,2018,3,3, 15 ,8738,1696,1534,11968
3/3/2018,2018,3,3, 16 ,8460,1650,1470,11580
3/3/2018,2018,3,3, 17 ,8165,1584,1419,11168
3/3/2018,2018,3,3, 18 ,8121,1675,1506,11302
3/3/2018,2018,3,3, 19 ,8577,1783,1558,11918
3/3/2018,2018,3,3, 20 ,8505,1718,1513,11736
3/3/2018,2018,3,3, 21 ,8433,1676,1458,11567
3/3/2018,2018,3,3, 22 ,8191,1574,1356,11121
3/3/2018,2018,3,3, 23 ,7782,1468,1252,10502
3/3/2018,2018,3,3, 24 ,7359,1383,1156,9898
3/4/2018,2018,3,4, 1 ,7101,1322,1123,9546
3/4/2018,2018,3,4, 2 ,6791,1280,1045,9116
3/4/2018,2018,3,4, 3 ,6571,1239,1052,8862
3/4/2018,2018,3,4, 4 ,6440,1225,1007,8672
3/4/2018,2018,3,4, 5 ,6334,1219,1010,8563
3/4/2018,2018,3,4, 6 ,6158,1225,1022,8405
3/4/2018,2018,3,4, 7 ,6119,1203,1004,8326
3/4/2018,2018,3,4, 8 ,6359,1245,1027,8631
3/4/2018,2018,3,4, 9 ,6835,1325,1133,9293
3/4/2018,2018,3,4, 10 ,7333,1420,1207,9960
3/4/2018,2018,3,4, 11 ,7590,1470,1283,10343
3/4/2018,2018,3,4, 12 ,7570,1476,1301,10347
3/4/2018,2018,3,4, 13 ,7589,1474,1307,10370
3/4/2018,2018,3,4, 14 ,7740,1468,1317,10525
3/4/2018,2018,3,4, 15 ,7719,1441,1291,10451
3/4/2018,2018,3,4, 16 ,7530,1432,1273,10235
3/4/2018,2018,3,4, 17 ,7350,1448,1276,10074
3/4/2018,2018,3,4, 18 ,7375,1573,1366,10314
3/4/2018,2018,3,4, 19 ,7983,1686,1484,11153
3/4/2018,2018,3,4, 20 ,8021,1650,1439,11110
3/4/2018,2018,3,4, 21 ,7922,1580,1382,10884
3/4/2018,2018,3,4, 22 ,7669,1503,1267,10439
3/4/2018,2018,3,4, 23 ,7286,1406,1153,9845
3/4/2018,2018,3,4, 24 ,6960,1310,1125,9395
3/5/2018,2018,3,5, 1 ,6685,1255,1046,8986
3/5/2018,2018,3,5, 2 ,6349,1208,1009,8566
3/5/2018,2018,3,5, 3 ,6247,1179,978,8404
3/5/2018,2018,3,5, 4 ,6043,1160,969,8172
3/5/2018,2018,3,5, 5 ,6207,1211,1025,8443
3/5/2018,2018,3,5, 6 ,6437,1277,1095,8809
3/5/2018,2018,3,5, 7 ,6564,1230,1025,8819
3/5/2018,2018,3,5, 8 ,7429,1393,1170,9992
3/5/2018,2018,3,5, 9 ,8359,1627,1379,11365
3/5/2018,2018,3,5, 10 ,8936,1759,1517,12212
3/5/2018,2018,3,5, 11 ,9311,1831,1589,12731
3/5/2018,2018,3,5, 12 ,9162,1821,1580,12563
3/5/2018,2018,3,5, 13 ,9247,1804,1597,12648
3/5/2018,2018,3,5, 14 ,9642,1859,1670,13171
3/5/2018,2018,3,5, 15 ,9604,1859,1653,13116
3/5/2018,2018,3,5, 16 ,9501,1831,1627,12959
3/5/2018,2018,3,5, 17 ,9083,1736,1542,12361
3/5/2018,2018,3,5, 18 ,8698,1752,1592,12042
3/5/2018,2018,3,5, 19 ,9067,1850,1648,12565
3/5/2018,2018,3,5, 20 ,8983,1788,1567,12338
3/5/2018,2018,3,5, 21 ,8831,1729,1513,12073
3/5/2018,2018,3,5, 22 ,8324,1605,1359,11288
3/5/2018,2018,3,5, 23 ,7940,1484,1243,10667
3/5/2018,2018,3,5, 24 ,7546,1399,1170,10115
3/6/2018,2018,3,6, 1 ,7202,1330,1111,9643
3/6/2018,2018,3,6, 2 ,6979,1291,1074,9344
3/6/2018,2018,3,6, 3 ,6787,1259,1050,9096
3/6/2018,2018,3,6, 4 ,6622,1247,1038,8907
3/6/2018,2018,3,6, 5 ,6771,1288,1081,9140
3/6/2018,2018,3,6, 6 ,6910,1337,1149,9396
3/6/2018,2018,3,6, 7 ,6951,1276,1063,9290
3/6/2018,2018,3,6, 8 ,7706,1438,1202,10346
3/6/2018,2018,3,6, 9 ,8624,1677,1432,11733
3/6/2018,2018,3,6, 10 ,9084,1806,1560,12450
3/6/2018,2018,3,6, 11 ,9531,1874,1621,13026
3/6/2018,2018,3,6, 12 ,9385,1833,1590,12808
3/6/2018,2018,3,6, 13 ,9399,1849,1613,12861
3/6/2018,2018,3,6, 14 ,9871,1914,1691,13476
3/6/2018,2018,3,6, 15 ,9787,1913,1667,13367
3/6/2018,2018,3,6, 16 ,9606,1870,1645,13121
3/6/2018,2018,3,6, 17 ,9125,1778,1569,12472
3/6/2018,2018,3,6, 18 ,8896,1826,1592,12314
3/6/2018,2018,3,6, 19 ,9182,1913,1655,12750
3/6/2018,2018,3,6, 20 ,9057,1837,1617,12511
3/6/2018,2018,3,6, 21 ,8942,1771,1537,12250
3/6/2018,2018,3,6, 22 ,8520,1614,1381,11515
3/6/2018,2018,3,6, 23 ,8055,1497,1271,10823
3/6/2018,2018,3,6, 24 ,7679,1404,1194,10277
3/7/2018,2018,3,7, 1 ,7386,1357,1148,9891
3/7/2018,2018,3,7, 2 ,7148,1307,1098,9553
3/7/2018,2018,3,7, 3 ,6869,1271,1058,9198
3/7/2018,2018,3,7, 4 ,6791,1256,1053,9100
3/7/2018,2018,3,7, 5 ,6853,1299,1102,9254
3/7/2018,2018,3,7, 6 ,6983,1348,1085,9416
3/7/2018,2018,3,7, 7 ,6985,1301,1059,9345
3/7/2018,2018,3,7, 8 ,7801,1435,1209,10445
3/7/2018,2018,3,7, 9 ,8677,1656,1401,11734
3/7/2018,2018,3,7, 10 ,9172,1798,1545,12515
3/7/2018,2018,3,7, 11 ,9508,1857,1641,13006
3/7/2018,2018,3,7, 12 ,9327,1814,1610,12751
3/7/2018,2018,3,7, 13 ,9282,1816,1594,12692
3/7/2018,2018,3,7, 14 ,9562,1851,1680,13093
3/7/2018,2018,3,7, 15 ,9542,1872,1656,13070
3/7/2018,2018,3,7, 16 ,9391,1845,1634,12870
3/7/2018,2018,3,7, 17 ,8963,1737,1584,12284
3/7/2018,2018,3,7, 18 ,8789,1757,1615,12161
3/7/2018,2018,3,7, 19 ,9144,1859,1645,12648
3/7/2018,2018,3,7, 20 ,9029,1795,1591,12415
3/7/2018,2018,3,7, 21 ,8776,1713,1547,12036
3/7/2018,2018,3,7, 22 ,8445,1591,1394,11430
3/7/2018,2018,3,7, 23 ,8033,1479,1269,10781
3/7/2018,2018,3,7, 24 ,7608,1406,1187,10201
3/8/2018,2018,3,8, 1 ,7263,1353,1136,9752
3/8/2018,2018,3,8, 2 ,7036,1306,1094,9436
3/8/2018,2018,3,8, 3 ,6792,1261,1055,9108
3/8/2018,2018,3,8, 4 ,6675,1254,1048,8977
3/8/2018,2018,3,8, 5 ,6790,1293,1090,9173
3/8/2018,2018,3,8, 6 ,6986,1347,1150,9483
3/8/2018,2018,3,8, 7 ,6951,1281,1060,9292
3/8/2018,2018,3,8, 8 ,7705,1455,1190,10350
3/8/2018,2018,3,8, 9 ,8677,1681,1406,11764
3/8/2018,2018,3,8, 10 ,9150,1783,1558,12491
3/8/2018,2018,3,8, 11 ,9431,1860,1632,12923
3/8/2018,2018,3,8, 12 ,9184,1812,1601,12597
3/8/2018,2018,3,8, 13 ,9240,1831,1612,12683
3/8/2018,2018,3,8, 14 ,9464,1914,1700,13078
3/8/2018,2018,3,8, 15 ,9237,1894,1710,12841
3/8/2018,2018,3,8, 16 ,9061,1837,1664,12562
3/8/2018,2018,3,8, 17 ,8762,1764,1579,12105
3/8/2018,2018,3,8, 18 ,8615,1763,1610,11988
3/8/2018,2018,3,8, 19 ,8927,1877,1669,12473
3/8/2018,2018,3,8, 20 ,8780,1805,1593,12178
3/8/2018,2018,3,8, 21 ,8616,1753,1533,11902
3/8/2018,2018,3,8, 22 ,8167,1606,1329,11102
3/8/2018,2018,3,8, 23 ,7788,1488,1224,10500
3/8/2018,2018,3,8, 24 ,7402,1402,1161,9965
3/9/2018,2018,3,9, 1 ,7053,1337,1118,9508
3/9/2018,2018,3,9, 2 ,6806,1302,1075,9183
3/9/2018,2018,3,9, 3 ,6561,1254,1042,8857
3/9/2018,2018,3,9, 4 ,6510,1249,1045,8804
3/9/2018,2018,3,9, 5 ,6601,1277,1064,8942
3/9/2018,2018,3,9, 6 ,6745,1317,1125,9187
3/9/2018,2018,3,9, 7 ,6740,1292,1046,9078
3/9/2018,2018,3,9, 8 ,7423,1433,1189,10045
3/9/2018,2018,3,9, 9 ,8114,1663,1415,11192
3/9/2018,2018,3,9, 10 ,8679,1787,1555,12021
3/9/2018,2018,3,9, 11 ,8924,1859,1610,12393
3/9/2018,2018,3,9, 12 ,8710,1815,1599,12124
3/9/2018,2018,3,9, 13 ,8732,1822,1605,12159
3/9/2018,2018,3,9, 14 ,9063,1887,1645,12595
3/9/2018,2018,3,9, 15 ,8952,1864,1627,12443
3/9/2018,2018,3,9, 16 ,8792,1810,1608,12210
3/9/2018,2018,3,9, 17 ,8416,1712,1528,11656
3/9/2018,2018,3,9, 18 ,8272,1721,1569,11562
3/9/2018,2018,3,9, 19 ,8573,1825,1636,12034
3/9/2018,2018,3,9, 20 ,8388,1745,1557,11690
3/9/2018,2018,3,9, 21 ,8106,1692,1503,11301
3/9/2018,2018,3,9, 22 ,7828,1559,1358,10745
3/9/2018,2018,3,9, 23 ,7392,1456,1269,10117
3/9/2018,2018,3,9, 24 ,6947,1379,1179,9505
3/10/2018,2018,3,10, 1 ,6638,1333,1138,9109
3/10/2018,2018,3,10, 2 ,6488,1278,1092,8858
3/10/2018,2018,3,10, 3 ,6294,1237,1058,8589
3/10/2018,2018,3,10, 4 ,6167,1217,1045,8429
3/10/2018,2018,3,10, 5 ,6123,1238,1063,8424
3/10/2018,2018,3,10, 6 ,6208,1259,1049,8516
3/10/2018,2018,3,10, 7 ,6283,1248,1042,8573
3/10/2018,2018,3,10, 8 ,6831,1362,1142,9335
3/10/2018,2018,3,10, 9 ,7506,1543,1299,10348
3/10/2018,2018,3,10, 10 ,7966,1650,1421,11037
3/10/2018,2018,3,10, 11 ,8178,1737,1492,11407
3/10/2018,2018,3,10, 12 ,7918,1706,1477,11101
3/10/2018,2018,3,10, 13 ,7810,1719,1498,11027
3/10/2018,2018,3,10, 14 ,8044,1758,1565,11367
3/10/2018,2018,3,10, 15 ,7954,1738,1553,11245
3/10/2018,2018,3,10, 16 ,7793,1689,1509,10991
3/10/2018,2018,3,10, 17 ,7506,1611,1435,10552
3/10/2018,2018,3,10, 18 ,7478,1675,1516,10669
3/10/2018,2018,3,10, 19 ,7894,1788,1585,11267
3/10/2018,2018,3,10, 20 ,7773,1723,1552,11048
3/10/2018,2018,3,10, 21 ,7490,1658,1492,10640
3/10/2018,2018,3,10, 22 ,7200,1557,1389,10146
3/10/2018,2018,3,10, 23 ,6812,1464,1253,9529
3/10/2018,2018,3,10, 24 ,6464,1358,1153,8975
3/11/2018,2018,3,11, 1 ,6109,1303,1102,8514
3/11/2018,2018,3,11, 2 ,5930,1277,1072,8279
3/11/2018,2018,3,11, 3 ,5796,1248,1041,8085
3/11/2018,2018,3,11, 4 ,5695,1236,1032,7963
3/11/2018,2018,3,11, 5 ,5630,1232,1035,7897
3/11/2018,2018,3,11, 6 ,5574,1225,1044,7843
3/11/2018,2018,3,11, 7 ,5621,1225,1019,7865
3/11/2018,2018,3,11, 8 ,5862,1274,1060,8196
3/11/2018,2018,3,11, 9 ,6267,1353,1135,8755
3/11/2018,2018,3,11, 10 ,6739,1433,1241,9413
3/11/2018,2018,3,11, 11 ,6989,1489,1310,9788
3/11/2018,2018,3,11, 12 ,6905,1468,1313,9686
3/11/2018,2018,3,11, 13 ,6827,1466,1322,9615
3/11/2018,2018,3,11, 14 ,6890,1453,1331,9674
3/11/2018,2018,3,11, 15 ,6874,1437,1321,9632
3/11/2018,2018,3,11, 16 ,6781,1424,1287,9492
3/11/2018,2018,3,11, 17 ,6728,1433,1311,9472
3/11/2018,2018,3,11, 18 ,6836,1580,1389,9805
3/11/2018,2018,3,11, 19 ,7338,1650,1500,10488
3/11/2018,2018,3,11, 20 ,7277,1593,1487,10357
3/11/2018,2018,3,11, 21 ,7135,1527,1426,10088
3/11/2018,2018,3,11, 22 ,6764,1416,1327,9507
3/11/2018,2018,3,11, 23 ,6440,1333,1198,8971
3/11/2018,2018,3,11, 24 ,6092,1257,1109,8458
3/12/2018,2018,3,12, 1 ,5844,1191,1069,8104
3/12/2018,2018,3,12, 2 ,5611,1157,1031,7799
3/12/2018,2018,3,12, 3 ,5479,1127,998,7604
3/12/2018,2018,3,12, 4 ,5460,1119,979,7558
3/12/2018,2018,3,12, 5 ,5726,1166,1032,7924
3/12/2018,2018,3,12, 6 ,6041,1257,1102,8400
3/12/2018,2018,3,12, 7 ,6200,1237,1028,8465
3/12/2018,2018,3,12, 8 ,6978,1323,1187,9488
3/12/2018,2018,3,12, 9 ,7824,1525,1407,10756
3/12/2018,2018,3,12, 10 ,8334,1625,1552,11511
3/12/2018,2018,3,12, 11 ,8592,1689,1627,11908
3/12/2018,2018,3,12, 12 ,8480,1647,1628,11755
3/12/2018,2018,3,12, 13 ,8432,1629,1626,11687
3/12/2018,2018,3,12, 14 ,8797,1687,1706,12190
3/12/2018,2018,3,12, 15 ,8811,1684,1687,12182
3/12/2018,2018,3,12, 16 ,8621,1648,1653,11922
3/12/2018,2018,3,12, 17 ,8225,1618,1578,11421
3/12/2018,2018,3,12, 18 ,8006,1716,1585,11307
3/12/2018,2018,3,12, 19 ,8366,1731,1657,11754
3/12/2018,2018,3,12, 20 ,8192,1653,1611,11456
3/12/2018,2018,3,12, 21 ,7953,1548,1532,11033
3/12/2018,2018,3,12, 22 ,7488,1384,1395,10267
3/12/2018,2018,3,12, 23 ,7043,1276,1266,9585
3/12/2018,2018,3,12, 24 ,6656,1206,1137,8999
3/13/2018,2018,3,13, 1 ,6377,1168,1137,8682
3/13/2018,2018,3,13, 2 ,6164,1134,1131,8429
3/13/2018,2018,3,13, 3 ,5998,1113,1098,8209
3/13/2018,2018,3,13, 4 ,5912,1112,1077,8101
3/13/2018,2018,3,13, 5 ,6171,1161,1122,8454
3/13/2018,2018,3,13, 6 ,6451,1254,1158,8863
3/13/2018,2018,3,13, 7 ,6534,1219,1075,8828
3/13/2018,2018,3,13, 8 ,7257,1346,1233,9836
3/13/2018,2018,3,13, 9 ,8143,1555,1445,11143
3/13/2018,2018,3,13, 10 ,8591,1663,1509,11763
3/13/2018,2018,3,13, 11 ,8913,1681,1621,12215
3/13/2018,2018,3,13, 12 ,8747,1633,1601,11981
3/13/2018,2018,3,13, 13 ,8753,1625,1610,11988
3/13/2018,2018,3,13, 14 ,9196,1677,1674,12547
3/13/2018,2018,3,13, 15 ,9113,1681,1653,12447
3/13/2018,2018,3,13, 16 ,8973,1667,1614,12254
3/13/2018,2018,3,13, 17 ,8591,1627,1547,11765
3/13/2018,2018,3,13, 18 ,8396,1706,1576,11678
3/13/2018,2018,3,13, 19 ,8700,1754,1634,12088
3/13/2018,2018,3,13, 20 ,8516,1677,1546,11739
3/13/2018,2018,3,13, 21 ,8233,1587,1500,11320
3/13/2018,2018,3,13, 22 ,7811,1441,1361,10613
3/13/2018,2018,3,13, 23 ,7335,1343,1208,9886
3/13/2018,2018,3,13, 24 ,6952,1268,1184,9404
3/14/2018,2018,3,14, 1 ,6611,1218,1125,8954
3/14/2018,2018,3,14, 2 ,6427,1184,1072,8683
3/14/2018,2018,3,14, 3 ,6218,1146,1036,8400
3/14/2018,2018,3,14, 4 ,6160,1141,1024,8325
3/14/2018,2018,3,14, 5 ,6319,1186,1068,8573
3/14/2018,2018,3,14, 6 ,6524,1262,1158,8944
3/14/2018,2018,3,14, 7 ,6590,1224,1072,8886
3/14/2018,2018,3,14, 8 ,7287,1371,1221,9879
3/14/2018,2018,3,14, 9 ,8214,1587,1446,11247
3/14/2018,2018,3,14, 10 ,8703,1707,1572,11982
3/14/2018,2018,3,14, 11 ,9022,1783,1629,12434
3/14/2018,2018,3,14, 12 ,8861,1747,1604,12212
3/14/2018,2018,3,14, 13 ,8819,1760,1622,12201
3/14/2018,2018,3,14, 14 ,9238,1819,1665,12722
3/14/2018,2018,3,14, 15 ,9177,1815,1673,12665
3/14/2018,2018,3,14, 16 ,9043,1751,1627,12421
3/14/2018,2018,3,14, 17 ,8579,1684,1568,11831
3/14/2018,2018,3,14, 18 ,8316,1697,1597,11610
3/14/2018,2018,3,14, 19 ,8650,1786,1649,12085
3/14/2018,2018,3,14, 20 ,8408,1727,1597,11732
3/14/2018,2018,3,14, 21 ,8172,1647,1533,11352
3/14/2018,2018,3,14, 22 ,7726,1515,1406,10647
3/14/2018,2018,3,14, 23 ,7253,1390,1284,9927
3/14/2018,2018,3,14, 24 ,6928,1323,1210,9461
3/15/2018,2018,3,15, 1 ,6594,1263,1160,9017
3/15/2018,2018,3,15, 2 ,6406,1224,1113,8743
3/15/2018,2018,3,15, 3 ,6232,1192,1075,8499
3/15/2018,2018,3,15, 4 ,6130,1193,1068,8391
3/15/2018,2018,3,15, 5 ,6281,1234,1113,8628
3/15/2018,2018,3,15, 6 ,6500,1298,1180,8978
3/15/2018,2018,3,15, 7 ,6576,1246,1097,8919
3/15/2018,2018,3,15, 8 ,7277,1385,1189,9851
3/15/2018,2018,3,15, 9 ,8203,1614,1433,11250
3/15/2018,2018,3,15, 10 ,8732,1726,1552,12010
3/15/2018,2018,3,15, 11 ,9034,1786,1623,12443
3/15/2018,2018,3,15, 12 ,8915,1757,1614,12286
3/15/2018,2018,3,15, 13 ,8970,1733,1639,12342
3/15/2018,2018,3,15, 14 ,9447,1822,1708,12977
3/15/2018,2018,3,15, 15 ,9385,1831,1702,12918
3/15/2018,2018,3,15, 16 ,9208,1802,1657,12667
3/15/2018,2018,3,15, 17 ,8788,1714,1576,12078
3/15/2018,2018,3,15, 18 ,8499,1759,1623,11881
3/15/2018,2018,3,15, 19 ,8829,1845,1673,12347
3/15/2018,2018,3,15, 20 ,8742,1776,1514,12032
3/15/2018,2018,3,15, 21 ,8458,1692,1446,11596
3/15/2018,2018,3,15, 22 ,8124,1551,1355,11030
3/15/2018,2018,3,15, 23 ,7730,1431,1303,10464
3/15/2018,2018,3,15, 24 ,7294,1333,1224,9851
3/16/2018,2018,3,16, 1 ,6983,1303,1166,9452
3/16/2018,2018,3,16, 2 ,6740,1273,1134,9147
3/16/2018,2018,3,16, 3 ,6493,1227,1094,8814
3/16/2018,2018,3,16, 4 ,6411,1226,1083,8720
3/16/2018,2018,3,16, 5 ,6573,1271,1124,8968
3/16/2018,2018,3,16, 6 ,6716,1299,1151,9166
3/16/2018,2018,3,16, 7 ,6739,1249,1097,9085
3/16/2018,2018,3,16, 8 ,7551,1420,1230,10201
3/16/2018,2018,3,16, 9 ,8440,1651,1474,11565
3/16/2018,2018,3,16, 10 ,8975,1792,1576,12343
3/16/2018,2018,3,16, 11 ,9288,1808,1644,12740
3/16/2018,2018,3,16, 12 ,9113,1818,1643,12574
3/16/2018,2018,3,16, 13 ,9189,1830,1654,12673
3/16/2018,2018,3,16, 14 ,9569,1896,1688,13153
3/16/2018,2018,3,16, 15 ,9571,1882,1718,13171
3/16/2018,2018,3,16, 16 ,9371,1823,1670,12864
3/16/2018,2018,3,16, 17 ,8909,1715,1556,12180
3/16/2018,2018,3,16, 18 ,8720,1752,1598,12070
3/16/2018,2018,3,16, 19 ,8971,1836,1654,12461
3/16/2018,2018,3,16, 20 ,8809,1782,1629,12220
3/16/2018,2018,3,16, 21 ,8655,1719,1547,11921
3/16/2018,2018,3,16, 22 ,8330,1558,1401,11289
3/16/2018,2018,3,16, 23 ,7925,1449,1272,10646
3/16/2018,2018,3,16, 24 ,7488,1380,1263,10131
3/17/2018,2018,3,17, 1 ,7199,1314,1188,9701
3/17/2018,2018,3,17, 2 ,6929,1278,1148,9355
3/17/2018,2018,3,17, 3 ,6718,1248,1109,9075
3/17/2018,2018,3,17, 4 ,6526,1232,1086,8844
3/17/2018,2018,3,17, 5 ,6443,1231,1088,8762
3/17/2018,2018,3,17, 6 ,6461,1227,1110,8798
3/17/2018,2018,3,17, 7 ,6523,1221,1094,8838
3/17/2018,2018,3,17, 8 ,7201,1343,1190,9734
3/17/2018,2018,3,17, 9 ,7875,1507,1324,10706
3/17/2018,2018,3,17, 10 ,8331,1591,1455,11377
3/17/2018,2018,3,17, 11 ,8616,1644,1504,11764
3/17/2018,2018,3,17, 12 ,8370,1618,1501,11489
3/17/2018,2018,3,17, 13 ,8489,1626,1515,11630
3/17/2018,2018,3,17, 14 ,8796,1661,1532,11989
3/17/2018,2018,3,17, 15 ,8745,1660,1517,11922
3/17/2018,2018,3,17, 16 ,8494,1605,1493,11592
3/17/2018,2018,3,17, 17 ,8134,1547,1430,11111
3/17/2018,2018,3,17, 18 ,8033,1625,1430,11088
3/17/2018,2018,3,17, 19 ,8488,1762,1568,11818
3/17/2018,2018,3,17, 20 ,8417,1757,1556,11730
3/17/2018,2018,3,17, 21 ,8296,1700,1486,11482
3/17/2018,2018,3,17, 22 ,8089,1632,1398,11119
3/17/2018,2018,3,17, 23 ,7695,1514,1286,10495
3/17/2018,2018,3,17, 24 ,7280,1411,1185,9876
3/18/2018,2018,3,18, 1 ,7041,1330,1168,9539
3/18/2018,2018,3,18, 2 ,6778,1288,1126,9192
3/18/2018,2018,3,18, 3 ,6530,1258,1078,8866
3/18/2018,2018,3,18, 4 ,6362,1239,1033,8634
3/18/2018,2018,3,18, 5 ,6271,1225,1051,8547
3/18/2018,2018,3,18, 6 ,6058,1222,979,8259
3/18/2018,2018,3,18, 7 ,6046,1208,942,8196
3/18/2018,2018,3,18, 8 ,6372,1270,944,8586
3/18/2018,2018,3,18, 9 ,6836,1351,1039,9226
3/18/2018,2018,3,18, 10 ,7402,1439,1143,9984
3/18/2018,2018,3,18, 11 ,7630,1497,1202,10329
3/18/2018,2018,3,18, 12 ,7584,1496,1214,10294
3/18/2018,2018,3,18, 13 ,7607,1503,1239,10349
3/18/2018,2018,3,18, 14 ,7756,1526,1275,10557
3/18/2018,2018,3,18, 15 ,7653,1506,1290,10449
3/18/2018,2018,3,18, 16 ,7498,1479,1257,10234
3/18/2018,2018,3,18, 17 ,7331,1494,1254,10079
3/18/2018,2018,3,18, 18 ,7457,1585,1297,10339
3/18/2018,2018,3,18, 19 ,8081,1727,1456,11264
3/18/2018,2018,3,18, 20 ,8077,1696,1452,11225
3/18/2018,2018,3,18, 21 ,7965,1620,1435,11020
3/18/2018,2018,3,18, 22 ,7704,1531,1361,10596
3/18/2018,2018,3,18, 23 ,7298,1434,1268,10000
3/18/2018,2018,3,18, 24 ,6933,1341,1101,9375
3/19/2018,2018,3,19, 1 ,6632,1299,1080,9011
3/19/2018,2018,3,19, 2 ,6338,1242,1056,8636
3/19/2018,2018,3,19, 3 ,6168,1204,1048,8420
3/19/2018,2018,3,19, 4 ,6008,1178,1025,8211
3/19/2018,2018,3,19, 5 ,6158,1225,1056,8439
3/19/2018,2018,3,19, 6 ,6302,1304,1118,8724
3/19/2018,2018,3,19, 7 ,6474,1270,1050,8794
3/19/2018,2018,3,19, 8 ,7334,1425,1165,9924
3/19/2018,2018,3,19, 9 ,8286,1649,1365,11300
3/19/2018,2018,3,19, 10 ,8896,1775,1466,12137
3/19/2018,2018,3,19, 11 ,9279,1859,1512,12650
3/19/2018,2018,3,19, 12 ,9172,1833,1477,12482
3/19/2018,2018,3,19, 13 ,9209,1851,1482,12542
3/19/2018,2018,3,19, 14 ,9691,1930,1515,13136
3/19/2018,2018,3,19, 15 ,9575,1913,1482,12970
3/19/2018,2018,3,19, 16 ,9436,1879,1462,12777
3/19/2018,2018,3,19, 17 ,9028,1769,1467,12264
3/19/2018,2018,3,19, 18 ,8620,1811,1475,11906
3/19/2018,2018,3,19, 19 ,8949,1901,1533,12383
3/19/2018,2018,3,19, 20 ,8792,1819,1421,12032
3/19/2018,2018,3,19, 21 ,8704,1751,1384,11839
3/19/2018,2018,3,19, 22 ,8310,1607,1242,11159
3/19/2018,2018,3,19, 23 ,7887,1484,1137,10508
3/19/2018,2018,3,19, 24 ,7462,1398,1069,9929
3/20/2018,2018,3,20, 1 ,7135,1352,993,9480
3/20/2018,2018,3,20, 2 ,6899,1311,996,9206
3/20/2018,2018,3,20, 3 ,6639,1278,962,8879
3/20/2018,2018,3,20, 4 ,6479,1262,961,8702
3/20/2018,2018,3,20, 5 ,6629,1295,998,8922
3/20/2018,2018,3,20, 6 ,6682,1346,1047,9075
3/20/2018,2018,3,20, 7 ,6767,1310,1007,9084
3/20/2018,2018,3,20, 8 ,7559,1468,1144,10171
3/20/2018,2018,3,20, 9 ,8465,1685,1360,11510
3/20/2018,2018,3,20, 10 ,9085,1845,1487,12417
3/20/2018,2018,3,20, 11 ,9401,1892,1594,12887
3/20/2018,2018,3,20, 12 ,9305,1853,1580,12738
3/20/2018,2018,3,20, 13 ,9332,1885,1595,12812
3/20/2018,2018,3,20, 14 ,9699,1956,1661,13316
3/20/2018,2018,3,20, 15 ,9650,1935,1639,13224
3/20/2018,2018,3,20, 16 ,9441,1883,1567,12891
3/20/2018,2018,3,20, 17 ,8903,1800,1533,12236
3/20/2018,2018,3,20, 18 ,8636,1818,1567,12021
3/20/2018,2018,3,20, 19 ,8991,1899,1615,12505
3/20/2018,2018,3,20, 20 ,8828,1822,1548,12198
3/20/2018,2018,3,20, 21 ,8752,1768,1472,11992
3/20/2018,2018,3,20, 22 ,8436,1627,1340,11403
3/20/2018,2018,3,20, 23 ,7955,1527,1232,10714
3/20/2018,2018,3,20, 24 ,7552,1447,1146,10145
3/21/2018,2018,3,21, 1 ,7213,1325,1100,9638
3/21/2018,2018,3,21, 2 ,6956,1288,1068,9312
3/21/2018,2018,3,21, 3 ,6703,1245,1039,8987
3/21/2018,2018,3,21, 4 ,6607,1263,1025,8895
3/21/2018,2018,3,21, 5 ,6602,1303,1063,8968
3/21/2018,2018,3,21, 6 ,6696,1344,1136,9176
3/21/2018,2018,3,21, 7 ,6865,1315,1062,9242
3/21/2018,2018,3,21, 8 ,7617,1484,1192,10293
3/21/2018,2018,3,21, 9 ,8553,1717,1410,11680
3/21/2018,2018,3,21, 10 ,9029,1838,1533,12400
3/21/2018,2018,3,21, 11 ,9407,1915,1621,12943
3/21/2018,2018,3,21, 12 ,9283,1870,1599,12752
3/21/2018,2018,3,21, 13 ,9278,1849,1591,12718
3/21/2018,2018,3,21, 14 ,9664,1927,1644,13235
3/21/2018,2018,3,21, 15 ,9597,1902,1589,13088
3/21/2018,2018,3,21, 16 ,9402,1878,1568,12848
3/21/2018,2018,3,21, 17 ,8935,1776,1541,12252
3/21/2018,2018,3,21, 18 ,8714,1806,1579,12099
3/21/2018,2018,3,21, 19 ,8983,1903,1581,12467
3/21/2018,2018,3,21, 20 ,8796,1822,1502,12120
3/21/2018,2018,3,21, 21 ,8628,1737,1469,11834
3/21/2018,2018,3,21, 22 ,8243,1608,1328,11179
3/21/2018,2018,3,21, 23 ,7764,1488,1216,10468
3/21/2018,2018,3,21, 24 ,7398,1395,1134,9927
3/22/2018,2018,3,22, 1 ,7061,1329,1101,9491
3/22/2018,2018,3,22, 2 ,6850,1297,1054,9201
3/22/2018,2018,3,22, 3 ,6726,1262,1023,9011
3/22/2018,2018,3,22, 4 ,6536,1244,1006,8786
3/22/2018,2018,3,22, 5 ,6640,1266,1032,8938
3/22/2018,2018,3,22, 6 ,6726,1327,1108,9161
3/22/2018,2018,3,22, 7 ,6816,1301,1055,9172
3/22/2018,2018,3,22, 8 ,7539,1459,1223,10221
3/22/2018,2018,3,22, 9 ,8414,1698,1427,11539
3/22/2018,2018,3,22, 10 ,8857,1827,1562,12246
3/22/2018,2018,3,22, 11 ,9085,1900,1624,12609
3/22/2018,2018,3,22, 12 ,8796,1858,1602,12256
3/22/2018,2018,3,22, 13 ,8687,1856,1606,12149
3/22/2018,2018,3,22, 14 ,8959,1929,1650,12538
3/22/2018,2018,3,22, 15 ,8862,1911,1622,12395
3/22/2018,2018,3,22, 16 ,8712,1859,1582,12153
3/22/2018,2018,3,22, 17 ,8366,1769,1513,11648
3/22/2018,2018,3,22, 18 ,8280,1788,1538,11606
3/22/2018,2018,3,22, 19 ,8473,1892,1564,11929
3/22/2018,2018,3,22, 20 ,8336,1820,1522,11678
3/22/2018,2018,3,22, 21 ,8112,1733,1440,11285
3/22/2018,2018,3,22, 22 ,7740,1603,1316,10659
3/22/2018,2018,3,22, 23 ,7310,1499,1214,10023
3/22/2018,2018,3,22, 24 ,6865,1395,1129,9389
3/23/2018,2018,3,23, 1 ,6619,1343,1084,9046
3/23/2018,2018,3,23, 2 ,6460,1296,1056,8812
3/23/2018,2018,3,23, 3 ,6287,1274,1025,8586
3/23/2018,2018,3,23, 4 ,6174,1255,1018,8447
3/23/2018,2018,3,23, 5 ,6318,1274,1055,8647
3/23/2018,2018,3,23, 6 ,6429,1306,1122,8857
3/23/2018,2018,3,23, 7 ,6618,1298,1056,8972
3/23/2018,2018,3,23, 8 ,7266,1450,1187,9903
3/23/2018,2018,3,23, 9 ,8106,1678,1386,11170
3/23/2018,2018,3,23, 10 ,8525,1811,1542,11878
3/23/2018,2018,3,23, 11 ,8826,1876,1609,12311
3/23/2018,2018,3,23, 12 ,8647,1797,1580,12024
3/23/2018,2018,3,23, 13 ,8620,1806,1585,12011
3/23/2018,2018,3,23, 14 ,8911,1873,1651,12435
3/23/2018,2018,3,23, 15 ,8805,1850,1583,12238
3/23/2018,2018,3,23, 16 ,8646,1798,1586,12030
3/23/2018,2018,3,23, 17 ,8232,1739,1530,11501
3/23/2018,2018,3,23, 18 ,8003,1765,1544,11312
3/23/2018,2018,3,23, 19 ,8263,1835,1592,11690
3/23/2018,2018,3,23, 20 ,8020,1773,1513,11306
3/23/2018,2018,3,23, 21 ,7535,1701,1451,10687
3/23/2018,2018,3,23, 22 ,7485,1592,1328,10405
3/23/2018,2018,3,23, 23 ,7091,1460,1218,9769
3/23/2018,2018,3,23, 24 ,6753,1376,1156,9285
3/24/2018,2018,3,24, 1 ,6491,1302,1114,8907
3/24/2018,2018,3,24, 2 ,6297,1262,1077,8636
3/24/2018,2018,3,24, 3 ,6084,1238,1042,8364
3/24/2018,2018,3,24, 4 ,5969,1212,1028,8209
3/24/2018,2018,3,24, 5 ,5908,1232,1039,8179
3/24/2018,2018,3,24, 6 ,5969,1255,1048,8272
3/24/2018,2018,3,24, 7 ,6055,1267,1044,8366
3/24/2018,2018,3,24, 8 ,6596,1362,1142,9100
3/24/2018,2018,3,24, 9 ,7264,1539,1267,10070
3/24/2018,2018,3,24, 10 ,7819,1635,1404,10858
3/24/2018,2018,3,24, 11 ,8106,1695,1501,11302
3/24/2018,2018,3,24, 12 ,7918,1651,1463,11032
3/24/2018,2018,3,24, 13 ,7963,1608,1484,11055
3/24/2018,2018,3,24, 14 ,8091,1626,1513,11230
3/24/2018,2018,3,24, 15 ,7984,1617,1504,11105
3/24/2018,2018,3,24, 16 ,7807,1599,1434,10840
3/24/2018,2018,3,24, 17 ,7482,1557,1416,10455
3/24/2018,2018,3,24, 18 ,7427,1656,1533,10616
3/24/2018,2018,3,24, 19 ,7854,1747,1576,11177
3/24/2018,2018,3,24, 20 ,7712,1697,1519,10928
3/24/2018,2018,3,24, 21 ,7474,1610,1441,10525
3/24/2018,2018,3,24, 22 ,7189,1538,1358,10085
3/24/2018,2018,3,24, 23 ,6791,1418,1236,9445
3/24/2018,2018,3,24, 24 ,6442,1342,1160,8944
3/25/2018,2018,3,25, 1 ,6199,1287,1096,8582
3/25/2018,2018,3,25, 2 ,5996,1243,1034,8273
3/25/2018,2018,3,25, 3 ,5836,1216,1031,8083
3/25/2018,2018,3,25, 4 ,5706,1207,1008,7921
3/25/2018,2018,3,25, 5 ,5647,1197,1028,7872
3/25/2018,2018,3,25, 6 ,5563,1198,1035,7796
3/25/2018,2018,3,25, 7 ,5635,1181,1029,7845
3/25/2018,2018,3,25, 8 ,5939,1223,1070,8232
3/25/2018,2018,3,25, 9 ,6344,1294,1159,8797
3/25/2018,2018,3,25, 10 ,6883,1385,1238,9506
3/25/2018,2018,3,25, 11 ,7120,1441,1296,9857
3/25/2018,2018,3,25, 12 ,7066,1417,1302,9785
3/25/2018,2018,3,25, 13 ,7084,1423,1276,9783
3/25/2018,2018,3,25, 14 ,7196,1429,1339,9964
3/25/2018,2018,3,25, 15 ,7065,1402,1330,9797
3/25/2018,2018,3,25, 16 ,6922,1404,1295,9621
3/25/2018,2018,3,25, 17 ,6794,1399,1266,9459
3/25/2018,2018,3,25, 18 ,6951,1537,1421,9909
3/25/2018,2018,3,25, 19 ,7561,1645,1518,10724
3/25/2018,2018,3,25, 20 ,7541,1598,1483,10622
3/25/2018,2018,3,25, 21 ,7348,1514,1422,10284
3/25/2018,2018,3,25, 22 ,7005,1422,1317,9744
3/25/2018,2018,3,25, 23 ,6646,1348,1231,9225
3/25/2018,2018,3,25, 24 ,6288,1271,1155,8714
3/26/2018,2018,3,26, 1 ,6037,1218,1093,8348
3/26/2018,2018,3,26, 2 ,5800,1179,1057,8036
3/26/2018,2018,3,26, 3 ,5616,1159,1023,7798
3/26/2018,2018,3,26, 4 ,5600,1138,996,7734
3/26/2018,2018,3,26, 5 ,5667,1163,1042,7872
3/26/2018,2018,3,26, 6 ,5833,1224,1096,8153
3/26/2018,2018,3,26, 7 ,6100,1210,1064,8374
3/26/2018,2018,3,26, 8 ,6918,1360,1152,9430
3/26/2018,2018,3,26, 9 ,7821,1573,1383,10777
3/26/2018,2018,3,26, 10 ,8434,1683,1495,11612
3/26/2018,2018,3,26, 11 ,8757,1762,1579,12098
3/26/2018,2018,3,26, 12 ,8570,1723,1553,11846
3/26/2018,2018,3,26, 13 ,8590,1743,1540,11873
3/26/2018,2018,3,26, 14 ,8949,1799,1528,12276
3/26/2018,2018,3,26, 15 ,8837,1781,1522,12140
3/26/2018,2018,3,26, 16 ,8657,1756,1493,11906
3/26/2018,2018,3,26, 17 ,8289,1675,1456,11420
3/26/2018,2018,3,26, 18 ,8066,1699,1525,11290
3/26/2018,2018,3,26, 19 ,8391,1797,1543,11731
3/26/2018,2018,3,26, 20 ,8171,1711,1487,11369
3/26/2018,2018,3,26, 21 ,7894,1620,1416,10930
3/26/2018,2018,3,26, 22 ,7543,1467,1288,10298
3/26/2018,2018,3,26, 23 ,7134,1365,1184,9683
3/26/2018,2018,3,26, 24 ,6786,1297,1125,9208
3/27/2018,2018,3,27, 1 ,6467,1232,1076,8775
3/27/2018,2018,3,27, 2 ,6263,1195,1050,8508
3/27/2018,2018,3,27, 3 ,6028,1171,1016,8215
3/27/2018,2018,3,27, 4 ,5986,1152,995,8133
3/27/2018,2018,3,27, 5 ,6105,1166,1019,8290
3/27/2018,2018,3,27, 6 ,6198,1199,1090,8487
3/27/2018,2018,3,27, 7 ,6502,1197,1063,8762
3/27/2018,2018,3,27, 8 ,7092,1369,1185,9646
3/27/2018,2018,3,27, 9 ,7854,1592,1379,10825
3/27/2018,2018,3,27, 10 ,8424,1700,1514,11638
3/27/2018,2018,3,27, 11 ,8700,1762,1605,12067
3/27/2018,2018,3,27, 12 ,8540,1727,1563,11830
3/27/2018,2018,3,27, 13 ,8442,1731,1576,11749
3/27/2018,2018,3,27, 14 ,8816,1797,1640,12253
3/27/2018,2018,3,27, 15 ,8702,1777,1629,12108
3/27/2018,2018,3,27, 16 ,8608,1722,1591,11921
3/27/2018,2018,3,27, 17 ,8159,1638,1522,11319
3/27/2018,2018,3,27, 18 ,7976,1697,1560,11233
3/27/2018,2018,3,27, 19 ,8307,1761,1609,11677
3/27/2018,2018,3,27, 20 ,8074,1690,1522,11286
3/27/2018,2018,3,27, 21 ,7810,1591,1458,10859
3/27/2018,2018,3,27, 22 ,7477,1471,1389,10337
3/27/2018,2018,3,27, 23 ,7090,1364,1148,9602
3/27/2018,2018,3,27, 24 ,6708,1287,1106,9101
3/28/2018,2018,3,28, 1 ,6425,1223,1077,8725
3/28/2018,2018,3,28, 2 ,6256,1187,1044,8487
3/28/2018,2018,3,28, 3 ,6059,1157,1001,8217
3/28/2018,2018,3,28, 4 ,5901,1138,997,8036
3/28/2018,2018,3,28, 5 ,5949,1158,1019,8126
3/28/2018,2018,3,28, 6 ,6013,1190,1059,8262
3/28/2018,2018,3,28, 7 ,6193,1196,1042,8431
3/28/2018,2018,3,28, 8 ,6927,1340,1169,9436
3/28/2018,2018,3,28, 9 ,7741,1553,1373,10667
3/28/2018,2018,3,28, 10 ,8214,1662,1491,11367
3/28/2018,2018,3,28, 11 ,8528,1718,1579,11825
3/28/2018,2018,3,28, 12 ,8338,1665,1583,11586
3/28/2018,2018,3,28, 13 ,8189,1654,1569,11412
3/28/2018,2018,3,28, 14 ,8425,1696,1596,11717
3/28/2018,2018,3,28, 15 ,8324,1670,1586,11580
3/28/2018,2018,3,28, 16 ,8123,1629,1526,11278
3/28/2018,2018,3,28, 17 ,7659,1568,1438,10665
3/28/2018,2018,3,28, 18 ,7586,1643,1525,10754
3/28/2018,2018,3,28, 19 ,7883,1719,1563,11165
3/28/2018,2018,3,28, 20 ,7776,1655,1516,10947
3/28/2018,2018,3,28, 21 ,7568,1573,1451,10592
3/28/2018,2018,3,28, 22 ,7249,1449,1306,10004
3/28/2018,2018,3,28, 23 ,6829,1360,1209,9398
3/28/2018,2018,3,28, 24 ,6532,1271,1170,8973
3/29/2018,2018,3,29, 1 ,6211,1215,1046,8472
3/29/2018,2018,3,29, 2 ,6055,1170,1007,8232
3/29/2018,2018,3,29, 3 ,5794,1132,968,7894
3/29/2018,2018,3,29, 4 ,5628,1100,946,7674
3/29/2018,2018,3,29, 5 ,5510,1104,944,7558
3/29/2018,2018,3,29, 6 ,5307,1076,952,7335
3/29/2018,2018,3,29, 7 ,5211,1068,957,7236
3/29/2018,2018,3,29, 8 ,5370,1123,1019,7512
3/29/2018,2018,3,29, 9 ,5650,1209,1069,7928
3/29/2018,2018,3,29, 10 ,5834,1261,1180,8275
3/29/2018,2018,3,29, 11 ,6013,1318,1238,8569
3/29/2018,2018,3,29, 12 ,6067,1308,1253,8628
3/29/2018,2018,3,29, 13 ,6100,1317,1273,8690
3/29/2018,2018,3,29, 14 ,6237,1330,1283,8850
3/29/2018,2018,3,29, 15 ,6101,1301,1262,8664
3/29/2018,2018,3,29, 16 ,5956,1260,1224,8440
3/29/2018,2018,3,29, 17 ,5851,1242,1195,8288
3/29/2018,2018,3,29, 18 ,6049,1374,1238,8661
3/29/2018,2018,3,29, 19 ,6466,1484,1340,9290
3/29/2018,2018,3,29, 20 ,6502,1430,1304,9236
3/29/2018,2018,3,29, 21 ,6440,1388,1258,9086
3/29/2018,2018,3,29, 22 ,6296,1329,1223,8848
3/29/2018,2018,3,29, 23 ,6147,1242,1144,8533
3/29/2018,2018,3,29, 24 ,5787,1162,1051,8000
3/30/2018,2018,3,30, 1 ,5531,1112,986,7629
3/30/2018,2018,3,30, 2 ,5346,1073,944,7363
3/30/2018,2018,3,30, 3 ,5176,1042,909,7127
3/30/2018,2018,3,30, 4 ,5012,1017,888,6917
3/30/2018,2018,3,30, 5 ,4933,1012,878,6823
3/30/2018,2018,3,30, 6 ,4759,999,865,6623
3/30/2018,2018,3,30, 7 ,4727,1006,866,6599
3/30/2018,2018,3,30, 8 ,4788,1050,887,6725
3/30/2018,2018,3,30, 9 ,4974,1079,907,6960
3/30/2018,2018,3,30, 10 ,5203,1125,958,7286
3/30/2018,2018,3,30, 11 ,5385,1155,1008,7548
3/30/2018,2018,3,30, 12 ,5243,1149,1014,7406
3/30/2018,2018,3,30, 13 ,5402,1153,1020,7575
3/30/2018,2018,3,30, 14 ,5491,1157,1040,7688
3/30/2018,2018,3,30, 15 ,5525,1159,1004,7688
3/30/2018,2018,3,30, 16 ,5400,1135,973,7508
3/30/2018,2018,3,30, 17 ,5308,1107,965,7380
3/30/2018,2018,3,30, 18 ,5485,1225,1093,7803
3/30/2018,2018,3,30, 19 ,5906,1361,1255,8522
3/30/2018,2018,3,30, 20 ,5965,1363,1240,8568
3/30/2018,2018,3,30, 21 ,6037,1344,1215,8596
3/30/2018,2018,3,30, 22 ,6048,1295,1143,8486
3/30/2018,2018,3,30, 23 ,5963,1220,1065,8248
3/30/2018,2018,3,30, 24 ,5632,1148,925,7705
3/31/2018,2018,3,31, 1 ,5380,1096,944,7420
3/31/2018,2018,3,31, 2 ,5128,1062,901,7091
3/31/2018,2018,3,31, 3 ,4978,1033,873,6884
3/31/2018,2018,3,31, 4 ,4882,1012,857,6751
3/31/2018,2018,3,31, 5 ,4835,1018,857,6710
3/31/2018,2018,3,31, 6 ,4826,1024,878,6728
3/31/2018,2018,3,31, 7 ,4955,1061,919,6935
3/31/2018,2018,3,31, 8 ,5226,1146,1015,7387
3/31/2018,2018,3,31, 9 ,5640,1237,1111,7988
3/31/2018,2018,3,31, 10 ,6011,1322,1213,8546
3/31/2018,2018,3,31, 11 ,6254,1382,1291,8927
3/31/2018,2018,3,31, 12 ,6238,1380,1298,8916
3/31/2018,2018,3,31, 13 ,6239,1386,1291,8916
3/31/2018,2018,3,31, 14 ,6300,1397,1335,9032
3/31/2018,2018,3,31, 15 ,6304,1362,1294,8960
3/31/2018,2018,3,31, 16 ,6221,1336,1239,8796
3/31/2018,2018,3,31, 17 ,6138,1342,1292,8772
3/31/2018,2018,3,31, 18 ,6433,1475,1376,9284
3/31/2018,2018,3,31, 19 ,6851,1574,1419,9844
3/31/2018,2018,3,31, 20 ,6808,1518,1375,9701
3/31/2018,2018,3,31, 21 ,6659,1452,1340,9451
3/31/2018,2018,3,31, 22 ,6406,1368,1244,9018
3/31/2018,2018,3,31, 23 ,6087,1263,1145,8495
3/31/2018,2018,3,31, 24 ,5830,1200,1075,8105
4/1/2018,2018,4,1, 1 ,5569,1151,1018,7738
4/1/2018,2018,4,1, 2 ,5371,1111,990,7472
4/1/2018,2018,4,1, 3 ,5256,1077,962,7295
4/1/2018,2018,4,1, 4 ,5154,1062,935,7151
4/1/2018,2018,4,1, 5 ,5116,1061,928,7105
4/1/2018,2018,4,1, 6 ,5088,1060,937,7085
4/1/2018,2018,4,1, 7 ,5103,1075,959,7137
4/1/2018,2018,4,1, 8 ,5407,1115,1018,7540
4/1/2018,2018,4,1, 9 ,5816,1204,1045,8065
4/1/2018,2018,4,1, 10 ,6338,1294,1148,8780
4/1/2018,2018,4,1, 11 ,6563,1343,1236,9142
4/1/2018,2018,4,1, 12 ,6535,1352,1245,9132
4/1/2018,2018,4,1, 13 ,6517,1359,1265,9141
4/1/2018,2018,4,1, 14 ,6600,1370,1251,9221
4/1/2018,2018,4,1, 15 ,6645,1358,1242,9245
4/1/2018,2018,4,1, 16 ,6498,1326,1270,9094
4/1/2018,2018,4,1, 17 ,6411,1342,1246,8999
4/1/2018,2018,4,1, 18 ,6675,1456,1369,9500
4/1/2018,2018,4,1, 19 ,7243,1608,1416,10267
4/1/2018,2018,4,1, 20 ,7224,1547,1386,10157
4/1/2018,2018,4,1, 21 ,7126,1478,1326,9930
4/1/2018,2018,4,1, 22 ,6808,1377,1284,9469
4/1/2018,2018,4,1, 23 ,6512,1282,1177,8971
4/1/2018,2018,4,1, 24 ,6199,1218,1063,8480
4/2/2018,2018,4,2, 1 ,5841,1161,1035,8037
4/2/2018,2018,4,2, 2 ,5702,1123,997,7822
4/2/2018,2018,4,2, 3 ,5498,1094,972,7564
4/2/2018,2018,4,2, 4 ,5390,1086,963,7439
4/2/2018,2018,4,2, 5 ,5488,1113,982,7583
4/2/2018,2018,4,2, 6 ,5687,1155,1027,7869
4/2/2018,2018,4,2, 7 ,6005,1172,1013,8190
4/2/2018,2018,4,2, 8 ,6836,1347,1175,9358
4/2/2018,2018,4,2, 9 ,7773,1563,1404,10740
4/2/2018,2018,4,2, 10 ,8485,1694,1551,11730
4/2/2018,2018,4,2, 11 ,8883,1772,1652,12307
4/2/2018,2018,4,2, 12 ,8740,1747,1637,12124
4/2/2018,2018,4,2, 13 ,8671,1757,1653,12081
4/2/2018,2018,4,2, 14 ,8921,1841,1694,12456
4/2/2018,2018,4,2, 15 ,8917,1803,1680,12400
4/2/2018,2018,4,2, 16 ,8826,1782,1645,12253
4/2/2018,2018,4,2, 17 ,8455,1688,1572,11715
4/2/2018,2018,4,2, 18 ,8232,1714,1594,11540
4/2/2018,2018,4,2, 19 ,8514,1807,1635,11956
4/2/2018,2018,4,2, 20 ,8352,1739,1578,11669
4/2/2018,2018,4,2, 21 ,8137,1665,1514,11316
4/2/2018,2018,4,2, 22 ,7834,1536,1377,10747
4/2/2018,2018,4,2, 23 ,7386,1421,1274,10081
4/2/2018,2018,4,2, 24 ,7011,1338,1164,9513
4/3/2018,2018,4,3, 1 ,6749,1278,1136,9163
4/3/2018,2018,4,3, 2 ,6503,1239,1106,8848
4/3/2018,2018,4,3, 3 ,6318,1210,1069,8597
4/3/2018,2018,4,3, 4 ,6177,1196,1064,8437
4/3/2018,2018,4,3, 5 ,6225,1220,1081,8526
4/3/2018,2018,4,3, 6 ,6376,1248,1119,8743
4/3/2018,2018,4,3, 7 ,6599,1259,1092,8950
4/3/2018,2018,4,3, 8 ,7356,1426,1247,10029
4/3/2018,2018,4,3, 9 ,8272,1649,1459,11380
4/3/2018,2018,4,3, 10 ,8825,1782,1615,12222
4/3/2018,2018,4,3, 11 ,9191,1866,1693,12750
4/3/2018,2018,4,3, 12 ,8991,1811,1651,12453
4/3/2018,2018,4,3, 13 ,8886,1830,1678,12394
4/3/2018,2018,4,3, 14 ,9165,1900,1729,12794
4/3/2018,2018,4,3, 15 ,9035,1884,1707,12626
4/3/2018,2018,4,3, 16 ,8883,1842,1697,12422
4/3/2018,2018,4,3, 17 ,8612,1754,1596,11962
4/3/2018,2018,4,3, 18 ,8400,1767,1618,11785
4/3/2018,2018,4,3, 19 ,8752,1867,1656,12275
4/3/2018,2018,4,3, 20 ,8546,1796,1602,11944
4/3/2018,2018,4,3, 21 ,8380,1725,1507,11612
4/3/2018,2018,4,3, 22 ,7957,1595,1356,10908
4/3/2018,2018,4,3, 23 ,7499,1482,1253,10234
4/3/2018,2018,4,3, 24 ,7130,1397,1185,9712
4/4/2018,2018,4,4, 1 ,6845,1353,1150,9348
4/4/2018,2018,4,4, 2 ,6635,1301,1112,9048
4/4/2018,2018,4,4, 3 ,6399,1257,1076,8732
4/4/2018,2018,4,4, 4 ,6338,1243,1046,8627
4/4/2018,2018,4,4, 5 ,6339,1264,1083,8686
4/4/2018,2018,4,4, 6 ,6478,1284,1115,8877
4/4/2018,2018,4,4, 7 ,6705,1284,1106,9095
4/4/2018,2018,4,4, 8 ,7514,1442,1238,10194
4/4/2018,2018,4,4, 9 ,8355,1681,1460,11496
4/4/2018,2018,4,4, 10 ,8881,1793,1588,12262
4/4/2018,2018,4,4, 11 ,9168,1886,1666,12720
4/4/2018,2018,4,4, 12 ,8972,1838,1632,12442
4/4/2018,2018,4,4, 13 ,8929,1850,1636,12415
4/4/2018,2018,4,4, 14 ,9208,1925,1710,12843
4/4/2018,2018,4,4, 15 ,9076,1902,1681,12659
4/4/2018,2018,4,4, 16 ,8954,1862,1647,12463
4/4/2018,2018,4,4, 17 ,8584,1763,1568,11915
4/4/2018,2018,4,4, 18 ,8442,1778,1618,11838
4/4/2018,2018,4,4, 19 ,8708,1874,1639,12221
4/4/2018,2018,4,4, 20 ,8570,1809,1575,11954
4/4/2018,2018,4,4, 21 ,8355,1764,1497,11616
4/4/2018,2018,4,4, 22 ,8030,1634,1368,11032
4/4/2018,2018,4,4, 23 ,7600,1529,1257,10386
4/4/2018,2018,4,4, 24 ,7253,1436,1178,9867
4/5/2018,2018,4,5, 1 ,6885,1389,1130,9404
4/5/2018,2018,4,5, 2 ,6705,1338,1100,9143
4/5/2018,2018,4,5, 3 ,6465,1283,1071,8819
4/5/2018,2018,4,5, 4 ,6374,1260,1052,8686
4/5/2018,2018,4,5, 5 ,6394,1294,1084,8772
4/5/2018,2018,4,5, 6 ,6456,1308,1110,8874
4/5/2018,2018,4,5, 7 ,6698,1314,1096,9108
4/5/2018,2018,4,5, 8 ,7461,1477,1234,10172
4/5/2018,2018,4,5, 9 ,8325,1703,1386,11414
4/5/2018,2018,4,5, 10 ,8862,1836,1570,12268
4/5/2018,2018,4,5, 11 ,9164,1906,1639,12709
4/5/2018,2018,4,5, 12 ,8875,1861,1584,12320
4/5/2018,2018,4,5, 13 ,8799,1866,1594,12259
4/5/2018,2018,4,5, 14 ,9065,1899,1643,12607
4/5/2018,2018,4,5, 15 ,8982,1869,1622,12473
4/5/2018,2018,4,5, 16 ,8903,1846,1586,12335
4/5/2018,2018,4,5, 17 ,8605,1754,1532,11891
4/5/2018,2018,4,5, 18 ,8385,1759,1545,11689
4/5/2018,2018,4,5, 19 ,8679,1855,1556,12090
4/5/2018,2018,4,5, 20 ,8468,1794,1504,11766
4/5/2018,2018,4,5, 21 ,8252,1723,1457,11432
4/5/2018,2018,4,5, 22 ,7941,1573,1352,10866
4/5/2018,2018,4,5, 23 ,7516,1474,1253,10243
4/5/2018,2018,4,5, 24 ,7111,1390,1175,9676
4/6/2018,2018,4,6, 1 ,6806,1346,1121,9273
4/6/2018,2018,4,6, 2 ,6600,1314,1063,8977
4/6/2018,2018,4,6, 3 ,6445,1269,1044,8758
4/6/2018,2018,4,6, 4 ,6323,1241,1039,8603
4/6/2018,2018,4,6, 5 ,6313,1259,1054,8626
4/6/2018,2018,4,6, 6 ,6343,1261,1089,8693
4/6/2018,2018,4,6, 7 ,6628,1283,1093,9004
4/6/2018,2018,4,6, 8 ,7478,1444,1238,10160
4/6/2018,2018,4,6, 9 ,8419,1660,1403,11482
4/6/2018,2018,4,6, 10 ,8928,1793,1549,12270
4/6/2018,2018,4,6, 11 ,9288,1844,1589,12721
4/6/2018,2018,4,6, 12 ,9115,1813,1667,12595
4/6/2018,2018,4,6, 13 ,9080,1836,1623,12539
4/6/2018,2018,4,6, 14 ,9465,1898,1688,13051
4/6/2018,2018,4,6, 15 ,9442,1889,1666,12997
4/6/2018,2018,4,6, 16 ,9273,1846,1642,12761
4/6/2018,2018,4,6, 17 ,8869,1741,1554,12164
4/6/2018,2018,4,6, 18 ,8507,1740,1598,11845
4/6/2018,2018,4,6, 19 ,8872,1846,1613,12331
4/6/2018,2018,4,6, 20 ,8795,1776,1595,12166
4/6/2018,2018,4,6, 21 ,8648,1709,1491,11848
4/6/2018,2018,4,6, 22 ,8325,1599,1379,11303
4/6/2018,2018,4,6, 23 ,7871,1474,1269,10614
4/6/2018,2018,4,6, 24 ,7481,1392,1177,10050
4/7/2018,2018,4,7, 1 ,7183,1332,1137,9652
4/7/2018,2018,4,7, 2 ,6879,1276,1114,9269
4/7/2018,2018,4,7, 3 ,6702,1251,1078,9031
4/7/2018,2018,4,7, 4 ,6598,1237,1044,8879
4/7/2018,2018,4,7, 5 ,6529,1249,1050,8828
4/7/2018,2018,4,7, 6 ,6404,1262,1054,8720
4/7/2018,2018,4,7, 7 ,6494,1271,1076,8841
4/7/2018,2018,4,7, 8 ,7064,1388,1190,9642
4/7/2018,2018,4,7, 9 ,7805,1547,1330,10682
4/7/2018,2018,4,7, 10 ,8353,1638,1447,11438
4/7/2018,2018,4,7, 11 ,8623,1728,1521,11872
4/7/2018,2018,4,7, 12 ,8463,1669,1506,11638
4/7/2018,2018,4,7, 13 ,8396,1672,1532,11600
4/7/2018,2018,4,7, 14 ,8656,1703,1583,11942
4/7/2018,2018,4,7, 15 ,8593,1682,1563,11838
4/7/2018,2018,4,7, 16 ,8379,1636,1529,11544
4/7/2018,2018,4,7, 17 ,7981,1588,1453,11022
4/7/2018,2018,4,7, 18 ,7877,1690,1536,11103
4/7/2018,2018,4,7, 19 ,8355,1751,1572,11678
4/7/2018,2018,4,7, 20 ,8220,1700,1562,11482
4/7/2018,2018,4,7, 21 ,8177,1625,1492,11294
4/7/2018,2018,4,7, 22 ,7944,1552,1403,10899
4/7/2018,2018,4,7, 23 ,7662,1435,1153,10250
4/7/2018,2018,4,7, 24 ,7300,1352,1088,9740
4/8/2018,2018,4,8, 1 ,7020,1298,1147,9465
4/8/2018,2018,4,8, 2 ,6729,1267,1097,9093
4/8/2018,2018,4,8, 3 ,6507,1226,1065,8798
4/8/2018,2018,4,8, 4 ,6321,1201,1046,8568
4/8/2018,2018,4,8, 5 ,6221,1196,1043,8460
4/8/2018,2018,4,8, 6 ,6045,1189,1015,8249
4/8/2018,2018,4,8, 7 ,6005,1190,1002,8197
4/8/2018,2018,4,8, 8 ,6250,1238,1044,8532
4/8/2018,2018,4,8, 9 ,6630,1319,1136,9085
4/8/2018,2018,4,8, 10 ,7110,1406,1239,9755
4/8/2018,2018,4,8, 11 ,7263,1441,1302,10006
4/8/2018,2018,4,8, 12 ,7208,1446,1330,9984
4/8/2018,2018,4,8, 13 ,7285,1447,1326,10058
4/8/2018,2018,4,8, 14 ,7271,1453,1355,10079
4/8/2018,2018,4,8, 15 ,7231,1437,1343,10011
4/8/2018,2018,4,8, 16 ,7184,1416,1318,9918
4/8/2018,2018,4,8, 17 ,7056,1420,1287,9763
4/8/2018,2018,4,8, 18 ,7169,1549,1367,10085
4/8/2018,2018,4,8, 19 ,7684,1676,1510,10870
4/8/2018,2018,4,8, 20 ,7673,1614,1469,10756
4/8/2018,2018,4,8, 21 ,7558,1560,1438,10556
4/8/2018,2018,4,8, 22 ,7344,1460,1351,10155
4/8/2018,2018,4,8, 23 ,7056,1369,1257,9682
4/8/2018,2018,4,8, 24 ,6735,1295,1165,9195
4/9/2018,2018,4,9, 1 ,6510,1247,1124,8881
4/9/2018,2018,4,9, 2 ,6226,1202,1083,8511
4/9/2018,2018,4,9, 3 ,6047,1174,1045,8266
4/9/2018,2018,4,9, 4 ,5902,1165,1032,8099
4/9/2018,2018,4,9, 5 ,5903,1192,1024,8119
4/9/2018,2018,4,9, 6 ,5876,1205,1046,8127
4/9/2018,2018,4,9, 7 ,5950,1214,1043,8207
4/9/2018,2018,4,9, 8 ,6351,1286,1129,8766
4/9/2018,2018,4,9, 9 ,6897,1431,1265,9593
4/9/2018,2018,4,9, 10 ,7493,1553,1416,10462
4/9/2018,2018,4,9, 11 ,7719,1616,1475,10810
4/9/2018,2018,4,9, 12 ,7659,1600,1461,10720
4/9/2018,2018,4,9, 13 ,7657,1599,1474,10730
4/9/2018,2018,4,9, 14 ,7812,1669,1531,11012
4/9/2018,2018,4,9, 15 ,7764,1652,1517,10933
4/9/2018,2018,4,9, 16 ,7632,1618,1452,10702
4/9/2018,2018,4,9, 17 ,7392,1575,1381,10348
4/9/2018,2018,4,9, 18 ,7512,1676,1551,10739
4/9/2018,2018,4,9, 19 ,8119,1760,1594,11473
4/9/2018,2018,4,9, 20 ,8084,1717,1524,11325
4/9/2018,2018,4,9, 21 ,8000,1658,1501,11159
4/9/2018,2018,4,9, 22 ,7689,1537,1367,10593
4/9/2018,2018,4,9, 23 ,7307,1447,1267,10021
4/9/2018,2018,4,9, 24 ,6991,1375,1175,9541
4/10/2018,2018,4,10, 1 ,6687,1312,1124,9123
4/10/2018,2018,4,10, 2 ,6442,1271,1056,8769
4/10/2018,2018,4,10, 3 ,6265,1239,1060,8564
4/10/2018,2018,4,10, 4 ,6185,1224,1039,8448
4/10/2018,2018,4,10, 5 ,6205,1239,1070,8514
4/10/2018,2018,4,10, 6 ,6315,1263,1104,8682
4/10/2018,2018,4,10, 7 ,6780,1304,1092,9176
4/10/2018,2018,4,10, 8 ,7740,1483,1160,10383
4/10/2018,2018,4,10, 9 ,8702,1720,1470,11892
4/10/2018,2018,4,10, 10 ,9251,1837,1608,12696
4/10/2018,2018,4,10, 11 ,9584,1905,1614,13103
4/10/2018,2018,4,10, 12 ,9425,1889,1638,12952
4/10/2018,2018,4,10, 13 ,9443,1900,1698,13041
4/10/2018,2018,4,10, 14 ,9786,1964,1729,13479
4/10/2018,2018,4,10, 15 ,9651,1919,1722,13292
4/10/2018,2018,4,10, 16 ,9290,1893,1702,12885
4/10/2018,2018,4,10, 17 ,8979,1795,1659,12433
4/10/2018,2018,4,10, 18 ,8653,1804,1645,12102
4/10/2018,2018,4,10, 19 ,8984,1910,1653,12547
4/10/2018,2018,4,10, 20 ,8832,1842,1597,12271
4/10/2018,2018,4,10, 21 ,8632,1783,1547,11962
4/10/2018,2018,4,10, 22 ,8288,1654,1429,11371
4/10/2018,2018,4,10, 23 ,7966,1557,1309,10832
4/10/2018,2018,4,10, 24 ,7524,1477,1215,10216
4/11/2018,2018,4,11, 1 ,7181,1413,1165,9759
4/11/2018,2018,4,11, 2 ,6969,1367,1145,9481
4/11/2018,2018,4,11, 3 ,6756,1325,1106,9187
4/11/2018,2018,4,11, 4 ,6593,1305,1082,8980
4/11/2018,2018,4,11, 5 ,6620,1306,1093,9019
4/11/2018,2018,4,11, 6 ,6659,1316,1129,9104
4/11/2018,2018,4,11, 7 ,6902,1341,1132,9375
4/11/2018,2018,4,11, 8 ,7827,1526,1297,10650
4/11/2018,2018,4,11, 9 ,8820,1759,1507,12086
4/11/2018,2018,4,11, 10 ,9412,1871,1632,12915
4/11/2018,2018,4,11, 11 ,9688,1945,1730,13363
4/11/2018,2018,4,11, 12 ,9533,1882,1679,13094
4/11/2018,2018,4,11, 13 ,9587,1875,1697,13159
4/11/2018,2018,4,11, 14 ,9928,1939,1684,13551
4/11/2018,2018,4,11, 15 ,9820,1930,1666,13416
4/11/2018,2018,4,11, 16 ,9621,1900,1651,13172
4/11/2018,2018,4,11, 17 ,9187,1789,1603,12579
4/11/2018,2018,4,11, 18 ,8846,1812,1650,12308
4/11/2018,2018,4,11, 19 ,9105,1894,1632,12631
4/11/2018,2018,4,11, 20 ,9005,1805,1591,12401
4/11/2018,2018,4,11, 21 ,8934,1741,1495,12170
4/11/2018,2018,4,11, 22 ,8593,1633,1379,11605
4/11/2018,2018,4,11, 23 ,8249,1536,1261,11046
4/11/2018,2018,4,11, 24 ,7834,1441,1189,10464
4/12/2018,2018,4,12, 1 ,7512,1381,1141,10034
4/12/2018,2018,4,12, 2 ,7218,1340,1114,9672
4/12/2018,2018,4,12, 3 ,6983,1311,1085,9379
4/12/2018,2018,4,12, 4 ,6851,1291,1061,9203
4/12/2018,2018,4,12, 5 ,6837,1306,1089,9232
4/12/2018,2018,4,12, 6 ,6849,1316,1123,9288
4/12/2018,2018,4,12, 7 ,7129,1346,1132,9607
4/12/2018,2018,4,12, 8 ,8048,1511,1283,10842
4/12/2018,2018,4,12, 9 ,8973,1767,1510,12250
4/12/2018,2018,4,12, 10 ,9542,1877,1616,13035
4/12/2018,2018,4,12, 11 ,9828,1943,1724,13495
4/12/2018,2018,4,12, 12 ,9628,1906,1706,13240
4/12/2018,2018,4,12, 13 ,9648,1907,1729,13284
4/12/2018,2018,4,12, 14 ,10016,1973,1774,13763
4/12/2018,2018,4,12, 15 ,10004,1961,1736,13701
4/12/2018,2018,4,12, 16 ,9827,1924,1704,13455
4/12/2018,2018,4,12, 17 ,9295,1818,1604,12717
4/12/2018,2018,4,12, 18 ,8968,1799,1645,12412
4/12/2018,2018,4,12, 19 ,9307,1905,1665,12877
4/12/2018,2018,4,12, 20 ,9236,1839,1629,12704
4/12/2018,2018,4,12, 21 ,9064,1773,1558,12395
4/12/2018,2018,4,12, 22 ,8743,1671,1446,11860
4/12/2018,2018,4,12, 23 ,8370,1567,1344,11281
4/12/2018,2018,4,12, 24 ,7955,1495,1254,10704
4/13/2018,2018,4,13, 1 ,7634,1426,1195,10255
4/13/2018,2018,4,13, 2 ,7304,1384,1149,9837
4/13/2018,2018,4,13, 3 ,7109,1346,1118,9573
4/13/2018,2018,4,13, 4 ,6972,1333,1088,9393
4/13/2018,2018,4,13, 5 ,6879,1335,1109,9323
4/13/2018,2018,4,13, 6 ,6889,1335,1118,9342
4/13/2018,2018,4,13, 7 ,7184,1370,1135,9689
4/13/2018,2018,4,13, 8 ,8117,1538,1264,10919
4/13/2018,2018,4,13, 9 ,9031,1768,1479,12278
4/13/2018,2018,4,13, 10 ,9585,1892,1633,13110
4/13/2018,2018,4,13, 11 ,9884,1952,1694,13530
4/13/2018,2018,4,13, 12 ,9670,1910,1664,13244
4/13/2018,2018,4,13, 13 ,9754,1918,1687,13359
4/13/2018,2018,4,13, 14 ,10094,1997,1729,13820
4/13/2018,2018,4,13, 15 ,9951,1965,1700,13616
4/13/2018,2018,4,13, 16 ,9752,1923,1687,13362
4/13/2018,2018,4,13, 17 ,9325,1802,1590,12717
4/13/2018,2018,4,13, 18 ,8952,1818,1636,12406
4/13/2018,2018,4,13, 19 ,9275,1918,1664,12857
4/13/2018,2018,4,13, 20 ,9181,1849,1616,12646
4/13/2018,2018,4,13, 21 ,9118,1801,1572,12491
4/13/2018,2018,4,13, 22 ,8819,1704,1462,11985
4/13/2018,2018,4,13, 23 ,8454,1595,1339,11388
4/13/2018,2018,4,13, 24 ,8089,1501,1262,10852
4/14/2018,2018,4,14, 1 ,7700,1450,1212,10362
4/14/2018,2018,4,14, 2 ,7469,1399,1180,10048
4/14/2018,2018,4,14, 3 ,7162,1358,1138,9658
4/14/2018,2018,4,14, 4 ,7001,1328,1122,9451
4/14/2018,2018,4,14, 5 ,6870,1332,1105,9307
4/14/2018,2018,4,14, 6 ,6725,1315,1125,9165
4/14/2018,2018,4,14, 7 ,6851,1336,1127,9314
4/14/2018,2018,4,14, 8 ,7526,1472,1240,10238
4/14/2018,2018,4,14, 9 ,8306,1652,1373,11331
4/14/2018,2018,4,14, 10 ,8884,1764,1513,12161
4/14/2018,2018,4,14, 11 ,9185,1838,1565,12588
4/14/2018,2018,4,14, 12 ,9002,1789,1577,12368
4/14/2018,2018,4,14, 13 ,9055,1789,1580,12424
4/14/2018,2018,4,14, 14 ,9350,1839,1622,12811
4/14/2018,2018,4,14, 15 ,9200,1833,1603,12636
4/14/2018,2018,4,14, 16 ,8983,1782,1565,12330
4/14/2018,2018,4,14, 17 ,8563,1703,1513,11779
4/14/2018,2018,4,14, 18 ,8346,1749,1564,11659
4/14/2018,2018,4,14, 19 ,8839,1884,1646,12369
4/14/2018,2018,4,14, 20 ,8811,1844,1559,12214
4/14/2018,2018,4,14, 21 ,8746,1785,1528,12059
4/14/2018,2018,4,14, 22 ,8575,1711,1426,11712
4/14/2018,2018,4,14, 23 ,8276,1603,1337,11216
4/14/2018,2018,4,14, 24 ,7913,1510,1242,10665
4/15/2018,2018,4,15, 1 ,7541,1432,1203,10176
4/15/2018,2018,4,15, 2 ,7229,1393,1129,9751
4/15/2018,2018,4,15, 3 ,7044,1351,1122,9517
4/15/2018,2018,4,15, 4 ,6830,1325,1092,9247
4/15/2018,2018,4,15, 5 ,6697,1300,1088,9085
4/15/2018,2018,4,15, 6 ,6457,1284,1094,8835
4/15/2018,2018,4,15, 7 ,6415,1269,1054,8738
4/15/2018,2018,4,15, 8 ,6781,1337,1097,9215
4/15/2018,2018,4,15, 9 ,7339,1432,1167,9938
4/15/2018,2018,4,15, 10 ,7791,1524,1263,10578
4/15/2018,2018,4,15, 11 ,8052,1582,1307,10941
4/15/2018,2018,4,15, 12 ,8037,1582,1311,10930
4/15/2018,2018,4,15, 13 ,8102,1591,1319,11012
4/15/2018,2018,4,15, 14 ,8216,1587,1317,11120
4/15/2018,2018,4,15, 15 ,8227,1575,1301,11103
4/15/2018,2018,4,15, 16 ,7944,1525,1279,10748
4/15/2018,2018,4,15, 17 ,7787,1493,1292,10572
4/15/2018,2018,4,15, 18 ,7829,1594,1397,10820
4/15/2018,2018,4,15, 19 ,8444,1777,1454,11675
4/15/2018,2018,4,15, 20 ,8425,1729,1424,11578
4/15/2018,2018,4,15, 21 ,8360,1697,1396,11453
4/15/2018,2018,4,15, 22 ,8293,1611,1308,11212
4/15/2018,2018,4,15, 23 ,7970,1526,1211,10707
4/15/2018,2018,4,15, 24 ,7625,1445,1038,10108
4/16/2018,2018,4,16, 1 ,7294,1372,1080,9746
4/16/2018,2018,4,16, 2 ,6996,1322,1004,9322
4/16/2018,2018,4,16, 3 ,6814,1281,971,9066
4/16/2018,2018,4,16, 4 ,6612,1250,951,8813
4/16/2018,2018,4,16, 5 ,6549,1264,975,8788
4/16/2018,2018,4,16, 6 ,6593,1269,1033,8895
4/16/2018,2018,4,16, 7 ,6968,1311,1059,9338
4/16/2018,2018,4,16, 8 ,8033,1480,1150,10663
4/16/2018,2018,4,16, 9 ,8930,1712,1352,11994
4/16/2018,2018,4,16, 10 ,9527,1829,1484,12840
4/16/2018,2018,4,16, 11 ,9902,1898,1553,13353
4/16/2018,2018,4,16, 12 ,9778,1848,1512,13138
4/16/2018,2018,4,16, 13 ,9743,1878,1493,13114
4/16/2018,2018,4,16, 14 ,10105,1938,1556,13599
4/16/2018,2018,4,16, 15 ,10002,1921,1553,13476
4/16/2018,2018,4,16, 16 ,9856,1898,1540,13294
4/16/2018,2018,4,16, 17 ,9341,1790,1519,12650
4/16/2018,2018,4,16, 18 ,8887,1812,1573,12272
4/16/2018,2018,4,16, 19 ,9305,1885,1585,12775
4/16/2018,2018,4,16, 20 ,9169,1819,1519,12507
4/16/2018,2018,4,16, 21 ,9043,1761,1460,12264
4/16/2018,2018,4,16, 22 ,8787,1630,1341,11758
4/16/2018,2018,4,16, 23 ,8356,1525,1227,11108
4/16/2018,2018,4,16, 24 ,7929,1448,1157,10534
4/17/2018,2018,4,17, 1 ,7656,1386,1106,10148
4/17/2018,2018,4,17, 2 ,7417,1348,1079,9844
4/17/2018,2018,4,17, 3 ,7173,1317,1043,9533
4/17/2018,2018,4,17, 4 ,6982,1297,1035,9314
4/17/2018,2018,4,17, 5 ,6847,1300,1043,9190
4/17/2018,2018,4,17, 6 ,6803,1311,1084,9198
4/17/2018,2018,4,17, 7 ,7047,1340,1084,9471
4/17/2018,2018,4,17, 8 ,8025,1499,1246,10770
4/17/2018,2018,4,17, 9 ,8787,1744,1448,11979
4/17/2018,2018,4,17, 10 ,9429,1866,1582,12877
4/17/2018,2018,4,17, 11 ,9858,1949,1652,13459
4/17/2018,2018,4,17, 12 ,9691,1895,1624,13210
4/17/2018,2018,4,17, 13 ,9679,1893,1640,13212
4/17/2018,2018,4,17, 14 ,10104,1925,1701,13730
4/17/2018,2018,4,17, 15 ,10036,1911,1674,13621
4/17/2018,2018,4,17, 16 ,9860,1883,1650,13393
4/17/2018,2018,4,17, 17 ,9360,1801,1560,12721
4/17/2018,2018,4,17, 18 ,9004,1803,1624,12431
4/17/2018,2018,4,17, 19 ,9327,1906,1620,12853
4/17/2018,2018,4,17, 20 ,9154,1853,1464,12471
4/17/2018,2018,4,17, 21 ,8996,1808,1456,12260
4/17/2018,2018,4,17, 22 ,8735,1683,1392,11810
4/17/2018,2018,4,17, 23 ,8361,1563,1293,11217
4/17/2018,2018,4,17, 24 ,7932,1482,1168,10582
4/18/2018,2018,4,18, 1 ,7615,1415,1155,10185
4/18/2018,2018,4,18, 2 ,7381,1377,1096,9854
4/18/2018,2018,4,18, 3 ,7119,1342,1078,9539
4/18/2018,2018,4,18, 4 ,6978,1319,1061,9358
4/18/2018,2018,4,18, 5 ,6924,1324,1078,9326
4/18/2018,2018,4,18, 6 ,6846,1327,1098,9271
4/18/2018,2018,4,18, 7 ,7125,1352,1104,9581
4/18/2018,2018,4,18, 8 ,7965,1535,1237,10737
4/18/2018,2018,4,18, 9 ,8872,1772,1428,12072
4/18/2018,2018,4,18, 10 ,9385,1881,1583,12849
4/18/2018,2018,4,18, 11 ,9750,1968,1653,13371
4/18/2018,2018,4,18, 12 ,9527,1915,1624,13066
4/18/2018,2018,4,18, 13 ,9514,1906,1610,13030
4/18/2018,2018,4,18, 14 ,9929,1952,1616,13497
4/18/2018,2018,4,18, 15 ,9853,1940,1584,13377
4/18/2018,2018,4,18, 16 ,9709,1902,1592,13203
4/18/2018,2018,4,18, 17 ,9262,1811,1528,12601
4/18/2018,2018,4,18, 18 ,8869,1821,1547,12237
4/18/2018,2018,4,18, 19 ,9204,1911,1606,12721
4/18/2018,2018,4,18, 20 ,9093,1850,1568,12511
4/18/2018,2018,4,18, 21 ,8941,1797,1479,12217
4/18/2018,2018,4,18, 22 ,8624,1671,1360,11655
4/18/2018,2018,4,18, 23 ,8270,1564,1251,11085
4/18/2018,2018,4,18, 24 ,7874,1500,1177,10551
4/19/2018,2018,4,19, 1 ,7551,1444,1124,10119
4/19/2018,2018,4,19, 2 ,7313,1396,1088,9797
4/19/2018,2018,4,19, 3 ,7077,1351,1048,9476
4/19/2018,2018,4,19, 4 ,6885,1334,1031,9250
4/19/2018,2018,4,19, 5 ,6877,1338,1060,9275
4/19/2018,2018,4,19, 6 ,6863,1345,1096,9304
4/19/2018,2018,4,19, 7 ,7151,1358,1089,9598
4/19/2018,2018,4,19, 8 ,8061,1545,1245,10851
4/19/2018,2018,4,19, 9 ,8945,1790,1446,12181
4/19/2018,2018,4,19, 10 ,9386,1913,1602,12901
4/19/2018,2018,4,19, 11 ,9801,1965,1637,13403
4/19/2018,2018,4,19, 12 ,9582,1910,1661,13153
4/19/2018,2018,4,19, 13 ,9672,1934,1667,13273
4/19/2018,2018,4,19, 14 ,10083,2003,1737,13823
4/19/2018,2018,4,19, 15 ,9954,1991,1680,13625
4/19/2018,2018,4,19, 16 ,9709,1947,1671,13327
4/19/2018,2018,4,19, 17 ,9179,1828,1577,12584
4/19/2018,2018,4,19, 18 ,8871,1849,1633,12353
4/19/2018,2018,4,19, 19 ,9205,1939,1628,12772
4/19/2018,2018,4,19, 20 ,9081,1895,1586,12562
4/19/2018,2018,4,19, 21 ,8933,1825,1529,12287
4/19/2018,2018,4,19, 22 ,8660,1710,1361,11731
4/19/2018,2018,4,19, 23 ,8333,1591,1285,11209
4/19/2018,2018,4,19, 24 ,7938,1508,1190,10636
4/20/2018,2018,4,20, 1 ,7678,1457,1176,10311
4/20/2018,2018,4,20, 2 ,7426,1412,1124,9962
4/20/2018,2018,4,20, 3 ,7172,1370,1093,9635
4/20/2018,2018,4,20, 4 ,7013,1345,1076,9434
4/20/2018,2018,4,20, 5 ,6992,1359,1101,9452
4/20/2018,2018,4,20, 6 ,6940,1345,1117,9402
4/20/2018,2018,4,20, 7 ,7238,1366,1112,9716
4/20/2018,2018,4,20, 8 ,8172,1534,1245,10951
4/20/2018,2018,4,20, 9 ,9060,1758,1464,12282
4/20/2018,2018,4,20, 10 ,9653,1913,1588,13154
4/20/2018,2018,4,20, 11 ,9907,1979,1671,13557
4/20/2018,2018,4,20, 12 ,9796,1929,1642,13367
4/20/2018,2018,4,20, 13 ,9782,1931,1654,13367
4/20/2018,2018,4,20, 14 ,10061,2003,1701,13765
4/20/2018,2018,4,20, 15 ,9993,1979,1674,13646
4/20/2018,2018,4,20, 16 ,9787,1937,1613,13337
4/20/2018,2018,4,20, 17 ,9286,1820,1544,12650
4/20/2018,2018,4,20, 18 ,8847,1831,1591,12269
4/20/2018,2018,4,20, 19 ,9255,1930,1620,12805
4/20/2018,2018,4,20, 20 ,9104,1881,1563,12548
4/20/2018,2018,4,20, 21 ,8978,1820,1511,12309
4/20/2018,2018,4,20, 22 ,8640,1698,1384,11722
4/20/2018,2018,4,20, 23 ,8316,1592,1278,11186
4/20/2018,2018,4,20, 24 ,8019,1501,1193,10713
4/21/2018,2018,4,21, 1 ,7705,1439,1151,10295
4/21/2018,2018,4,21, 2 ,7410,1400,1114,9924
4/21/2018,2018,4,21, 3 ,7179,1362,1081,9622
4/21/2018,2018,4,21, 4 ,6987,1339,1055,9381
4/21/2018,2018,4,21, 5 ,6864,1337,1038,9239
4/21/2018,2018,4,21, 6 ,6644,1318,1015,8977
4/21/2018,2018,4,21, 7 ,6716,1329,1023,9068
4/21/2018,2018,4,21, 8 ,7370,1451,1143,9964
4/21/2018,2018,4,21, 9 ,8169,1627,1366,11162
4/21/2018,2018,4,21, 10 ,8701,1738,1486,11925
4/21/2018,2018,4,21, 11 ,9133,1805,1531,12469
4/21/2018,2018,4,21, 12 ,9097,1766,1506,12369
4/21/2018,2018,4,21, 13 ,9058,1775,1532,12365
4/21/2018,2018,4,21, 14 ,9354,1819,1544,12717
4/21/2018,2018,4,21, 15 ,9311,1832,1529,12672
4/21/2018,2018,4,21, 16 ,9061,1764,1524,12349
4/21/2018,2018,4,21, 17 ,8608,1698,1458,11764
4/21/2018,2018,4,21, 18 ,8433,1753,1548,11734
4/21/2018,2018,4,21, 19 ,8928,1865,1583,12376
4/21/2018,2018,4,21, 20 ,8904,1810,1522,12236
4/21/2018,2018,4,21, 21 ,8825,1779,1443,12047
4/21/2018,2018,4,21, 22 ,8655,1693,1397,11745
4/21/2018,2018,4,21, 23 ,8389,1593,1314,11296
4/21/2018,2018,4,21, 24 ,8099,1492,1223,10814
4/22/2018,2018,4,22, 1 ,7783,1429,1167,10379
4/22/2018,2018,4,22, 2 ,7490,1380,1116,9986
4/22/2018,2018,4,22, 3 ,7227,1337,1072,9636
4/22/2018,2018,4,22, 4 ,7067,1307,1051,9425
4/22/2018,2018,4,22, 5 ,6911,1296,1055,9262
4/22/2018,2018,4,22, 6 ,6575,1249,1048,8872
4/22/2018,2018,4,22, 7 ,6487,1260,1019,8766
4/22/2018,2018,4,22, 8 ,6875,1352,1061,9288
4/22/2018,2018,4,22, 9 ,7336,1453,1162,9951
4/22/2018,2018,4,22, 10 ,7812,1556,1275,10643
4/22/2018,2018,4,22, 11 ,8023,1603,1331,10957
4/22/2018,2018,4,22, 12 ,8005,1604,1335,10944
4/22/2018,2018,4,22, 13 ,7991,1632,1358,10981
4/22/2018,2018,4,22, 14 ,8142,1643,1358,11143
4/22/2018,2018,4,22, 15 ,8100,1628,1342,11070
4/22/2018,2018,4,22, 16 ,7993,1573,1318,10884
4/22/2018,2018,4,22, 17 ,7819,1559,1263,10641
4/22/2018,2018,4,22, 18 ,7836,1630,1372,10838
4/22/2018,2018,4,22, 19 ,8464,1804,1490,11758
4/22/2018,2018,4,22, 20 ,8534,1776,1496,11806
4/22/2018,2018,4,22, 21 ,8475,1719,1453,11647
4/22/2018,2018,4,22, 22 ,8350,1633,1359,11342
4/22/2018,2018,4,22, 23 ,8065,1544,1264,10873
4/22/2018,2018,4,22, 24 ,7697,1467,1191,10355
4/23/2018,2018,4,23, 1 ,7313,1397,1133,9843
4/23/2018,2018,4,23, 2 ,7028,1343,1093,9464
4/23/2018,2018,4,23, 3 ,6790,1301,1062,9153
4/23/2018,2018,4,23, 4 ,6628,1286,1045,8959
4/23/2018,2018,4,23, 5 ,6619,1295,1071,8985
4/23/2018,2018,4,23, 6 ,6566,1291,1085,8942
4/23/2018,2018,4,23, 7 ,7030,1338,1090,9458
4/23/2018,2018,4,23, 8 ,8076,1530,1271,10877
4/23/2018,2018,4,23, 9 ,9168,1780,1486,12434
4/23/2018,2018,4,23, 10 ,9716,1919,1643,13278
4/23/2018,2018,4,23, 11 ,10040,2006,1723,13769
4/23/2018,2018,4,23, 12 ,9894,1938,1688,13520
4/23/2018,2018,4,23, 13 ,9897,1949,1704,13550
4/23/2018,2018,4,23, 14 ,10353,2032,1769,14154
4/23/2018,2018,4,23, 15 ,10288,2022,1753,14063
4/23/2018,2018,4,23, 16 ,10150,1995,1711,13856
4/23/2018,2018,4,23, 17 ,9600,1873,1592,13065
4/23/2018,2018,4,23, 18 ,9179,1848,1659,12686
4/23/2018,2018,4,23, 19 ,9518,1973,1677,13168
4/23/2018,2018,4,23, 20 ,9480,1923,1629,13032
4/23/2018,2018,4,23, 21 ,9330,1861,1585,12776
4/23/2018,2018,4,23, 22 ,8989,1746,1433,12168
4/23/2018,2018,4,23, 23 ,8739,1630,1308,11677
4/23/2018,2018,4,23, 24 ,8359,1537,1248,11144
4/24/2018,2018,4,24, 1 ,7997,1474,1196,10667
4/24/2018,2018,4,24, 2 ,7697,1434,1141,10272
4/24/2018,2018,4,24, 3 ,7505,1386,1110,10001
4/24/2018,2018,4,24, 4 ,7321,1354,1083,9758
4/24/2018,2018,4,24, 5 ,7198,1364,1114,9676
4/24/2018,2018,4,24, 6 ,7097,1345,1121,9563
4/24/2018,2018,4,24, 7 ,7481,1368,1120,9969
4/24/2018,2018,4,24, 8 ,8475,1559,1306,11340
4/24/2018,2018,4,24, 9 ,9350,1786,1469,12605
4/24/2018,2018,4,24, 10 ,9952,1926,1599,13477
4/24/2018,2018,4,24, 11 ,10294,2009,1665,13968
4/24/2018,2018,4,24, 12 ,10155,1956,1650,13761
4/24/2018,2018,4,24, 13 ,10167,1972,1707,13846
4/24/2018,2018,4,24, 14 ,10511,2036,1762,14309
4/24/2018,2018,4,24, 15 ,10367,1996,1769,14132
4/24/2018,2018,4,24, 16 ,10084,1981,1709,13774
4/24/2018,2018,4,24, 17 ,9631,1867,1591,13089
4/24/2018,2018,4,24, 18 ,9227,1843,1629,12699
4/24/2018,2018,4,24, 19 ,9530,1964,1681,13175
4/24/2018,2018,4,24, 20 ,9420,1911,1633,12964
4/24/2018,2018,4,24, 21 ,9280,1822,1594,12696
4/24/2018,2018,4,24, 22 ,9018,1720,1435,12173
4/24/2018,2018,4,24, 23 ,8604,1614,1325,11543
4/24/2018,2018,4,24, 24 ,8277,1528,1255,11060
4/25/2018,2018,4,25, 1 ,7870,1469,1207,10546
4/25/2018,2018,4,25, 2 ,7634,1421,1160,10215
4/25/2018,2018,4,25, 3 ,7409,1379,1108,9896
4/25/2018,2018,4,25, 4 ,7216,1353,1104,9673
4/25/2018,2018,4,25, 5 ,7210,1357,1130,9697
4/25/2018,2018,4,25, 6 ,7093,1340,1143,9576
4/25/2018,2018,4,25, 7 ,7444,1357,1134,9935
4/25/2018,2018,4,25, 8 ,8394,1550,1306,11250
4/25/2018,2018,4,25, 9 ,9355,1790,1521,12666
4/25/2018,2018,4,25, 10 ,9900,1911,1635,13446
4/25/2018,2018,4,25, 11 ,10203,1988,1697,13888
4/25/2018,2018,4,25, 12 ,9977,1946,1671,13594
4/25/2018,2018,4,25, 13 ,9808,1940,1708,13456
4/25/2018,2018,4,25, 14 ,10282,1969,1765,14016
4/25/2018,2018,4,25, 15 ,10280,1963,1721,13964
4/25/2018,2018,4,25, 16 ,9444,1920,1698,13062
4/25/2018,2018,4,25, 17 ,9534,1832,1549,12915
4/25/2018,2018,4,25, 18 ,9142,1824,1635,12601
4/25/2018,2018,4,25, 19 ,9481,1941,1625,13047
4/25/2018,2018,4,25, 20 ,9431,1877,1597,12905
4/25/2018,2018,4,25, 21 ,9266,1803,1552,12621
4/25/2018,2018,4,25, 22 ,8985,1695,1417,12097
4/25/2018,2018,4,25, 23 ,8713,1580,1319,11612
4/25/2018,2018,4,25, 24 ,8311,1507,1274,11092
4/26/2018,2018,4,26, 1 ,8013,1440,1197,10650
4/26/2018,2018,4,26, 2 ,7746,1391,1158,10295
4/26/2018,2018,4,26, 3 ,7497,1352,1125,9974
4/26/2018,2018,4,26, 4 ,7294,1339,1100,9733
4/26/2018,2018,4,26, 5 ,7219,1347,1118,9684
4/26/2018,2018,4,26, 6 ,7122,1324,1132,9578
4/26/2018,2018,4,26, 7 ,7493,1363,1149,10005
4/26/2018,2018,4,26, 8 ,8391,1533,1313,11237
4/26/2018,2018,4,26, 9 ,9193,1750,1531,12474
4/26/2018,2018,4,26, 10 ,9713,1865,1674,13252
4/26/2018,2018,4,26, 11 ,10063,1948,1782,13793
4/26/2018,2018,4,26, 12 ,9861,1917,1723,13501
4/26/2018,2018,4,26, 13 ,9913,1936,1744,13593
4/26/2018,2018,4,26, 14 ,10235,2000,1733,13968
4/26/2018,2018,4,26, 15 ,10220,1981,1699,13900
4/26/2018,2018,4,26, 16 ,10103,1945,1713,13761
4/26/2018,2018,4,26, 17 ,9569,1835,1617,13021
4/26/2018,2018,4,26, 18 ,9215,1817,1653,12685
4/26/2018,2018,4,26, 19 ,9513,1919,1664,13096
4/26/2018,2018,4,26, 20 ,9415,1872,1605,12892
4/26/2018,2018,4,26, 21 ,9281,1820,1555,12656
4/26/2018,2018,4,26, 22 ,8991,1704,1421,12116
4/26/2018,2018,4,26, 23 ,8656,1594,1319,11569
4/26/2018,2018,4,26, 24 ,8208,1520,1279,11007
4/27/2018,2018,4,27, 1 ,7970,1455,1143,10568
4/27/2018,2018,4,27, 2 ,7743,1410,1130,10283
4/27/2018,2018,4,27, 3 ,7457,1369,1113,9939
4/27/2018,2018,4,27, 4 ,7222,1337,1081,9640
4/27/2018,2018,4,27, 5 ,7197,1353,1109,9659
4/27/2018,2018,4,27, 6 ,7067,1333,1115,9515
4/27/2018,2018,4,27, 7 ,7339,1362,1126,9827
4/27/2018,2018,4,27, 8 ,8294,1539,1283,11116
4/27/2018,2018,4,27, 9 ,9260,1775,1498,12533
4/27/2018,2018,4,27, 10 ,9757,1911,1661,13329
4/27/2018,2018,4,27, 11 ,10100,1975,1699,13774
4/27/2018,2018,4,27, 12 ,9940,1928,1677,13545
4/27/2018,2018,4,27, 13 ,10032,1950,1702,13684
4/27/2018,2018,4,27, 14 ,10362,2011,1740,14113
4/27/2018,2018,4,27, 15 ,10329,1986,1691,14006
4/27/2018,2018,4,27, 16 ,10103,1924,1675,13702
4/27/2018,2018,4,27, 17 ,9541,1830,1592,12963
4/27/2018,2018,4,27, 18 ,9057,1827,1597,12481
4/27/2018,2018,4,27, 19 ,9351,1914,1610,12875
4/27/2018,2018,4,27, 20 ,9297,1864,1567,12728
4/27/2018,2018,4,27, 21 ,9207,1809,1500,12516
4/27/2018,2018,4,27, 22 ,8943,1700,1398,12041
4/27/2018,2018,4,27, 23 ,8615,1605,1278,11498
4/27/2018,2018,4,27, 24 ,8247,1524,1219,10990
4/28/2018,2018,4,28, 1 ,7940,1459,1160,10559
4/28/2018,2018,4,28, 2 ,7690,1418,1149,10257
4/28/2018,2018,4,28, 3 ,7342,1379,1125,9846
4/28/2018,2018,4,28, 4 ,7168,1350,1096,9614
4/28/2018,2018,4,28, 5 ,7037,1347,1105,9489
4/28/2018,2018,4,28, 6 ,6832,1307,1117,9256
4/28/2018,2018,4,28, 7 ,7014,1326,1111,9451
4/28/2018,2018,4,28, 8 ,7717,1462,1250,10429
4/28/2018,2018,4,28, 9 ,8517,1672,1470,11659
4/28/2018,2018,4,28, 10 ,8995,1761,1481,12237
4/28/2018,2018,4,28, 11 ,9305,1827,1541,12673
4/28/2018,2018,4,28, 12 ,9141,1800,1529,12470
4/28/2018,2018,4,28, 13 ,9159,1802,1531,12492
4/28/2018,2018,4,28, 14 ,9504,1849,1603,12956
4/28/2018,2018,4,28, 15 ,9449,1831,1577,12857
4/28/2018,2018,4,28, 16 ,9186,1789,1536,12511
4/28/2018,2018,4,28, 17 ,8689,1694,1461,11844
4/28/2018,2018,4,28, 18 ,8471,1740,1567,11778
4/28/2018,2018,4,28, 19 ,8955,1879,1567,12401
4/28/2018,2018,4,28, 20 ,8964,1828,1522,12314
4/28/2018,2018,4,28, 21 ,8949,1784,1478,12211
4/28/2018,2018,4,28, 22 ,8831,1724,1395,11950
4/28/2018,2018,4,28, 23 ,8495,1618,1281,11394
4/28/2018,2018,4,28, 24 ,8161,1479,1195,10835
4/29/2018,2018,4,29, 1 ,7721,1412,1130,10263
4/29/2018,2018,4,29, 2 ,7539,1364,1098,10001
4/29/2018,2018,4,29, 3 ,7328,1329,1049,9706
4/29/2018,2018,4,29, 4 ,7143,1333,1053,9529
4/29/2018,2018,4,29, 5 ,6966,1321,1009,9296
4/29/2018,2018,4,29, 6 ,6616,1280,1030,8926
4/29/2018,2018,4,29, 7 ,6547,1293,1043,8883
4/29/2018,2018,4,29, 8 ,6877,1363,1057,9297
4/29/2018,2018,4,29, 9 ,7516,1476,1142,10134
4/29/2018,2018,4,29, 10 ,7980,1565,1251,10796
4/29/2018,2018,4,29, 11 ,8026,1622,1329,10977
4/29/2018,2018,4,29, 12 ,8125,1627,1308,11060
4/29/2018,2018,4,29, 13 ,8154,1638,1324,11116
4/29/2018,2018,4,29, 14 ,8300,1636,1314,11250
4/29/2018,2018,4,29, 15 ,8286,1610,1271,11167
4/29/2018,2018,4,29, 16 ,8101,1576,1243,10920
4/29/2018,2018,4,29, 17 ,7890,1546,1172,10608
4/29/2018,2018,4,29, 18 ,7851,1646,1354,10851
4/29/2018,2018,4,29, 19 ,8425,1800,1461,11686
4/29/2018,2018,4,29, 20 ,8493,1752,1456,11701
4/29/2018,2018,4,29, 21 ,8503,1729,1422,11654
4/29/2018,2018,4,29, 22 ,8384,1659,1335,11378
4/29/2018,2018,4,29, 23 ,8177,1562,1211,10950
4/29/2018,2018,4,29, 24 ,7826,1480,1149,10455
4/30/2018,2018,4,30, 1 ,7491,1417,1096,10004
4/30/2018,2018,4,30, 2 ,7282,1361,1052,9695
4/30/2018,2018,4,30, 3 ,7005,1312,1016,9333
4/30/2018,2018,4,30, 4 ,6745,1289,994,9028
4/30/2018,2018,4,30, 5 ,6761,1294,1007,9062
4/30/2018,2018,4,30, 6 ,6669,1287,1044,9000
4/30/2018,2018,4,30, 7 ,6976,1307,1063,9346
4/30/2018,2018,4,30, 8 ,8004,1503,1234,10741
4/30/2018,2018,4,30, 9 ,8903,1727,1420,12050
4/30/2018,2018,4,30, 10 ,9475,1859,1597,12931
4/30/2018,2018,4,30, 11 ,9773,1903,1682,13358
4/30/2018,2018,4,30, 12 ,9654,1892,1657,13203
4/30/2018,2018,4,30, 13 ,9704,1884,1665,13253
4/30/2018,2018,4,30, 14 ,10080,1940,1715,13735
4/30/2018,2018,4,30, 15 ,10017,1899,1714,13630
4/30/2018,2018,4,30, 16 ,9793,1850,1654,13297
4/30/2018,2018,4,30, 17 ,9300,1783,1575,12658
4/30/2018,2018,4,30, 18 ,8839,1770,1591,12200
4/30/2018,2018,4,30, 19 ,9154,1861,1632,12647
4/30/2018,2018,4,30, 20 ,9071,1807,1583,12461
4/30/2018,2018,4,30, 21 ,8933,1751,1530,12214
4/30/2018,2018,4,30, 22 ,8726,1643,1366,11735
4/30/2018,2018,4,30, 23 ,8354,1553,1296,11203
4/30/2018,2018,4,30, 24 ,7990,1472,1200,10662
5/1/2018,2018,5,1, 1 ,7663,1409,1138,10210
5/1/2018,2018,5,1, 2 ,7346,1359,1093,9798
5/1/2018,2018,5,1, 3 ,7104,1327,1057,9488
5/1/2018,2018,5,1, 4 ,6907,1303,1030,9240
5/1/2018,2018,5,1, 5 ,6745,1291,1042,9078
5/1/2018,2018,5,1, 6 ,6415,1272,1042,8729
5/1/2018,2018,5,1, 7 ,6449,1269,1048,8766
5/1/2018,2018,5,1, 8 ,6902,1365,1112,9379
5/1/2018,2018,5,1, 9 ,7500,1488,1263,10251
5/1/2018,2018,5,1, 10 ,8089,1609,1380,11078
5/1/2018,2018,5,1, 11 ,8287,1688,1437,11412
5/1/2018,2018,5,1, 12 ,8297,1680,1432,11409
5/1/2018,2018,5,1, 13 ,8336,1660,1453,11449
5/1/2018,2018,5,1, 14 ,8517,1691,1464,11672
5/1/2018,2018,5,1, 15 ,8530,1693,1441,11664
5/1/2018,2018,5,1, 16 ,8314,1658,1400,11372
5/1/2018,2018,5,1, 17 ,8075,1603,1376,11054
5/1/2018,2018,5,1, 18 ,8074,1698,1486,11258
5/1/2018,2018,5,1, 19 ,8649,1811,1526,11986
5/1/2018,2018,5,1, 20 ,8716,1787,1497,12000
5/1/2018,2018,5,1, 21 ,8676,1739,1438,11853
5/1/2018,2018,5,1, 22 ,8478,1635,1325,11438
5/1/2018,2018,5,1, 23 ,8199,1533,1204,10936
5/1/2018,2018,5,1, 24 ,7774,1462,1141,10377
5/2/2018,2018,5,2, 1 ,7487,1405,1098,9990
5/2/2018,2018,5,2, 2 ,7231,1370,1074,9675
5/2/2018,2018,5,2, 3 ,6994,1327,1033,9354
5/2/2018,2018,5,2, 4 ,6808,1305,1020,9133
5/2/2018,2018,5,2, 5 ,6756,1323,1025,9104
5/2/2018,2018,5,2, 6 ,6669,1304,1047,9020
5/2/2018,2018,5,2, 7 ,7195,1349,1064,9608
5/2/2018,2018,5,2, 8 ,8221,1557,1235,11013
5/2/2018,2018,5,2, 9 ,9264,1790,1429,12483
5/2/2018,2018,5,2, 10 ,9860,1899,1568,13327
5/2/2018,2018,5,2, 11 ,10248,1955,1646,13849
5/2/2018,2018,5,2, 12 ,10150,1938,1600,13688
5/2/2018,2018,5,2, 13 ,10194,1930,1602,13726
5/2/2018,2018,5,2, 14 ,10571,2013,1645,14229
5/2/2018,2018,5,2, 15 ,10555,1991,1620,14166
5/2/2018,2018,5,2, 16 ,10362,1943,1612,13917
5/2/2018,2018,5,2, 17 ,9851,1860,1554,13265
5/2/2018,2018,5,2, 18 ,9300,1860,1580,12740
5/2/2018,2018,5,2, 19 ,9631,1946,1537,13114
5/2/2018,2018,5,2, 20 ,9514,1890,1501,12905
5/2/2018,2018,5,2, 21 ,9446,1834,1440,12720
5/2/2018,2018,5,2, 22 ,9238,1715,1324,12277
5/2/2018,2018,5,2, 23 ,8911,1608,1220,11739
5/2/2018,2018,5,2, 24 ,8492,1511,1145,11148
5/3/2018,2018,5,3, 1 ,8116,1458,1100,10674
5/3/2018,2018,5,3, 2 ,7789,1402,1069,10260
5/3/2018,2018,5,3, 3 ,7597,1372,1034,10003
5/3/2018,2018,5,3, 4 ,7405,1338,1025,9768
5/3/2018,2018,5,3, 5 ,7277,1335,1052,9664
5/3/2018,2018,5,3, 6 ,7137,1335,1079,9551
5/3/2018,2018,5,3, 7 ,7455,1336,1098,9889
5/3/2018,2018,5,3, 8 ,8420,1482,1270,11172
5/3/2018,2018,5,3, 9 ,9384,1704,1487,12575
5/3/2018,2018,5,3, 10 ,9930,1804,1634,13368
5/3/2018,2018,5,3, 11 ,10257,1806,1683,13746
5/3/2018,2018,5,3, 12 ,10123,1718,1654,13495
5/3/2018,2018,5,3, 13 ,10138,1696,1626,13460
5/3/2018,2018,5,3, 14 ,10512,1718,1679,13909
5/3/2018,2018,5,3, 15 ,10474,1720,1637,13831
5/3/2018,2018,5,3, 16 ,10274,1722,1603,13599
5/3/2018,2018,5,3, 17 ,9771,1701,1563,13035
5/3/2018,2018,5,3, 18 ,9381,1741,1599,12721
5/3/2018,2018,5,3, 19 ,9670,1782,1554,13006
5/3/2018,2018,5,3, 20 ,9558,1716,1502,12776
5/3/2018,2018,5,3, 21 ,9452,1632,1440,12524
5/3/2018,2018,5,3, 22 ,9198,1512,1325,12035
5/3/2018,2018,5,3, 23 ,8905,1418,1235,11558
5/3/2018,2018,5,3, 24 ,8550,1350,1101,11001
5/4/2018,2018,5,4, 1 ,8247,1293,1108,10648
5/4/2018,2018,5,4, 2 ,7945,1261,1086,10292
5/4/2018,2018,5,4, 3 ,7658,1232,1055,9945
5/4/2018,2018,5,4, 4 ,7430,1218,1026,9674
5/4/2018,2018,5,4, 5 ,7419,1234,1048,9701
5/4/2018,2018,5,4, 6 ,7229,1248,1082,9559
5/4/2018,2018,5,4, 7 ,7544,1286,1089,9919
5/4/2018,2018,5,4, 8 ,8490,1445,1236,11171
5/4/2018,2018,5,4, 9 ,9285,1668,1452,12405
5/4/2018,2018,5,4, 10 ,9821,1809,1603,13233
5/4/2018,2018,5,4, 11 ,10109,1827,1680,13616
5/4/2018,2018,5,4, 12 ,9897,1777,1661,13335
5/4/2018,2018,5,4, 13 ,9937,1817,1653,13407
5/4/2018,2018,5,4, 14 ,10314,1875,1750,13939
5/4/2018,2018,5,4, 15 ,10325,1846,1707,13878
5/4/2018,2018,5,4, 16 ,10181,1832,1637,13650
5/4/2018,2018,5,4, 17 ,9650,1755,1566,12971
5/4/2018,2018,5,4, 18 ,9163,1783,1620,12566
5/4/2018,2018,5,4, 19 ,9491,1832,1653,12976
5/4/2018,2018,5,4, 20 ,9487,1783,1597,12867
5/4/2018,2018,5,4, 21 ,9438,1706,1542,12686
5/4/2018,2018,5,4, 22 ,9208,1605,1356,12169
5/4/2018,2018,5,4, 23 ,8854,1491,1202,11547
5/4/2018,2018,5,4, 24 ,8522,1413,1191,11126
5/5/2018,2018,5,5, 1 ,8158,1342,1098,10598
5/5/2018,2018,5,5, 2 ,7877,1291,1088,10256
5/5/2018,2018,5,5, 3 ,7606,1259,1064,9929
5/5/2018,2018,5,5, 4 ,7412,1244,1047,9703
5/5/2018,2018,5,5, 5 ,7281,1254,1065,9600
5/5/2018,2018,5,5, 6 ,7004,1238,1073,9315
5/5/2018,2018,5,5, 7 ,7074,1235,1064,9373
5/5/2018,2018,5,5, 8 ,7690,1329,1177,10196
5/5/2018,2018,5,5, 9 ,8316,1475,1323,11114
5/5/2018,2018,5,5, 10 ,8676,1576,1452,11704
5/5/2018,2018,5,5, 11 ,8895,1637,1524,12056
5/5/2018,2018,5,5, 12 ,8614,1622,1518,11754
5/5/2018,2018,5,5, 13 ,8592,1667,1517,11776
5/5/2018,2018,5,5, 14 ,8787,1722,1580,12089
5/5/2018,2018,5,5, 15 ,8658,1719,1549,11926
5/5/2018,2018,5,5, 16 ,8511,1680,1506,11697
5/5/2018,2018,5,5, 17 ,8183,1626,1463,11272
5/5/2018,2018,5,5, 18 ,8098,1701,1560,11359
5/5/2018,2018,5,5, 19 ,8640,1800,1602,12042
5/5/2018,2018,5,5, 20 ,8668,1760,1565,11993
5/5/2018,2018,5,5, 21 ,8648,1710,1528,11886
5/5/2018,2018,5,5, 22 ,8499,1632,1422,11553
5/5/2018,2018,5,5, 23 ,8125,1520,1287,10932
5/5/2018,2018,5,5, 24 ,7784,1426,1147,10357
5/6/2018,2018,5,6, 1 ,7419,1359,1149,9927
5/6/2018,2018,5,6, 2 ,7213,1323,1111,9647
5/6/2018,2018,5,6, 3 ,6993,1286,1072,9351
5/6/2018,2018,5,6, 4 ,6747,1261,1039,9047
5/6/2018,2018,5,6, 5 ,6636,1255,1044,8935
5/6/2018,2018,5,6, 6 ,6333,1217,1045,8595
5/6/2018,2018,5,6, 7 ,6372,1233,1046,8651
5/6/2018,2018,5,6, 8 ,6744,1309,1111,9164
5/6/2018,2018,5,6, 9 ,7229,1432,1202,9863
5/6/2018,2018,5,6, 10 ,7665,1514,1317,10496
5/6/2018,2018,5,6, 11 ,8014,1581,1395,10990
5/6/2018,2018,5,6, 12 ,8008,1576,1405,10989
5/6/2018,2018,5,6, 13 ,8030,1589,1422,11041
5/6/2018,2018,5,6, 14 ,8166,1603,1421,11190
5/6/2018,2018,5,6, 15 ,8134,1594,1404,11132
5/6/2018,2018,5,6, 16 ,7999,1540,1386,10925
5/6/2018,2018,5,6, 17 ,7838,1529,1362,10729
5/6/2018,2018,5,6, 18 ,7856,1625,1473,10954
5/6/2018,2018,5,6, 19 ,8511,1768,1549,11828
5/6/2018,2018,5,6, 20 ,8601,1744,1441,11786
5/6/2018,2018,5,6, 21 ,8595,1683,1456,11734
5/6/2018,2018,5,6, 22 ,8504,1587,1323,11414
5/6/2018,2018,5,6, 23 ,8212,1504,1277,10993
5/6/2018,2018,5,6, 24 ,7906,1421,1186,10513
5/7/2018,2018,5,7, 1 ,7583,1351,1130,10064
5/7/2018,2018,5,7, 2 ,7249,1308,1131,9688
5/7/2018,2018,5,7, 3 ,6957,1271,1058,9286
5/7/2018,2018,5,7, 4 ,6823,1247,1036,9106
5/7/2018,2018,5,7, 5 ,6758,1252,1062,9072
5/7/2018,2018,5,7, 6 ,6719,1258,1076,9053
5/7/2018,2018,5,7, 7 ,7184,1303,1096,9583
5/7/2018,2018,5,7, 8 ,8213,1491,1282,10986
5/7/2018,2018,5,7, 9 ,9174,1731,1483,12388
5/7/2018,2018,5,7, 10 ,9760,1853,1635,13248
5/7/2018,2018,5,7, 11 ,10186,1924,1709,13819
5/7/2018,2018,5,7, 12 ,10076,1898,1708,13682
5/7/2018,2018,5,7, 13 ,10120,1929,1703,13752
5/7/2018,2018,5,7, 14 ,10562,1978,1761,14301
5/7/2018,2018,5,7, 15 ,10373,1967,1745,14085
5/7/2018,2018,5,7, 16 ,10093,1931,1714,13738
5/7/2018,2018,5,7, 17 ,9586,1817,1635,13038
5/7/2018,2018,5,7, 18 ,9175,1806,1638,12619
5/7/2018,2018,5,7, 19 ,9547,1875,1654,13076
5/7/2018,2018,5,7, 20 ,9536,1837,1631,13004
5/7/2018,2018,5,7, 21 ,9472,1774,1563,12809
5/7/2018,2018,5,7, 22 ,9219,1650,1414,12283
5/7/2018,2018,5,7, 23 ,8833,1542,1279,11654
5/7/2018,2018,5,7, 24 ,8427,1468,1214,11109
5/8/2018,2018,5,8, 1 ,8134,1391,1197,10722
5/8/2018,2018,5,8, 2 ,7825,1348,1158,10331
5/8/2018,2018,5,8, 3 ,7571,1313,1112,9996
5/8/2018,2018,5,8, 4 ,7368,1291,1097,9756
5/8/2018,2018,5,8, 5 ,7266,1299,1023,9588
5/8/2018,2018,5,8, 6 ,7127,1287,1059,9473
5/8/2018,2018,5,8, 7 ,7517,1337,1126,9980
5/8/2018,2018,5,8, 8 ,8569,1540,1274,11383
5/8/2018,2018,5,8, 9 ,9377,1776,1467,12620
5/8/2018,2018,5,8, 10 ,9930,1887,1581,13398
5/8/2018,2018,5,8, 11 ,10280,1978,1676,13934
5/8/2018,2018,5,8, 12 ,10182,1935,1647,13764
5/8/2018,2018,5,8, 13 ,10282,1941,1625,13848
5/8/2018,2018,5,8, 14 ,10639,1978,1703,14320
5/8/2018,2018,5,8, 15 ,10528,1954,1698,14180
5/8/2018,2018,5,8, 16 ,10319,1904,1663,13886
5/8/2018,2018,5,8, 17 ,9730,1812,1603,13145
5/8/2018,2018,5,8, 18 ,9330,1813,1625,12768
5/8/2018,2018,5,8, 19 ,9603,1891,1648,13142
5/8/2018,2018,5,8, 20 ,9371,1842,1607,12820
5/8/2018,2018,5,8, 21 ,9253,1746,1502,12501
5/8/2018,2018,5,8, 22 ,8927,1638,1425,11990
5/8/2018,2018,5,8, 23 ,8628,1538,1279,11445
5/8/2018,2018,5,8, 24 ,8280,1461,1162,10903
5/9/2018,2018,5,9, 1 ,7947,1391,1164,10502
5/9/2018,2018,5,9, 2 ,7707,1344,1116,10167
5/9/2018,2018,5,9, 3 ,7475,1311,1091,9877
5/9/2018,2018,5,9, 4 ,7328,1281,1080,9689
5/9/2018,2018,5,9, 5 ,7267,1293,1102,9662
5/9/2018,2018,5,9, 6 ,7106,1285,1113,9504
5/9/2018,2018,5,9, 7 ,7462,1326,1119,9907
5/9/2018,2018,5,9, 8 ,8439,1527,1256,11222
5/9/2018,2018,5,9, 9 ,9386,1771,1497,12654
5/9/2018,2018,5,9, 10 ,9884,1894,1616,13394
5/9/2018,2018,5,9, 11 ,10301,1977,1700,13978
5/9/2018,2018,5,9, 12 ,10174,1936,1674,13784
5/9/2018,2018,5,9, 13 ,10229,1939,1673,13841
5/9/2018,2018,5,9, 14 ,10603,2006,1738,14347
5/9/2018,2018,5,9, 15 ,10477,1977,1696,14150
5/9/2018,2018,5,9, 16 ,10201,1928,1656,13785
5/9/2018,2018,5,9, 17 ,9675,1856,1592,13123
5/9/2018,2018,5,9, 18 ,9238,1829,1642,12709
5/9/2018,2018,5,9, 19 ,9532,1906,1663,13101
5/9/2018,2018,5,9, 20 ,9458,1844,1615,12917
5/9/2018,2018,5,9, 21 ,9430,1763,1546,12739
5/9/2018,2018,5,9, 22 ,9110,1654,1404,12168
5/9/2018,2018,5,9, 23 ,8586,1556,1280,11422
5/9/2018,2018,5,9, 24 ,8326,1475,1236,11037
5/10/2018,2018,5,10, 1 ,7981,1409,1165,10555
5/10/2018,2018,5,10, 2 ,7737,1357,1116,10210
5/10/2018,2018,5,10, 3 ,7464,1326,1083,9873
5/10/2018,2018,5,10, 4 ,7259,1306,1065,9630
5/10/2018,2018,5,10, 5 ,7224,1311,1071,9606
5/10/2018,2018,5,10, 6 ,7090,1302,1101,9493
5/10/2018,2018,5,10, 7 ,7468,1333,1101,9902
5/10/2018,2018,5,10, 8 ,8380,1530,1241,11151
5/10/2018,2018,5,10, 9 ,9270,1757,1465,12492
5/10/2018,2018,5,10, 10 ,9782,1901,1615,13298
5/10/2018,2018,5,10, 11 ,10108,1970,1687,13765
5/10/2018,2018,5,10, 12 ,10017,1939,1678,13634
5/10/2018,2018,5,10, 13 ,10069,1956,1664,13689
5/10/2018,2018,5,10, 14 ,10461,2030,1749,14240
5/10/2018,2018,5,10, 15 ,10367,2006,1717,14090
5/10/2018,2018,5,10, 16 ,10055,1968,1689,13712
5/10/2018,2018,5,10, 17 ,9486,1857,1606,12949
5/10/2018,2018,5,10, 18 ,8982,1787,1613,12382
5/10/2018,2018,5,10, 19 ,9408,1937,1639,12984
5/10/2018,2018,5,10, 20 ,9323,1869,1605,12797
5/10/2018,2018,5,10, 21 ,9273,1797,1457,12527
5/10/2018,2018,5,10, 22 ,9065,1688,1454,12207
5/10/2018,2018,5,10, 23 ,8727,1575,1343,11645
5/10/2018,2018,5,10, 24 ,8377,1486,1234,11097
5/11/2018,2018,5,11, 1 ,8042,1424,1205,10671
5/11/2018,2018,5,11, 2 ,7783,1374,1134,10291
5/11/2018,2018,5,11, 3 ,7507,1335,1097,9939
5/11/2018,2018,5,11, 4 ,7315,1300,1084,9699
5/11/2018,2018,5,11, 5 ,7240,1300,1107,9647
5/11/2018,2018,5,11, 6 ,7056,1286,1112,9454
5/11/2018,2018,5,11, 7 ,7377,1319,1118,9814
5/11/2018,2018,5,11, 8 ,8273,1513,1261,11047
5/11/2018,2018,5,11, 9 ,9187,1754,1513,12454
5/11/2018,2018,5,11, 10 ,9784,1890,1636,13310
5/11/2018,2018,5,11, 11 ,10147,1976,1713,13836
5/11/2018,2018,5,11, 12 ,10001,1916,1692,13609
5/11/2018,2018,5,11, 13 ,10059,1919,1705,13683
5/11/2018,2018,5,11, 14 ,10438,1996,1771,14205
5/11/2018,2018,5,11, 15 ,10260,1990,1752,14002
5/11/2018,2018,5,11, 16 ,10026,1951,1707,13684
5/11/2018,2018,5,11, 17 ,9515,1834,1608,12957
5/11/2018,2018,5,11, 18 ,9073,1802,1627,12502
5/11/2018,2018,5,11, 19 ,9393,1915,1667,12975
5/11/2018,2018,5,11, 20 ,9329,1852,1624,12805
5/11/2018,2018,5,11, 21 ,9231,1797,1576,12604
5/11/2018,2018,5,11, 22 ,8996,1693,1472,12161
5/11/2018,2018,5,11, 23 ,8673,1587,1367,11627
5/11/2018,2018,5,11, 24 ,8326,1498,1268,11092
5/12/2018,2018,5,12, 1 ,8001,1439,1228,10668
5/12/2018,2018,5,12, 2 ,7696,1383,1177,10256
5/12/2018,2018,5,12, 3 ,7429,1349,1140,9918
5/12/2018,2018,5,12, 4 ,7278,1336,1120,9734
5/12/2018,2018,5,12, 5 ,7159,1309,1121,9589
5/12/2018,2018,5,12, 6 ,6842,1279,1124,9245
5/12/2018,2018,5,12, 7 ,6978,1309,1119,9406
5/12/2018,2018,5,12, 8 ,7674,1455,1254,10383
5/12/2018,2018,5,12, 9 ,8450,1644,1370,11464
5/12/2018,2018,5,12, 10 ,9031,1775,1542,12348
5/12/2018,2018,5,12, 11 ,9409,1833,1626,12868
5/12/2018,2018,5,12, 12 ,9274,1798,1605,12677
5/12/2018,2018,5,12, 13 ,9363,1795,1613,12771
5/12/2018,2018,5,12, 14 ,9680,1855,1670,13205
5/12/2018,2018,5,12, 15 ,9529,1838,1593,12960
5/12/2018,2018,5,12, 16 ,9076,1776,1577,12429
5/12/2018,2018,5,12, 17 ,8582,1705,1483,11770
5/12/2018,2018,5,12, 18 ,8453,1723,1532,11708
5/12/2018,2018,5,12, 19 ,8834,1858,1636,12328
5/12/2018,2018,5,12, 20 ,8907,1824,1589,12320
5/12/2018,2018,5,12, 21 ,8912,1771,1544,12227
5/12/2018,2018,5,12, 22 ,8719,1697,1459,11875
5/12/2018,2018,5,12, 23 ,8451,1584,1346,11381
5/12/2018,2018,5,12, 24 ,8097,1498,1267,10862
5/13/2018,2018,5,13, 1 ,7775,1431,1207,10413
5/13/2018,2018,5,13, 2 ,7494,1386,1131,10011
5/13/2018,2018,5,13, 3 ,7248,1342,1118,9708
5/13/2018,2018,5,13, 4 ,7001,1305,1094,9400
5/13/2018,2018,5,13, 5 ,6845,1290,1085,9220
5/13/2018,2018,5,13, 6 ,6469,1249,1073,8791
5/13/2018,2018,5,13, 7 ,6572,1269,1065,8906
5/13/2018,2018,5,13, 8 ,6969,1343,1132,9444
5/13/2018,2018,5,13, 9 ,7472,1473,1237,10182
5/13/2018,2018,5,13, 10 ,7998,1563,1348,10909
5/13/2018,2018,5,13, 11 ,8270,1591,1392,11253
5/13/2018,2018,5,13, 12 ,8248,1613,1350,11211
5/13/2018,2018,5,13, 13 ,8322,1629,1422,11373
5/13/2018,2018,5,13, 14 ,8496,1637,1374,11507
5/13/2018,2018,5,13, 15 ,8416,1612,1418,11446
5/13/2018,2018,5,13, 16 ,8213,1548,1357,11118
5/13/2018,2018,5,13, 17 ,7938,1526,1302,10766
5/13/2018,2018,5,13, 18 ,7907,1601,1441,10949
5/13/2018,2018,5,13, 19 ,8458,1737,1504,11699
5/13/2018,2018,5,13, 20 ,8452,1719,1511,11682
5/13/2018,2018,5,13, 21 ,8506,1669,1490,11665
5/13/2018,2018,5,13, 22 ,8396,1604,1415,11415
5/13/2018,2018,5,13, 23 ,8172,1509,1287,10968
5/13/2018,2018,5,13, 24 ,7835,1419,1168,10422
5/14/2018,2018,5,14, 1 ,7480,1353,1163,9996
5/14/2018,2018,5,14, 2 ,7237,1303,1098,9638
5/14/2018,2018,5,14, 3 ,6958,1264,1075,9297
5/14/2018,2018,5,14, 4 ,6755,1229,1064,9048
5/14/2018,2018,5,14, 5 ,6621,1234,1079,8934
5/14/2018,2018,5,14, 6 ,6266,1189,1043,8498
5/14/2018,2018,5,14, 7 ,6211,1180,1000,8391
5/14/2018,2018,5,14, 8 ,6421,1228,1039,8688
5/14/2018,2018,5,14, 9 ,6838,1305,1136,9279
5/14/2018,2018,5,14, 10 ,7286,1399,1234,9919
5/14/2018,2018,5,14, 11 ,7727,1495,1333,10555
5/14/2018,2018,5,14, 12 ,7892,1543,1383,10818
5/14/2018,2018,5,14, 13 ,8052,1556,1403,11011
5/14/2018,2018,5,14, 14 ,8200,1580,1413,11193
5/14/2018,2018,5,14, 15 ,8240,1557,1402,11199
5/14/2018,2018,5,14, 16 ,8128,1515,1358,11001
5/14/2018,2018,5,14, 17 ,8037,1491,1329,10857
5/14/2018,2018,5,14, 18 ,7880,1599,1423,10902
5/14/2018,2018,5,14, 19 ,8561,1718,1458,11737
5/14/2018,2018,5,14, 20 ,8560,1704,1435,11699
5/14/2018,2018,5,14, 21 ,8636,1666,1407,11709
5/14/2018,2018,5,14, 22 ,8505,1576,1288,11369
5/14/2018,2018,5,14, 23 ,8224,1494,1230,10948
5/14/2018,2018,5,14, 24 ,7930,1414,1156,10500
5/15/2018,2018,5,15, 1 ,7642,1358,1107,10107
5/15/2018,2018,5,15, 2 ,7380,1319,1078,9777
5/15/2018,2018,5,15, 3 ,7169,1288,1042,9499
5/15/2018,2018,5,15, 4 ,6983,1263,1023,9269
5/15/2018,2018,5,15, 5 ,6870,1266,1038,9174
5/15/2018,2018,5,15, 6 ,6804,1252,1048,9104
5/15/2018,2018,5,15, 7 ,7284,1297,1083,9664
5/15/2018,2018,5,15, 8 ,8332,1502,1258,11092
5/15/2018,2018,5,15, 9 ,9299,1751,1480,12530
5/15/2018,2018,5,15, 10 ,9841,1901,1650,13392
5/15/2018,2018,5,15, 11 ,10088,1963,1681,13732
5/15/2018,2018,5,15, 12 ,10038,1951,1698,13687
5/15/2018,2018,5,15, 13 ,10116,1953,1693,13762
5/15/2018,2018,5,15, 14 ,10382,2006,1754,14142
5/15/2018,2018,5,15, 15 ,10207,1987,1726,13920
5/15/2018,2018,5,15, 16 ,9842,1941,1690,13473
5/15/2018,2018,5,15, 17 ,9365,1829,1620,12814
5/15/2018,2018,5,15, 18 ,8994,1821,1644,12459
5/15/2018,2018,5,15, 19 ,9369,1892,1622,12883
5/15/2018,2018,5,15, 20 ,9360,1851,1594,12805
5/15/2018,2018,5,15, 21 ,9294,1797,1566,12657
5/15/2018,2018,5,15, 22 ,9100,1692,1422,12214
5/15/2018,2018,5,15, 23 ,8657,1576,1340,11573
5/15/2018,2018,5,15, 24 ,8326,1508,1133,10967
5/16/2018,2018,5,16, 1 ,8000,1447,1201,10648
5/16/2018,2018,5,16, 2 ,7720,1400,1167,10287
5/16/2018,2018,5,16, 3 ,7493,1365,1139,9997
5/16/2018,2018,5,16, 4 ,7255,1336,1101,9692
5/16/2018,2018,5,16, 5 ,7230,1345,1121,9696
5/16/2018,2018,5,16, 6 ,7072,1327,1123,9522
5/16/2018,2018,5,16, 7 ,7417,1364,1129,9910
5/16/2018,2018,5,16, 8 ,8285,1533,1313,11131
5/16/2018,2018,5,16, 9 ,9297,1784,1535,12616
5/16/2018,2018,5,16, 10 ,9875,1918,1674,13467
5/16/2018,2018,5,16, 11 ,10243,1968,1695,13906
5/16/2018,2018,5,16, 12 ,10125,1949,1687,13761
5/16/2018,2018,5,16, 13 ,10185,1963,1715,13863
5/16/2018,2018,5,16, 14 ,10601,1995,1698,14294
5/16/2018,2018,5,16, 15 ,10568,1985,1664,14217
5/16/2018,2018,5,16, 16 ,10355,1949,1688,13992
5/16/2018,2018,5,16, 17 ,9757,1848,1630,13235
5/16/2018,2018,5,16, 18 ,9256,1861,1704,12821
5/16/2018,2018,5,16, 19 ,9527,1936,1543,13006
5/16/2018,2018,5,16, 20 ,9537,1892,1596,13025
5/16/2018,2018,5,16, 21 ,9454,1824,1557,12835
5/16/2018,2018,5,16, 22 ,9169,1706,1449,12324
5/16/2018,2018,5,16, 23 ,8871,1588,1349,11808
5/16/2018,2018,5,16, 24 ,8447,1516,1202,11165
5/17/2018,2018,5,17, 1 ,8129,1462,1178,10769
5/17/2018,2018,5,17, 2 ,7854,1417,1181,10452
5/17/2018,2018,5,17, 3 ,7628,1373,1152,10153
5/17/2018,2018,5,17, 4 ,7392,1349,1125,9866
5/17/2018,2018,5,17, 5 ,7284,1353,1121,9758
5/17/2018,2018,5,17, 6 ,7111,1333,1121,9565
5/17/2018,2018,5,17, 7 ,7502,1365,1151,10018
5/17/2018,2018,5,17, 8 ,8464,1571,1314,11349
5/17/2018,2018,5,17, 9 ,9417,1835,1562,12814
5/17/2018,2018,5,17, 10 ,9956,1957,1670,13583
5/17/2018,2018,5,17, 11 ,10313,2018,1740,14071
5/17/2018,2018,5,17, 12 ,10159,1965,1677,13801
5/17/2018,2018,5,17, 13 ,10244,1983,1727,13954
5/17/2018,2018,5,17, 14 ,10679,2019,1768,14466
5/17/2018,2018,5,17, 15 ,10564,1983,1723,14270
5/17/2018,2018,5,17, 16 ,10368,1951,1742,14061
5/17/2018,2018,5,17, 17 ,9883,1876,1651,13410
5/17/2018,2018,5,17, 18 ,9223,1858,1676,12757
5/17/2018,2018,5,17, 19 ,9476,1954,1662,13092
5/17/2018,2018,5,17, 20 ,9403,1898,1604,12905
5/17/2018,2018,5,17, 21 ,9448,1831,1556,12835
5/17/2018,2018,5,17, 22 ,9252,1716,1450,12418
5/17/2018,2018,5,17, 23 ,9001,1626,1369,11996
5/17/2018,2018,5,17, 24 ,8618,1542,1356,11516
5/18/2018,2018,5,18, 1 ,8276,1467,1233,10976
5/18/2018,2018,5,18, 2 ,7989,1421,1191,10601
5/18/2018,2018,5,18, 3 ,7713,1379,1172,10264
5/18/2018,2018,5,18, 4 ,7461,1340,1149,9950
5/18/2018,2018,5,18, 5 ,7334,1347,1153,9834
5/18/2018,2018,5,18, 6 ,7147,1333,1146,9626
5/18/2018,2018,5,18, 7 ,7497,1365,1151,10013
5/18/2018,2018,5,18, 8 ,8508,1552,1298,11358
5/18/2018,2018,5,18, 9 ,9433,1812,1540,12785
5/18/2018,2018,5,18, 10 ,9937,1945,1693,13575
5/18/2018,2018,5,18, 11 ,10230,2014,1762,14006
5/18/2018,2018,5,18, 12 ,10109,1967,1721,13797
5/18/2018,2018,5,18, 13 ,10173,1964,1693,13830
5/18/2018,2018,5,18, 14 ,10597,2004,1765,14366
5/18/2018,2018,5,18, 15 ,10503,1989,1735,14227
5/18/2018,2018,5,18, 16 ,10253,1945,1707,13905
5/18/2018,2018,5,18, 17 ,9726,1848,1627,13201
5/18/2018,2018,5,18, 18 ,9252,1845,1664,12761
5/18/2018,2018,5,18, 19 ,9602,1932,1648,13182
5/18/2018,2018,5,18, 20 ,9586,1886,1567,13039
5/18/2018,2018,5,18, 21 ,9689,1848,1529,13066
5/18/2018,2018,5,18, 22 ,9362,1735,1407,12504
5/18/2018,2018,5,18, 23 ,9051,1636,1270,11957
5/18/2018,2018,5,18, 24 ,8706,1546,1212,11464
5/19/2018,2018,5,19, 1 ,8347,1463,1173,10983
5/19/2018,2018,5,19, 2 ,8085,1414,1145,10644
5/19/2018,2018,5,19, 3 ,7873,1354,1142,10369
5/19/2018,2018,5,19, 4 ,7569,1328,1112,10009
5/19/2018,2018,5,19, 5 ,7387,1336,1124,9847
5/19/2018,2018,5,19, 6 ,7061,1299,1125,9485
5/19/2018,2018,5,19, 7 ,7197,1321,1115,9633
5/19/2018,2018,5,19, 8 ,7877,1462,1241,10580
5/19/2018,2018,5,19, 9 ,8478,1653,1360,11491
5/19/2018,2018,5,19, 10 ,9025,1758,1467,12250
5/19/2018,2018,5,19, 11 ,9350,1818,1556,12724
5/19/2018,2018,5,19, 12 ,9235,1759,1534,12528
5/19/2018,2018,5,19, 13 ,9297,1771,1570,12638
5/19/2018,2018,5,19, 14 ,9612,1814,1615,13041
5/19/2018,2018,5,19, 15 ,9453,1788,1576,12817
5/19/2018,2018,5,19, 16 ,9096,1745,1520,12361
5/19/2018,2018,5,19, 17 ,8696,1696,1468,11860
5/19/2018,2018,5,19, 18 ,8493,1736,1546,11775
5/19/2018,2018,5,19, 19 ,8977,1864,1580,12421
5/19/2018,2018,5,19, 20 ,9036,1829,1570,12435
5/19/2018,2018,5,19, 21 ,9045,1762,1528,12335
5/19/2018,2018,5,19, 22 ,8959,1695,1447,12101
5/19/2018,2018,5,19, 23 ,8702,1588,1327,11617
5/19/2018,2018,5,19, 24 ,8352,1491,1225,11068
5/20/2018,2018,5,20, 1 ,8034,1431,1172,10637
5/20/2018,2018,5,20, 2 ,7755,1383,1138,10276
5/20/2018,2018,5,20, 3 ,7519,1343,1121,9983
5/20/2018,2018,5,20, 4 ,7281,1309,1082,9672
5/20/2018,2018,5,20, 5 ,7114,1294,1078,9486
5/20/2018,2018,5,20, 6 ,6721,1258,1047,9026
5/20/2018,2018,5,20, 7 ,6798,1259,1040,9097
5/20/2018,2018,5,20, 8 ,7151,1322,1111,9584
5/20/2018,2018,5,20, 9 ,7693,1459,1225,10377
5/20/2018,2018,5,20, 10 ,8176,1547,1328,11051
5/20/2018,2018,5,20, 11 ,8459,1602,1391,11452
5/20/2018,2018,5,20, 12 ,8391,1587,1346,11324
5/20/2018,2018,5,20, 13 ,8444,1600,1230,11274
5/20/2018,2018,5,20, 14 ,8573,1607,1264,11444
5/20/2018,2018,5,20, 15 ,8387,1555,1213,11155
5/20/2018,2018,5,20, 16 ,8157,1525,1237,10919
5/20/2018,2018,5,20, 17 ,7938,1532,1305,10775
5/20/2018,2018,5,20, 18 ,8002,1658,1352,11012
5/20/2018,2018,5,20, 19 ,8572,1767,1342,11681
5/20/2018,2018,5,20, 20 ,8739,1747,1334,11820
5/20/2018,2018,5,20, 21 ,8713,1694,1308,11715
5/20/2018,2018,5,20, 22 ,8607,1614,1268,11489
5/20/2018,2018,5,20, 23 ,8343,1513,1158,11014
5/20/2018,2018,5,20, 24 ,7981,1432,1177,10590
5/21/2018,2018,5,21, 1 ,7643,1377,1066,10086
5/21/2018,2018,5,21, 2 ,7372,1332,1039,9743
5/21/2018,2018,5,21, 3 ,7110,1288,1020,9418
5/21/2018,2018,5,21, 4 ,6949,1265,1005,9219
5/21/2018,2018,5,21, 5 ,6927,1270,1013,9210
5/21/2018,2018,5,21, 6 ,6838,1254,1036,9128
5/21/2018,2018,5,21, 7 ,7331,1313,1050,9694
5/21/2018,2018,5,21, 8 ,8361,1524,1226,11111
5/21/2018,2018,5,21, 9 ,9398,1783,1464,12645
5/21/2018,2018,5,21, 10 ,9944,1901,1617,13462
5/21/2018,2018,5,21, 11 ,10306,1957,1680,13943
5/21/2018,2018,5,21, 12 ,10185,1918,1679,13782
5/21/2018,2018,5,21, 13 ,10239,1903,1693,13835
5/21/2018,2018,5,21, 14 ,10589,1976,1745,14310
5/21/2018,2018,5,21, 15 ,10487,1915,1777,14179
5/21/2018,2018,5,21, 16 ,10293,1876,1710,13879
5/21/2018,2018,5,21, 17 ,9833,1771,1641,13245
5/21/2018,2018,5,21, 18 ,9340,1790,1683,12813
5/21/2018,2018,5,21, 19 ,9686,1853,1674,13213
5/21/2018,2018,5,21, 20 ,9572,1814,1623,13009
5/21/2018,2018,5,21, 21 ,9352,1748,1601,12701
5/21/2018,2018,5,21, 22 ,9066,1625,1469,12160
5/21/2018,2018,5,21, 23 ,8709,1527,1349,11585
5/21/2018,2018,5,21, 24 ,8287,1436,1261,10984
5/22/2018,2018,5,22, 1 ,7974,1380,1201,10555
5/22/2018,2018,5,22, 2 ,7726,1327,1174,10227
5/22/2018,2018,5,22, 3 ,7462,1280,1161,9903
5/22/2018,2018,5,22, 4 ,7240,1254,1123,9617
5/22/2018,2018,5,22, 5 ,7151,1265,1148,9564
5/22/2018,2018,5,22, 6 ,7001,1265,1138,9404
5/22/2018,2018,5,22, 7 ,7354,1303,1158,9815
5/22/2018,2018,5,22, 8 ,8441,1507,1361,11309
5/22/2018,2018,5,22, 9 ,9378,1753,1579,12710
5/22/2018,2018,5,22, 10 ,10012,1906,1705,13623
5/22/2018,2018,5,22, 11 ,10431,1978,1776,14185
5/22/2018,2018,5,22, 12 ,10314,1934,1756,14004
5/22/2018,2018,5,22, 13 ,10406,1924,1775,14105
5/22/2018,2018,5,22, 14 ,10690,1995,1794,14479
5/22/2018,2018,5,22, 15 ,10285,1978,1810,14073
5/22/2018,2018,5,22, 16 ,9852,1918,1777,13547
5/22/2018,2018,5,22, 17 ,9408,1833,1687,12928
5/22/2018,2018,5,22, 18 ,9061,1826,1689,12576
5/22/2018,2018,5,22, 19 ,9442,1918,1736,13096
5/22/2018,2018,5,22, 20 ,9449,1870,1690,13009
5/22/2018,2018,5,22, 21 ,9380,1798,1651,12829
5/22/2018,2018,5,22, 22 ,9087,1676,1252,12015
5/22/2018,2018,5,22, 23 ,8688,1579,1190,11457
5/22/2018,2018,5,22, 24 ,8357,1498,1103,10958
5/23/2018,2018,5,23, 1 ,8017,1439,1278,10734
5/23/2018,2018,5,23, 2 ,7701,1402,1237,10340
5/23/2018,2018,5,23, 3 ,7437,1351,1223,10011
5/23/2018,2018,5,23, 4 ,7236,1324,1174,9734
5/23/2018,2018,5,23, 5 ,7192,1327,1184,9703
5/23/2018,2018,5,23, 6 ,7029,1316,1178,9523
5/23/2018,2018,5,23, 7 ,7354,1335,1172,9861
5/23/2018,2018,5,23, 8 ,8303,1543,1354,11200
5/23/2018,2018,5,23, 9 ,9184,1805,1600,12589
5/23/2018,2018,5,23, 10 ,9848,1945,1720,13513
5/23/2018,2018,5,23, 11 ,10164,2027,1788,13979
5/23/2018,2018,5,23, 12 ,10065,1972,1760,13797
5/23/2018,2018,5,23, 13 ,10135,1976,1753,13864
5/23/2018,2018,5,23, 14 ,10505,2042,1847,14394
5/23/2018,2018,5,23, 15 ,10379,2007,1818,14204
5/23/2018,2018,5,23, 16 ,10115,1979,1786,13880
5/23/2018,2018,5,23, 17 ,9691,1856,1695,13242
5/23/2018,2018,5,23, 18 ,9297,1846,1706,12849
5/23/2018,2018,5,23, 19 ,9650,1956,1740,13346
5/23/2018,2018,5,23, 20 ,9679,1901,1673,13253
5/23/2018,2018,5,23, 21 ,9608,1847,1632,13087
5/23/2018,2018,5,23, 22 ,9407,1730,1518,12655
5/23/2018,2018,5,23, 23 ,9055,1627,1344,12026
5/23/2018,2018,5,23, 24 ,8668,1540,1276,11484
5/24/2018,2018,5,24, 1 ,8314,1473,1282,11069
5/24/2018,2018,5,24, 2 ,8093,1402,1240,10735
5/24/2018,2018,5,24, 3 ,7792,1380,1194,10366
5/24/2018,2018,5,24, 4 ,7586,1353,1158,10097
5/24/2018,2018,5,24, 5 ,7514,1353,1164,10031
5/24/2018,2018,5,24, 6 ,7301,1322,1161,9784
5/24/2018,2018,5,24, 7 ,7656,1369,1173,10198
5/24/2018,2018,5,24, 8 ,8612,1581,1356,11549
5/24/2018,2018,5,24, 9 ,9594,1830,1467,12891
5/24/2018,2018,5,24, 10 ,10144,1976,1703,13823
5/24/2018,2018,5,24, 11 ,10450,2007,1794,14251
5/24/2018,2018,5,24, 12 ,10311,1976,1738,14025
5/24/2018,2018,5,24, 13 ,10381,1986,1770,14137
5/24/2018,2018,5,24, 14 ,10392,2052,1790,14234
5/24/2018,2018,5,24, 15 ,10207,2028,1786,14021
5/24/2018,2018,5,24, 16 ,9993,1991,1769,13753
5/24/2018,2018,5,24, 17 ,9484,1883,1737,13104
5/24/2018,2018,5,24, 18 ,9149,1831,1696,12676
5/24/2018,2018,5,24, 19 ,9440,1965,1712,13117
5/24/2018,2018,5,24, 20 ,9428,1924,1673,13025
5/24/2018,2018,5,24, 21 ,9366,1865,1615,12846
5/24/2018,2018,5,24, 22 ,9119,1765,1503,12387
5/24/2018,2018,5,24, 23 ,8737,1653,1400,11790
5/24/2018,2018,5,24, 24 ,8371,1557,1297,11225
5/25/2018,2018,5,25, 1 ,8028,1499,1268,10795
5/25/2018,2018,5,25, 2 ,7763,1438,1225,10426
5/25/2018,2018,5,25, 3 ,7489,1399,1196,10084
5/25/2018,2018,5,25, 4 ,7269,1375,1159,9803
5/25/2018,2018,5,25, 5 ,7157,1371,1141,9669
5/25/2018,2018,5,25, 6 ,7023,1343,1157,9523
5/25/2018,2018,5,25, 7 ,7433,1374,1163,9970
5/25/2018,2018,5,25, 8 ,8463,1583,1327,11373
5/25/2018,2018,5,25, 9 ,9491,1830,1534,12855
5/25/2018,2018,5,25, 10 ,10052,1937,1642,13631
5/25/2018,2018,5,25, 11 ,10400,2002,1708,14110
5/25/2018,2018,5,25, 12 ,10110,1948,1651,13709
5/25/2018,2018,5,25, 13 ,9948,1907,1645,13500
5/25/2018,2018,5,25, 14 ,10061,1959,1691,13711
5/25/2018,2018,5,25, 15 ,9747,1918,1655,13320
5/25/2018,2018,5,25, 16 ,9594,1831,1641,13066
5/25/2018,2018,5,25, 17 ,9199,1733,1578,12510
5/25/2018,2018,5,25, 18 ,8841,1744,1590,12175
5/25/2018,2018,5,25, 19 ,9222,1743,1528,12493
5/25/2018,2018,5,25, 20 ,9169,1701,1551,12421
5/25/2018,2018,5,25, 21 ,9155,1658,1417,12230
5/25/2018,2018,5,25, 22 ,8897,1566,1300,11763
5/25/2018,2018,5,25, 23 ,8488,1470,1213,11171
5/25/2018,2018,5,25, 24 ,8140,1396,1262,10798
5/26/2018,2018,5,26, 1 ,7841,1350,1148,10339
5/26/2018,2018,5,26, 2 ,7597,1308,1130,10035
5/26/2018,2018,5,26, 3 ,7306,1263,1114,9683
5/26/2018,2018,5,26, 4 ,7133,1244,1078,9455
5/26/2018,2018,5,26, 5 ,7017,1256,1092,9365
5/26/2018,2018,5,26, 6 ,6764,1233,1088,9085
5/26/2018,2018,5,26, 7 ,6907,1269,1020,9196
5/26/2018,2018,5,26, 8 ,7677,1402,1130,10209
5/26/2018,2018,5,26, 9 ,8514,1584,1285,11383
5/26/2018,2018,5,26, 10 ,9171,1690,1442,12303
5/26/2018,2018,5,26, 11 ,9445,1760,1495,12700
5/26/2018,2018,5,26, 12 ,9342,1724,1485,12551
5/26/2018,2018,5,26, 13 ,9416,1747,1510,12673
5/26/2018,2018,5,26, 14 ,9703,1811,1549,13063
5/26/2018,2018,5,26, 15 ,9496,1783,1520,12799
5/26/2018,2018,5,26, 16 ,9077,1729,1499,12305
5/26/2018,2018,5,26, 17 ,8566,1672,1426,11664
5/26/2018,2018,5,26, 18 ,8344,1692,1485,11521
5/26/2018,2018,5,26, 19 ,8862,1836,1556,12254
5/26/2018,2018,5,26, 20 ,8958,1809,1567,12334
5/26/2018,2018,5,26, 21 ,8975,1757,1474,12206
5/26/2018,2018,5,26, 22 ,8769,1692,1446,11907
5/26/2018,2018,5,26, 23 ,8514,1592,1360,11466
5/26/2018,2018,5,26, 24 ,8160,1502,1218,10880
5/27/2018,2018,5,27, 1 ,7826,1436,1189,10451
5/27/2018,2018,5,27, 2 ,7554,1385,1139,10078
5/27/2018,2018,5,27, 3 ,7306,1350,1124,9780
5/27/2018,2018,5,27, 4 ,7087,1312,1107,9506
5/27/2018,2018,5,27, 5 ,6860,1308,1094,9262
5/27/2018,2018,5,27, 6 ,6496,1242,1064,8802
5/27/2018,2018,5,27, 7 ,6588,1272,1061,8921
5/27/2018,2018,5,27, 8 ,7015,1341,1104,9460
5/27/2018,2018,5,27, 9 ,7516,1440,1166,10122
5/27/2018,2018,5,27, 10 ,8083,1551,1268,10902
5/27/2018,2018,5,27, 11 ,8360,1597,1346,11303
5/27/2018,2018,5,27, 12 ,8314,1586,1336,11236
5/27/2018,2018,5,27, 13 ,8409,1589,1342,11340
5/27/2018,2018,5,27, 14 ,8549,1565,1346,11460
5/27/2018,2018,5,27, 15 ,8476,1575,1325,11376
5/27/2018,2018,5,27, 16 ,8335,1540,1288,11163
5/27/2018,2018,5,27, 17 ,8089,1504,1283,10876
5/27/2018,2018,5,27, 18 ,8026,1595,1383,11004
5/27/2018,2018,5,27, 19 ,8747,1768,1495,12010
5/27/2018,2018,5,27, 20 ,8880,1705,1452,12037
5/27/2018,2018,5,27, 21 ,8972,1693,1379,12044
5/27/2018,2018,5,27, 22 ,8874,1613,1331,11818
5/27/2018,2018,5,27, 23 ,8625,1519,1251,11395
5/27/2018,2018,5,27, 24 ,8278,1448,1180,10906
5/28/2018,2018,5,28, 1 ,7945,1374,1149,10468
5/28/2018,2018,5,28, 2 ,7629,1339,1128,10096
5/28/2018,2018,5,28, 3 ,7406,1295,1103,9804
5/28/2018,2018,5,28, 4 ,7192,1271,1078,9541
5/28/2018,2018,5,28, 5 ,7085,1273,1084,9442
5/28/2018,2018,5,28, 6 ,6949,1249,1085,9283
5/28/2018,2018,5,28, 7 ,7465,1318,1125,9908
5/28/2018,2018,5,28, 8 ,8462,1514,1279,11255
5/28/2018,2018,5,28, 9 ,9496,1763,1488,12747
5/28/2018,2018,5,28, 10 ,10103,1913,1670,13686
5/28/2018,2018,5,28, 11 ,10475,1949,1735,14159
5/28/2018,2018,5,28, 12 ,10341,1920,1702,13963
5/28/2018,2018,5,28, 13 ,10451,1942,1680,14073
5/28/2018,2018,5,28, 14 ,10813,2011,1715,14539
5/28/2018,2018,5,28, 15 ,10777,1976,1714,14467
5/28/2018,2018,5,28, 16 ,10591,1917,1670,14178
5/28/2018,2018,5,28, 17 ,10023,1834,1614,13471
5/28/2018,2018,5,28, 18 ,9448,1797,1602,12847
5/28/2018,2018,5,28, 19 ,9805,1928,1626,13359
5/28/2018,2018,5,28, 20 ,9930,1885,1581,13396
5/28/2018,2018,5,28, 21 ,9784,1815,1513,13112
5/28/2018,2018,5,28, 22 ,9615,1705,1380,12700
5/28/2018,2018,5,28, 23 ,9271,1603,1287,12161
5/28/2018,2018,5,28, 24 ,8877,1514,1218,11609
5/29/2018,2018,5,29, 1 ,8510,1444,1170,11124
5/29/2018,2018,5,29, 2 ,8240,1391,1130,10761
5/29/2018,2018,5,29, 3 ,7956,1358,1104,10418
5/29/2018,2018,5,29, 4 ,7704,1307,1072,10083
5/29/2018,2018,5,29, 5 ,7610,1302,1077,9989
5/29/2018,2018,5,29, 6 ,7410,1281,1108,9799
5/29/2018,2018,5,29, 7 ,7804,1320,1108,10232
5/29/2018,2018,5,29, 8 ,8753,1500,1241,11494
5/29/2018,2018,5,29, 9 ,9652,1745,1453,12850
5/29/2018,2018,5,29, 10 ,10237,1903,1595,13735
5/29/2018,2018,5,29, 11 ,10521,1963,1651,14135
5/29/2018,2018,5,29, 12 ,10395,1900,1628,13923
5/29/2018,2018,5,29, 13 ,10431,1889,1662,13982
5/29/2018,2018,5,29, 14 ,10730,1963,1729,14422
5/29/2018,2018,5,29, 15 ,10600,1949,1741,14290
5/29/2018,2018,5,29, 16 ,10451,1891,1732,14074
5/29/2018,2018,5,29, 17 ,9963,1802,1619,13384
5/29/2018,2018,5,29, 18 ,9445,1812,1659,12916
5/29/2018,2018,5,29, 19 ,9788,1912,1670,13370
5/29/2018,2018,5,29, 20 ,9765,1856,1629,13250
5/29/2018,2018,5,29, 21 ,9770,1778,1586,13134
5/29/2018,2018,5,29, 22 ,9491,1666,1452,12609
5/29/2018,2018,5,29, 23 ,9116,1554,1347,12017
5/29/2018,2018,5,29, 24 ,8722,1474,1226,11422
5/30/2018,2018,5,30, 1 ,8407,1420,1190,11017
5/30/2018,2018,5,30, 2 ,8155,1373,1156,10684
5/30/2018,2018,5,30, 3 ,7873,1327,1134,10334
5/30/2018,2018,5,30, 4 ,7642,1303,1113,10058
5/30/2018,2018,5,30, 5 ,7547,1300,1112,9959
5/30/2018,2018,5,30, 6 ,7333,1287,1137,9757
5/30/2018,2018,5,30, 7 ,7695,1308,1143,10146
5/30/2018,2018,5,30, 8 ,8683,1491,1275,11449
5/30/2018,2018,5,30, 9 ,9588,1724,1462,12774
5/30/2018,2018,5,30, 10 ,10186,1848,1523,13557
5/30/2018,2018,5,30, 11 ,10289,1921,1647,13857
5/30/2018,2018,5,30, 12 ,10292,1868,1600,13760
5/30/2018,2018,5,30, 13 ,10322,1865,1592,13779
5/30/2018,2018,5,30, 14 ,10463,1908,1674,14045
5/30/2018,2018,5,30, 15 ,10207,1854,1677,13738
5/30/2018,2018,5,30, 16 ,9993,1817,1621,13431
5/30/2018,2018,5,30, 17 ,9669,1753,1584,13006
5/30/2018,2018,5,30, 18 ,9174,1774,1616,12564
5/30/2018,2018,5,30, 19 ,9549,1822,1600,12971
5/30/2018,2018,5,30, 20 ,9572,1774,1522,12868
5/30/2018,2018,5,30, 21 ,9519,1706,1474,12699
5/30/2018,2018,5,30, 22 ,9205,1592,1319,12116
5/30/2018,2018,5,30, 23 ,8874,1482,1242,11598
5/30/2018,2018,5,30, 24 ,8515,1408,1196,11119
5/31/2018,2018,5,31, 1 ,8165,1355,1143,10663
5/31/2018,2018,5,31, 2 ,7912,1317,1109,10338
5/31/2018,2018,5,31, 3 ,7628,1272,1101,10001
5/31/2018,2018,5,31, 4 ,7459,1252,1077,9788
5/31/2018,2018,5,31, 5 ,7414,1271,1077,9762
5/31/2018,2018,5,31, 6 ,7242,1267,1099,9608
5/31/2018,2018,5,31, 7 ,7539,1302,1124,9965
5/31/2018,2018,5,31, 8 ,8346,1500,1254,11100
5/31/2018,2018,5,31, 9 ,9287,1735,1465,12487
5/31/2018,2018,5,31, 10 ,9821,1858,1599,13278
5/31/2018,2018,5,31, 11 ,10181,1931,1644,13756
5/31/2018,2018,5,31, 12 ,10102,1887,1622,13611
5/31/2018,2018,5,31, 13 ,10059,1888,1643,13590
5/31/2018,2018,5,31, 14 ,10525,1953,1691,14169
5/31/2018,2018,5,31, 15 ,10441,1929,1653,14023
5/31/2018,2018,5,31, 16 ,10195,1894,1607,13696
5/31/2018,2018,5,31, 17 ,9683,1794,1561,13038
5/31/2018,2018,5,31, 18 ,9297,1792,1607,12696
5/31/2018,2018,5,31, 19 ,9599,1897,1586,13082
5/31/2018,2018,5,31, 20 ,9608,1834,1585,13027
5/31/2018,2018,5,31, 21 ,9611,1755,1520,12886
5/31/2018,2018,5,31, 22 ,9357,1640,1393,12390
5/31/2018,2018,5,31, 23 ,8972,1520,1281,11773
5/31/2018,2018,5,31, 24 ,8578,1430,1206,11214
6/1/2018,2018,6,1, 1 ,8290,1371,1099,10760
6/1/2018,2018,6,1, 2 ,8027,1324,1111,10462
6/1/2018,2018,6,1, 3 ,7747,1291,1086,10124
6/1/2018,2018,6,1, 4 ,7515,1270,1057,9842
6/1/2018,2018,6,1, 5 ,7416,1282,1062,9760
6/1/2018,2018,6,1, 6 ,7210,1265,1079,9554
6/1/2018,2018,6,1, 7 ,7521,1292,1088,9901
6/1/2018,2018,6,1, 8 ,8479,1484,1225,11188
6/1/2018,2018,6,1, 9 ,9502,1744,1450,12696
6/1/2018,2018,6,1, 10 ,10048,1871,1591,13510
6/1/2018,2018,6,1, 11 ,10418,1944,1646,14008
6/1/2018,2018,6,1, 12 ,10225,1881,1599,13705
6/1/2018,2018,6,1, 13 ,10311,1866,1593,13770
6/1/2018,2018,6,1, 14 ,10652,1920,1665,14237
6/1/2018,2018,6,1, 15 ,10522,1880,1623,14025
6/1/2018,2018,6,1, 16 ,10299,1834,1590,13723
6/1/2018,2018,6,1, 17 ,9711,1753,1546,13010
6/1/2018,2018,6,1, 18 ,9266,1775,1546,12587
6/1/2018,2018,6,1, 19 ,9627,1830,1556,13013
6/1/2018,2018,6,1, 20 ,9689,1786,1534,13009
6/1/2018,2018,6,1, 21 ,9612,1716,1482,12810
6/1/2018,2018,6,1, 22 ,9411,1606,1353,12370
6/1/2018,2018,6,1, 23 ,9132,1496,1259,11887
6/1/2018,2018,6,1, 24 ,8769,1425,1206,11400
6/2/2018,2018,6,2, 1 ,8404,1358,1121,10883
6/2/2018,2018,6,2, 2 ,8138,1303,1088,10529
6/2/2018,2018,6,2, 3 ,7881,1273,1062,10216
6/2/2018,2018,6,2, 4 ,7655,1250,1036,9941
6/2/2018,2018,6,2, 5 ,7550,1235,1046,9831
6/2/2018,2018,6,2, 6 ,7195,1235,1070,9500
6/2/2018,2018,6,2, 7 ,7368,1244,1084,9696
6/2/2018,2018,6,2, 8 ,8078,1343,1135,10556
6/2/2018,2018,6,2, 9 ,8835,1513,1231,11579
6/2/2018,2018,6,2, 10 ,9409,1574,1340,12323
6/2/2018,2018,6,2, 11 ,9682,1600,1385,12667
6/2/2018,2018,6,2, 12 ,9527,1551,1372,12450
6/2/2018,2018,6,2, 13 ,9493,1532,1386,12411
6/2/2018,2018,6,2, 14 ,9372,1576,1460,12408
6/2/2018,2018,6,2, 15 ,9254,1552,1422,12228
6/2/2018,2018,6,2, 16 ,8928,1524,1411,11863
6/2/2018,2018,6,2, 17 ,8545,1517,1377,11439
6/2/2018,2018,6,2, 18 ,8548,1580,1484,11612
6/2/2018,2018,6,2, 19 ,9024,1659,1499,12182
6/2/2018,2018,6,2, 20 ,9060,1623,1481,12164
6/2/2018,2018,6,2, 21 ,9083,1541,1419,12043
6/2/2018,2018,6,2, 22 ,8896,1451,1326,11673
6/2/2018,2018,6,2, 23 ,8569,1339,1228,11136
6/2/2018,2018,6,2, 24 ,8236,1258,1205,10699
6/3/2018,2018,6,3, 1 ,7682,1208,1082,9972
6/3/2018,2018,6,3, 2 ,7428,1173,1062,9663
6/3/2018,2018,6,3, 3 ,7167,1143,1036,9346
6/3/2018,2018,6,3, 4 ,6919,1123,1007,9049
6/3/2018,2018,6,3, 5 ,6796,1125,1007,8928
6/3/2018,2018,6,3, 6 ,6426,1111,997,8534
6/3/2018,2018,6,3, 7 ,6432,1125,1022,8579
6/3/2018,2018,6,3, 8 ,6861,1182,1058,9101
6/3/2018,2018,6,3, 9 ,7412,1283,1140,9835
6/3/2018,2018,6,3, 10 ,7849,1360,1210,10419
6/3/2018,2018,6,3, 11 ,8070,1432,1280,10782
6/3/2018,2018,6,3, 12 ,7892,1436,1267,10595
6/3/2018,2018,6,3, 13 ,7917,1447,1230,10594
6/3/2018,2018,6,3, 14 ,8082,1472,1283,10837
6/3/2018,2018,6,3, 15 ,8096,1446,1262,10804
6/3/2018,2018,6,3, 16 ,7958,1421,1237,10616
6/3/2018,2018,6,3, 17 ,7861,1415,1269,10545
6/3/2018,2018,6,3, 18 ,7862,1537,1343,10742
6/3/2018,2018,6,3, 19 ,8556,1683,1411,11650
6/3/2018,2018,6,3, 20 ,8713,1668,1427,11808
6/3/2018,2018,6,3, 21 ,8714,1607,1356,11677
6/3/2018,2018,6,3, 22 ,8534,1512,1248,11294
6/3/2018,2018,6,3, 23 ,8238,1419,1153,10810
6/3/2018,2018,6,3, 24 ,7829,1352,1132,10313
6/4/2018,2018,6,4, 1 ,7509,1289,1018,9816
6/4/2018,2018,6,4, 2 ,7197,1226,984,9407
6/4/2018,2018,6,4, 3 ,6888,1204,977,9069
6/4/2018,2018,6,4, 4 ,6757,1184,960,8901
6/4/2018,2018,6,4, 5 ,6829,1234,1025,9088
6/4/2018,2018,6,4, 6 ,6698,1226,1031,8955
6/4/2018,2018,6,4, 7 ,7123,1228,996,9347
6/4/2018,2018,6,4, 8 ,8249,1440,1173,10862
6/4/2018,2018,6,4, 9 ,9324,1722,1383,12429
6/4/2018,2018,6,4, 10 ,9988,1870,1521,13379
6/4/2018,2018,6,4, 11 ,10260,1900,1598,13758
6/4/2018,2018,6,4, 12 ,10112,1851,1561,13524
6/4/2018,2018,6,4, 13 ,10142,1864,1595,13601
6/4/2018,2018,6,4, 14 ,10524,1928,1667,14119
6/4/2018,2018,6,4, 15 ,10499,1555,1641,13695
6/4/2018,2018,6,4, 16 ,10364,1587,1613,13564
6/4/2018,2018,6,4, 17 ,9872,1725,1570,13167
6/4/2018,2018,6,4, 18 ,9336,1804,1586,12726
6/4/2018,2018,6,4, 19 ,9749,1902,1636,13287
6/4/2018,2018,6,4, 20 ,9836,1854,1607,13297
6/4/2018,2018,6,4, 21 ,9854,1795,1530,13179
6/4/2018,2018,6,4, 22 ,9576,1685,1411,12672
6/4/2018,2018,6,4, 23 ,9228,1562,1308,12098
6/4/2018,2018,6,4, 24 ,8799,1481,1075,11355
6/5/2018,2018,6,5, 1 ,8455,1422,1160,11037
6/5/2018,2018,6,5, 2 ,8201,1372,1135,10708
6/5/2018,2018,6,5, 3 ,7962,1316,1116,10394
6/5/2018,2018,6,5, 4 ,7732,1290,1111,10133
6/5/2018,2018,6,5, 5 ,7773,1330,1139,10242
6/5/2018,2018,6,5, 6 ,7491,1338,1137,9966
6/5/2018,2018,6,5, 7 ,7708,1304,1081,10093
6/5/2018,2018,6,5, 8 ,8785,1436,1225,11446
6/5/2018,2018,6,5, 9 ,9565,1654,1387,12606
6/5/2018,2018,6,5, 10 ,9960,1775,1492,13227
6/5/2018,2018,6,5, 11 ,10361,1847,1562,13770
6/5/2018,2018,6,5, 12 ,10247,1816,1554,13617
6/5/2018,2018,6,5, 13 ,10267,1802,1574,13643
6/5/2018,2018,6,5, 14 ,10630,1873,1628,14131
6/5/2018,2018,6,5, 15 ,10421,1840,1622,13883
6/5/2018,2018,6,5, 16 ,10183,1811,1588,13582
6/5/2018,2018,6,5, 17 ,9668,1739,1560,12967
6/5/2018,2018,6,5, 18 ,9338,1744,1590,12672
6/5/2018,2018,6,5, 19 ,9477,1798,1623,12898
6/5/2018,2018,6,5, 20 ,9514,1752,1568,12834
6/5/2018,2018,6,5, 21 ,9456,1670,1452,12578
6/5/2018,2018,6,5, 22 ,9165,1527,1331,12023
6/5/2018,2018,6,5, 23 ,8759,1436,1232,11427
6/5/2018,2018,6,5, 24 ,8380,1358,1231,10969
6/6/2018,2018,6,6, 1 ,8001,1298,1117,10416
6/6/2018,2018,6,6, 2 ,7700,1239,1092,10031
6/6/2018,2018,6,6, 3 ,7429,1207,1080,9716
6/6/2018,2018,6,6, 4 ,7301,1197,1067,9565
6/6/2018,2018,6,6, 5 ,7348,1235,1108,9691
6/6/2018,2018,6,6, 6 ,7132,1254,1128,9514
6/6/2018,2018,6,6, 7 ,7478,1237,1048,9763
6/6/2018,2018,6,6, 8 ,8258,1401,1168,10827
6/6/2018,2018,6,6, 9 ,9154,1617,1328,12099
6/6/2018,2018,6,6, 10 ,9680,1724,1432,12836
6/6/2018,2018,6,6, 11 ,10015,1774,1506,13295
6/6/2018,2018,6,6, 12 ,9773,1753,1480,13006
6/6/2018,2018,6,6, 13 ,9671,1747,1445,12863
6/6/2018,2018,6,6, 14 ,9861,1824,1414,13099
6/6/2018,2018,6,6, 15 ,9739,1811,1447,12997
6/6/2018,2018,6,6, 16 ,9625,1769,1487,12881
6/6/2018,2018,6,6, 17 ,9304,1732,1495,12531
6/6/2018,2018,6,6, 18 ,9041,1756,1575,12372
6/6/2018,2018,6,6, 19 ,9420,1809,1564,12793
6/6/2018,2018,6,6, 20 ,9413,1763,1499,12675
6/6/2018,2018,6,6, 21 ,9278,1664,1457,12399
6/6/2018,2018,6,6, 22 ,8886,1531,1300,11717
6/6/2018,2018,6,6, 23 ,8513,1432,1222,11167
6/6/2018,2018,6,6, 24 ,8090,1359,1176,10625
6/7/2018,2018,6,7, 1 ,7700,1315,1124,10139
6/7/2018,2018,6,7, 2 ,7409,1265,1111,9785
6/7/2018,2018,6,7, 3 ,7141,1238,1079,9458
6/7/2018,2018,6,7, 4 ,6976,1227,1074,9277
6/7/2018,2018,6,7, 5 ,6968,1260,1121,9349
6/7/2018,2018,6,7, 6 ,6894,1285,1117,9296
6/7/2018,2018,6,7, 7 ,7138,1255,1068,9461
6/7/2018,2018,6,7, 8 ,7937,1439,1252,10628
6/7/2018,2018,6,7, 9 ,8817,1682,1467,11966
6/7/2018,2018,6,7, 10 ,9520,1800,1580,12900
6/7/2018,2018,6,7, 11 ,9809,1862,1640,13311
6/7/2018,2018,6,7, 12 ,9441,1775,1612,12828
6/7/2018,2018,6,7, 13 ,9362,1756,1629,12747
6/7/2018,2018,6,7, 14 ,9755,1813,1688,13256
6/7/2018,2018,6,7, 15 ,9624,1822,1677,13123
6/7/2018,2018,6,7, 16 ,9479,1790,1662,12931
6/7/2018,2018,6,7, 17 ,9115,1722,1602,12439
6/7/2018,2018,6,7, 18 ,8853,1744,1595,12192
6/7/2018,2018,6,7, 19 ,9122,1821,1660,12603
6/7/2018,2018,6,7, 20 ,9113,1771,1631,12515
6/7/2018,2018,6,7, 21 ,9009,1671,1577,12257
6/7/2018,2018,6,7, 22 ,8655,1550,1435,11640
6/7/2018,2018,6,7, 23 ,8271,1429,1326,11026
6/7/2018,2018,6,7, 24 ,7884,1351,1241,10476
6/8/2018,2018,6,8, 1 ,7555,1298,1183,10036
6/8/2018,2018,6,8, 2 ,7264,1250,1155,9669
6/8/2018,2018,6,8, 3 ,7148,1227,1131,9506
6/8/2018,2018,6,8, 4 ,7002,1218,1107,9327
6/8/2018,2018,6,8, 5 ,7030,1253,1167,9450
6/8/2018,2018,6,8, 6 ,7021,1276,1106,9403
6/8/2018,2018,6,8, 7 ,7201,1222,1082,9505
6/8/2018,2018,6,8, 8 ,8051,1368,1250,10669
6/8/2018,2018,6,8, 9 ,8876,1598,1457,11931
6/8/2018,2018,6,8, 10 ,9472,1713,1600,12785
6/8/2018,2018,6,8, 11 ,9663,1771,1690,13124
6/8/2018,2018,6,8, 12 ,9450,1702,1666,12818
6/8/2018,2018,6,8, 13 ,9264,1697,1657,12618
6/8/2018,2018,6,8, 14 ,9547,1742,1741,13030
6/8/2018,2018,6,8, 15 ,9311,1728,1704,12743
6/8/2018,2018,6,8, 16 ,9137,1708,1681,12526
6/8/2018,2018,6,8, 17 ,8888,1665,1608,12161
6/8/2018,2018,6,8, 18 ,8701,1666,1651,12018
6/8/2018,2018,6,8, 19 ,8806,1726,1680,12212
6/8/2018,2018,6,8, 20 ,8755,1680,1658,12093
6/8/2018,2018,6,8, 21 ,8639,1602,1614,11855
6/8/2018,2018,6,8, 22 ,8281,1450,1481,11212
6/8/2018,2018,6,8, 23 ,7854,1374,1361,10589
6/8/2018,2018,6,8, 24 ,7519,1319,1304,10142
6/9/2018,2018,6,9, 1 ,7278,1268,1234,9780
6/9/2018,2018,6,9, 2 ,7045,1219,1203,9467
6/9/2018,2018,6,9, 3 ,6870,1192,1164,9226
6/9/2018,2018,6,9, 4 ,6720,1178,1148,9046
6/9/2018,2018,6,9, 5 ,6654,1187,1129,8970
6/9/2018,2018,6,9, 6 ,6517,1182,1123,8822
6/9/2018,2018,6,9, 7 ,6708,1199,1138,9045
6/9/2018,2018,6,9, 8 ,7328,1328,1233,9889
6/9/2018,2018,6,9, 9 ,7940,1508,1400,10848
6/9/2018,2018,6,9, 10 ,8383,1627,1531,11541
6/9/2018,2018,6,9, 11 ,8556,1706,1598,11860
6/9/2018,2018,6,9, 12 ,8242,1654,1573,11469
6/9/2018,2018,6,9, 13 ,8063,1651,1536,11250
6/9/2018,2018,6,9, 14 ,8207,1673,1586,11466
6/9/2018,2018,6,9, 15 ,7966,1662,1604,11232
6/9/2018,2018,6,9, 16 ,7845,1619,1568,11032
6/9/2018,2018,6,9, 17 ,7705,1574,1509,10788
6/9/2018,2018,6,9, 18 ,7845,1628,1604,11077
6/9/2018,2018,6,9, 19 ,8100,1741,1654,11495
6/9/2018,2018,6,9, 20 ,8080,1704,1614,11398
6/9/2018,2018,6,9, 21 ,7844,1644,1584,11072
6/9/2018,2018,6,9, 22 ,7476,1533,1485,10494
6/9/2018,2018,6,9, 23 ,7041,1434,1385,9860
6/9/2018,2018,6,9, 24 ,6716,1349,1292,9357
6/10/2018,2018,6,10, 1 ,6439,1288,1224,8951
6/10/2018,2018,6,10, 2 ,6234,1249,1196,8679
6/10/2018,2018,6,10, 3 ,6071,1221,1157,8449
6/10/2018,2018,6,10, 4 ,5974,1199,1116,8289
6/10/2018,2018,6,10, 5 ,6006,1193,1108,8307
6/10/2018,2018,6,10, 6 ,5811,1178,1084,8073
6/10/2018,2018,6,10, 7 ,5963,1181,1071,8215
6/10/2018,2018,6,10, 8 ,6377,1240,1128,8745
6/10/2018,2018,6,10, 9 ,6751,1341,1238,9330
6/10/2018,2018,6,10, 10 ,7108,1425,1330,9863
6/10/2018,2018,6,10, 11 ,7273,1467,1359,10099
6/10/2018,2018,6,10, 12 ,7169,1451,1400,10020
6/10/2018,2018,6,10, 13 ,7083,1435,1431,9949
6/10/2018,2018,6,10, 14 ,7050,1449,1427,9926
6/10/2018,2018,6,10, 15 ,6970,1411,1413,9794
6/10/2018,2018,6,10, 16 ,6905,1407,1389,9701
6/10/2018,2018,6,10, 17 ,6940,1413,1385,9738
6/10/2018,2018,6,10, 18 ,7112,1503,1483,10098
6/10/2018,2018,6,10, 19 ,7573,1658,1564,10795
6/10/2018,2018,6,10, 20 ,7553,1637,1557,10747
6/10/2018,2018,6,10, 21 ,7361,1583,1528,10472
6/10/2018,2018,6,10, 22 ,7010,1487,1421,9918
6/10/2018,2018,6,10, 23 ,6659,1393,1311,9363
6/10/2018,2018,6,10, 24 ,6305,1306,1231,8842
6/11/2018,2018,6,11, 1 ,6001,1252,1173,8426
6/11/2018,2018,6,11, 2 ,5793,1209,1140,8142
6/11/2018,2018,6,11, 3 ,5713,1178,1097,7988
6/11/2018,2018,6,11, 4 ,5683,1167,1082,7932
6/11/2018,2018,6,11, 5 ,5776,1200,1134,8110
6/11/2018,2018,6,11, 6 ,5922,1207,1117,8246
6/11/2018,2018,6,11, 7 ,6264,1163,1062,8489
6/11/2018,2018,6,11, 8 ,7038,1359,1274,9671
6/11/2018,2018,6,11, 9 ,7995,1588,1478,11061
6/11/2018,2018,6,11, 10 ,8484,1747,1609,11840
6/11/2018,2018,6,11, 11 ,8461,1780,1695,11936
6/11/2018,2018,6,11, 12 ,8132,1730,1657,11519
6/11/2018,2018,6,11, 13 ,7956,1740,1678,11374
6/11/2018,2018,6,11, 14 ,8148,1809,1739,11696
6/11/2018,2018,6,11, 15 ,8086,1782,1704,11572
6/11/2018,2018,6,11, 16 ,8028,1751,1654,11433
6/11/2018,2018,6,11, 17 ,7920,1667,1591,11178
6/11/2018,2018,6,11, 18 ,7799,1669,1600,11068
6/11/2018,2018,6,11, 19 ,8014,1804,1664,11482
6/11/2018,2018,6,11, 20 ,7957,1740,1612,11309
6/11/2018,2018,6,11, 21 ,7719,1661,1549,10929
6/11/2018,2018,6,11, 22 ,7281,1560,1430,10271
6/11/2018,2018,6,11, 23 ,6909,1440,1318,9667
6/11/2018,2018,6,11, 24 ,6590,1362,1250,9202
6/12/2018,2018,6,12, 1 ,6310,1303,1187,8800
6/12/2018,2018,6,12, 2 ,6158,1259,1145,8562
6/12/2018,2018,6,12, 3 ,5994,1217,1126,8337
6/12/2018,2018,6,12, 4 ,5867,1183,1088,8138
6/12/2018,2018,6,12, 5 ,5886,1197,1086,8169
6/12/2018,2018,6,12, 6 ,5847,1186,1069,8102
6/12/2018,2018,6,12, 7 ,5952,1193,1088,8233
6/12/2018,2018,6,12, 8 ,6387,1301,1191,8879
6/12/2018,2018,6,12, 9 ,6896,1471,1334,9701
6/12/2018,2018,6,12, 10 ,7454,1590,1482,10526
6/12/2018,2018,6,12, 11 ,7639,1666,1557,10862
6/12/2018,2018,6,12, 12 ,7521,1660,1535,10716
6/12/2018,2018,6,12, 13 ,7452,1643,1570,10665
6/12/2018,2018,6,12, 14 ,7468,1681,1629,10778
6/12/2018,2018,6,12, 15 ,7353,1666,1585,10604
6/12/2018,2018,6,12, 16 ,7288,1615,1531,10434
6/12/2018,2018,6,12, 17 ,7253,1554,1486,10293
6/12/2018,2018,6,12, 18 ,7372,1607,1538,10517
6/12/2018,2018,6,12, 19 ,7783,1738,1608,11129
6/12/2018,2018,6,12, 20 ,7734,1708,1525,10967
6/12/2018,2018,6,12, 21 ,7524,1650,1510,10684
6/12/2018,2018,6,12, 22 ,7195,1535,1394,10124
6/12/2018,2018,6,12, 23 ,6787,1429,1294,9510
6/12/2018,2018,6,12, 24 ,6397,1359,1204,8960
6/13/2018,2018,6,13, 1 ,6195,1294,1162,8651
6/13/2018,2018,6,13, 2 ,5973,1254,1151,8378
6/13/2018,2018,6,13, 3 ,5843,1217,1122,8182
6/13/2018,2018,6,13, 4 ,5810,1204,1086,8100
6/13/2018,2018,6,13, 5 ,6017,1243,1142,8402
6/13/2018,2018,6,13, 6 ,6123,1236,1142,8501
6/13/2018,2018,6,13, 7 ,6471,1216,1084,8771
6/13/2018,2018,6,13, 8 ,7280,1434,1293,10007
6/13/2018,2018,6,13, 9 ,8106,1676,1490,11272
6/13/2018,2018,6,13, 10 ,8475,1793,1628,11896
6/13/2018,2018,6,13, 11 ,8662,1875,1689,12226
6/13/2018,2018,6,13, 12 ,8339,1835,1669,11843
6/13/2018,2018,6,13, 13 ,8289,1829,1668,11786
6/13/2018,2018,6,13, 14 ,8558,1883,1741,12182
6/13/2018,2018,6,13, 15 ,8547,1853,1732,12132
6/13/2018,2018,6,13, 16 ,8544,1849,1655,12048
6/13/2018,2018,6,13, 17 ,8448,1754,1600,11802
6/13/2018,2018,6,13, 18 ,8336,1731,1641,11708
6/13/2018,2018,6,13, 19 ,8411,1862,1663,11936
6/13/2018,2018,6,13, 20 ,8324,1818,1590,11732
6/13/2018,2018,6,13, 21 ,8083,1757,1521,11361
6/13/2018,2018,6,13, 22 ,7425,1616,1387,10428
6/13/2018,2018,6,13, 23 ,7000,1511,1295,9806
6/13/2018,2018,6,13, 24 ,6641,1424,1193,9258
6/14/2018,2018,6,14, 1 ,6344,1366,1173,8883
6/14/2018,2018,6,14, 2 ,6188,1324,1137,8649
6/14/2018,2018,6,14, 3 ,6103,1294,1117,8514
6/14/2018,2018,6,14, 4 ,6055,1269,1103,8427
6/14/2018,2018,6,14, 5 ,6270,1302,1151,8723
6/14/2018,2018,6,14, 6 ,6305,1282,1121,8708
6/14/2018,2018,6,14, 7 ,6672,1259,1056,8987
6/14/2018,2018,6,14, 8 ,7398,1460,1228,10086
6/14/2018,2018,6,14, 9 ,8221,1691,1441,11353
6/14/2018,2018,6,14, 10 ,8645,1804,1590,12039
6/14/2018,2018,6,14, 11 ,8966,1869,1661,12496
6/14/2018,2018,6,14, 12 ,8751,1820,1633,12204
6/14/2018,2018,6,14, 13 ,8683,1849,1664,12196
6/14/2018,2018,6,14, 14 ,9028,1922,1656,12606
6/14/2018,2018,6,14, 15 ,8903,1907,1676,12486
6/14/2018,2018,6,14, 16 ,8804,1847,1598,12249
6/14/2018,2018,6,14, 17 ,8629,1753,1551,11933
6/14/2018,2018,6,14, 18 ,8407,1731,1567,11705
6/14/2018,2018,6,14, 19 ,8625,1833,1607,12065
6/14/2018,2018,6,14, 20 ,8512,1784,1563,11859
6/14/2018,2018,6,14, 21 ,8180,1723,1511,11414
6/14/2018,2018,6,14, 22 ,7700,1596,1323,10619
6/14/2018,2018,6,14, 23 ,7399,1483,1279,10161
6/14/2018,2018,6,14, 24 ,7041,1408,1219,9668
6/15/2018,2018,6,15, 1 ,6736,1353,1170,9259
6/15/2018,2018,6,15, 2 ,6560,1305,1141,9006
6/15/2018,2018,6,15, 3 ,6366,1258,1113,8737
6/15/2018,2018,6,15, 4 ,6267,1225,1103,8595
6/15/2018,2018,6,15, 5 ,6242,1227,1098,8567
6/15/2018,2018,6,15, 6 ,6168,1194,1083,8445
6/15/2018,2018,6,15, 7 ,6246,1222,1080,8548
6/15/2018,2018,6,15, 8 ,6719,1346,1185,9250
6/15/2018,2018,6,15, 9 ,7355,1520,1306,10181
6/15/2018,2018,6,15, 10 ,7944,1642,1453,11039
6/15/2018,2018,6,15, 11 ,8288,1708,1527,11523
6/15/2018,2018,6,15, 12 ,8021,1694,1507,11222
6/15/2018,2018,6,15, 13 ,8060,1692,1516,11268
6/15/2018,2018,6,15, 14 ,8240,1739,1561,11540
6/15/2018,2018,6,15, 15 ,8161,1716,1520,11397
6/15/2018,2018,6,15, 16 ,8021,1676,1492,11189
6/15/2018,2018,6,15, 17 ,7860,1619,1450,10929
6/15/2018,2018,6,15, 18 ,7862,1626,1516,11004
6/15/2018,2018,6,15, 19 ,8224,1776,1570,11570
6/15/2018,2018,6,15, 20 ,8207,1755,1512,11474
6/15/2018,2018,6,15, 21 ,8087,1690,1454,11231
6/15/2018,2018,6,15, 22 ,7745,1585,1326,10656
6/15/2018,2018,6,15, 23 ,7338,1465,1223,10026
6/15/2018,2018,6,15, 24 ,7003,1378,1165,9546
6/16/2018,2018,6,16, 1 ,6759,1301,1141,9201
6/16/2018,2018,6,16, 2 ,6463,1260,1104,8827
6/16/2018,2018,6,16, 3 ,6260,1226,1064,8550
6/16/2018,2018,6,16, 4 ,6147,1218,958,8323
6/16/2018,2018,6,16, 5 ,6064,1212,1059,8335
6/16/2018,2018,6,16, 6 ,6029,1191,1076,8296
6/16/2018,2018,6,16, 7 ,6278,1209,1065,8552
6/16/2018,2018,6,16, 8 ,6676,1345,1155,9176
6/16/2018,2018,6,16, 9 ,7277,1512,1286,10075
6/16/2018,2018,6,16, 10 ,7949,1631,1400,10980
6/16/2018,2018,6,16, 11 ,8326,1686,1469,11481
6/16/2018,2018,6,16, 12 ,8164,1672,1444,11280
6/16/2018,2018,6,16, 13 ,8140,1680,1491,11311
6/16/2018,2018,6,16, 14 ,8344,1741,1544,11629
6/16/2018,2018,6,16, 15 ,8189,1716,1531,11436
6/16/2018,2018,6,16, 16 ,8027,1675,1451,11153
6/16/2018,2018,6,16, 17 ,7797,1611,1432,10840
6/16/2018,2018,6,16, 18 ,7826,1621,1507,10954
6/16/2018,2018,6,16, 19 ,8219,1774,1553,11546
6/16/2018,2018,6,16, 20 ,8230,1747,1501,11478
6/16/2018,2018,6,16, 21 ,8125,1705,1442,11272
6/16/2018,2018,6,16, 22 ,7927,1623,1346,10896
6/16/2018,2018,6,16, 23 ,7500,1520,1251,10271
6/16/2018,2018,6,16, 24 ,7033,1414,1163,9610
6/17/2018,2018,6,17, 1 ,6744,1357,1110,9211
6/17/2018,2018,6,17, 2 ,6536,1306,1078,8920
6/17/2018,2018,6,17, 3 ,6354,1272,1042,8668
6/17/2018,2018,6,17, 4 ,6229,1227,1015,8471
6/17/2018,2018,6,17, 5 ,6128,1217,1037,8382
6/17/2018,2018,6,17, 6 ,5961,1181,1039,8181
6/17/2018,2018,6,17, 7 ,6025,1182,1032,8239
6/17/2018,2018,6,17, 8 ,6312,1252,1050,8614
6/17/2018,2018,6,17, 9 ,6880,1350,1123,9353
6/17/2018,2018,6,17, 10 ,7353,1441,1214,10008
6/17/2018,2018,6,17, 11 ,7600,1481,1272,10353
6/17/2018,2018,6,17, 12 ,7598,1494,1284,10376
6/17/2018,2018,6,17, 13 ,7533,1489,1295,10317
6/17/2018,2018,6,17, 14 ,7507,1482,1309,10298
6/17/2018,2018,6,17, 15 ,7466,1443,1297,10206
6/17/2018,2018,6,17, 16 ,7358,1397,1288,10043
6/17/2018,2018,6,17, 17 ,7191,1405,1296,9892
6/17/2018,2018,6,17, 18 ,7267,1525,1404,10196
6/17/2018,2018,6,17, 19 ,7985,1646,1482,11113
6/17/2018,2018,6,17, 20 ,8055,1627,1464,11146
6/17/2018,2018,6,17, 21 ,7988,1560,1405,10953
6/17/2018,2018,6,17, 22 ,7727,1490,1287,10504
6/17/2018,2018,6,17, 23 ,7460,1401,1185,10046
6/17/2018,2018,6,17, 24 ,7032,1323,1113,9468
6/18/2018,2018,6,18, 1 ,6709,1274,1082,9065
6/18/2018,2018,6,18, 2 ,6484,1233,1048,8765
6/18/2018,2018,6,18, 3 ,6216,1204,1008,8428
6/18/2018,2018,6,18, 4 ,6113,1186,1004,8303
6/18/2018,2018,6,18, 5 ,6348,1240,1086,8674
6/18/2018,2018,6,18, 6 ,6397,1246,1095,8738
6/18/2018,2018,6,18, 7 ,6610,1214,1023,8847
6/18/2018,2018,6,18, 8 ,7587,1422,1216,10225
6/18/2018,2018,6,18, 9 ,8603,1667,1401,11671
6/18/2018,2018,6,18, 10 ,9187,1783,1537,12507
6/18/2018,2018,6,18, 11 ,9470,1788,1607,12865
6/18/2018,2018,6,18, 12 ,9285,1786,1601,12672
6/18/2018,2018,6,18, 13 ,9351,1791,1663,12805
6/18/2018,2018,6,18, 14 ,9685,1877,1708,13270
6/18/2018,2018,6,18, 15 ,9599,1853,1646,13098
6/18/2018,2018,6,18, 16 ,9449,1807,1613,12869
6/18/2018,2018,6,18, 17 ,9111,1749,1548,12408
6/18/2018,2018,6,18, 18 ,8831,1761,1613,12205
6/18/2018,2018,6,18, 19 ,9176,1875,1609,12660
6/18/2018,2018,6,18, 20 ,9121,1829,1578,12528
6/18/2018,2018,6,18, 21 ,8990,1758,1492,12240
6/18/2018,2018,6,18, 22 ,8617,1614,1360,11591
6/18/2018,2018,6,18, 23 ,8173,1510,1253,10936
6/18/2018,2018,6,18, 24 ,7789,1424,1160,10373
6/19/2018,2018,6,19, 1 ,7401,1367,1124,9892
6/19/2018,2018,6,19, 2 ,7156,1322,1098,9576
6/19/2018,2018,6,19, 3 ,6940,1284,1060,9284
6/19/2018,2018,6,19, 4 ,6786,1249,1067,9102
6/19/2018,2018,6,19, 5 ,6949,1304,1138,9391
6/19/2018,2018,6,19, 6 ,6860,1293,1124,9277
6/19/2018,2018,6,19, 7 ,7113,1236,1053,9402
6/19/2018,2018,6,19, 8 ,8126,1427,1267,10820
6/19/2018,2018,6,19, 9 ,9043,1656,1475,12174
6/19/2018,2018,6,19, 10 ,9559,1785,1594,12938
6/19/2018,2018,6,19, 11 ,9872,1834,1650,13356
6/19/2018,2018,6,19, 12 ,9660,1793,1637,13090
6/19/2018,2018,6,19, 13 ,9673,1775,1635,13083
6/19/2018,2018,6,19, 14 ,10013,1813,1700,13526
6/19/2018,2018,6,19, 15 ,10041,1806,1684,13531
6/19/2018,2018,6,19, 16 ,9817,1775,1637,13229
6/19/2018,2018,6,19, 17 ,9368,1622,1603,12593
6/19/2018,2018,6,19, 18 ,8976,1710,1607,12293
6/19/2018,2018,6,19, 19 ,9347,1820,1683,12850
6/19/2018,2018,6,19, 20 ,9363,1775,1647,12785
6/19/2018,2018,6,19, 21 ,9258,1701,1557,12516
6/19/2018,2018,6,19, 22 ,8862,1571,1377,11810
6/19/2018,2018,6,19, 23 ,8522,1466,1280,11268
6/19/2018,2018,6,19, 24 ,8135,1391,1183,10709
6/20/2018,2018,6,20, 1 ,7718,1337,1153,10208
6/20/2018,2018,6,20, 2 ,7488,1293,1115,9896
6/20/2018,2018,6,20, 3 ,7255,1257,1089,9601
6/20/2018,2018,6,20, 4 ,7135,1235,1087,9457
6/20/2018,2018,6,20, 5 ,7191,1287,1152,9630
6/20/2018,2018,6,20, 6 ,7076,1286,1197,9559
6/20/2018,2018,6,20, 7 ,7269,1256,1124,9649
6/20/2018,2018,6,20, 8 ,8228,1463,1213,10904
6/20/2018,2018,6,20, 9 ,9143,1701,1418,12262
6/20/2018,2018,6,20, 10 ,9632,1794,1526,12952
6/20/2018,2018,6,20, 11 ,9882,1882,1606,13370
6/20/2018,2018,6,20, 12 ,9870,1774,1593,13237
6/20/2018,2018,6,20, 13 ,9800,1762,1592,13154
6/20/2018,2018,6,20, 14 ,10100,1826,1656,13582
6/20/2018,2018,6,20, 15 ,9880,1803,1643,13326
6/20/2018,2018,6,20, 16 ,9628,1807,1613,13048
6/20/2018,2018,6,20, 17 ,9125,1716,1564,12405
6/20/2018,2018,6,20, 18 ,8919,1740,1604,12263
6/20/2018,2018,6,20, 19 ,8980,1845,1651,12476
6/20/2018,2018,6,20, 20 ,8876,1802,1596,12274
6/20/2018,2018,6,20, 21 ,8755,1733,1530,12018
6/20/2018,2018,6,20, 22 ,8315,1593,1368,11276
6/20/2018,2018,6,20, 23 ,7910,1483,1268,10661
6/20/2018,2018,6,20, 24 ,7540,1403,1187,10130
6/21/2018,2018,6,21, 1 ,7303,1345,1137,9785
6/21/2018,2018,6,21, 2 ,7066,1308,1128,9502
6/21/2018,2018,6,21, 3 ,6823,1270,1100,9193
6/21/2018,2018,6,21, 4 ,6786,1263,1085,9134
6/21/2018,2018,6,21, 5 ,6987,1312,1162,9461
6/21/2018,2018,6,21, 6 ,6898,1300,1156,9354
6/21/2018,2018,6,21, 7 ,7080,1264,1067,9411
6/21/2018,2018,6,21, 8 ,7987,1487,1235,10709
6/21/2018,2018,6,21, 9 ,8941,1717,1423,12081
6/21/2018,2018,6,21, 10 ,9440,1822,1550,12812
6/21/2018,2018,6,21, 11 ,9780,1891,1599,13270
6/21/2018,2018,6,21, 12 ,9502,1790,1524,12816
6/21/2018,2018,6,21, 13 ,9485,1755,1528,12768
6/21/2018,2018,6,21, 14 ,9846,1729,1568,13143
6/21/2018,2018,6,21, 15 ,9656,1740,1544,12940
6/21/2018,2018,6,21, 16 ,9405,1745,1482,12632
6/21/2018,2018,6,21, 17 ,9091,1685,1486,12262
6/21/2018,2018,6,21, 18 ,8709,1713,1535,11957
6/21/2018,2018,6,21, 19 ,8756,1822,1518,12096
6/21/2018,2018,6,21, 20 ,8642,1778,1485,11905
6/21/2018,2018,6,21, 21 ,8470,1689,1368,11527
6/21/2018,2018,6,21, 22 ,7745,1558,1249,10552
6/21/2018,2018,6,21, 23 ,7575,1448,1169,10192
6/21/2018,2018,6,21, 24 ,7265,1367,1198,9830
6/22/2018,2018,6,22, 1 ,6993,1300,1072,9365
6/22/2018,2018,6,22, 2 ,6781,1273,1046,9100
6/22/2018,2018,6,22, 3 ,6603,1238,1017,8858
6/22/2018,2018,6,22, 4 ,6550,1225,1010,8785
6/22/2018,2018,6,22, 5 ,6648,1267,1099,9014
6/22/2018,2018,6,22, 6 ,6609,1283,1125,9017
6/22/2018,2018,6,22, 7 ,6919,1243,1056,9218
6/22/2018,2018,6,22, 8 ,7809,1401,1203,10413
6/22/2018,2018,6,22, 9 ,8717,1648,1404,11769
6/22/2018,2018,6,22, 10 ,9242,1771,1543,12556
6/22/2018,2018,6,22, 11 ,9468,1849,1614,12931
6/22/2018,2018,6,22, 12 ,9346,1810,1580,12736
6/22/2018,2018,6,22, 13 ,9329,1812,1576,12717
6/22/2018,2018,6,22, 14 ,9684,1861,1641,13186
6/22/2018,2018,6,22, 15 ,9657,1854,1630,13141
6/22/2018,2018,6,22, 16 ,9406,1824,1576,12806
6/22/2018,2018,6,22, 17 ,9044,1733,1469,12246
6/22/2018,2018,6,22, 18 ,8805,1732,1528,12065
6/22/2018,2018,6,22, 19 ,8796,1828,1573,12197
6/22/2018,2018,6,22, 20 ,8740,1778,1538,12056
6/22/2018,2018,6,22, 21 ,8618,1712,1460,11790
6/22/2018,2018,6,22, 22 ,8178,1573,1320,11071
6/22/2018,2018,6,22, 23 ,7802,1466,1215,10483
6/22/2018,2018,6,22, 24 ,7431,1391,1128,9950
6/23/2018,2018,6,23, 1 ,7109,1333,1081,9523
6/23/2018,2018,6,23, 2 ,6906,1295,1059,9260
6/23/2018,2018,6,23, 3 ,6730,1257,1024,9011
6/23/2018,2018,6,23, 4 ,6570,1236,999,8805
6/23/2018,2018,6,23, 5 ,6522,1244,993,8759
6/23/2018,2018,6,23, 6 ,6493,1242,1048,8783
6/23/2018,2018,6,23, 7 ,6734,1267,1013,9014
6/23/2018,2018,6,23, 8 ,7284,1404,1093,9781
6/23/2018,2018,6,23, 9 ,8103,1597,1223,10923
6/23/2018,2018,6,23, 10 ,8758,1701,1336,11795
6/23/2018,2018,6,23, 11 ,9035,1762,1398,12195
6/23/2018,2018,6,23, 12 ,8939,1727,1406,12072
6/23/2018,2018,6,23, 13 ,8993,1712,1420,12125
6/23/2018,2018,6,23, 14 ,9241,1742,1486,12469
6/23/2018,2018,6,23, 15 ,9159,1721,1467,12347
6/23/2018,2018,6,23, 16 ,8838,1687,1438,11963
6/23/2018,2018,6,23, 17 ,8402,1633,1424,11459
6/23/2018,2018,6,23, 18 ,8247,1666,1474,11387
6/23/2018,2018,6,23, 19 ,8514,1812,1565,11891
6/23/2018,2018,6,23, 20 ,8603,1770,1539,11912
6/23/2018,2018,6,23, 21 ,8422,1709,1468,11599
6/23/2018,2018,6,23, 22 ,8125,1612,1375,11112
6/23/2018,2018,6,23, 23 ,7827,1343,1256,10426
6/23/2018,2018,6,23, 24 ,7423,1283,1164,9870
6/24/2018,2018,6,24, 1 ,7137,1247,1119,9503
6/24/2018,2018,6,24, 2 ,6870,1225,1078,9173
6/24/2018,2018,6,24, 3 ,6704,1189,1038,8931
6/24/2018,2018,6,24, 4 ,6516,1171,1010,8697
6/24/2018,2018,6,24, 5 ,6418,1169,1032,8619
6/24/2018,2018,6,24, 6 ,6191,1156,1020,8367
6/24/2018,2018,6,24, 7 ,6277,1184,1027,8488
6/24/2018,2018,6,24, 8 ,6645,1261,1071,8977
6/24/2018,2018,6,24, 9 ,7183,1379,1173,9735
6/24/2018,2018,6,24, 10 ,7642,1472,1269,10383
6/24/2018,2018,6,24, 11 ,7877,1528,1311,10716
6/24/2018,2018,6,24, 12 ,7933,1537,1326,10796
6/24/2018,2018,6,24, 13 ,7956,1558,1344,10858
6/24/2018,2018,6,24, 14 ,8076,1577,1373,11026
6/24/2018,2018,6,24, 15 ,7960,1546,1363,10869
6/24/2018,2018,6,24, 16 ,7862,1490,1326,10678
6/24/2018,2018,6,24, 17 ,7741,1499,1305,10545
6/24/2018,2018,6,24, 18 ,7782,1581,1415,10778
6/24/2018,2018,6,24, 19 ,8374,1715,1524,11613
6/24/2018,2018,6,24, 20 ,8450,1692,1493,11635
6/24/2018,2018,6,24, 21 ,8314,1620,1454,11388
6/24/2018,2018,6,24, 22 ,8048,1526,1337,10911
6/24/2018,2018,6,24, 23 ,7629,1423,1237,10289
6/24/2018,2018,6,24, 24 ,7240,1351,1154,9745
6/25/2018,2018,6,25, 1 ,6883,1284,1084,9251
6/25/2018,2018,6,25, 2 ,6593,1243,1056,8892
6/25/2018,2018,6,25, 3 ,6462,1199,1028,8689
6/25/2018,2018,6,25, 4 ,6355,1199,1004,8558
6/25/2018,2018,6,25, 5 ,6501,1250,1087,8838
6/25/2018,2018,6,25, 6 ,6518,1262,1072,8852
6/25/2018,2018,6,25, 7 ,6791,1232,998,9021
6/25/2018,2018,6,25, 8 ,7714,1424,1203,10341
6/25/2018,2018,6,25, 9 ,8726,1670,1448,11844
6/25/2018,2018,6,25, 10 ,9352,1796,1580,12728
6/25/2018,2018,6,25, 11 ,9677,1876,1646,13199
6/25/2018,2018,6,25, 12 ,9414,1843,1642,12899
6/25/2018,2018,6,25, 13 ,9330,1787,1660,12777
6/25/2018,2018,6,25, 14 ,9680,1854,1673,13207
6/25/2018,2018,6,25, 15 ,9647,1814,1688,13149
6/25/2018,2018,6,25, 16 ,9408,1795,1641,12844
6/25/2018,2018,6,25, 17 ,9070,1721,1580,12371
6/25/2018,2018,6,25, 18 ,8855,1751,1587,12193
6/25/2018,2018,6,25, 19 ,8939,1805,1636,12380
6/25/2018,2018,6,25, 20 ,8857,1740,1594,12191
6/25/2018,2018,6,25, 21 ,8614,1663,1538,11815
6/25/2018,2018,6,25, 22 ,8115,1543,1396,11054
6/25/2018,2018,6,25, 23 ,7715,1431,1248,10394
6/25/2018,2018,6,25, 24 ,7316,1346,1168,9830
6/26/2018,2018,6,26, 1 ,7070,1290,1138,9498
6/26/2018,2018,6,26, 2 ,6854,1258,1102,9214
6/26/2018,2018,6,26, 3 ,6643,1227,1062,8932
6/26/2018,2018,6,26, 4 ,6538,1204,1066,8808
6/26/2018,2018,6,26, 5 ,6714,1261,1134,9109
6/26/2018,2018,6,26, 6 ,6723,1283,1153,9159
6/26/2018,2018,6,26, 7 ,6906,1234,1065,9205
6/26/2018,2018,6,26, 8 ,7837,1411,1234,10482
6/26/2018,2018,6,26, 9 ,8706,1657,1453,11816
6/26/2018,2018,6,26, 10 ,9217,1773,1573,12563
6/26/2018,2018,6,26, 11 ,9490,1862,1662,13014
6/26/2018,2018,6,26, 12 ,9045,1828,1629,12502
6/26/2018,2018,6,26, 13 ,8969,1800,1639,12408
6/26/2018,2018,6,26, 14 ,9156,1870,1690,12716
6/26/2018,2018,6,26, 15 ,9049,1834,1671,12554
6/26/2018,2018,6,26, 16 ,8952,1805,1598,12355
6/26/2018,2018,6,26, 17 ,8679,1739,1554,11972
6/26/2018,2018,6,26, 18 ,8642,1745,1587,11974
6/26/2018,2018,6,26, 19 ,8861,1839,1646,12346
6/26/2018,2018,6,26, 20 ,8776,1771,1586,12133
6/26/2018,2018,6,26, 21 ,8496,1691,1470,11657
6/26/2018,2018,6,26, 22 ,8001,1560,1322,10883
6/26/2018,2018,6,26, 23 ,7536,1438,1226,10200
6/26/2018,2018,6,26, 24 ,7181,1353,1227,9761
6/27/2018,2018,6,27, 1 ,6880,1301,1138,9319
6/27/2018,2018,6,27, 2 ,6657,1263,1100,9020
6/27/2018,2018,6,27, 3 ,6457,1238,1066,8761
6/27/2018,2018,6,27, 4 ,6408,1228,1051,8687
6/27/2018,2018,6,27, 5 ,6537,1280,1119,8936
6/27/2018,2018,6,27, 6 ,6562,1292,1112,8966
6/27/2018,2018,6,27, 7 ,6804,1253,1057,9114
6/27/2018,2018,6,27, 8 ,7740,1436,1246,10422
6/27/2018,2018,6,27, 9 ,8615,1676,1459,11750
6/27/2018,2018,6,27, 10 ,9227,1777,1576,12580
6/27/2018,2018,6,27, 11 ,9550,1851,1642,13043
6/27/2018,2018,6,27, 12 ,9334,1815,1593,12742
6/27/2018,2018,6,27, 13 ,9388,1809,1616,12813
6/27/2018,2018,6,27, 14 ,9653,1900,1665,13218
6/27/2018,2018,6,27, 15 ,9501,1864,1647,13012
6/27/2018,2018,6,27, 16 ,9217,1831,1607,12655
6/27/2018,2018,6,27, 17 ,8902,1739,1559,12200
6/27/2018,2018,6,27, 18 ,8632,1764,1558,11954
6/27/2018,2018,6,27, 19 ,8892,1879,1645,12416
6/27/2018,2018,6,27, 20 ,8800,1811,1578,12189
6/27/2018,2018,6,27, 21 ,8578,1748,1522,11848
6/27/2018,2018,6,27, 22 ,8232,1605,1398,11235
6/27/2018,2018,6,27, 23 ,7807,1486,1280,10573
6/27/2018,2018,6,27, 24 ,7384,1396,1201,9981
6/28/2018,2018,6,28, 1 ,6965,1339,1136,9440
6/28/2018,2018,6,28, 2 ,6784,1296,1098,9178
6/28/2018,2018,6,28, 3 ,6642,1260,1064,8966
6/28/2018,2018,6,28, 4 ,6540,1247,1057,8844
6/28/2018,2018,6,28, 5 ,6660,1301,1130,9091
6/28/2018,2018,6,28, 6 ,6654,1314,1154,9122
6/28/2018,2018,6,28, 7 ,6874,1257,1071,9202
6/28/2018,2018,6,28, 8 ,7876,1439,1239,10554
6/28/2018,2018,6,28, 9 ,8726,1677,1448,11851
6/28/2018,2018,6,28, 10 ,9323,1780,1572,12675
6/28/2018,2018,6,28, 11 ,9641,1861,1620,13122
6/28/2018,2018,6,28, 12 ,9484,1815,1625,12924
6/28/2018,2018,6,28, 13 ,9493,1833,1617,12943
6/28/2018,2018,6,28, 14 ,9894,1929,1708,13531
6/28/2018,2018,6,28, 15 ,9758,1884,1690,13332
6/28/2018,2018,6,28, 16 ,9669,1851,1658,13178
6/28/2018,2018,6,28, 17 ,9243,1786,1592,12621
6/28/2018,2018,6,28, 18 ,8910,1791,1589,12290
6/28/2018,2018,6,28, 19 ,9169,1890,1691,12750
6/28/2018,2018,6,28, 20 ,9196,1827,1622,12645
6/28/2018,2018,6,28, 21 ,9120,1747,1560,12427
6/28/2018,2018,6,28, 22 ,8698,1620,1442,11760
6/28/2018,2018,6,28, 23 ,8289,1511,1335,11135
6/28/2018,2018,6,28, 24 ,7876,1414,1194,10484
6/29/2018,2018,6,29, 1 ,7489,1361,1212,10062
6/29/2018,2018,6,29, 2 ,7286,1305,1164,9755
6/29/2018,2018,6,29, 3 ,7062,1278,1125,9465
6/29/2018,2018,6,29, 4 ,6873,1261,1115,9249
6/29/2018,2018,6,29, 5 ,6961,1302,1154,9417
6/29/2018,2018,6,29, 6 ,6931,1307,1167,9405
6/29/2018,2018,6,29, 7 ,7124,1267,1127,9518
6/29/2018,2018,6,29, 8 ,8046,1454,1248,10748
6/29/2018,2018,6,29, 9 ,8910,1697,1422,12029
6/29/2018,2018,6,29, 10 ,9435,1805,1563,12803
6/29/2018,2018,6,29, 11 ,9769,1863,1630,13262
6/29/2018,2018,6,29, 12 ,9593,1813,1610,13016
6/29/2018,2018,6,29, 13 ,9599,1822,1612,13033
6/29/2018,2018,6,29, 14 ,9852,1885,1678,13415
6/29/2018,2018,6,29, 15 ,9817,1876,1661,13354
6/29/2018,2018,6,29, 16 ,9569,1828,1616,13013
6/29/2018,2018,6,29, 17 ,9111,1762,1534,12407
6/29/2018,2018,6,29, 18 ,8802,1733,1562,12097
6/29/2018,2018,6,29, 19 ,9117,1857,1626,12600
6/29/2018,2018,6,29, 20 ,9232,1809,1575,12616
6/29/2018,2018,6,29, 21 ,9109,1747,1450,12306
6/29/2018,2018,6,29, 22 ,8761,1622,1384,11767
6/29/2018,2018,6,29, 23 ,8307,1511,1292,11110
6/29/2018,2018,6,29, 24 ,7970,1429,1268,10667
6/30/2018,2018,6,30, 1 ,7626,1359,1138,10123
6/30/2018,2018,6,30, 2 ,7346,1316,1093,9755
6/30/2018,2018,6,30, 3 ,7156,1280,1059,9495
6/30/2018,2018,6,30, 4 ,6970,1254,1044,9268
6/30/2018,2018,6,30, 5 ,6895,1255,1048,9198
6/30/2018,2018,6,30, 6 ,6723,1240,1075,9038
6/30/2018,2018,6,30, 7 ,6840,1254,1089,9183
6/30/2018,2018,6,30, 8 ,7482,1386,1185,10053
6/30/2018,2018,6,30, 9 ,8139,1574,1316,11029
6/30/2018,2018,6,30, 10 ,8711,1681,1418,11810
6/30/2018,2018,6,30, 11 ,8958,1761,1493,12212
6/30/2018,2018,6,30, 12 ,8706,1741,1524,11971
6/30/2018,2018,6,30, 13 ,8609,1761,1554,11924
6/30/2018,2018,6,30, 14 ,8875,1823,1606,12304
6/30/2018,2018,6,30, 15 ,8693,1759,1566,12018
6/30/2018,2018,6,30, 16 ,8470,1692,1500,11662
6/30/2018,2018,6,30, 17 ,8167,1618,1444,11229
6/30/2018,2018,6,30, 18 ,8162,1670,1493,11325
6/30/2018,2018,6,30, 19 ,8617,1796,1574,11987
6/30/2018,2018,6,30, 20 ,8655,1743,1537,11935
6/30/2018,2018,6,30, 21 ,8533,1651,1457,11641
6/30/2018,2018,6,30, 22 ,8282,1570,1373,11225
6/30/2018,2018,6,30, 23 ,7946,1475,1270,10691
6/30/2018,2018,6,30, 24 ,7546,1392,1219,10157
7/1/2018,2018,7,1, 1 ,7169,1322,1093,9584
7/1/2018,2018,7,1, 2 ,6880,1282,1067,9229
7/1/2018,2018,7,1, 3 ,6687,1245,1040,8972
7/1/2018,2018,7,1, 4 ,6571,1220,1018,8809
7/1/2018,2018,7,1, 5 ,6438,1206,1023,8667
7/1/2018,2018,7,1, 6 ,6189,1171,1024,8384
7/1/2018,2018,7,1, 7 ,6179,1174,1023,8376
7/1/2018,2018,7,1, 8 ,6524,1232,1068,8824
7/1/2018,2018,7,1, 9 ,7020,1344,1097,9461
7/1/2018,2018,7,1, 10 ,7507,1449,1187,10143
7/1/2018,2018,7,1, 11 ,7708,1508,1242,10458
7/1/2018,2018,7,1, 12 ,7625,1496,1266,10387
7/1/2018,2018,7,1, 13 ,7673,1503,1217,10393
7/1/2018,2018,7,1, 14 ,7684,1522,1290,10496
7/1/2018,2018,7,1, 15 ,7573,1507,1253,10333
7/1/2018,2018,7,1, 16 ,7454,1463,1250,10167
7/1/2018,2018,7,1, 17 ,7406,1458,1246,10110
7/1/2018,2018,7,1, 18 ,7478,1519,1378,10375
7/1/2018,2018,7,1, 19 ,8090,1684,1488,11262
7/1/2018,2018,7,1, 20 ,8160,1669,1456,11285
7/1/2018,2018,7,1, 21 ,8067,1604,1390,11061
7/1/2018,2018,7,1, 22 ,7842,1507,1303,10652
7/1/2018,2018,7,1, 23 ,7524,1396,1191,10111
7/1/2018,2018,7,1, 24 ,7101,1319,1176,9596
7/2/2018,2018,7,2, 1 ,6751,1265,1062,9078
7/2/2018,2018,7,2, 2 ,6469,1223,1037,8729
7/2/2018,2018,7,2, 3 ,6297,1188,993,8478
7/2/2018,2018,7,2, 4 ,6210,1184,990,8384
7/2/2018,2018,7,2, 5 ,6340,1231,1055,8626
7/2/2018,2018,7,2, 6 ,6394,1261,1078,8733
7/2/2018,2018,7,2, 7 ,6789,1219,1000,9008
7/2/2018,2018,7,2, 8 ,7733,1409,1180,10322
7/2/2018,2018,7,2, 9 ,8654,1649,1406,11709
7/2/2018,2018,7,2, 10 ,9119,1789,1570,12478
7/2/2018,2018,7,2, 11 ,9364,1883,1629,12876
7/2/2018,2018,7,2, 12 ,9246,1832,1600,12678
7/2/2018,2018,7,2, 13 ,9261,1838,1600,12699
7/2/2018,2018,7,2, 14 ,9609,1940,1657,13206
7/2/2018,2018,7,2, 15 ,9608,1894,1630,13132
7/2/2018,2018,7,2, 16 ,9464,1855,1600,12919
7/2/2018,2018,7,2, 17 ,9020,1760,1526,12306
7/2/2018,2018,7,2, 18 ,8804,1762,1571,12137
7/2/2018,2018,7,2, 19 ,9055,1885,1590,12530
7/2/2018,2018,7,2, 20 ,9079,1840,1509,12428
7/2/2018,2018,7,2, 21 ,8954,1716,1438,12108
7/2/2018,2018,7,2, 22 ,8557,1588,1291,11436
7/2/2018,2018,7,2, 23 ,8154,1458,1234,10846
7/2/2018,2018,7,2, 24 ,7746,1363,1164,10273
7/3/2018,2018,7,3, 1 ,7389,1313,1096,9798
7/3/2018,2018,7,3, 2 ,7121,1277,1059,9457
7/3/2018,2018,7,3, 3 ,6915,1250,1014,9179
7/3/2018,2018,7,3, 4 ,6822,1229,1016,9067
7/3/2018,2018,7,3, 5 ,6949,1274,1099,9322
7/3/2018,2018,7,3, 6 ,6871,1285,1121,9277
7/3/2018,2018,7,3, 7 ,7097,1231,1051,9379
7/3/2018,2018,7,3, 8 ,8026,1437,1216,10679
7/3/2018,2018,7,3, 9 ,8923,1689,1418,12030
7/3/2018,2018,7,3, 10 ,9386,1811,1536,12733
7/3/2018,2018,7,3, 11 ,9764,1867,1622,13253
7/3/2018,2018,7,3, 12 ,9505,1834,1572,12911
7/3/2018,2018,7,3, 13 ,9385,1835,1592,12812
7/3/2018,2018,7,3, 14 ,9662,1894,1643,13199
7/3/2018,2018,7,3, 15 ,9604,1842,1630,13076
7/3/2018,2018,7,3, 16 ,9471,1826,1610,12907
7/3/2018,2018,7,3, 17 ,9104,1747,1553,12404
7/3/2018,2018,7,3, 18 ,8793,1739,1577,12109
7/3/2018,2018,7,3, 19 ,9170,1835,1635,12640
7/3/2018,2018,7,3, 20 ,9126,1786,1588,12500
7/3/2018,2018,7,3, 21 ,8958,1710,1515,12183
7/3/2018,2018,7,3, 22 ,8642,1560,1347,11549
7/3/2018,2018,7,3, 23 ,8127,1453,1234,10814
7/3/2018,2018,7,3, 24 ,7760,1365,1168,10293
7/4/2018,2018,7,4, 1 ,7444,1309,1123,9876
7/4/2018,2018,7,4, 2 ,7119,1253,1082,9454
7/4/2018,2018,7,4, 3 ,6918,1241,1059,9218
7/4/2018,2018,7,4, 4 ,6809,1226,1055,9090
7/4/2018,2018,7,4, 5 ,6949,1267,1123,9339
7/4/2018,2018,7,4, 6 ,6860,1278,1133,9271
7/4/2018,2018,7,4, 7 ,7021,1256,1061,9338
7/4/2018,2018,7,4, 8 ,8018,1452,1213,10683
7/4/2018,2018,7,4, 9 ,8903,1686,1437,12026
7/4/2018,2018,7,4, 10 ,9452,1800,1522,12774
7/4/2018,2018,7,4, 11 ,9707,1873,1614,13194
7/4/2018,2018,7,4, 12 ,9609,1805,1597,13011
7/4/2018,2018,7,4, 13 ,9617,1750,1589,12956
7/4/2018,2018,7,4, 14 ,9903,1828,1638,13369
7/4/2018,2018,7,4, 15 ,9791,1787,1611,13189
7/4/2018,2018,7,4, 16 ,9562,1785,1573,12920
7/4/2018,2018,7,4, 17 ,9213,1720,1548,12481
7/4/2018,2018,7,4, 18 ,8849,1716,1582,12147
7/4/2018,2018,7,4, 19 ,9201,1838,1584,12623
7/4/2018,2018,7,4, 20 ,9223,1783,1518,12524
7/4/2018,2018,7,4, 21 ,9034,1698,1420,12152
7/4/2018,2018,7,4, 22 ,8660,1578,1306,11544
7/4/2018,2018,7,4, 23 ,8185,1453,1199,10837
7/4/2018,2018,7,4, 24 ,7713,1366,1120,10199
7/5/2018,2018,7,5, 1 ,7445,1310,1090,9845
7/5/2018,2018,7,5, 2 ,7214,1270,1048,9532
7/5/2018,2018,7,5, 3 ,6954,1241,1015,9210
7/5/2018,2018,7,5, 4 ,6804,1226,1018,9048
7/5/2018,2018,7,5, 5 ,6973,1278,1101,9352
7/5/2018,2018,7,5, 6 ,6888,1284,1125,9297
7/5/2018,2018,7,5, 7 ,7052,1247,1030,9329
7/5/2018,2018,7,5, 8 ,8088,1422,1179,10689
7/5/2018,2018,7,5, 9 ,8975,1668,1405,12048
7/5/2018,2018,7,5, 10 ,9485,1802,1532,12819
7/5/2018,2018,7,5, 11 ,9820,1869,1588,13277
7/5/2018,2018,7,5, 12 ,9681,1801,1588,13070
7/5/2018,2018,7,5, 13 ,9594,1810,1512,12916
7/5/2018,2018,7,5, 14 ,9888,1876,1612,13376
7/5/2018,2018,7,5, 15 ,9714,1857,1572,13143
7/5/2018,2018,7,5, 16 ,9609,1827,1549,12985
7/5/2018,2018,7,5, 17 ,9153,1726,1499,12378
7/5/2018,2018,7,5, 18 ,8854,1745,1511,12110
7/5/2018,2018,7,5, 19 ,9192,1866,1566,12624
7/5/2018,2018,7,5, 20 ,9198,1805,1499,12502
7/5/2018,2018,7,5, 21 ,9016,1711,1422,12149
7/5/2018,2018,7,5, 22 ,8663,1544,1290,11497
7/5/2018,2018,7,5, 23 ,8247,1457,1193,10897
7/5/2018,2018,7,5, 24 ,7799,1360,1111,10270
7/6/2018,2018,7,6, 1 ,7444,1326,1071,9841
7/6/2018,2018,7,6, 2 ,7175,1288,1045,9508
7/6/2018,2018,7,6, 3 ,6982,1256,1021,9259
7/6/2018,2018,7,6, 4 ,6855,1242,1018,9115
7/6/2018,2018,7,6, 5 ,6959,1283,1118,9360
7/6/2018,2018,7,6, 6 ,6957,1307,1096,9360
7/6/2018,2018,7,6, 7 ,7123,1269,1056,9448
7/6/2018,2018,7,6, 8 ,8116,1444,1209,10769
7/6/2018,2018,7,6, 9 ,9048,1658,1395,12101
7/6/2018,2018,7,6, 10 ,9555,1766,1512,12833
7/6/2018,2018,7,6, 11 ,9895,1837,1588,13320
7/6/2018,2018,7,6, 12 ,9723,1800,1554,13077
7/6/2018,2018,7,6, 13 ,9648,1806,1559,13013
7/6/2018,2018,7,6, 14 ,9909,1876,1623,13408
7/6/2018,2018,7,6, 15 ,9661,1847,1600,13108
7/6/2018,2018,7,6, 16 ,9442,1828,1567,12837
7/6/2018,2018,7,6, 17 ,9087,1705,1529,12321
7/6/2018,2018,7,6, 18 ,8817,1709,1521,12047
7/6/2018,2018,7,6, 19 ,9151,1836,1575,12562
7/6/2018,2018,7,6, 20 ,9175,1780,1465,12420
7/6/2018,2018,7,6, 21 ,9036,1700,1384,12120
7/6/2018,2018,7,6, 22 ,8665,1581,1280,11526
7/6/2018,2018,7,6, 23 ,8248,1467,1171,10886
7/6/2018,2018,7,6, 24 ,7816,1383,1123,10322
7/7/2018,2018,7,7, 1 ,7506,1323,977,9806
7/7/2018,2018,7,7, 2 ,7286,1280,953,9519
7/7/2018,2018,7,7, 3 ,7094,1246,814,9154
7/7/2018,2018,7,7, 4 ,6927,1229,918,9074
7/7/2018,2018,7,7, 5 ,6846,1215,932,8993
7/7/2018,2018,7,7, 6 ,6706,1209,1036,8951
7/7/2018,2018,7,7, 7 ,6914,1221,1023,9158
7/7/2018,2018,7,7, 8 ,7576,1338,1140,10054
7/7/2018,2018,7,7, 9 ,8244,1523,1286,11053
7/7/2018,2018,7,7, 10 ,8776,1638,1364,11778
7/7/2018,2018,7,7, 11 ,9117,1702,1423,12242
7/7/2018,2018,7,7, 12 ,8861,1663,1418,11942
7/7/2018,2018,7,7, 13 ,8764,1665,1442,11871
7/7/2018,2018,7,7, 14 ,8982,1709,1508,12199
7/7/2018,2018,7,7, 15 ,8782,1670,1487,11939
7/7/2018,2018,7,7, 16 ,8517,1656,1441,11614
7/7/2018,2018,7,7, 17 ,8249,1568,1351,11168
7/7/2018,2018,7,7, 18 ,8191,1597,1431,11219
7/7/2018,2018,7,7, 19 ,8542,1726,1515,11783
7/7/2018,2018,7,7, 20 ,8602,1679,1494,11775
7/7/2018,2018,7,7, 21 ,8528,1610,1429,11567
7/7/2018,2018,7,7, 22 ,8140,1536,1311,10987
7/7/2018,2018,7,7, 23 ,7823,1420,1231,10474
7/7/2018,2018,7,7, 24 ,7392,1340,1127,9859
7/8/2018,2018,7,8, 1 ,7149,1283,1087,9519
7/8/2018,2018,7,8, 2 ,6895,1237,1050,9182
7/8/2018,2018,7,8, 3 ,6717,1211,1023,8951
7/8/2018,2018,7,8, 4 ,6524,1188,988,8700
7/8/2018,2018,7,8, 5 ,6448,1182,1003,8633
7/8/2018,2018,7,8, 6 ,6213,1144,1008,8365
7/8/2018,2018,7,8, 7 ,6219,1174,1006,8399
7/8/2018,2018,7,8, 8 ,6472,1245,1021,8738
7/8/2018,2018,7,8, 9 ,6861,1369,1150,9380
7/8/2018,2018,7,8, 10 ,7352,1468,1238,10058
7/8/2018,2018,7,8, 11 ,7740,1516,1258,10514
7/8/2018,2018,7,8, 12 ,7726,1517,1274,10517
7/8/2018,2018,7,8, 13 ,7728,1517,1320,10565
7/8/2018,2018,7,8, 14 ,7756,1536,1308,10600
7/8/2018,2018,7,8, 15 ,7556,1508,1293,10357
7/8/2018,2018,7,8, 16 ,7416,1477,1290,10183
7/8/2018,2018,7,8, 17 ,7389,1470,1293,10152
7/8/2018,2018,7,8, 18 ,7527,1540,1353,10420
7/8/2018,2018,7,8, 19 ,7952,1662,1473,11087
7/8/2018,2018,7,8, 20 ,8067,1606,1486,11159
7/8/2018,2018,7,8, 21 ,8003,1531,1423,10957
7/8/2018,2018,7,8, 22 ,7674,1430,1318,10422
7/8/2018,2018,7,8, 23 ,7273,1333,1219,9825
7/8/2018,2018,7,8, 24 ,6910,1305,1142,9357
7/9/2018,2018,7,9, 1 ,6639,1207,1086,8932
7/9/2018,2018,7,9, 2 ,6388,1171,1041,8600
7/9/2018,2018,7,9, 3 ,6163,1134,1010,8307
7/9/2018,2018,7,9, 4 ,6091,1132,1000,8223
7/9/2018,2018,7,9, 5 ,6270,1188,1083,8541
7/9/2018,2018,7,9, 6 ,6402,1236,1119,8757
7/9/2018,2018,7,9, 7 ,6683,1191,1032,8906
7/9/2018,2018,7,9, 8 ,7675,1354,1200,10229
7/9/2018,2018,7,9, 9 ,8583,1600,1422,11605
7/9/2018,2018,7,9, 10 ,9210,1730,1572,12512
7/9/2018,2018,7,9, 11 ,9530,1803,1652,12985
7/9/2018,2018,7,9, 12 ,9297,1755,1637,12689
7/9/2018,2018,7,9, 13 ,9164,1766,1625,12555
7/9/2018,2018,7,9, 14 ,9464,1845,1686,12995
7/9/2018,2018,7,9, 15 ,9375,1833,1680,12888
7/9/2018,2018,7,9, 16 ,9192,1818,1655,12665
7/9/2018,2018,7,9, 17 ,8820,1730,1560,12110
7/9/2018,2018,7,9, 18 ,8522,1715,1569,11806
7/9/2018,2018,7,9, 19 ,8902,1844,1709,12455
7/9/2018,2018,7,9, 20 ,8841,1780,1632,12253
7/9/2018,2018,7,9, 21 ,8679,1702,1567,11948
7/9/2018,2018,7,9, 22 ,8244,1562,1412,11218
7/9/2018,2018,7,9, 23 ,7793,1449,1299,10541
7/9/2018,2018,7,9, 24 ,7386,1376,1228,9990
7/10/2018,2018,7,10, 1 ,7120,1327,1168,9615
7/10/2018,2018,7,10, 2 ,6899,1280,1127,9306
7/10/2018,2018,7,10, 3 ,6677,1248,1088,9013
7/10/2018,2018,7,10, 4 ,6477,1239,1071,8787
7/10/2018,2018,7,10, 5 ,6634,1288,1136,9058
7/10/2018,2018,7,10, 6 ,6758,1297,1166,9221
7/10/2018,2018,7,10, 7 ,6870,1264,1082,9216
7/10/2018,2018,7,10, 8 ,7827,1462,1217,10506
7/10/2018,2018,7,10, 9 ,8593,1709,1431,11733
7/10/2018,2018,7,10, 10 ,9163,1787,1561,12511
7/10/2018,2018,7,10, 11 ,9492,1886,1621,12999
7/10/2018,2018,7,10, 12 ,9268,1819,1545,12632
7/10/2018,2018,7,10, 13 ,9305,1833,1565,12703
7/10/2018,2018,7,10, 14 ,9558,1921,1667,13146
7/10/2018,2018,7,10, 15 ,9503,1887,1625,13015
7/10/2018,2018,7,10, 16 ,9359,1875,1585,12819
7/10/2018,2018,7,10, 17 ,8996,1723,1573,12292
7/10/2018,2018,7,10, 18 ,8719,1734,1611,12064
7/10/2018,2018,7,10, 19 ,8943,1833,1642,12418
7/10/2018,2018,7,10, 20 ,8974,1784,1580,12338
7/10/2018,2018,7,10, 21 ,8789,1707,1492,11988
7/10/2018,2018,7,10, 22 ,8388,1592,1338,11318
7/10/2018,2018,7,10, 23 ,7982,1480,1241,10703
7/10/2018,2018,7,10, 24 ,7552,1387,1263,10202
7/11/2018,2018,7,11, 1 ,7210,1324,1089,9623
7/11/2018,2018,7,11, 2 ,6976,1275,1060,9311
7/11/2018,2018,7,11, 3 ,6764,1242,1037,9043
7/11/2018,2018,7,11, 4 ,6679,1225,1018,8922
7/11/2018,2018,7,11, 5 ,6801,1278,1089,9168
7/11/2018,2018,7,11, 6 ,6800,1296,1141,9237
7/11/2018,2018,7,11, 7 ,6955,1230,1053,9238
7/11/2018,2018,7,11, 8 ,7911,1403,1221,10535
7/11/2018,2018,7,11, 9 ,8741,1694,1379,11814
7/11/2018,2018,7,11, 10 ,9293,1806,1491,12590
7/11/2018,2018,7,11, 11 ,9525,1885,1587,12997
7/11/2018,2018,7,11, 12 ,9241,1855,1558,12654
7/11/2018,2018,7,11, 13 ,9163,1858,1571,12592
7/11/2018,2018,7,11, 14 ,9419,1941,1471,12831
7/11/2018,2018,7,11, 15 ,9296,1921,1517,12734
7/11/2018,2018,7,11, 16 ,9164,1873,1471,12508
7/11/2018,2018,7,11, 17 ,8873,1793,1459,12125
7/11/2018,2018,7,11, 18 ,8614,1780,1461,11855
7/11/2018,2018,7,11, 19 ,8923,1865,1603,12391
7/11/2018,2018,7,11, 20 ,8928,1804,1518,12250
7/11/2018,2018,7,11, 21 ,8696,1724,1459,11879
7/11/2018,2018,7,11, 22 ,8233,1582,1318,11133
7/11/2018,2018,7,11, 23 ,7807,1472,1231,10510
7/11/2018,2018,7,11, 24 ,7414,1384,1138,9936
7/12/2018,2018,7,12, 1 ,7123,1319,1029,9471
7/12/2018,2018,7,12, 2 ,6953,1274,1003,9230
7/12/2018,2018,7,12, 3 ,9717,1249,971,11937
7/12/2018,2018,7,12, 4 ,6651,1226,980,8857
7/12/2018,2018,7,12, 5 ,6831,1265,1023,9119
7/12/2018,2018,7,12, 6 ,6824,1307,1096,9227
7/12/2018,2018,7,12, 7 ,6962,1241,1038,9241
7/12/2018,2018,7,12, 8 ,7893,1391,1130,10414
7/12/2018,2018,7,12, 9 ,8648,1618,1303,11569
7/12/2018,2018,7,12, 10 ,9141,1713,1398,12252
7/12/2018,2018,7,12, 11 ,9477,1764,1444,12685
7/12/2018,2018,7,12, 12 ,9142,1707,1444,12293
7/12/2018,2018,7,12, 13 ,9018,1706,1392,12116
7/12/2018,2018,7,12, 14 ,9219,1791,1430,12440
7/12/2018,2018,7,12, 15 ,9121,1769,1421,12311
7/12/2018,2018,7,12, 16 ,9042,1725,1408,12175
7/12/2018,2018,7,12, 17 ,8718,1666,1405,11789
7/12/2018,2018,7,12, 18 ,8593,1706,1452,11751
7/12/2018,2018,7,12, 19 ,8826,1795,1494,12115
7/12/2018,2018,7,12, 20 ,8747,1741,1426,11914
7/12/2018,2018,7,12, 21 ,8544,1658,1343,11545
7/12/2018,2018,7,12, 22 ,8084,1527,1226,10837
7/12/2018,2018,7,12, 23 ,7625,1419,1153,10197
7/12/2018,2018,7,12, 24 ,7230,1326,1085,9641
7/13/2018,2018,7,13, 1 ,7035,1256,1015,9306
7/13/2018,2018,7,13, 2 ,6725,1224,992,8941
7/13/2018,2018,7,13, 3 ,6612,1193,960,8765
7/13/2018,2018,7,13, 4 ,6568,1177,927,8672
7/13/2018,2018,7,13, 5 ,6704,1218,1031,8953
7/13/2018,2018,7,13, 6 ,6714,1252,1095,9061
7/13/2018,2018,7,13, 7 ,6902,1208,1020,9130
7/13/2018,2018,7,13, 8 ,7802,1377,1123,10302
7/13/2018,2018,7,13, 9 ,8753,1601,1292,11646
7/13/2018,2018,7,13, 10 ,9323,1732,1441,12496
7/13/2018,2018,7,13, 11 ,9569,1808,1540,12917
7/13/2018,2018,7,13, 12 ,9300,1742,1512,12554
7/13/2018,2018,7,13, 13 ,9206,1754,1522,12482
7/13/2018,2018,7,13, 14 ,9445,1824,1575,12844
7/13/2018,2018,7,13, 15 ,9433,1761,1559,12753
7/13/2018,2018,7,13, 16 ,9146,1704,1521,12371
7/13/2018,2018,7,13, 17 ,8760,1597,1479,11836
7/13/2018,2018,7,13, 18 ,8579,1598,1500,11677
7/13/2018,2018,7,13, 19 ,8734,1680,1568,11982
7/13/2018,2018,7,13, 20 ,8646,1612,1508,11766
7/13/2018,2018,7,13, 21 ,8485,1546,1425,11456
7/13/2018,2018,7,13, 22 ,8022,1443,1300,10765
7/13/2018,2018,7,13, 23 ,7677,1352,1213,10242
7/13/2018,2018,7,13, 24 ,7168,1265,1057,9490
7/14/2018,2018,7,14, 1 ,6935,1217,1063,9215
7/14/2018,2018,7,14, 2 ,6755,1190,1038,8983
7/14/2018,2018,7,14, 3 ,6539,1154,1012,8705
7/14/2018,2018,7,14, 4 ,6462,1128,1003,8593
7/14/2018,2018,7,14, 5 ,6473,1163,1025,8661
7/14/2018,2018,7,14, 6 ,6371,1177,1072,8620
7/14/2018,2018,7,14, 7 ,6587,1209,1069,8865
7/14/2018,2018,7,14, 8 ,7238,1336,1137,9711
7/14/2018,2018,7,14, 9 ,7950,1508,1228,10686
7/14/2018,2018,7,14, 10 ,8504,1619,1336,11459
7/14/2018,2018,7,14, 11 ,8797,1703,1422,11922
7/14/2018,2018,7,14, 12 ,8525,1616,1412,11553
7/14/2018,2018,7,14, 13 ,8467,1633,1398,11498
7/14/2018,2018,7,14, 14 ,8678,1676,1416,11770
7/14/2018,2018,7,14, 15 ,8616,1654,1432,11702
7/14/2018,2018,7,14, 16 ,8376,1622,1427,11425
7/14/2018,2018,7,14, 17 ,8094,1577,1387,11058
7/14/2018,2018,7,14, 18 ,8021,1617,1459,11097
7/14/2018,2018,7,14, 19 ,8387,1747,1565,11699
7/14/2018,2018,7,14, 20 ,8336,1712,1492,11540
7/14/2018,2018,7,14, 21 ,8220,1643,1450,11313
7/14/2018,2018,7,14, 22 ,7993,1556,1389,10938
7/14/2018,2018,7,14, 23 ,7660,1432,1249,10341
7/14/2018,2018,7,14, 24 ,7247,1345,1151,9743
7/15/2018,2018,7,15, 1 ,6989,1287,1118,9394
7/15/2018,2018,7,15, 2 ,6719,1244,1077,9040
7/15/2018,2018,7,15, 3 ,6537,1208,1039,8784
7/15/2018,2018,7,15, 4 ,6393,1186,1012,8591
7/15/2018,2018,7,15, 5 ,6288,1177,1021,8486
7/15/2018,2018,7,15, 6 ,6086,1168,1016,8270
7/15/2018,2018,7,15, 7 ,6128,1182,1013,8323
7/15/2018,2018,7,15, 8 ,6423,1247,974,8644
7/15/2018,2018,7,15, 9 ,6893,1349,1108,9350
7/15/2018,2018,7,15, 10 ,7307,1447,1225,9979
7/15/2018,2018,7,15, 11 ,7649,1529,1321,10499
7/15/2018,2018,7,15, 12 ,7577,1539,1327,10443
7/15/2018,2018,7,15, 13 ,7553,1532,1260,10345
7/15/2018,2018,7,15, 14 ,7618,1536,1255,10409
7/15/2018,2018,7,15, 15 ,7361,1471,1214,10046
7/15/2018,2018,7,15, 16 ,7265,1423,1211,9899
7/15/2018,2018,7,15, 17 ,7241,1459,1213,9913
7/15/2018,2018,7,15, 18 ,7315,1542,1307,10164
7/15/2018,2018,7,15, 19 ,7925,1632,1395,10952
7/15/2018,2018,7,15, 20 ,7981,1589,1383,10953
7/15/2018,2018,7,15, 21 ,7927,1503,1333,10763
7/15/2018,2018,7,15, 22 ,7580,1401,1217,10198
7/15/2018,2018,7,15, 23 ,7201,1300,1150,9651
7/15/2018,2018,7,15, 24 ,6813,1235,1218,9266
7/16/2018,2018,7,16, 1 ,6548,1181,987,8716
7/16/2018,2018,7,16, 2 ,6345,1146,973,8464
7/16/2018,2018,7,16, 3 ,6133,1121,947,8201
7/16/2018,2018,7,16, 4 ,6055,1122,954,8131
7/16/2018,2018,7,16, 5 ,6288,1169,1033,8490
7/16/2018,2018,7,16, 6 ,6406,1241,1096,8743
7/16/2018,2018,7,16, 7 ,6634,1209,1005,8848
7/16/2018,2018,7,16, 8 ,7468,1398,1139,10005
7/16/2018,2018,7,16, 9 ,8428,1609,1349,11386
7/16/2018,2018,7,16, 10 ,8982,1717,1474,12173
7/16/2018,2018,7,16, 11 ,9304,1774,1507,12585
7/16/2018,2018,7,16, 12 ,9099,1717,1465,12281
7/16/2018,2018,7,16, 13 ,9022,1707,1415,12144
7/16/2018,2018,7,16, 14 ,9257,1770,1493,12520
7/16/2018,2018,7,16, 15 ,9172,1750,1456,12378
7/16/2018,2018,7,16, 16 ,9028,1704,1457,12189
7/16/2018,2018,7,16, 17 ,8756,1688,1420,11864
7/16/2018,2018,7,16, 18 ,8552,1709,1407,11668
7/16/2018,2018,7,16, 19 ,8798,1767,1488,12053
7/16/2018,2018,7,16, 20 ,8693,1725,1475,11893
7/16/2018,2018,7,16, 21 ,8382,1640,1411,11433
7/16/2018,2018,7,16, 22 ,7919,1485,1321,10725
7/16/2018,2018,7,16, 23 ,7389,1379,1179,9947
7/16/2018,2018,7,16, 24 ,7024,1309,1108,9441
7/17/2018,2018,7,17, 1 ,6769,1256,1029,9054
7/17/2018,2018,7,17, 2 ,6490,1225,1001,8716
7/17/2018,2018,7,17, 3 ,6393,1199,980,8572
7/17/2018,2018,7,17, 4 ,6297,1194,984,8475
7/17/2018,2018,7,17, 5 ,6494,1240,1032,8766
7/17/2018,2018,7,17, 6 ,6603,1302,1093,8998
7/17/2018,2018,7,17, 7 ,6773,1251,1035,9059
7/17/2018,2018,7,17, 8 ,7437,1407,1166,10010
7/17/2018,2018,7,17, 9 ,8224,1622,1379,11225
7/17/2018,2018,7,17, 10 ,8680,1749,1499,11928
7/17/2018,2018,7,17, 11 ,8891,1808,1587,12286
7/17/2018,2018,7,17, 12 ,8608,1730,1547,11885
7/17/2018,2018,7,17, 13 ,8398,1723,1557,11678
7/17/2018,2018,7,17, 14 ,8521,1779,1632,11932
7/17/2018,2018,7,17, 15 ,8484,1746,1627,11857
7/17/2018,2018,7,17, 16 ,8343,1717,1602,11662
7/17/2018,2018,7,17, 17 ,8239,1680,1540,11459
7/17/2018,2018,7,17, 18 ,8186,1703,1585,11474
7/17/2018,2018,7,17, 19 ,8226,1786,1652,11664
7/17/2018,2018,7,17, 20 ,8073,1725,1612,11410
7/17/2018,2018,7,17, 21 ,7876,1622,1543,11041
7/17/2018,2018,7,17, 22 ,7403,1495,1398,10296
7/17/2018,2018,7,17, 23 ,7022,1388,1297,9707
7/17/2018,2018,7,17, 24 ,6663,1299,1201,9163
7/18/2018,2018,7,18, 1 ,6402,1277,1132,8811
7/18/2018,2018,7,18, 2 ,6237,1245,1090,8572
7/18/2018,2018,7,18, 3 ,6132,1232,1062,8426
7/18/2018,2018,7,18, 4 ,6088,1217,1057,8362
7/18/2018,2018,7,18, 5 ,6201,1271,1114,8586
7/18/2018,2018,7,18, 6 ,6367,1307,1177,8851
7/18/2018,2018,7,18, 7 ,6667,1250,1102,9019
7/18/2018,2018,7,18, 8 ,7372,1418,1146,9936
7/18/2018,2018,7,18, 9 ,8140,1638,1577,11355
7/18/2018,2018,7,18, 10 ,8668,1760,1554,11982
7/18/2018,2018,7,18, 11 ,8942,1872,1649,12463
7/18/2018,2018,7,18, 12 ,8628,1802,1629,12059
7/18/2018,2018,7,18, 13 ,8534,1803,1640,11977
7/18/2018,2018,7,18, 14 ,8827,1874,1709,12410
7/18/2018,2018,7,18, 15 ,8695,1890,1696,12281
7/18/2018,2018,7,18, 16 ,8678,1863,1676,12217
7/18/2018,2018,7,18, 17 ,8543,1768,1602,11913
7/18/2018,2018,7,18, 18 ,8402,1784,1591,11777
7/18/2018,2018,7,18, 19 ,8591,1911,1700,12202
7/18/2018,2018,7,18, 20 ,8514,1843,1657,12014
7/18/2018,2018,7,18, 21 ,8284,1770,1579,11633
7/18/2018,2018,7,18, 22 ,7811,1639,1447,10897
7/18/2018,2018,7,18, 23 ,7314,1524,1339,10177
7/18/2018,2018,7,18, 24 ,6917,1425,1241,9583
7/19/2018,2018,7,19, 1 ,6646,1362,1168,9176
7/19/2018,2018,7,19, 2 ,6531,1333,1144,9008
7/19/2018,2018,7,19, 3 ,6341,1301,1119,8761
7/19/2018,2018,7,19, 4 ,6258,1278,1103,8639
7/19/2018,2018,7,19, 5 ,6491,1321,1164,8976
7/19/2018,2018,7,19, 6 ,6622,1348,1197,9167
7/19/2018,2018,7,19, 7 ,6858,1295,1119,9272
7/19/2018,2018,7,19, 8 ,7684,1480,1250,10414
7/19/2018,2018,7,19, 9 ,8574,1729,1483,11786
7/19/2018,2018,7,19, 10 ,8993,1852,1611,12456
7/19/2018,2018,7,19, 11 ,9263,1935,1702,12900
7/19/2018,2018,7,19, 12 ,9065,1875,1682,12622
7/19/2018,2018,7,19, 13 ,8910,1857,1680,12447
7/19/2018,2018,7,19, 14 ,9243,1896,1750,12889
7/19/2018,2018,7,19, 15 ,9042,1852,1754,12648
7/19/2018,2018,7,19, 16 ,8905,1820,1700,12425
7/19/2018,2018,7,19, 17 ,8639,1735,1605,11979
7/19/2018,2018,7,19, 18 ,8517,1771,1600,11888
7/19/2018,2018,7,19, 19 ,8673,1856,1710,12239
7/19/2018,2018,7,19, 20 ,8574,1806,1672,12052
7/19/2018,2018,7,19, 21 ,8342,1714,1576,11632
7/19/2018,2018,7,19, 22 ,7838,1591,1497,10926
7/19/2018,2018,7,19, 23 ,7426,1480,1380,10286
7/19/2018,2018,7,19, 24 ,7039,1390,1264,9693
7/20/2018,2018,7,20, 1 ,6762,1342,1208,9312
7/20/2018,2018,7,20, 2 ,6555,1306,1159,9020
7/20/2018,2018,7,20, 3 ,6405,1270,1146,8821
7/20/2018,2018,7,20, 4 ,6342,1255,1132,8729
7/20/2018,2018,7,20, 5 ,6486,1298,1185,8969
7/20/2018,2018,7,20, 6 ,6475,1339,1209,9023
7/20/2018,2018,7,20, 7 ,6654,1293,1132,9079
7/20/2018,2018,7,20, 8 ,7339,1484,1314,10137
7/20/2018,2018,7,20, 9 ,8207,1726,1498,11431
7/20/2018,2018,7,20, 10 ,8677,1836,1599,12112
7/20/2018,2018,7,20, 11 ,8989,1920,1655,12564
7/20/2018,2018,7,20, 12 ,8808,1885,1598,12291
7/20/2018,2018,7,20, 13 ,8690,1895,1666,12251
7/20/2018,2018,7,20, 14 ,8965,1960,1694,12619
7/20/2018,2018,7,20, 15 ,8713,1923,1691,12327
7/20/2018,2018,7,20, 16 ,8641,1921,1696,12258
7/20/2018,2018,7,20, 17 ,8445,1815,1598,11858
7/20/2018,2018,7,20, 18 ,8302,1803,1619,11724
7/20/2018,2018,7,20, 19 ,8563,1919,1702,12184
7/20/2018,2018,7,20, 20 ,8451,1867,1640,11958
7/20/2018,2018,7,20, 21 ,8312,1799,1600,11711
7/20/2018,2018,7,20, 22 ,7800,1678,1467,10945
7/20/2018,2018,7,20, 23 ,7370,1561,1346,10277
7/20/2018,2018,7,20, 24 ,7086,1470,1335,9891
7/21/2018,2018,7,21, 1 ,6851,1411,1250,9512
7/21/2018,2018,7,21, 2 ,6625,1368,1188,9181
7/21/2018,2018,7,21, 3 ,6490,1338,1137,8965
7/21/2018,2018,7,21, 4 ,6432,1314,1117,8863
7/21/2018,2018,7,21, 5 ,6423,1317,1136,8876
7/21/2018,2018,7,21, 6 ,6371,1310,1073,8754
7/21/2018,2018,7,21, 7 ,6577,1310,1154,9041
7/21/2018,2018,7,21, 8 ,7099,1415,1265,9779
7/21/2018,2018,7,21, 9 ,7718,1591,1383,10692
7/21/2018,2018,7,21, 10 ,8079,1707,1521,11307
7/21/2018,2018,7,21, 11 ,8294,1794,1568,11656
7/21/2018,2018,7,21, 12 ,8120,1756,1553,11429
7/21/2018,2018,7,21, 13 ,7988,1750,1580,11318
7/21/2018,2018,7,21, 14 ,8109,1803,1607,11519
7/21/2018,2018,7,21, 15 ,7787,1783,1575,11145
7/21/2018,2018,7,21, 16 ,7572,1740,1540,10852
7/21/2018,2018,7,21, 17 ,7468,1653,1487,10608
7/21/2018,2018,7,21, 18 ,7521,1706,1537,10764
7/21/2018,2018,7,21, 19 ,7731,1861,1641,11233
7/21/2018,2018,7,21, 20 ,7775,1815,1577,11167
7/21/2018,2018,7,21, 21 ,7713,1753,1534,11000
7/21/2018,2018,7,21, 22 ,7446,1686,1452,10584
7/21/2018,2018,7,21, 23 ,7068,1557,1316,9941
7/21/2018,2018,7,21, 24 ,6743,1471,1237,9451
7/22/2018,2018,7,22, 1 ,6525,1411,1196,9132
7/22/2018,2018,7,22, 2 ,6277,1354,1165,8796
7/22/2018,2018,7,22, 3 ,6050,1314,1135,8499
7/22/2018,2018,7,22, 4 ,5985,1287,1121,8393
7/22/2018,2018,7,22, 5 ,5872,1271,1122,8265
7/22/2018,2018,7,22, 6 ,5778,1229,1084,8091
7/22/2018,2018,7,22, 7 ,5883,1243,1067,8193
7/22/2018,2018,7,22, 8 ,6194,1299,1114,8607
7/22/2018,2018,7,22, 9 ,6590,1411,1171,9172
7/22/2018,2018,7,22, 10 ,6963,1473,1238,9674
7/22/2018,2018,7,22, 11 ,7092,1522,1297,9911
7/22/2018,2018,7,22, 12 ,6931,1490,1309,9730
7/22/2018,2018,7,22, 13 ,6807,1473,1299,9579
7/22/2018,2018,7,22, 14 ,6704,1450,1298,9452
7/22/2018,2018,7,22, 15 ,6606,1444,1254,9304
7/22/2018,2018,7,22, 16 ,6613,1437,1244,9294
7/22/2018,2018,7,22, 17 ,6731,1459,1237,9427
7/22/2018,2018,7,22, 18 ,6949,1522,1365,9836
7/22/2018,2018,7,22, 19 ,7280,1653,1475,10408
7/22/2018,2018,7,22, 20 ,7199,1613,1438,10250
7/22/2018,2018,7,22, 21 ,7029,1536,1377,9942
7/22/2018,2018,7,22, 22 ,6734,1433,1283,9450
7/22/2018,2018,7,22, 23 ,6399,1331,1173,8903
7/22/2018,2018,7,22, 24 ,6066,1257,1124,8447
7/23/2018,2018,7,23, 1 ,5783,1214,1076,8073
7/23/2018,2018,7,23, 2 ,5616,1180,1038,7834
7/23/2018,2018,7,23, 3 ,5522,1152,1010,7684
7/23/2018,2018,7,23, 4 ,5431,1154,1012,7597
7/23/2018,2018,7,23, 5 ,5628,1199,1081,7908
7/23/2018,2018,7,23, 6 ,5823,1266,1160,8249
7/23/2018,2018,7,23, 7 ,6244,1246,1084,8574
7/23/2018,2018,7,23, 8 ,7031,1384,1214,9629
7/23/2018,2018,7,23, 9 ,7696,1601,1388,10685
7/23/2018,2018,7,23, 10 ,8193,1708,1511,11412
7/23/2018,2018,7,23, 11 ,8533,1785,1607,11925
7/23/2018,2018,7,23, 12 ,8295,1749,1589,11633
7/23/2018,2018,7,23, 13 ,8218,1731,1582,11531
7/23/2018,2018,7,23, 14 ,8408,1791,1645,11844
7/23/2018,2018,7,23, 15 ,8431,1786,1659,11876
7/23/2018,2018,7,23, 16 ,8437,1778,1595,11810
7/23/2018,2018,7,23, 17 ,8261,1736,1494,11491
7/23/2018,2018,7,23, 18 ,8224,1744,1584,11552
7/23/2018,2018,7,23, 19 ,8379,1847,1584,11810
7/23/2018,2018,7,23, 20 ,8294,1790,1542,11626
7/23/2018,2018,7,23, 21 ,8060,1701,1458,11219
7/23/2018,2018,7,23, 22 ,7629,1551,1361,10541
7/23/2018,2018,7,23, 23 ,7148,1424,1246,9818
7/23/2018,2018,7,23, 24 ,6809,1349,1175,9333
7/24/2018,2018,7,24, 1 ,6484,1296,1127,8907
7/24/2018,2018,7,24, 2 ,6268,1247,1080,8595
7/24/2018,2018,7,24, 3 ,6182,1214,1071,8467
7/24/2018,2018,7,24, 4 ,6137,1204,1061,8402
7/24/2018,2018,7,24, 5 ,6342,1252,1135,8729
7/24/2018,2018,7,24, 6 ,6545,1309,1180,9034
7/24/2018,2018,7,24, 7 ,6650,1251,1091,8992
7/24/2018,2018,7,24, 8 ,7412,1415,1223,10050
7/24/2018,2018,7,24, 9 ,8163,1663,1458,11284
7/24/2018,2018,7,24, 10 ,8641,1799,1574,12014
7/24/2018,2018,7,24, 11 ,8824,1867,1601,12292
7/24/2018,2018,7,24, 12 ,8560,1827,1637,12024
7/24/2018,2018,7,24, 13 ,8497,1817,1651,11965
7/24/2018,2018,7,24, 14 ,8903,1896,1702,12501
7/24/2018,2018,7,24, 15 ,8854,1878,1672,12404
7/24/2018,2018,7,24, 16 ,8755,1848,1623,12226
7/24/2018,2018,7,24, 17 ,8472,1780,1562,11814
7/24/2018,2018,7,24, 18 ,8432,1796,1591,11819
7/24/2018,2018,7,24, 19 ,8653,1872,1677,12202
7/24/2018,2018,7,24, 20 ,8602,1795,1617,12014
7/24/2018,2018,7,24, 21 ,8342,1706,1569,11617
7/24/2018,2018,7,24, 22 ,7895,1568,1431,10894
7/24/2018,2018,7,24, 23 ,7436,1467,1319,10222
7/24/2018,2018,7,24, 24 ,6995,1383,1227,9605
7/25/2018,2018,7,25, 1 ,6755,1326,1177,9258
7/25/2018,2018,7,25, 2 ,6521,1284,1136,8941
7/25/2018,2018,7,25, 3 ,6363,1263,1104,8730
7/25/2018,2018,7,25, 4 ,6315,1236,1095,8646
7/25/2018,2018,7,25, 5 ,6470,1290,1160,8920
7/25/2018,2018,7,25, 6 ,6543,1342,1196,9081
7/25/2018,2018,7,25, 7 ,6792,1284,1115,9191
7/25/2018,2018,7,25, 8 ,7651,1460,1266,10377
7/25/2018,2018,7,25, 9 ,8479,1696,1497,11672
7/25/2018,2018,7,25, 10 ,9026,1808,1599,12433
7/25/2018,2018,7,25, 11 ,9415,1866,1674,12955
7/25/2018,2018,7,25, 12 ,9169,1812,1650,12631
7/25/2018,2018,7,25, 13 ,9077,1827,1658,12562
7/25/2018,2018,7,25, 14 ,9339,1837,1730,12906
7/25/2018,2018,7,25, 15 ,9226,1838,1700,12764
7/25/2018,2018,7,25, 16 ,9101,1808,1677,12586
7/25/2018,2018,7,25, 17 ,8778,1739,1592,12109
7/25/2018,2018,7,25, 18 ,8494,1764,1619,11877
7/25/2018,2018,7,25, 19 ,8752,1848,1686,12286
7/25/2018,2018,7,25, 20 ,8682,1793,1588,12063
7/25/2018,2018,7,25, 21 ,8442,1710,1515,11667
7/25/2018,2018,7,25, 22 ,8072,1576,1477,11125
7/25/2018,2018,7,25, 23 ,7638,1467,1368,10473
7/25/2018,2018,7,25, 24 ,7275,1387,1278,9940
7/26/2018,2018,7,26, 1 ,6904,1333,1184,9421
7/26/2018,2018,7,26, 2 ,6713,1292,1150,9155
7/26/2018,2018,7,26, 3 ,6549,1260,1122,8931
7/26/2018,2018,7,26, 4 ,6445,1244,1114,8803
7/26/2018,2018,7,26, 5 ,6642,1295,1166,9103
7/26/2018,2018,7,26, 6 ,6698,1332,1200,9230
7/26/2018,2018,7,26, 7 ,6876,1274,1114,9264
7/26/2018,2018,7,26, 8 ,7798,1480,1239,10517
7/26/2018,2018,7,26, 9 ,8601,1697,1471,11769
7/26/2018,2018,7,26, 10 ,9144,1824,1589,12557
7/26/2018,2018,7,26, 11 ,9343,1894,1658,12895
7/26/2018,2018,7,26, 12 ,9068,1817,1649,12534
7/26/2018,2018,7,26, 13 ,8885,1788,1683,12356
7/26/2018,2018,7,26, 14 ,9145,1878,1732,12755
7/26/2018,2018,7,26, 15 ,9033,1877,1714,12624
7/26/2018,2018,7,26, 16 ,8866,1825,1650,12341
7/26/2018,2018,7,26, 17 ,8578,1776,1601,11955
7/26/2018,2018,7,26, 18 ,8426,1780,1631,11837
7/26/2018,2018,7,26, 19 ,8632,1871,1628,12131
7/26/2018,2018,7,26, 20 ,8633,1806,1646,12085
7/26/2018,2018,7,26, 21 ,8347,1747,1587,11681
7/26/2018,2018,7,26, 22 ,7912,1611,1443,10966
7/26/2018,2018,7,26, 23 ,7513,1484,1337,10334
7/26/2018,2018,7,26, 24 ,7067,1393,1253,9713
7/27/2018,2018,7,27, 1 ,6800,1341,1192,9333
7/27/2018,2018,7,27, 2 ,6568,1300,1148,9016
7/27/2018,2018,7,27, 3 ,6432,1278,1113,8823
7/27/2018,2018,7,27, 4 ,6377,1258,1123,8758
7/27/2018,2018,7,27, 5 ,6513,1303,1163,8979
7/27/2018,2018,7,27, 6 ,6571,1330,1192,9093
7/27/2018,2018,7,27, 7 ,6662,1289,1127,9078
7/27/2018,2018,7,27, 8 ,7397,1440,1302,10139
7/27/2018,2018,7,27, 9 ,8193,1655,1533,11381
7/27/2018,2018,7,27, 10 ,8672,1771,1653,12096
7/27/2018,2018,7,27, 11 ,8831,1837,1712,12380
7/27/2018,2018,7,27, 12 ,8594,1765,1705,12064
7/27/2018,2018,7,27, 13 ,8576,1773,1715,12064
7/27/2018,2018,7,27, 14 ,8815,1777,1763,12355
7/27/2018,2018,7,27, 15 ,8751,1758,1717,12226
7/27/2018,2018,7,27, 16 ,8727,1752,1693,12172
7/27/2018,2018,7,27, 17 ,8456,1695,1614,11765
7/27/2018,2018,7,27, 18 ,8297,1706,1626,11629
7/27/2018,2018,7,27, 19 ,8561,1813,1711,12085
7/27/2018,2018,7,27, 20 ,8469,1754,1667,11890
7/27/2018,2018,7,27, 21 ,8273,1676,1618,11567
7/27/2018,2018,7,27, 22 ,7888,1555,1454,10897
7/27/2018,2018,7,27, 23 ,7420,1435,1374,10229
7/27/2018,2018,7,27, 24 ,7074,1353,1283,9710
7/28/2018,2018,7,28, 1 ,6753,1300,1226,9279
7/28/2018,2018,7,28, 2 ,6616,1264,1181,9061
7/28/2018,2018,7,28, 3 ,6453,1232,1142,8827
7/28/2018,2018,7,28, 4 ,6295,1212,1116,8623
7/28/2018,2018,7,28, 5 ,6297,1221,1115,8633
7/28/2018,2018,7,28, 6 ,6285,1229,1124,8638
7/28/2018,2018,7,28, 7 ,6428,1257,1122,8807
7/28/2018,2018,7,28, 8 ,6994,1365,1226,9585
7/28/2018,2018,7,28, 9 ,7626,1530,1382,10538
7/28/2018,2018,7,28, 10 ,8156,1641,1500,11297
7/28/2018,2018,7,28, 11 ,8524,1706,1562,11792
7/28/2018,2018,7,28, 12 ,8343,1690,1571,11604
7/28/2018,2018,7,28, 13 ,8258,1684,1590,11532
7/28/2018,2018,7,28, 14 ,8411,1753,1603,11767
7/28/2018,2018,7,28, 15 ,8289,1731,1608,11628
7/28/2018,2018,7,28, 16 ,8173,1681,1574,11428
7/28/2018,2018,7,28, 17 ,7978,1620,1483,11081
7/28/2018,2018,7,28, 18 ,7903,1643,1515,11061
7/28/2018,2018,7,28, 19 ,8284,1834,1626,11744
7/28/2018,2018,7,28, 20 ,8268,1775,1581,11624
7/28/2018,2018,7,28, 21 ,8179,1725,1528,11432
7/28/2018,2018,7,28, 22 ,7816,1620,1430,10866
7/28/2018,2018,7,28, 23 ,7429,1488,1314,10231
7/28/2018,2018,7,28, 24 ,7053,1402,1274,9729
7/29/2018,2018,7,29, 1 ,6710,1334,1153,9197
7/29/2018,2018,7,29, 2 ,6500,1282,1121,8903
7/29/2018,2018,7,29, 3 ,6332,1266,1101,8699
7/29/2018,2018,7,29, 4 ,6159,1233,1086,8478
7/29/2018,2018,7,29, 5 ,6062,1213,1093,8368
7/29/2018,2018,7,29, 6 ,5919,1190,1088,8197
7/29/2018,2018,7,29, 7 ,5977,1209,1058,8244
7/29/2018,2018,7,29, 8 ,6315,1274,1089,8678
7/29/2018,2018,7,29, 9 ,6837,1397,1125,9359
7/29/2018,2018,7,29, 10 ,7340,1504,1214,10058
7/29/2018,2018,7,29, 11 ,7592,1561,1283,10436
7/29/2018,2018,7,29, 12 ,7620,1551,1283,10454
7/29/2018,2018,7,29, 13 ,7632,1571,1291,10494
7/29/2018,2018,7,29, 14 ,7658,1590,1302,10550
7/29/2018,2018,7,29, 15 ,7510,1554,1283,10347
7/29/2018,2018,7,29, 16 ,7374,1520,1266,10160
7/29/2018,2018,7,29, 17 ,7220,1515,1299,10034
7/29/2018,2018,7,29, 18 ,7356,1597,1409,10362
7/29/2018,2018,7,29, 19 ,8031,1735,1563,11329
7/29/2018,2018,7,29, 20 ,8082,1695,1543,11320
7/29/2018,2018,7,29, 21 ,8013,1620,1475,11108
7/29/2018,2018,7,29, 22 ,7821,1503,1358,10682
7/29/2018,2018,7,29, 23 ,7350,1421,1266,10037
7/29/2018,2018,7,29, 24 ,6931,1343,1166,9440
7/30/2018,2018,7,30, 1 ,6628,1277,1144,9049
7/30/2018,2018,7,30, 2 ,6414,1252,1102,8768
7/30/2018,2018,7,30, 3 ,6271,1211,1070,8552
7/30/2018,2018,7,30, 4 ,6186,1209,1071,8466
7/30/2018,2018,7,30, 5 ,6336,1257,1127,8720
7/30/2018,2018,7,30, 6 ,6486,1303,1117,8906
7/30/2018,2018,7,30, 7 ,6726,1248,1069,9043
7/30/2018,2018,7,30, 8 ,7674,1449,1254,10377
7/30/2018,2018,7,30, 9 ,8649,1710,1488,11847
7/30/2018,2018,7,30, 10 ,9189,1839,1606,12634
7/30/2018,2018,7,30, 11 ,9549,1916,1664,13129
7/30/2018,2018,7,30, 12 ,9382,1863,1683,12928
7/30/2018,2018,7,30, 13 ,9329,1869,1680,12878
7/30/2018,2018,7,30, 14 ,9646,1965,1682,13293
7/30/2018,2018,7,30, 15 ,9563,1934,1617,13114
7/30/2018,2018,7,30, 16 ,9413,1901,1590,12904
7/30/2018,2018,7,30, 17 ,9024,1813,1560,12397
7/30/2018,2018,7,30, 18 ,8694,1807,1560,12061
7/30/2018,2018,7,30, 19 ,9111,1914,1625,12650
7/30/2018,2018,7,30, 20 ,9078,1858,1582,12518
7/30/2018,2018,7,30, 21 ,8896,1773,1523,12192
7/30/2018,2018,7,30, 22 ,8533,1639,1379,11551
7/30/2018,2018,7,30, 23 ,8093,1549,1277,10919
7/30/2018,2018,7,30, 24 ,7669,1432,1219,10320
7/31/2018,2018,7,31, 1 ,6628,1364,1168,9160
7/31/2018,2018,7,31, 2 ,6414,1328,1131,8873
7/31/2018,2018,7,31, 3 ,6271,1289,1094,8654
7/31/2018,2018,7,31, 4 ,6186,1268,1101,8555
7/31/2018,2018,7,31, 5 ,6336,1311,1161,8808
7/31/2018,2018,7,31, 6 ,6486,1334,1191,9011
7/31/2018,2018,7,31, 7 ,6726,1268,1100,9094
7/31/2018,2018,7,31, 8 ,7674,1452,1244,10370
7/31/2018,2018,7,31, 9 ,8649,1705,1459,11813
7/31/2018,2018,7,31, 10 ,9189,1820,1595,12604
7/31/2018,2018,7,31, 11 ,9549,1904,1658,13111
7/31/2018,2018,7,31, 12 ,9382,1841,1649,12872
7/31/2018,2018,7,31, 13 ,9329,1828,1632,12789
7/31/2018,2018,7,31, 14 ,9646,1877,1703,13226
7/31/2018,2018,7,31, 15 ,9563,1876,1647,13086
7/31/2018,2018,7,31, 16 ,9413,1825,1626,12864
7/31/2018,2018,7,31, 17 ,9024,1740,1584,12348
7/31/2018,2018,7,31, 18 ,8694,1737,1590,12021
7/31/2018,2018,7,31, 19 ,9111,1837,1634,12582
7/31/2018,2018,7,31, 20 ,9078,1781,1586,12445
7/31/2018,2018,7,31, 21 ,8896,1686,1502,12084
7/31/2018,2018,7,31, 22 ,8533,1565,1347,11445
7/31/2018,2018,7,31, 23 ,8093,1448,1260,10801
7/31/2018,2018,7,31, 24 ,7669,1373,1201,10243
8/1/2018,2018,8,1, 1 ,7397,1316,1149,9862
8/1/2018,2018,8,1, 2 ,7122,1274,1109,9505
8/1/2018,2018,8,1, 3 ,6965,1240,1084,9289
8/1/2018,2018,8,1, 4 ,6769,1226,1077,9072
8/1/2018,2018,8,1, 5 ,6902,1274,1127,9303
8/1/2018,2018,8,1, 6 ,6968,1298,1175,9441
8/1/2018,2018,8,1, 7 ,7064,1240,1103,9407
8/1/2018,2018,8,1, 8 ,7918,1417,1240,10575
8/1/2018,2018,8,1, 9 ,8767,1657,1429,11853
8/1/2018,2018,8,1, 10 ,9388,1772,1572,12732
8/1/2018,2018,8,1, 11 ,9718,1846,1674,13238
8/1/2018,2018,8,1, 12 ,9573,1794,1645,13012
8/1/2018,2018,8,1, 13 ,9512,1813,1636,12961
8/1/2018,2018,8,1, 14 ,9800,1874,1681,13355
8/1/2018,2018,8,1, 15 ,9737,1846,1645,13228
8/1/2018,2018,8,1, 16 ,9575,1820,1619,13014
8/1/2018,2018,8,1, 17 ,9097,1742,1553,12392
8/1/2018,2018,8,1, 18 ,8757,1761,1606,12124
8/1/2018,2018,8,1, 19 ,9217,1852,1632,12701
8/1/2018,2018,8,1, 20 ,9191,1795,1579,12565
8/1/2018,2018,8,1, 21 ,9074,1718,1529,12321
8/1/2018,2018,8,1, 22 ,8669,1581,1392,11642
8/1/2018,2018,8,1, 23 ,8235,1462,1284,10981
8/1/2018,2018,8,1, 24 ,7840,1391,1187,10418
8/2/2018,2018,8,2, 1 ,7510,1326,1143,9979
8/2/2018,2018,8,2, 2 ,7285,1292,1110,9687
8/2/2018,2018,8,2, 3 ,7075,1260,1098,9433
8/2/2018,2018,8,2, 4 ,6894,1249,1072,9215
8/2/2018,2018,8,2, 5 ,7015,1283,1129,9427
8/2/2018,2018,8,2, 6 ,6962,1327,1183,9472
8/2/2018,2018,8,2, 7 ,7100,1273,1102,9475
8/2/2018,2018,8,2, 8 ,8009,1452,1214,10675
8/2/2018,2018,8,2, 9 ,8762,1694,1419,11875
8/2/2018,2018,8,2, 10 ,9327,1789,1486,12602
8/2/2018,2018,8,2, 11 ,9633,1870,1537,13040
8/2/2018,2018,8,2, 12 ,9353,1791,1554,12698
8/2/2018,2018,8,2, 13 ,9310,1765,1530,12605
8/2/2018,2018,8,2, 14 ,9727,1850,1575,13152
8/2/2018,2018,8,2, 15 ,9617,1803,1552,12972
8/2/2018,2018,8,2, 16 ,9402,1768,1551,12721
8/2/2018,2018,8,2, 17 ,8966,1713,1496,12175
8/2/2018,2018,8,2, 18 ,8692,1748,1508,11948
8/2/2018,2018,8,2, 19 ,9075,1801,1475,12351
8/2/2018,2018,8,2, 20 ,8976,1741,1442,12159
8/2/2018,2018,8,2, 21 ,8882,1645,1370,11897
8/2/2018,2018,8,2, 22 ,8552,1529,1245,11326
8/2/2018,2018,8,2, 23 ,8078,1417,1142,10637
8/2/2018,2018,8,2, 24 ,7671,1344,1078,10093
8/3/2018,2018,8,3, 1 ,7409,1288,1021,9718
8/3/2018,2018,8,3, 2 ,7165,1251,1007,9423
8/3/2018,2018,8,3, 3 ,6892,1217,972,9081
8/3/2018,2018,8,3, 4 ,6794,1203,976,8973
8/3/2018,2018,8,3, 5 ,6904,1249,1031,9184
8/3/2018,2018,8,3, 6 ,6889,1300,1091,9280
8/3/2018,2018,8,3, 7 ,6947,1264,1028,9239
8/3/2018,2018,8,3, 8 ,7811,1414,1144,10369
8/3/2018,2018,8,3, 9 ,8715,1635,1336,11686
8/3/2018,2018,8,3, 10 ,9316,1743,1457,12516
8/3/2018,2018,8,3, 11 ,9589,1782,1515,12886
8/3/2018,2018,8,3, 12 ,9392,1719,1456,12567
8/3/2018,2018,8,3, 13 ,9352,1707,1464,12523
8/3/2018,2018,8,3, 14 ,9584,1778,1513,12875
8/3/2018,2018,8,3, 15 ,9545,1756,1478,12779
8/3/2018,2018,8,3, 16 ,9331,1729,1477,12537
8/3/2018,2018,8,3, 17 ,8849,1674,1445,11968
8/3/2018,2018,8,3, 18 ,8569,1700,1467,11736
8/3/2018,2018,8,3, 19 ,8967,1766,1542,12275
8/3/2018,2018,8,3, 20 ,8917,1709,1469,12095
8/3/2018,2018,8,3, 21 ,8715,1617,1416,11748
8/3/2018,2018,8,3, 22 ,8388,1483,1285,11156
8/3/2018,2018,8,3, 23 ,8031,1366,1188,10585
8/3/2018,2018,8,3, 24 ,7611,1300,1113,10024
8/4/2018,2018,8,4, 1 ,7272,1263,1053,9588
8/4/2018,2018,8,4, 2 ,7041,1225,1004,9270
8/4/2018,2018,8,4, 3 ,6840,1205,981,9026
8/4/2018,2018,8,4, 4 ,6672,1184,962,8818
8/4/2018,2018,8,4, 5 ,6609,1207,974,8790
8/4/2018,2018,8,4, 6 ,6527,1220,1038,8785
8/4/2018,2018,8,4, 7 ,6663,1242,1049,8954
8/4/2018,2018,8,4, 8 ,7339,1354,1126,9819
8/4/2018,2018,8,4, 9 ,8158,1505,1206,10869
8/4/2018,2018,8,4, 10 ,8709,1603,1322,11634
8/4/2018,2018,8,4, 11 ,8973,1666,1396,12035
8/4/2018,2018,8,4, 12 ,8786,1592,1379,11757
8/4/2018,2018,8,4, 13 ,8749,1588,1368,11705
8/4/2018,2018,8,4, 14 ,9015,1639,1451,12105
8/4/2018,2018,8,4, 15 ,8797,1611,1441,11849
8/4/2018,2018,8,4, 16 ,8429,1583,1412,11424
8/4/2018,2018,8,4, 17 ,8133,1554,1395,11082
8/4/2018,2018,8,4, 18 ,8066,1599,1425,11090
8/4/2018,2018,8,4, 19 ,8365,1682,1544,11591
8/4/2018,2018,8,4, 20 ,8397,1625,1487,11509
8/4/2018,2018,8,4, 21 ,8311,1550,1427,11288
8/4/2018,2018,8,4, 22 ,8045,1461,1357,10863
8/4/2018,2018,8,4, 23 ,7608,1333,1240,10181
8/4/2018,2018,8,4, 24 ,7210,1261,1155,9626
8/5/2018,2018,8,5, 1 ,6949,1208,1093,9250
8/5/2018,2018,8,5, 2 ,6725,1179,1040,8944
8/5/2018,2018,8,5, 3 ,6508,1158,1008,8674
8/5/2018,2018,8,5, 4 ,6328,1145,988,8461
8/5/2018,2018,8,5, 5 ,6205,1150,1003,8358
8/5/2018,2018,8,5, 6 ,6036,1147,1019,8202
8/5/2018,2018,8,5, 7 ,6101,1163,999,8263
8/5/2018,2018,8,5, 8 ,6448,1216,1036,8700
8/5/2018,2018,8,5, 9 ,6959,1288,1112,9359
8/5/2018,2018,8,5, 10 ,7426,1379,1222,10027
8/5/2018,2018,8,5, 11 ,7697,1419,1272,10388
8/5/2018,2018,8,5, 12 ,7711,1428,1289,10428
8/5/2018,2018,8,5, 13 ,7633,1443,1269,10345
8/5/2018,2018,8,5, 14 ,7658,1440,1300,10398
8/5/2018,2018,8,5, 15 ,7533,1424,1269,10226
8/5/2018,2018,8,5, 16 ,7278,1402,1263,9943
8/5/2018,2018,8,5, 17 ,7269,1430,1270,9969
8/5/2018,2018,8,5, 18 ,7377,1527,1366,10270
8/5/2018,2018,8,5, 19 ,7978,1636,1468,11082
8/5/2018,2018,8,5, 20 ,8082,1605,1464,11151
8/5/2018,2018,8,5, 21 ,7984,1515,1431,10930
8/5/2018,2018,8,5, 22 ,7740,1407,1318,10465
8/5/2018,2018,8,5, 23 ,7325,1313,1215,9853
8/5/2018,2018,8,5, 24 ,6913,1232,1064,9209
8/6/2018,2018,8,6, 1 ,6611,1191,1066,8868
8/6/2018,2018,8,6, 2 ,6390,1158,1021,8569
8/6/2018,2018,8,6, 3 ,6192,1133,1005,8330
8/6/2018,2018,8,6, 4 ,6108,1124,1004,8236
8/6/2018,2018,8,6, 5 ,6284,1167,1066,8517
8/6/2018,2018,8,6, 6 ,6404,1224,1134,8762
8/6/2018,2018,8,6, 7 ,6657,1203,1044,8904
8/6/2018,2018,8,6, 8 ,7688,1338,1207,10233
8/6/2018,2018,8,6, 9 ,8689,1553,1411,11653
8/6/2018,2018,8,6, 10 ,9282,1653,1539,12474
8/6/2018,2018,8,6, 11 ,9558,1727,1621,12906
8/6/2018,2018,8,6, 12 ,9334,1681,1567,12582
8/6/2018,2018,8,6, 13 ,9275,1686,1579,12540
8/6/2018,2018,8,6, 14 ,9643,1745,1640,13028
8/6/2018,2018,8,6, 15 ,9488,1720,1617,12825
8/6/2018,2018,8,6, 16 ,9281,1676,1569,12526
8/6/2018,2018,8,6, 17 ,8941,1621,1530,12092
8/6/2018,2018,8,6, 18 ,8716,1693,1572,11981
8/6/2018,2018,8,6, 19 ,8916,1783,1583,12282
8/6/2018,2018,8,6, 20 ,8831,1729,1533,12093
8/6/2018,2018,8,6, 21 ,8678,1636,1469,11783
8/6/2018,2018,8,6, 22 ,8248,1507,1331,11086
8/6/2018,2018,8,6, 23 ,7798,1402,1207,10407
8/6/2018,2018,8,6, 24 ,7423,1326,1143,9892
8/7/2018,2018,8,7, 1 ,7102,1278,1088,9468
8/7/2018,2018,8,7, 2 ,6866,1241,1065,9172
8/7/2018,2018,8,7, 3 ,6711,1215,1058,8984
8/7/2018,2018,8,7, 4 ,6582,1216,1029,8827
8/7/2018,2018,8,7, 5 ,6732,1268,1106,9106
8/7/2018,2018,8,7, 6 ,6857,1318,1154,9329
8/7/2018,2018,8,7, 7 ,6952,1267,1057,9276
8/7/2018,2018,8,7, 8 ,7922,1430,1209,10561
8/7/2018,2018,8,7, 9 ,8788,1651,1437,11876
8/7/2018,2018,8,7, 10 ,9243,1781,1546,12570
8/7/2018,2018,8,7, 11 ,9571,1846,1593,13010
8/7/2018,2018,8,7, 12 ,9239,1775,1556,12570
8/7/2018,2018,8,7, 13 ,9213,1794,1567,12574
8/7/2018,2018,8,7, 14 ,9580,1876,1641,13097
8/7/2018,2018,8,7, 15 ,9488,1837,1672,12997
8/7/2018,2018,8,7, 16 ,9263,1817,1624,12704
8/7/2018,2018,8,7, 17 ,8891,1736,1524,12151
8/7/2018,2018,8,7, 18 ,8686,1765,1584,12035
8/7/2018,2018,8,7, 19 ,8892,1842,1671,12405
8/7/2018,2018,8,7, 20 ,8892,1769,1619,12280
8/7/2018,2018,8,7, 21 ,8672,1699,1543,11914
8/7/2018,2018,8,7, 22 ,8241,1559,1393,11193
8/7/2018,2018,8,7, 23 ,7752,1452,1278,10482
8/7/2018,2018,8,7, 24 ,7299,1367,1210,9876
8/8/2018,2018,8,8, 1 ,7062,1324,1153,9539
8/8/2018,2018,8,8, 2 ,6839,1284,1101,9224
8/8/2018,2018,8,8, 3 ,6624,1242,1071,8937
8/8/2018,2018,8,8, 4 ,6596,1245,1080,8921
8/8/2018,2018,8,8, 5 ,6779,1285,1143,9207
8/8/2018,2018,8,8, 6 ,6855,1319,1190,9364
8/8/2018,2018,8,8, 7 ,7009,1282,1103,9394
8/8/2018,2018,8,8, 8 ,7807,1445,1266,10518
8/8/2018,2018,8,8, 9 ,8515,1649,1453,11617
8/8/2018,2018,8,8, 10 ,9086,1764,1608,12458
8/8/2018,2018,8,8, 11 ,9383,1823,1669,12875
8/8/2018,2018,8,8, 12 ,9183,1770,1630,12583
8/8/2018,2018,8,8, 13 ,9107,1760,1642,12509
8/8/2018,2018,8,8, 14 ,9467,1837,1687,12991
8/8/2018,2018,8,8, 15 ,9394,1830,1717,12941
8/8/2018,2018,8,8, 16 ,9203,1816,1663,12682
8/8/2018,2018,8,8, 17 ,8897,1733,1584,12214
8/8/2018,2018,8,8, 18 ,8662,1733,1594,11989
8/8/2018,2018,8,8, 19 ,8924,1837,1694,12455
8/8/2018,2018,8,8, 20 ,8838,1775,1632,12245
8/8/2018,2018,8,8, 21 ,8591,1691,1573,11855
8/8/2018,2018,8,8, 22 ,8167,1530,1437,11134
8/8/2018,2018,8,8, 23 ,7714,1418,1324,10456
8/8/2018,2018,8,8, 24 ,7335,1346,1225,9906
8/9/2018,2018,8,9, 1 ,7027,1285,1135,9447
8/9/2018,2018,8,9, 2 ,6869,1258,1102,9229
8/9/2018,2018,8,9, 3 ,6678,1236,1062,8976
8/9/2018,2018,8,9, 4 ,6654,1226,1049,8929
8/9/2018,2018,8,9, 5 ,6787,1274,1145,9206
8/9/2018,2018,8,9, 6 ,6903,1316,1201,9420
8/9/2018,2018,8,9, 7 ,7056,1266,1109,9431
8/9/2018,2018,8,9, 8 ,7836,1443,1280,10559
8/9/2018,2018,8,9, 9 ,8483,1689,1496,11668
8/9/2018,2018,8,9, 10 ,9044,1810,1625,12479
8/9/2018,2018,8,9, 11 ,9352,1867,1670,12889
8/9/2018,2018,8,9, 12 ,9092,1816,1662,12570
8/9/2018,2018,8,9, 13 ,8945,1790,1676,12411
8/9/2018,2018,8,9, 14 ,9179,1851,1767,12797
8/9/2018,2018,8,9, 15 ,9086,1784,1713,12583
8/9/2018,2018,8,9, 16 ,8971,1786,1672,12429
8/9/2018,2018,8,9, 17 ,8723,1737,1613,12073
8/9/2018,2018,8,9, 18 ,8572,1769,1673,12014
8/9/2018,2018,8,9, 19 ,8802,1852,1701,12355
8/9/2018,2018,8,9, 20 ,8673,1780,1638,12091
8/9/2018,2018,8,9, 21 ,8534,1691,1572,11797
8/9/2018,2018,8,9, 22 ,8114,1558,1453,11125
8/9/2018,2018,8,9, 23 ,7667,1446,1355,10468
8/9/2018,2018,8,9, 24 ,7335,1376,1262,9973
8/10/2018,2018,8,10, 1 ,6962,1321,1221,9504
8/10/2018,2018,8,10, 2 ,6717,1285,1176,9178
8/10/2018,2018,8,10, 3 ,6551,1246,1140,8937
8/10/2018,2018,8,10, 4 ,6481,1242,1132,8855
8/10/2018,2018,8,10, 5 ,6644,1286,1179,9109
8/10/2018,2018,8,10, 6 ,6836,1322,1210,9368
8/10/2018,2018,8,10, 7 ,6951,1270,1104,9325
8/10/2018,2018,8,10, 8 ,7782,1417,1297,10496
8/10/2018,2018,8,10, 9 ,8516,1673,1497,11686
8/10/2018,2018,8,10, 10 ,9061,1785,1618,12464
8/10/2018,2018,8,10, 11 ,9212,1876,1710,12798
8/10/2018,2018,8,10, 12 ,8851,1819,1700,12370
8/10/2018,2018,8,10, 13 ,8840,1808,1711,12359
8/10/2018,2018,8,10, 14 ,9066,1882,1759,12707
8/10/2018,2018,8,10, 15 ,8885,1877,1751,12513
8/10/2018,2018,8,10, 16 ,8838,1825,1708,12371
8/10/2018,2018,8,10, 17 ,8606,1754,1624,11984
8/10/2018,2018,8,10, 18 ,8482,1761,1650,11893
8/10/2018,2018,8,10, 19 ,8673,1826,1700,12199
8/10/2018,2018,8,10, 20 ,8532,1753,1655,11940
8/10/2018,2018,8,10, 21 ,8334,1639,1572,11545
8/10/2018,2018,8,10, 22 ,7924,1505,1479,10908
8/10/2018,2018,8,10, 23 ,7453,1389,1369,10211
8/10/2018,2018,8,10, 24 ,7203,1321,1303,9827
8/11/2018,2018,8,11, 1 ,6902,1266,1253,9421
8/11/2018,2018,8,11, 2 ,6728,1239,1192,9159
8/11/2018,2018,8,11, 3 ,6573,1213,1139,8925
8/11/2018,2018,8,11, 4 ,6440,1201,1149,8790
8/11/2018,2018,8,11, 5 ,6388,1220,1152,8760
8/11/2018,2018,8,11, 6 ,6445,1235,1158,8838
8/11/2018,2018,8,11, 7 ,6582,1233,1156,8971
8/11/2018,2018,8,11, 8 ,7158,1365,1239,9762
8/11/2018,2018,8,11, 9 ,7755,1554,1368,10677
8/11/2018,2018,8,11, 10 ,8209,1681,1558,11448
8/11/2018,2018,8,11, 11 ,8311,1747,1594,11652
8/11/2018,2018,8,11, 12 ,7955,1712,1571,11238
8/11/2018,2018,8,11, 13 ,7855,1736,1597,11188
8/11/2018,2018,8,11, 14 ,7921,1759,1665,11345
8/11/2018,2018,8,11, 15 ,7778,1728,1629,11135
8/11/2018,2018,8,11, 16 ,7626,1681,1574,10881
8/11/2018,2018,8,11, 17 ,7589,1643,1488,10720
8/11/2018,2018,8,11, 18 ,7629,1691,1576,10896
8/11/2018,2018,8,11, 19 ,7826,1801,1666,11293
8/11/2018,2018,8,11, 20 ,7706,1754,1586,11046
8/11/2018,2018,8,11, 21 ,7444,1696,1573,10713
8/11/2018,2018,8,11, 22 ,7096,1613,1501,10210
8/11/2018,2018,8,11, 23 ,6878,1511,1388,9777
8/11/2018,2018,8,11, 24 ,6472,1399,1275,9146
8/12/2018,2018,8,12, 1 ,6273,1339,1204,8816
8/12/2018,2018,8,12, 2 ,6117,1292,1152,8561
8/12/2018,2018,8,12, 3 ,5975,1264,1111,8350
8/12/2018,2018,8,12, 4 ,5885,1238,1068,8191
8/12/2018,2018,8,12, 5 ,5899,1233,1087,8219
8/12/2018,2018,8,12, 6 ,5804,1206,1078,8088
8/12/2018,2018,8,12, 7 ,5891,1208,1079,8178
8/12/2018,2018,8,12, 8 ,6186,1269,1118,8573
8/12/2018,2018,8,12, 9 ,6582,1379,1231,9192
8/12/2018,2018,8,12, 10 ,7008,1466,1315,9789
8/12/2018,2018,8,12, 11 ,7143,1509,1375,10027
8/12/2018,2018,8,12, 12 ,7017,1498,1379,9894
8/12/2018,2018,8,12, 13 ,6762,1489,1391,9642
8/12/2018,2018,8,12, 14 ,6751,1502,1410,9663
8/12/2018,2018,8,12, 15 ,6683,1503,1380,9566
8/12/2018,2018,8,12, 16 ,6723,1465,1352,9540
8/12/2018,2018,8,12, 17 ,6823,1463,1342,9628
8/12/2018,2018,8,12, 18 ,7155,1583,1417,10155
8/12/2018,2018,8,12, 19 ,7454,1721,1566,10741
8/12/2018,2018,8,12, 20 ,7483,1684,1545,10712
8/12/2018,2018,8,12, 21 ,7180,1632,1492,10304
8/12/2018,2018,8,12, 22 ,6792,1535,1391,9718
8/12/2018,2018,8,12, 23 ,6417,1431,1293,9141
8/12/2018,2018,8,12, 24 ,6185,1346,1202,8733
8/13/2018,2018,8,13, 1 ,5865,1284,1147,8296
8/13/2018,2018,8,13, 2 ,5694,1248,1096,8038
8/13/2018,2018,8,13, 3 ,5596,1221,1063,7880
8/13/2018,2018,8,13, 4 ,5574,1199,1052,7825
8/13/2018,2018,8,13, 5 ,5781,1255,1117,8153
8/13/2018,2018,8,13, 6 ,6074,1294,1157,8525
8/13/2018,2018,8,13, 7 ,6430,1248,1073,8751
8/13/2018,2018,8,13, 8 ,7177,1438,1247,9862
8/13/2018,2018,8,13, 9 ,7792,1701,1505,10998
8/13/2018,2018,8,13, 10 ,8361,1826,1641,11828
8/13/2018,2018,8,13, 11 ,8665,1878,1672,12215
8/13/2018,2018,8,13, 12 ,8463,1856,1657,11976
8/13/2018,2018,8,13, 13 ,8287,1846,1715,11848
8/13/2018,2018,8,13, 14 ,8517,1932,1771,12220
8/13/2018,2018,8,13, 15 ,8486,1917,1738,12141
8/13/2018,2018,8,13, 16 ,8432,1884,1716,12032
8/13/2018,2018,8,13, 17 ,8331,1789,1664,11784
8/13/2018,2018,8,13, 18 ,8248,1795,1659,11702
8/13/2018,2018,8,13, 19 ,8371,1898,1719,11988
8/13/2018,2018,8,13, 20 ,7986,1845,1684,11515
8/13/2018,2018,8,13, 21 ,7698,1762,1569,11029
8/13/2018,2018,8,13, 22 ,7356,1655,1422,10433
8/13/2018,2018,8,13, 23 ,6854,1536,1336,9726
8/13/2018,2018,8,13, 24 ,6597,1449,1252,9298
8/14/2018,2018,8,14, 1 ,6388,1390,1115,8893
8/14/2018,2018,8,14, 2 ,6236,1332,1071,8639
8/14/2018,2018,8,14, 3 ,6098,1295,1039,8432
8/14/2018,2018,8,14, 4 ,6062,1284,1038,8384
8/14/2018,2018,8,14, 5 ,6293,1315,1063,8671
8/14/2018,2018,8,14, 6 ,6446,1341,1217,9004
8/14/2018,2018,8,14, 7 ,6714,1287,1173,9174
8/14/2018,2018,8,14, 8 ,7462,1486,1310,10258
8/14/2018,2018,8,14, 9 ,8085,1713,1516,11314
8/14/2018,2018,8,14, 10 ,8677,1820,1688,12185
8/14/2018,2018,8,14, 11 ,8934,1893,1745,12572
8/14/2018,2018,8,14, 12 ,8733,1848,1705,12286
8/14/2018,2018,8,14, 13 ,8649,1830,1704,12183
8/14/2018,2018,8,14, 14 ,8875,1911,1751,12537
8/14/2018,2018,8,14, 15 ,8392,1913,1734,12039
8/14/2018,2018,8,14, 16 ,8434,1891,1677,12002
8/14/2018,2018,8,14, 17 ,8283,1802,1656,11741
8/14/2018,2018,8,14, 18 ,8188,1791,1689,11668
8/14/2018,2018,8,14, 19 ,8465,1920,1759,12144
8/14/2018,2018,8,14, 20 ,8415,1858,1724,11997
8/14/2018,2018,8,14, 21 ,8181,1767,1655,11603
8/14/2018,2018,8,14, 22 ,7784,1640,1520,10944
8/14/2018,2018,8,14, 23 ,7389,1514,1397,10300
8/14/2018,2018,8,14, 24 ,7016,1432,1296,9744
8/15/2018,2018,8,15, 1 ,6765,1352,1277,9394
8/15/2018,2018,8,15, 2 ,6568,1311,1207,9086
8/15/2018,2018,8,15, 3 ,6447,1275,1175,8897
8/15/2018,2018,8,15, 4 ,6345,1264,1162,8771
8/15/2018,2018,8,15, 5 ,6553,1301,1209,9063
8/15/2018,2018,8,15, 6 ,6650,1337,1228,9215
8/15/2018,2018,8,15, 7 ,6940,1276,1143,9359
8/15/2018,2018,8,15, 8 ,7690,1444,1332,10466
8/15/2018,2018,8,15, 9 ,8493,1700,1556,11749
8/15/2018,2018,8,15, 10 ,8984,1815,1670,12469
8/15/2018,2018,8,15, 11 ,9360,1910,1742,13012
8/15/2018,2018,8,15, 12 ,9128,1870,1723,12721
8/15/2018,2018,8,15, 13 ,9068,1869,1751,12688
8/15/2018,2018,8,15, 14 ,9448,1959,1821,13228
8/15/2018,2018,8,15, 15 ,9345,1933,1786,13064
8/15/2018,2018,8,15, 16 ,9202,1887,1755,12844
8/15/2018,2018,8,15, 17 ,8816,1788,1582,12186
8/15/2018,2018,8,15, 18 ,8621,1795,1709,12125
8/15/2018,2018,8,15, 19 ,8911,1901,1774,12586
8/15/2018,2018,8,15, 20 ,8807,1848,1720,12375
8/15/2018,2018,8,15, 21 ,8565,1775,1656,11996
8/15/2018,2018,8,15, 22 ,8244,1655,1536,11435
8/15/2018,2018,8,15, 23 ,7775,1542,1423,10740
8/15/2018,2018,8,15, 24 ,7390,1453,1297,10140
8/16/2018,2018,8,16, 1 ,7148,1391,1265,9804
8/16/2018,2018,8,16, 2 ,6901,1350,1228,9479
8/16/2018,2018,8,16, 3 ,6728,1314,1198,9240
8/16/2018,2018,8,16, 4 ,6686,1290,1176,9152
8/16/2018,2018,8,16, 5 ,6787,1325,1228,9340
8/16/2018,2018,8,16, 6 ,6846,1343,1250,9439
8/16/2018,2018,8,16, 7 ,7036,1294,1159,9489
8/16/2018,2018,8,16, 8 ,7929,1474,1303,10706
8/16/2018,2018,8,16, 9 ,8747,1716,1508,11971
8/16/2018,2018,8,16, 10 ,9237,1837,1635,12709
8/16/2018,2018,8,16, 11 ,9490,1893,1704,13087
8/16/2018,2018,8,16, 12 ,9326,1838,1666,12830
8/16/2018,2018,8,16, 13 ,9272,1849,1637,12758
8/16/2018,2018,8,16, 14 ,9597,1940,1704,13241
8/16/2018,2018,8,16, 15 ,9525,1907,1694,13126
8/16/2018,2018,8,16, 16 ,9394,1880,1680,12954
8/16/2018,2018,8,16, 17 ,9031,1799,1516,12346
8/16/2018,2018,8,16, 18 ,8819,1820,1671,12310
8/16/2018,2018,8,16, 19 ,9117,1891,1694,12702
8/16/2018,2018,8,16, 20 ,8949,1831,1676,12456
8/16/2018,2018,8,16, 21 ,8832,1763,1612,12207
8/16/2018,2018,8,16, 22 ,8344,1635,1490,11469
8/16/2018,2018,8,16, 23 ,7810,1524,1373,10707
8/16/2018,2018,8,16, 24 ,7422,1440,1295,10157
8/17/2018,2018,8,17, 1 ,7061,1374,1243,9678
8/17/2018,2018,8,17, 2 ,6785,1334,1202,9321
8/17/2018,2018,8,17, 3 ,6639,1295,1170,9104
8/17/2018,2018,8,17, 4 ,6603,1276,1146,9025
8/17/2018,2018,8,17, 5 ,6827,1303,1190,9320
8/17/2018,2018,8,17, 6 ,6872,1328,1161,9361
8/17/2018,2018,8,17, 7 ,6991,1274,1152,9417
8/17/2018,2018,8,17, 8 ,7808,1425,1266,10499
8/17/2018,2018,8,17, 9 ,8781,1679,1413,11873
8/17/2018,2018,8,17, 10 ,9212,1804,1524,12540
8/17/2018,2018,8,17, 11 ,9549,1865,1547,12961
8/17/2018,2018,8,17, 12 ,9256,1829,1557,12642
8/17/2018,2018,8,17, 13 ,9233,1821,1542,12596
8/17/2018,2018,8,17, 14 ,9505,1883,1606,12994
8/17/2018,2018,8,17, 15 ,9489,1870,1592,12951
8/17/2018,2018,8,17, 16 ,9336,1836,1567,12739
8/17/2018,2018,8,17, 17 ,8932,1769,1529,12230
8/17/2018,2018,8,17, 18 ,8778,1785,1630,12193
8/17/2018,2018,8,17, 19 ,9023,1833,1629,12485
8/17/2018,2018,8,17, 20 ,8815,1772,1553,12140
8/17/2018,2018,8,17, 21 ,8680,1713,1497,11890
8/17/2018,2018,8,17, 22 ,8309,1594,1378,11281
8/17/2018,2018,8,17, 23 ,7845,1486,1278,10609
8/17/2018,2018,8,17, 24 ,7441,1393,1247,10081
8/18/2018,2018,8,18, 1 ,7048,1337,1165,9550
8/18/2018,2018,8,18, 2 ,6829,1294,1110,9233
8/18/2018,2018,8,18, 3 ,6675,1258,1076,9009
8/18/2018,2018,8,18, 4 ,6482,1235,1068,8785
8/18/2018,2018,8,18, 5 ,6518,1244,1102,8864
8/18/2018,2018,8,18, 6 ,6427,1256,1086,8769
8/18/2018,2018,8,18, 7 ,6656,1250,1097,9003
8/18/2018,2018,8,18, 8 ,7209,1370,1190,9769
8/18/2018,2018,8,18, 9 ,7843,1531,1349,10723
8/18/2018,2018,8,18, 10 ,8388,1643,1441,11472
8/18/2018,2018,8,18, 11 ,8547,1682,1526,11755
8/18/2018,2018,8,18, 12 ,8300,1624,1529,11453
8/18/2018,2018,8,18, 13 ,8261,1610,1519,11390
8/18/2018,2018,8,18, 14 ,8364,1609,1564,11537
8/18/2018,2018,8,18, 15 ,8287,1608,1556,11451
8/18/2018,2018,8,18, 16 ,8126,1565,1521,11212
8/18/2018,2018,8,18, 17 ,7839,1558,1481,10878
8/18/2018,2018,8,18, 18 ,7921,1643,1591,11155
8/18/2018,2018,8,18, 19 ,8370,1734,1624,11728
8/18/2018,2018,8,18, 20 ,8300,1698,1577,11575
8/18/2018,2018,8,18, 21 ,8181,1635,1543,11359
8/18/2018,2018,8,18, 22 ,7869,1532,1449,10850
8/18/2018,2018,8,18, 23 ,7439,1419,1309,10167
8/18/2018,2018,8,18, 24 ,7111,1334,1259,9704
8/19/2018,2018,8,19, 1 ,6746,1278,1202,9226
8/19/2018,2018,8,19, 2 ,6542,1237,1172,8951
8/19/2018,2018,8,19, 3 ,6385,1200,1131,8716
8/19/2018,2018,8,19, 4 ,6274,1180,1097,8551
8/19/2018,2018,8,19, 5 ,6154,1180,1094,8428
8/19/2018,2018,8,19, 6 ,6065,1160,1110,8335
8/19/2018,2018,8,19, 7 ,6143,1180,1085,8408
8/19/2018,2018,8,19, 8 ,6418,1246,1117,8781
8/19/2018,2018,8,19, 9 ,6881,1333,1207,9421
8/19/2018,2018,8,19, 10 ,7352,1452,1304,10108
8/19/2018,2018,8,19, 11 ,7691,1510,1346,10547
8/19/2018,2018,8,19, 12 ,7646,1517,1361,10524
8/19/2018,2018,8,19, 13 ,7596,1532,1350,10478
8/19/2018,2018,8,19, 14 ,7586,1534,1377,10497
8/19/2018,2018,8,19, 15 ,7491,1537,1352,10380
8/19/2018,2018,8,19, 16 ,7320,1503,1330,10153
8/19/2018,2018,8,19, 17 ,7252,1493,1343,10088
8/19/2018,2018,8,19, 18 ,7524,1580,1465,10569
8/19/2018,2018,8,19, 19 ,7937,1735,1539,11211
8/19/2018,2018,8,19, 20 ,7904,1705,1515,11124
8/19/2018,2018,8,19, 21 ,7881,1651,1441,10973
8/19/2018,2018,8,19, 22 ,7521,1553,1325,10399
8/19/2018,2018,8,19, 23 ,7120,1439,1231,9790
8/19/2018,2018,8,19, 24 ,6809,1341,1216,9366
8/20/2018,2018,8,20, 1 ,6383,1278,1130,8791
8/20/2018,2018,8,20, 2 ,6220,1223,1082,8525
8/20/2018,2018,8,20, 3 ,6095,1188,1061,8344
8/20/2018,2018,8,20, 4 ,5998,1167,1036,8201
8/20/2018,2018,8,20, 5 ,6089,1204,1083,8376
8/20/2018,2018,8,20, 6 ,6340,1252,1125,8717
8/20/2018,2018,8,20, 7 ,6551,1208,1049,8808
8/20/2018,2018,8,20, 8 ,7323,1398,1223,9944
8/20/2018,2018,8,20, 9 ,8241,1656,1447,11344
8/20/2018,2018,8,20, 10 ,8679,1777,1579,12035
8/20/2018,2018,8,20, 11 ,8913,1852,1620,12385
8/20/2018,2018,8,20, 12 ,8631,1812,1634,12077
8/20/2018,2018,8,20, 13 ,8496,1828,1615,11939
8/20/2018,2018,8,20, 14 ,8758,1915,1714,12387
8/20/2018,2018,8,20, 15 ,8653,1884,1689,12226
8/20/2018,2018,8,20, 16 ,8564,1858,1648,12070
8/20/2018,2018,8,20, 17 ,8350,1766,1572,11688
8/20/2018,2018,8,20, 18 ,8197,1786,1611,11594
8/20/2018,2018,8,20, 19 ,8479,1882,1686,12047
8/20/2018,2018,8,20, 20 ,8321,1823,1627,11771
8/20/2018,2018,8,20, 21 ,8037,1749,1554,11340
8/20/2018,2018,8,20, 22 ,7747,1644,1438,10829
8/20/2018,2018,8,20, 23 ,7361,1520,1304,10185
8/20/2018,2018,8,20, 24 ,6978,1431,1206,9615
8/21/2018,2018,8,21, 1 ,6724,1373,1170,9267
8/21/2018,2018,8,21, 2 ,6504,1317,1140,8961
8/21/2018,2018,8,21, 3 ,6383,1275,1099,8757
8/21/2018,2018,8,21, 4 ,6203,1241,1074,8518
8/21/2018,2018,8,21, 5 ,6177,1246,1098,8521
8/21/2018,2018,8,21, 6 ,6142,1238,1098,8478
8/21/2018,2018,8,21, 7 ,6236,1228,1066,8530
8/21/2018,2018,8,21, 8 ,6651,1331,1141,9123
8/21/2018,2018,8,21, 9 ,7133,1480,1302,9915
8/21/2018,2018,8,21, 10 ,7696,1612,1430,10738
8/21/2018,2018,8,21, 11 ,8009,1695,1509,11213
8/21/2018,2018,8,21, 12 ,7878,1666,1485,11029
8/21/2018,2018,8,21, 13 ,7884,1686,1511,11081
8/21/2018,2018,8,21, 14 ,7953,1707,1560,11220
8/21/2018,2018,8,21, 15 ,7895,1721,1543,11159
8/21/2018,2018,8,21, 16 ,7838,1684,1507,11029
8/21/2018,2018,8,21, 17 ,7638,1632,1473,10743
8/21/2018,2018,8,21, 18 ,7726,1713,1587,11026
8/21/2018,2018,8,21, 19 ,8216,1830,1631,11677
8/21/2018,2018,8,21, 20 ,8179,1792,1580,11551
8/21/2018,2018,8,21, 21 ,7988,1751,1527,11266
8/21/2018,2018,8,21, 22 ,7689,1623,1413,10725
8/21/2018,2018,8,21, 23 ,7304,1510,1325,10139
8/21/2018,2018,8,21, 24 ,6936,1423,1233,9592
8/22/2018,2018,8,22, 1 ,6663,1367,1178,9208
8/22/2018,2018,8,22, 2 ,6430,1316,1131,8877
8/22/2018,2018,8,22, 3 ,6331,1278,1106,8715
8/22/2018,2018,8,22, 4 ,6320,1261,1087,8668
8/22/2018,2018,8,22, 5 ,6453,1298,1131,8882
8/22/2018,2018,8,22, 6 ,6611,1331,1157,9099
8/22/2018,2018,8,22, 7 ,6833,1273,1091,9197
8/22/2018,2018,8,22, 8 ,7737,1480,1244,10461
8/22/2018,2018,8,22, 9 ,8652,1723,1491,11866
8/22/2018,2018,8,22, 10 ,9247,1848,1632,12727
8/22/2018,2018,8,22, 11 ,9531,1904,1705,13140
8/22/2018,2018,8,22, 12 ,9291,1859,1682,12832
8/22/2018,2018,8,22, 13 ,9254,1874,1694,12822
8/22/2018,2018,8,22, 14 ,9566,1970,1754,13290
8/22/2018,2018,8,22, 15 ,9477,1949,1695,13121
8/22/2018,2018,8,22, 16 ,9299,1910,1705,12914
8/22/2018,2018,8,22, 17 ,8929,1807,1589,12325
8/22/2018,2018,8,22, 18 ,8678,1815,1658,12151
8/22/2018,2018,8,22, 19 ,9009,1930,1690,12629
8/22/2018,2018,8,22, 20 ,8865,1877,1647,12389
8/22/2018,2018,8,22, 21 ,8740,1788,1582,12110
8/22/2018,2018,8,22, 22 ,8330,1662,1443,11435
8/22/2018,2018,8,22, 23 ,7891,1554,1319,10764
8/22/2018,2018,8,22, 24 ,7513,1476,1236,10225
8/23/2018,2018,8,23, 1 ,7236,1405,1188,9829
8/23/2018,2018,8,23, 2 ,7003,1343,1144,9490
8/23/2018,2018,8,23, 3 ,6785,1303,1117,9205
8/23/2018,2018,8,23, 4 ,6741,1277,1108,9126
8/23/2018,2018,8,23, 5 ,6911,1326,1171,9408
8/23/2018,2018,8,23, 6 ,6964,1352,1190,9506
8/23/2018,2018,8,23, 7 ,7090,1299,1116,9505
8/23/2018,2018,8,23, 8 ,8010,1495,1298,10803
8/23/2018,2018,8,23, 9 ,8837,1753,1526,12116
8/23/2018,2018,8,23, 10 ,9335,1869,1669,12873
8/23/2018,2018,8,23, 11 ,9599,1935,1737,13271
8/23/2018,2018,8,23, 12 ,9352,1908,1729,12989
8/23/2018,2018,8,23, 13 ,9330,1911,1725,12966
8/23/2018,2018,8,23, 14 ,9710,2015,1787,13512
8/23/2018,2018,8,23, 15 ,9632,1988,1744,13364
8/23/2018,2018,8,23, 16 ,9462,1944,1693,13099
8/23/2018,2018,8,23, 17 ,9037,1842,1628,12507
8/23/2018,2018,8,23, 18 ,8769,1845,1675,12289
8/23/2018,2018,8,23, 19 ,9046,1964,1698,12708
8/23/2018,2018,8,23, 20 ,8911,1916,1653,12480
8/23/2018,2018,8,23, 21 ,8763,1839,1542,12144
8/23/2018,2018,8,23, 22 ,8412,1709,1397,11518
8/23/2018,2018,8,23, 23 ,8305,1586,1302,11193
8/23/2018,2018,8,23, 24 ,7609,1493,1223,10325
8/24/2018,2018,8,24, 1 ,7295,1431,1172,9898
8/24/2018,2018,8,24, 2 ,7134,1380,1140,9654
8/24/2018,2018,8,24, 3 ,6927,1342,1104,9373
8/24/2018,2018,8,24, 4 ,6864,1316,1091,9271
8/24/2018,2018,8,24, 5 ,6962,1351,1137,9450
8/24/2018,2018,8,24, 6 ,7003,1367,1193,9563
8/24/2018,2018,8,24, 7 ,7196,1329,1122,9647
8/24/2018,2018,8,24, 8 ,7973,1510,1269,10752
8/24/2018,2018,8,24, 9 ,8860,1757,1489,12106
8/24/2018,2018,8,24, 10 ,9385,1895,1620,12900
8/24/2018,2018,8,24, 11 ,9567,1949,1673,13189
8/24/2018,2018,8,24, 12 ,9293,1918,1647,12858
8/24/2018,2018,8,24, 13 ,9230,1902,1654,12786
8/24/2018,2018,8,24, 14 ,9528,2000,1696,13224
8/24/2018,2018,8,24, 15 ,9459,1972,1679,13110
8/24/2018,2018,8,24, 16 ,9303,1928,1643,12874
8/24/2018,2018,8,24, 17 ,8873,1820,1567,12260
8/24/2018,2018,8,24, 18 ,8680,1845,1630,12155
8/24/2018,2018,8,24, 19 ,8907,1917,1635,12459
8/24/2018,2018,8,24, 20 ,8840,1858,1557,12255
8/24/2018,2018,8,24, 21 ,8700,1786,1466,11952
8/24/2018,2018,8,24, 22 ,8300,1671,1318,11289
8/24/2018,2018,8,24, 23 ,7905,1550,1208,10663
8/24/2018,2018,8,24, 24 ,7589,1458,1140,10187
8/25/2018,2018,8,25, 1 ,7333,1414,1112,9859
8/25/2018,2018,8,25, 2 ,7081,1371,1066,9518
8/25/2018,2018,8,25, 3 ,6905,1335,1039,9279
8/25/2018,2018,8,25, 4 ,6761,1311,1024,9096
8/25/2018,2018,8,25, 5 ,6701,1314,1025,9040
8/25/2018,2018,8,25, 6 ,6727,1310,1091,9128
8/25/2018,2018,8,25, 7 ,6793,1309,1071,9173
8/25/2018,2018,8,25, 8 ,7266,1425,1159,9850
8/25/2018,2018,8,25, 9 ,7863,1609,1304,10776
8/25/2018,2018,8,25, 10 ,8441,1727,1391,11559
8/25/2018,2018,8,25, 11 ,8753,1789,1486,12028
8/25/2018,2018,8,25, 12 ,8512,1744,1471,11727
8/25/2018,2018,8,25, 13 ,8440,1763,1474,11677
8/25/2018,2018,8,25, 14 ,8603,1853,1506,11962
8/25/2018,2018,8,25, 15 ,8470,1765,1485,11720
8/25/2018,2018,8,25, 16 ,8302,1730,1455,11487
8/25/2018,2018,8,25, 17 ,8052,1663,1455,11170
8/25/2018,2018,8,25, 18 ,8134,1741,1542,11417
8/25/2018,2018,8,25, 19 ,8404,1816,1529,11749
8/25/2018,2018,8,25, 20 ,8383,1765,1447,11595
8/25/2018,2018,8,25, 21 ,8268,1718,1386,11372
8/25/2018,2018,8,25, 22 ,8027,1635,1279,10941
8/25/2018,2018,8,25, 23 ,7665,1499,1184,10348
8/25/2018,2018,8,25, 24 ,7336,1423,1105,9864
8/26/2018,2018,8,26, 1 ,7110,1363,1070,9543
8/26/2018,2018,8,26, 2 ,6870,1316,1020,9206
8/26/2018,2018,8,26, 3 ,6709,1278,1002,8989
8/26/2018,2018,8,26, 4 ,6569,1253,986,8808
8/26/2018,2018,8,26, 5 ,6401,1241,1000,8642
8/26/2018,2018,8,26, 6 ,6255,1212,1012,8479
8/26/2018,2018,8,26, 7 ,6241,1203,1028,8472
8/26/2018,2018,8,26, 8 ,6490,1252,1064,8806
8/26/2018,2018,8,26, 9 ,6986,1357,1155,9498
8/26/2018,2018,8,26, 10 ,7404,1436,1257,10097
8/26/2018,2018,8,26, 11 ,7585,1493,1339,10417
8/26/2018,2018,8,26, 12 ,7451,1508,1358,10317
8/26/2018,2018,8,26, 13 ,7391,1497,1350,10238
8/26/2018,2018,8,26, 14 ,7347,1506,1356,10209
8/26/2018,2018,8,26, 15 ,7247,1493,1330,10070
8/26/2018,2018,8,26, 16 ,7188,1471,1317,9976
8/26/2018,2018,8,26, 17 ,7123,1481,1310,9914
8/26/2018,2018,8,26, 18 ,7367,1600,1440,10407
8/26/2018,2018,8,26, 19 ,7861,1715,1484,11060
8/26/2018,2018,8,26, 20 ,7848,1673,1432,10953
8/26/2018,2018,8,26, 21 ,7671,1608,1386,10665
8/26/2018,2018,8,26, 22 ,7389,1511,1270,10170
8/26/2018,2018,8,26, 23 ,7138,1426,1183,9747
8/26/2018,2018,8,26, 24 ,6828,1339,1108,9275
8/27/2018,2018,8,27, 1 ,6552,1282,1056,8890
8/27/2018,2018,8,27, 2 ,6233,1237,1014,8484
8/27/2018,2018,8,27, 3 ,6128,1203,983,8314
8/27/2018,2018,8,27, 4 ,5960,1178,979,8117
8/27/2018,2018,8,27, 5 ,5927,1181,995,8103
8/27/2018,2018,8,27, 6 ,5951,1186,1010,8147
8/27/2018,2018,8,27, 7 ,6000,1195,1038,8233
8/27/2018,2018,8,27, 8 ,6407,1292,1104,8803
8/27/2018,2018,8,27, 9 ,6884,1457,1255,9596
8/27/2018,2018,8,27, 10 ,7512,1556,1380,10448
8/27/2018,2018,8,27, 11 ,7839,1626,1477,10942
8/27/2018,2018,8,27, 12 ,7821,1621,1481,10923
8/27/2018,2018,8,27, 13 ,7812,1635,1444,10891
8/27/2018,2018,8,27, 14 ,7979,1677,1499,11155
8/27/2018,2018,8,27, 15 ,7929,1644,1489,11062
8/27/2018,2018,8,27, 16 ,7807,1613,1463,10883
8/27/2018,2018,8,27, 17 ,7610,1588,1439,10637
8/27/2018,2018,8,27, 18 ,7755,1694,1552,11001
8/27/2018,2018,8,27, 19 ,8228,1797,1553,11578
8/27/2018,2018,8,27, 20 ,8185,1757,1520,11462
8/27/2018,2018,8,27, 21 ,8113,1685,1409,11207
8/27/2018,2018,8,27, 22 ,7831,1570,1314,10715
8/27/2018,2018,8,27, 23 ,7427,1466,1197,10090
8/27/2018,2018,8,27, 24 ,7088,1378,1132,9598
8/28/2018,2018,8,28, 1 ,6748,1323,1072,9143
8/28/2018,2018,8,28, 2 ,6530,1283,1031,8844
8/28/2018,2018,8,28, 3 ,6371,1255,1017,8643
8/28/2018,2018,8,28, 4 ,6324,1234,1004,8562
8/28/2018,2018,8,28, 5 ,6426,1278,1067,8771
8/28/2018,2018,8,28, 6 ,6614,1315,1144,9073
8/28/2018,2018,8,28, 7 ,6836,1267,1030,9133
8/28/2018,2018,8,28, 8 ,7844,1457,1190,10491
8/28/2018,2018,8,28, 9 ,8564,1700,1470,11734
8/28/2018,2018,8,28, 10 ,9192,1839,1627,12658
8/28/2018,2018,8,28, 11 ,9507,1916,1683,13106
8/28/2018,2018,8,28, 12 ,9358,1883,1669,12910
8/28/2018,2018,8,28, 13 ,9368,1866,1677,12911
8/28/2018,2018,8,28, 14 ,9681,1945,1757,13383
8/28/2018,2018,8,28, 15 ,9564,1931,1745,13240
8/28/2018,2018,8,28, 16 ,9430,1867,1688,12985
8/28/2018,2018,8,28, 17 ,8990,1779,1594,12363
8/28/2018,2018,8,28, 18 ,8791,1835,1691,12317
8/28/2018,2018,8,28, 19 ,9142,1871,1701,12714
8/28/2018,2018,8,28, 20 ,9034,1818,1655,12507
8/28/2018,2018,8,28, 21 ,8908,1735,1558,12201
8/28/2018,2018,8,28, 22 ,8523,1594,1402,11519
8/28/2018,2018,8,28, 23 ,8027,1489,1277,10793
8/28/2018,2018,8,28, 24 ,7614,1408,1212,10234
8/29/2018,2018,8,29, 1 ,7320,1353,1161,9834
8/29/2018,2018,8,29, 2 ,7035,1311,1123,9469
8/29/2018,2018,8,29, 3 ,6833,1267,1092,9192
8/29/2018,2018,8,29, 4 ,6756,1251,1078,9085
8/29/2018,2018,8,29, 5 ,6899,1288,1133,9320
8/29/2018,2018,8,29, 6 ,6941,1316,1181,9438
8/29/2018,2018,8,29, 7 ,7075,1277,1100,9452
8/29/2018,2018,8,29, 8 ,7862,1460,1251,10573
8/29/2018,2018,8,29, 9 ,8801,1713,1530,12044
8/29/2018,2018,8,29, 10 ,9410,1838,1667,12915
8/29/2018,2018,8,29, 11 ,9651,1923,1738,13312
8/29/2018,2018,8,29, 12 ,9361,1866,1697,12924
8/29/2018,2018,8,29, 13 ,9426,1885,1714,13025
8/29/2018,2018,8,29, 14 ,9816,1954,1764,13534
8/29/2018,2018,8,29, 15 ,9709,1887,1751,13347
8/29/2018,2018,8,29, 16 ,9548,1859,1702,13109
8/29/2018,2018,8,29, 17 ,9077,1783,1639,12499
8/29/2018,2018,8,29, 18 ,8929,1826,1653,12408
8/29/2018,2018,8,29, 19 ,9203,1880,1695,12778
8/29/2018,2018,8,29, 20 ,9161,1821,1585,12567
8/29/2018,2018,8,29, 21 ,8990,1738,1531,12259
8/29/2018,2018,8,29, 22 ,8657,1601,1404,11662
8/29/2018,2018,8,29, 23 ,8238,1483,1288,11009
8/29/2018,2018,8,29, 24 ,7748,1398,1206,10352
8/30/2018,2018,8,30, 1 ,7395,1339,1160,9894
8/30/2018,2018,8,30, 2 ,7190,1290,1132,9612
8/30/2018,2018,8,30, 3 ,6972,1260,1102,9334
8/30/2018,2018,8,30, 4 ,6842,1240,1091,9173
8/30/2018,2018,8,30, 5 ,6929,1289,1118,9336
8/30/2018,2018,8,30, 6 ,6922,1313,1165,9400
8/30/2018,2018,8,30, 7 ,7058,1242,1097,9397
8/30/2018,2018,8,30, 8 ,7974,1465,1231,10670
8/30/2018,2018,8,30, 9 ,8848,1711,1479,12038
8/30/2018,2018,8,30, 10 ,9344,1837,1616,12797
8/30/2018,2018,8,30, 11 ,9706,1878,1669,13253
8/30/2018,2018,8,30, 12 ,9501,1764,1634,12899
8/30/2018,2018,8,30, 13 ,9476,1774,1620,12870
8/30/2018,2018,8,30, 14 ,9841,1792,1682,13315
8/30/2018,2018,8,30, 15 ,9638,1764,1645,13047
8/30/2018,2018,8,30, 16 ,9507,1749,1609,12865
8/30/2018,2018,8,30, 17 ,9120,1718,1573,12411
8/30/2018,2018,8,30, 18 ,9033,1774,1588,12395
8/30/2018,2018,8,30, 19 ,9230,1800,1523,12553
8/30/2018,2018,8,30, 20 ,9045,1738,1499,12282
8/30/2018,2018,8,30, 21 ,8877,1654,1412,11943
8/30/2018,2018,8,30, 22 ,8502,1530,1292,11324
8/30/2018,2018,8,30, 23 ,8102,1412,1184,10698
8/30/2018,2018,8,30, 24 ,7658,1333,1116,10107
8/31/2018,2018,8,31, 1 ,7382,1286,1073,9741
8/31/2018,2018,8,31, 2 ,7121,1241,1050,9412
8/31/2018,2018,8,31, 3 ,6954,1218,1019,9191
8/31/2018,2018,8,31, 4 ,6805,1198,1027,9030
8/31/2018,2018,8,31, 5 ,6861,1245,1070,9176
8/31/2018,2018,8,31, 6 ,6929,1299,1159,9387
8/31/2018,2018,8,31, 7 ,7035,1282,1078,9395
8/31/2018,2018,8,31, 8 ,7926,1382,1204,10512
8/31/2018,2018,8,31, 9 ,8777,1567,1404,11748
8/31/2018,2018,8,31, 10 ,9310,1617,1528,12455
8/31/2018,2018,8,31, 11 ,9556,1650,1588,12794
8/31/2018,2018,8,31, 12 ,9378,1590,1559,12527
8/31/2018,2018,8,31, 13 ,9320,1558,1570,12448
8/31/2018,2018,8,31, 14 ,9552,1602,1614,12768
8/31/2018,2018,8,31, 15 ,9293,1595,1583,12471
8/31/2018,2018,8,31, 16 ,9121,1593,1583,12297
8/31/2018,2018,8,31, 17 ,8806,1565,1525,11896
8/31/2018,2018,8,31, 18 ,8509,1682,1622,11813
8/31/2018,2018,8,31, 19 ,8746,1700,1625,12071
8/31/2018,2018,8,31, 20 ,8644,1628,1574,11846
8/31/2018,2018,8,31, 21 ,8518,1542,1484,11544
8/31/2018,2018,8,31, 22 ,8214,1419,1364,10997
8/31/2018,2018,8,31, 23 ,7711,1315,1255,10281
8/31/2018,2018,8,31, 24 ,7356,1233,1171,9760
9/1/2018,2018,9,1, 1 ,7057,1188,1103,9348
9/1/2018,2018,9,1, 2 ,6735,1159,1077,8971
9/1/2018,2018,9,1, 3 ,6579,1135,1059,8773
9/1/2018,2018,9,1, 4 ,6485,1127,1055,8667
9/1/2018,2018,9,1, 5 ,6462,1148,1080,8690
9/1/2018,2018,9,1, 6 ,6431,1177,1091,8699
9/1/2018,2018,9,1, 7 ,6545,1194,1081,8820
9/1/2018,2018,9,1, 8 ,6987,1252,1178,9417
9/1/2018,2018,9,1, 9 ,7668,1435,1348,10451
9/1/2018,2018,9,1, 10 ,8313,1554,1432,11299
9/1/2018,2018,9,1, 11 ,8586,1624,1535,11745
9/1/2018,2018,9,1, 12 ,8451,1589,1515,11555
9/1/2018,2018,9,1, 13 ,8475,1620,1506,11601
9/1/2018,2018,9,1, 14 ,8742,1655,1581,11978
9/1/2018,2018,9,1, 15 ,8605,1624,1549,11778
9/1/2018,2018,9,1, 16 ,8348,1590,1503,11441
9/1/2018,2018,9,1, 17 ,8139,1538,1454,11131
9/1/2018,2018,9,1, 18 ,8125,1656,1536,11317
9/1/2018,2018,9,1, 19 ,8434,1720,1570,11724
9/1/2018,2018,9,1, 20 ,8339,1667,1519,11525
9/1/2018,2018,9,1, 21 ,8185,1590,1467,11242
9/1/2018,2018,9,1, 22 ,7861,1495,1370,10726
9/1/2018,2018,9,1, 23 ,7496,1375,1269,10140
9/1/2018,2018,9,1, 24 ,7194,1292,1185,9671
9/2/2018,2018,9,2, 1 ,6831,1229,1124,9184
9/2/2018,2018,9,2, 2 ,6681,1176,1074,8931
9/2/2018,2018,9,2, 3 ,6488,1146,1044,8678
9/2/2018,2018,9,2, 4 ,6320,1147,1028,8495
9/2/2018,2018,9,2, 5 ,6237,1140,1029,8406
9/2/2018,2018,9,2, 6 ,6089,1146,1032,8267
9/2/2018,2018,9,2, 7 ,6089,1158,1016,8263
9/2/2018,2018,9,2, 8 ,6388,1225,1065,8678
9/2/2018,2018,9,2, 9 ,6858,1316,1143,9317
9/2/2018,2018,9,2, 10 ,7341,1414,1206,9961
9/2/2018,2018,9,2, 11 ,7652,1479,1279,10410
9/2/2018,2018,9,2, 12 ,7659,1468,1246,10373
9/2/2018,2018,9,2, 13 ,7591,1481,1276,10348
9/2/2018,2018,9,2, 14 ,7727,1475,1316,10518
9/2/2018,2018,9,2, 15 ,7616,1456,1279,10351
9/2/2018,2018,9,2, 16 ,7408,1422,1258,10088
9/2/2018,2018,9,2, 17 ,7359,1417,1273,10049
9/2/2018,2018,9,2, 18 ,7606,1607,1432,10645
9/2/2018,2018,9,2, 19 ,7975,1695,1488,11158
9/2/2018,2018,9,2, 20 ,8029,1653,1447,11129
9/2/2018,2018,9,2, 21 ,7916,1590,1381,10887
9/2/2018,2018,9,2, 22 ,7645,1474,1276,10395
9/2/2018,2018,9,2, 23 ,7283,1363,1184,9830
9/2/2018,2018,9,2, 24 ,6850,1288,1125,9263
9/3/2018,2018,9,3, 1 ,6528,1227,1062,8817
9/3/2018,2018,9,3, 2 ,6272,1187,1025,8484
9/3/2018,2018,9,3, 3 ,6170,1151,997,8318
9/3/2018,2018,9,3, 4 ,5999,1148,995,8142
9/3/2018,2018,9,3, 5 ,6242,1202,1055,8499
9/3/2018,2018,9,3, 6 ,6431,1258,1130,8819
9/3/2018,2018,9,3, 7 ,6593,1219,1017,8829
9/3/2018,2018,9,3, 8 ,7322,1379,1169,9870
9/3/2018,2018,9,3, 9 ,8294,1627,1399,11320
9/3/2018,2018,9,3, 10 ,8932,1740,1530,12202
9/3/2018,2018,9,3, 11 ,9338,1784,1615,12737
9/3/2018,2018,9,3, 12 ,9156,1706,1611,12473
9/3/2018,2018,9,3, 13 ,9096,1693,1605,12394
9/3/2018,2018,9,3, 14 ,9493,1754,1670,12917
9/3/2018,2018,9,3, 15 ,9466,1731,1650,12847
9/3/2018,2018,9,3, 16 ,9227,1715,1580,12522
9/3/2018,2018,9,3, 17 ,8794,1669,1538,12001
9/3/2018,2018,9,3, 18 ,8679,1772,1576,12027
9/3/2018,2018,9,3, 19 ,8802,1793,1557,12152
9/3/2018,2018,9,3, 20 ,8643,1732,1539,11914
9/3/2018,2018,9,3, 21 ,8435,1639,1463,11537
9/3/2018,2018,9,3, 22 ,8099,1499,1324,10922
9/3/2018,2018,9,3, 23 ,7577,1393,1255,10225
9/3/2018,2018,9,3, 24 ,7209,1317,1157,9683
9/4/2018,2018,9,4, 1 ,6934,1265,1078,9277
9/4/2018,2018,9,4, 2 ,6752,1233,1074,9059
9/4/2018,2018,9,4, 3 ,6533,1202,1037,8772
9/4/2018,2018,9,4, 4 ,6334,1188,1032,8554
9/4/2018,2018,9,4, 5 ,6679,1242,1075,8996
9/4/2018,2018,9,4, 6 ,6731,1288,1148,9167
9/4/2018,2018,9,4, 7 ,6830,1243,1052,9125
9/4/2018,2018,9,4, 8 ,7758,1402,1203,10363
9/4/2018,2018,9,4, 9 ,8606,1625,1441,11672
9/4/2018,2018,9,4, 10 ,9057,1741,1563,12361
9/4/2018,2018,9,4, 11 ,9406,1790,1625,12821
9/4/2018,2018,9,4, 12 ,9193,1737,1610,12540
9/4/2018,2018,9,4, 13 ,9142,1727,1584,12453
9/4/2018,2018,9,4, 14 ,9442,1793,1671,12906
9/4/2018,2018,9,4, 15 ,9362,1743,1647,12752
9/4/2018,2018,9,4, 16 ,9235,1718,1616,12569
9/4/2018,2018,9,4, 17 ,8849,1670,1527,12046
9/4/2018,2018,9,4, 18 ,8622,1755,1607,11984
9/4/2018,2018,9,4, 19 ,8790,1760,1604,12154
9/4/2018,2018,9,4, 20 ,8657,1700,1536,11893
9/4/2018,2018,9,4, 21 ,8388,1608,1461,11457
9/4/2018,2018,9,4, 22 ,8017,1475,1322,10814
9/4/2018,2018,9,4, 23 ,7596,1365,1189,10150
9/4/2018,2018,9,4, 24 ,7149,1299,1093,9541
9/5/2018,2018,9,5, 1 ,6891,1263,1086,9240
9/5/2018,2018,9,5, 2 ,6693,1222,1061,8976
9/5/2018,2018,9,5, 3 ,6506,1199,1015,8720
9/5/2018,2018,9,5, 4 ,6442,1189,1011,8642
9/5/2018,2018,9,5, 5 ,6601,1240,1066,8907
9/5/2018,2018,9,5, 6 ,6714,1302,1130,9146
9/5/2018,2018,9,5, 7 ,6813,1262,1056,9131
9/5/2018,2018,9,5, 8 ,7628,1392,1198,10218
9/5/2018,2018,9,5, 9 ,8426,1584,1398,11408
9/5/2018,2018,9,5, 10 ,8994,1701,1528,12223
9/5/2018,2018,9,5, 11 ,9362,1770,1605,12737
9/5/2018,2018,9,5, 12 ,9203,1693,1567,12463
9/5/2018,2018,9,5, 13 ,9154,1687,1597,12438
9/5/2018,2018,9,5, 14 ,9574,1748,1663,12985
9/5/2018,2018,9,5, 15 ,9397,1736,1658,12791
9/5/2018,2018,9,5, 16 ,9135,1721,1622,12478
9/5/2018,2018,9,5, 17 ,8786,1684,1554,12024
9/5/2018,2018,9,5, 18 ,8656,1792,1649,12097
9/5/2018,2018,9,5, 19 ,8957,1797,1644,12398
9/5/2018,2018,9,5, 20 ,8860,1751,1593,12204
9/5/2018,2018,9,5, 21 ,8599,1651,1500,11750
9/5/2018,2018,9,5, 22 ,8171,1516,1368,11055
9/5/2018,2018,9,5, 23 ,7775,1398,1239,10412
9/5/2018,2018,9,5, 24 ,7352,1321,1171,9844
9/6/2018,2018,9,6, 1 ,7031,1267,1120,9418
9/6/2018,2018,9,6, 2 ,6877,1235,1068,9180
9/6/2018,2018,9,6, 3 ,6618,1214,1032,8864
9/6/2018,2018,9,6, 4 ,6527,1200,1024,8751
9/6/2018,2018,9,6, 5 ,6712,1246,1080,9038
9/6/2018,2018,9,6, 6 ,6812,1306,1140,9258
9/6/2018,2018,9,6, 7 ,6892,1264,1065,9221
9/6/2018,2018,9,6, 8 ,7793,1428,1199,10420
9/6/2018,2018,9,6, 9 ,8674,1656,1455,11785
9/6/2018,2018,9,6, 10 ,9216,1751,1603,12570
9/6/2018,2018,9,6, 11 ,9562,1790,1671,13023
9/6/2018,2018,9,6, 12 ,9182,1697,1641,12520
9/6/2018,2018,9,6, 13 ,9028,1698,1656,12382
9/6/2018,2018,9,6, 14 ,9150,1779,1652,12581
9/6/2018,2018,9,6, 15 ,9079,1753,1681,12513
9/6/2018,2018,9,6, 16 ,8950,1747,1650,12347
9/6/2018,2018,9,6, 17 ,8709,1705,1580,11994
9/6/2018,2018,9,6, 18 ,8590,1788,1686,12064
9/6/2018,2018,9,6, 19 ,8604,1790,1700,12094
9/6/2018,2018,9,6, 20 ,8423,1729,1597,11749
9/6/2018,2018,9,6, 21 ,8197,1640,1538,11375
9/6/2018,2018,9,6, 22 ,7778,1508,1392,10678
9/6/2018,2018,9,6, 23 ,7339,1393,1288,10020
9/6/2018,2018,9,6, 24 ,6985,1331,1181,9497
9/7/2018,2018,9,7, 1 ,6691,1270,1149,9110
9/7/2018,2018,9,7, 2 ,6556,1226,1117,8899
9/7/2018,2018,9,7, 3 ,6339,1200,1077,8616
9/7/2018,2018,9,7, 4 ,6321,1198,1053,8572
9/7/2018,2018,9,7, 5 ,6485,1248,1103,8836
9/7/2018,2018,9,7, 6 ,6601,1289,1136,9026
9/7/2018,2018,9,7, 7 ,6749,1249,1078,9076
9/7/2018,2018,9,7, 8 ,7479,1414,1264,10157
9/7/2018,2018,9,7, 9 ,8192,1650,1489,11331
9/7/2018,2018,9,7, 10 ,8738,1774,1607,12119
9/7/2018,2018,9,7, 11 ,8986,1833,1682,12501
9/7/2018,2018,9,7, 12 ,8751,1784,1671,12206
9/7/2018,2018,9,7, 13 ,8408,1800,1668,11876
9/7/2018,2018,9,7, 14 ,8902,1871,1696,12469
9/7/2018,2018,9,7, 15 ,8867,1857,1705,12429
9/7/2018,2018,9,7, 16 ,8705,1820,1660,12185
9/7/2018,2018,9,7, 17 ,8422,1733,1574,11729
9/7/2018,2018,9,7, 18 ,8386,1813,1658,11857
9/7/2018,2018,9,7, 19 ,8534,1845,1648,12027
9/7/2018,2018,9,7, 20 ,8395,1778,1617,11790
9/7/2018,2018,9,7, 21 ,8164,1703,1534,11401
9/7/2018,2018,9,7, 22 ,7739,1582,1401,10722
9/7/2018,2018,9,7, 23 ,7374,1462,1293,10129
9/7/2018,2018,9,7, 24 ,7034,1399,1207,9640
9/8/2018,2018,9,8, 1 ,6781,1334,1151,9266
9/8/2018,2018,9,8, 2 ,6561,1289,1139,8989
9/8/2018,2018,9,8, 3 ,6413,1261,1117,8791
9/8/2018,2018,9,8, 4 ,6254,1241,1084,8579
9/8/2018,2018,9,8, 5 ,6224,1235,1099,8558
9/8/2018,2018,9,8, 6 ,6207,1247,1129,8583
9/8/2018,2018,9,8, 7 ,6427,1252,1108,8787
9/8/2018,2018,9,8, 8 ,6889,1382,1217,9488
9/8/2018,2018,9,8, 9 ,7667,1557,1359,10583
9/8/2018,2018,9,8, 10 ,8268,1685,1482,11435
9/8/2018,2018,9,8, 11 ,8635,1751,1570,11956
9/8/2018,2018,9,8, 12 ,8502,1705,1550,11757
9/8/2018,2018,9,8, 13 ,8545,1721,1565,11831
9/8/2018,2018,9,8, 14 ,8747,1742,1595,12084
9/8/2018,2018,9,8, 15 ,8636,1735,1574,11945
9/8/2018,2018,9,8, 16 ,8395,1678,1461,11534
9/8/2018,2018,9,8, 17 ,8081,1633,1477,11191
9/8/2018,2018,9,8, 18 ,8036,1732,1532,11300
9/8/2018,2018,9,8, 19 ,8464,1770,1491,11725
9/8/2018,2018,9,8, 20 ,8401,1721,1436,11558
9/8/2018,2018,9,8, 21 ,8255,1666,1344,11265
9/8/2018,2018,9,8, 22 ,8059,1592,1272,10923
9/8/2018,2018,9,8, 23 ,7672,1470,1186,10328
9/8/2018,2018,9,8, 24 ,7318,1380,1100,9798
9/9/2018,2018,9,9, 1 ,7009,1303,1053,9365
9/9/2018,2018,9,9, 2 ,6757,1265,1010,9032
9/9/2018,2018,9,9, 3 ,6599,1229,973,8801
9/9/2018,2018,9,9, 4 ,6478,1211,964,8653
9/9/2018,2018,9,9, 5 ,6346,1200,971,8517
9/9/2018,2018,9,9, 6 ,6140,1153,985,8278
9/9/2018,2018,9,9, 7 ,6169,1169,983,8321
9/9/2018,2018,9,9, 8 ,6494,1239,1054,8787
9/9/2018,2018,9,9, 9 ,6923,1332,1165,9420
9/9/2018,2018,9,9, 10 ,7347,1433,1283,10063
9/9/2018,2018,9,9, 11 ,7726,1486,1312,10524
9/9/2018,2018,9,9, 12 ,7717,1480,1302,10499
9/9/2018,2018,9,9, 13 ,7792,1542,1319,10653
9/9/2018,2018,9,9, 14 ,7782,1540,1344,10666
9/9/2018,2018,9,9, 15 ,7776,1504,1327,10607
9/9/2018,2018,9,9, 16 ,7606,1475,1297,10378
9/9/2018,2018,9,9, 17 ,7515,1509,1310,10334
9/9/2018,2018,9,9, 18 ,7740,1638,1470,10848
9/9/2018,2018,9,9, 19 ,8282,1632,1472,11386
9/9/2018,2018,9,9, 20 ,8253,1587,1461,11301
9/9/2018,2018,9,9, 21 ,8093,1518,1149,10760
9/9/2018,2018,9,9, 22 ,7815,1426,1267,10508
9/9/2018,2018,9,9, 23 ,7441,1320,1201,9962
9/9/2018,2018,9,9, 24 ,7037,1244,929,9210
9/10/2018,2018,9,10, 1 ,6730,1196,1055,8981
9/10/2018,2018,9,10, 2 ,6488,1161,1008,8657
9/10/2018,2018,9,10, 3 ,6340,1129,984,8453
9/10/2018,2018,9,10, 4 ,6261,1121,972,8354
9/10/2018,2018,9,10, 5 ,6431,1174,1037,8642
9/10/2018,2018,9,10, 6 ,6627,1238,1096,8961
9/10/2018,2018,9,10, 7 ,6834,1208,1029,9071
9/10/2018,2018,9,10, 8 ,7820,1405,1169,10394
9/10/2018,2018,9,10, 9 ,8715,1664,1402,11781
9/10/2018,2018,9,10, 10 ,9199,1789,1549,12537
9/10/2018,2018,9,10, 11 ,9586,1879,1642,13107
9/10/2018,2018,9,10, 12 ,9349,1852,1608,12809
9/10/2018,2018,9,10, 13 ,9354,1837,1607,12798
9/10/2018,2018,9,10, 14 ,9713,1903,1687,13303
9/10/2018,2018,9,10, 15 ,9676,1883,1657,13216
9/10/2018,2018,9,10, 16 ,9475,1841,1609,12925
9/10/2018,2018,9,10, 17 ,8967,1779,1569,12315
9/10/2018,2018,9,10, 18 ,8962,1863,1639,12464
9/10/2018,2018,9,10, 19 ,9003,1847,1612,12462
9/10/2018,2018,9,10, 20 ,8901,1831,1536,12268
9/10/2018,2018,9,10, 21 ,8688,1720,1451,11859
9/10/2018,2018,9,10, 22 ,8243,1584,1326,11153
9/10/2018,2018,9,10, 23 ,7806,1463,1235,10504
9/10/2018,2018,9,10, 24 ,7406,1375,1144,9925
9/11/2018,2018,9,11, 1 ,7097,1327,1084,9508
9/11/2018,2018,9,11, 2 ,6892,1281,1047,9220
9/11/2018,2018,9,11, 3 ,6757,1253,1019,9029
9/11/2018,2018,9,11, 4 ,6669,1237,1007,8913
9/11/2018,2018,9,11, 5 ,6790,1273,1056,9119
9/11/2018,2018,9,11, 6 ,6968,1326,1087,9381
9/11/2018,2018,9,11, 7 ,7022,1260,1019,9301
9/11/2018,2018,9,11, 8 ,7879,1443,1184,10506
9/11/2018,2018,9,11, 9 ,8774,1685,1392,11851
9/11/2018,2018,9,11, 10 ,9335,1807,1532,12674
9/11/2018,2018,9,11, 11 ,9573,1873,1611,13057
9/11/2018,2018,9,11, 12 ,9377,1814,1573,12764
9/11/2018,2018,9,11, 13 ,9312,1828,1566,12706
9/11/2018,2018,9,11, 14 ,9659,1872,1643,13174
9/11/2018,2018,9,11, 15 ,9613,1859,1621,13093
9/11/2018,2018,9,11, 16 ,9399,1815,1582,12796
9/11/2018,2018,9,11, 17 ,9075,1750,1521,12346
9/11/2018,2018,9,11, 18 ,8928,1839,1632,12399
9/11/2018,2018,9,11, 19 ,9104,1860,1603,12567
9/11/2018,2018,9,11, 20 ,9013,1806,1540,12359
9/11/2018,2018,9,11, 21 ,8807,1722,1458,11987
9/11/2018,2018,9,11, 22 ,8328,1581,1329,11238
9/11/2018,2018,9,11, 23 ,7867,1457,1249,10573
9/11/2018,2018,9,11, 24 ,7475,1368,1144,9987
9/12/2018,2018,9,12, 1 ,7147,1316,1090,9553
9/12/2018,2018,9,12, 2 ,6916,1277,1064,9257
9/12/2018,2018,9,12, 3 ,6729,1247,1036,9012
9/12/2018,2018,9,12, 4 ,6709,1237,1030,8976
9/12/2018,2018,9,12, 5 ,6833,1279,1084,9196
9/12/2018,2018,9,12, 6 ,6899,1330,1145,9374
9/12/2018,2018,9,12, 7 ,7114,1275,1060,9449
9/12/2018,2018,9,12, 8 ,7990,1444,1182,10616
9/12/2018,2018,9,12, 9 ,8811,1670,1414,11895
9/12/2018,2018,9,12, 10 ,9281,1774,1520,12575
9/12/2018,2018,9,12, 11 ,9639,1856,1515,13010
9/12/2018,2018,9,12, 12 ,9447,1780,1552,12779
9/12/2018,2018,9,12, 13 ,9416,1781,1521,12718
9/12/2018,2018,9,12, 14 ,9700,1853,1603,13156
9/12/2018,2018,9,12, 15 ,9608,1820,1594,13022
9/12/2018,2018,9,12, 16 ,9405,1792,1563,12760
9/12/2018,2018,9,12, 17 ,8978,1750,1547,12275
9/12/2018,2018,9,12, 18 ,8987,1847,1640,12474
9/12/2018,2018,9,12, 19 ,9208,1841,1612,12661
9/12/2018,2018,9,12, 20 ,9047,1782,1525,12354
9/12/2018,2018,9,12, 21 ,8751,1679,1456,11886
9/12/2018,2018,9,12, 22 ,8322,1538,1310,11170
9/12/2018,2018,9,12, 23 ,7866,1428,1220,10514
9/12/2018,2018,9,12, 24 ,7433,1354,1127,9914
9/13/2018,2018,9,13, 1 ,7133,1303,1061,9497
9/13/2018,2018,9,13, 2 ,6943,1255,1040,9238
9/13/2018,2018,9,13, 3 ,6722,1220,1014,8956
9/13/2018,2018,9,13, 4 ,6616,1213,1008,8837
9/13/2018,2018,9,13, 5 ,6747,1264,1066,9077
9/13/2018,2018,9,13, 6 ,6850,1312,1137,9299
9/13/2018,2018,9,13, 7 ,7048,1276,1068,9392
9/13/2018,2018,9,13, 8 ,7852,1437,1157,10446
9/13/2018,2018,9,13, 9 ,8766,1647,1373,11786
9/13/2018,2018,9,13, 10 ,9306,1769,1477,12552
9/13/2018,2018,9,13, 11 ,9634,1851,1519,13004
9/13/2018,2018,9,13, 12 ,9565,1799,1475,12839
9/13/2018,2018,9,13, 13 ,9545,1793,1460,12798
9/13/2018,2018,9,13, 14 ,9891,1864,1505,13260
9/13/2018,2018,9,13, 15 ,9754,1806,1501,13061
9/13/2018,2018,9,13, 16 ,9551,1787,1478,12816
9/13/2018,2018,9,13, 17 ,9145,1738,1469,12352
9/13/2018,2018,9,13, 18 ,9023,1844,1591,12458
9/13/2018,2018,9,13, 19 ,9211,1834,1539,12584
9/13/2018,2018,9,13, 20 ,9128,1764,1476,12368
9/13/2018,2018,9,13, 21 ,8890,1678,1411,11979
9/13/2018,2018,9,13, 22 ,8338,1549,1259,11146
9/13/2018,2018,9,13, 23 ,7877,1445,1157,10479
9/13/2018,2018,9,13, 24 ,7474,1367,1081,9922
9/14/2018,2018,9,14, 1 ,7238,1317,1057,9612
9/14/2018,2018,9,14, 2 ,7054,1280,1030,9364
9/14/2018,2018,9,14, 3 ,6874,1235,996,9105
9/14/2018,2018,9,14, 4 ,6663,1212,979,8854
9/14/2018,2018,9,14, 5 ,6679,1237,1056,8972
9/14/2018,2018,9,14, 6 ,6756,1284,1125,9165
9/14/2018,2018,9,14, 7 ,7065,1278,1084,9427
9/14/2018,2018,9,14, 8 ,7738,1410,1178,10326
9/14/2018,2018,9,14, 9 ,8454,1598,1369,11421
9/14/2018,2018,9,14, 10 ,8907,1706,1443,12056
9/14/2018,2018,9,14, 11 ,9174,1748,1515,12437
9/14/2018,2018,9,14, 12 ,8825,1675,1460,11960
9/14/2018,2018,9,14, 13 ,8713,1672,1446,11831
9/14/2018,2018,9,14, 14 ,8890,1730,1427,12047
9/14/2018,2018,9,14, 15 ,8735,1674,1473,11882
9/14/2018,2018,9,14, 16 ,8651,1676,1447,11774
9/14/2018,2018,9,14, 17 ,8550,1656,1420,11626
9/14/2018,2018,9,14, 18 ,8528,1742,1516,11786
9/14/2018,2018,9,14, 19 ,8494,1703,1483,11680
9/14/2018,2018,9,14, 20 ,8215,1644,1413,11272
9/14/2018,2018,9,14, 21 ,7962,1551,1344,10857
9/14/2018,2018,9,14, 22 ,7515,1448,1093,10056
9/14/2018,2018,9,14, 23 ,7069,1352,1018,9439
9/14/2018,2018,9,14, 24 ,6586,1268,960,8814
9/15/2018,2018,9,15, 1 ,6251,1211,1037,8499
9/15/2018,2018,9,15, 2 ,5943,1173,1015,8131
9/15/2018,2018,9,15, 3 ,5655,1145,987,7787
9/15/2018,2018,9,15, 4 ,5369,1133,971,7473
9/15/2018,2018,9,15, 5 ,5121,1156,1000,7277
9/15/2018,2018,9,15, 6 ,4844,1193,1045,7082
9/15/2018,2018,9,15, 7 ,4971,1212,1054,7237
9/15/2018,2018,9,15, 8 ,5272,1310,1137,7719
9/15/2018,2018,9,15, 9 ,5676,1457,1301,8434
9/15/2018,2018,9,15, 10 ,6115,1527,1409,9051
9/15/2018,2018,9,15, 11 ,6317,1591,1470,9378
9/15/2018,2018,9,15, 12 ,6247,1561,1426,9234
9/15/2018,2018,9,15, 13 ,6267,1534,1445,9246
9/15/2018,2018,9,15, 14 ,6358,1590,1513,9461
9/15/2018,2018,9,15, 15 ,6343,1587,1484,9414
9/15/2018,2018,9,15, 16 ,6355,1559,1443,9357
9/15/2018,2018,9,15, 17 ,6430,1519,1408,9357
9/15/2018,2018,9,15, 18 ,6722,1668,1571,9961
9/15/2018,2018,9,15, 19 ,6950,1677,1563,10190
9/15/2018,2018,9,15, 20 ,6909,1650,1529,10088
9/15/2018,2018,9,15, 21 ,6821,1580,1472,9873
9/15/2018,2018,9,15, 22 ,6593,1490,1365,9448
9/15/2018,2018,9,15, 23 ,6294,1384,1265,8943
9/15/2018,2018,9,15, 24 ,6018,1302,1154,8474
9/16/2018,2018,9,16, 1 ,5819,1251,1121,8191
9/16/2018,2018,9,16, 2 ,5647,1210,1085,7942
9/16/2018,2018,9,16, 3 ,5487,1167,1043,7697
9/16/2018,2018,9,16, 4 ,5414,1140,1026,7580
9/16/2018,2018,9,16, 5 ,5408,1129,1040,7577
9/16/2018,2018,9,16, 6 ,5387,1128,1045,7560
9/16/2018,2018,9,16, 7 ,5484,1147,1040,7671
9/16/2018,2018,9,16, 8 ,5749,1219,1081,8049
9/16/2018,2018,9,16, 9 ,6240,1317,1176,8733
9/16/2018,2018,9,16, 10 ,6651,1408,1232,9291
9/16/2018,2018,9,16, 11 ,6932,1461,1329,9722
9/16/2018,2018,9,16, 12 ,6870,1483,1339,9692
9/16/2018,2018,9,16, 13 ,6824,1495,1346,9665
9/16/2018,2018,9,16, 14 ,6905,1496,1320,9721
9/16/2018,2018,9,16, 15 ,6889,1466,1286,9641
9/16/2018,2018,9,16, 16 ,6848,1447,1279,9574
9/16/2018,2018,9,16, 17 ,6867,1456,1310,9633
9/16/2018,2018,9,16, 18 ,7196,1675,1487,10358
9/16/2018,2018,9,16, 19 ,7417,1702,1520,10639
9/16/2018,2018,9,16, 20 ,7460,1667,1490,10617
9/16/2018,2018,9,16, 21 ,7333,1603,1431,10367
9/16/2018,2018,9,16, 22 ,7072,1500,1321,9893
9/16/2018,2018,9,16, 23 ,6747,1395,1232,9374
9/16/2018,2018,9,16, 24 ,6347,1314,1148,8809
9/17/2018,2018,9,17, 1 ,6053,1249,1101,8403
9/17/2018,2018,9,17, 2 ,5814,1209,1056,8079
9/17/2018,2018,9,17, 3 ,5682,1179,1016,7877
9/17/2018,2018,9,17, 4 ,5618,1164,1004,7786
9/17/2018,2018,9,17, 5 ,5873,1213,1078,8164
9/17/2018,2018,9,17, 6 ,6099,1265,1121,8485
9/17/2018,2018,9,17, 7 ,6428,1220,1035,8683
9/17/2018,2018,9,17, 8 ,7199,1399,1192,9790
9/17/2018,2018,9,17, 9 ,7992,1660,1429,11081
9/17/2018,2018,9,17, 10 ,8571,1755,1586,11912
9/17/2018,2018,9,17, 11 ,8937,1846,1676,12459
9/17/2018,2018,9,17, 12 ,8713,1808,1663,12184
9/17/2018,2018,9,17, 13 ,8626,1815,1667,12108
9/17/2018,2018,9,17, 14 ,8978,1885,1709,12572
9/17/2018,2018,9,17, 15 ,8925,1850,1688,12463
9/17/2018,2018,9,17, 16 ,8838,1819,1665,12322
9/17/2018,2018,9,17, 17 ,8581,1740,1617,11938
9/17/2018,2018,9,17, 18 ,8510,1860,1701,12071
9/17/2018,2018,9,17, 19 ,8649,1861,1638,12148
9/17/2018,2018,9,17, 20 ,8484,1801,1567,11852
9/17/2018,2018,9,17, 21 ,8230,1681,1500,11411
9/17/2018,2018,9,17, 22 ,7958,1577,1372,10907
9/17/2018,2018,9,17, 23 ,7479,1442,1262,10183
9/17/2018,2018,9,17, 24 ,7063,1338,1169,9570
9/18/2018,2018,9,18, 1 ,6751,1296,1123,9170
9/18/2018,2018,9,18, 2 ,6570,1270,1082,8922
9/18/2018,2018,9,18, 3 ,6422,1218,1059,8699
9/18/2018,2018,9,18, 4 ,6310,1204,1050,8564
9/18/2018,2018,9,18, 5 ,6441,1248,1103,8792
9/18/2018,2018,9,18, 6 ,6572,1307,1158,9037
9/18/2018,2018,9,18, 7 ,6647,1263,1069,8979
9/18/2018,2018,9,18, 8 ,7538,1434,1246,10218
9/18/2018,2018,9,18, 9 ,8432,1630,1456,11518
9/18/2018,2018,9,18, 10 ,9007,1729,1606,12342
9/18/2018,2018,9,18, 11 ,9197,1825,1677,12699
9/18/2018,2018,9,18, 12 ,8982,1752,1644,12378
9/18/2018,2018,9,18, 13 ,8958,1767,1635,12360
9/18/2018,2018,9,18, 14 ,9333,1873,1714,12920
9/18/2018,2018,9,18, 15 ,9204,1833,1700,12737
9/18/2018,2018,9,18, 16 ,9044,1809,1671,12524
9/18/2018,2018,9,18, 17 ,8734,1747,1612,12093
9/18/2018,2018,9,18, 18 ,8572,1868,1715,12155
9/18/2018,2018,9,18, 19 ,8835,1844,1689,12368
9/18/2018,2018,9,18, 20 ,8676,1782,1637,12095
9/18/2018,2018,9,18, 21 ,8508,1678,1550,11736
9/18/2018,2018,9,18, 22 ,8148,1528,1403,11079
9/18/2018,2018,9,18, 23 ,7720,1424,1295,10439
9/18/2018,2018,9,18, 24 ,7384,1345,1210,9939
9/19/2018,2018,9,19, 1 ,7041,1289,1168,9498
9/19/2018,2018,9,19, 2 ,6806,1246,1129,9181
9/19/2018,2018,9,19, 3 ,6691,1221,1097,9009
9/19/2018,2018,9,19, 4 ,6659,1205,1075,8939
9/19/2018,2018,9,19, 5 ,6746,1253,1142,9141
9/19/2018,2018,9,19, 6 ,6850,1290,1183,9323
9/19/2018,2018,9,19, 7 ,7010,1256,1106,9372
9/19/2018,2018,9,19, 8 ,7757,1427,1275,10459
9/19/2018,2018,9,19, 9 ,8632,1677,1527,11836
9/19/2018,2018,9,19, 10 ,9266,1787,1638,12691
9/19/2018,2018,9,19, 11 ,9538,1840,1711,13089
9/19/2018,2018,9,19, 12 ,9355,1800,1677,12832
9/19/2018,2018,9,19, 13 ,9284,1810,1686,12780
9/19/2018,2018,9,19, 14 ,9576,1879,1760,13215
9/19/2018,2018,9,19, 15 ,9361,1842,1732,12935
9/19/2018,2018,9,19, 16 ,9167,1817,1693,12677
9/19/2018,2018,9,19, 17 ,8900,1770,1625,12295
9/19/2018,2018,9,19, 18 ,8965,1900,1702,12567
9/19/2018,2018,9,19, 19 ,8981,1890,1659,12530
9/19/2018,2018,9,19, 20 ,8855,1828,1612,12295
9/19/2018,2018,9,19, 21 ,8650,1731,1542,11923
9/19/2018,2018,9,19, 22 ,8269,1615,1410,11294
9/19/2018,2018,9,19, 23 ,7871,1497,1282,10650
9/19/2018,2018,9,19, 24 ,7496,1407,1191,10094
9/20/2018,2018,9,20, 1 ,7146,1345,1136,9627
9/20/2018,2018,9,20, 2 ,6933,1300,1104,9337
9/20/2018,2018,9,20, 3 ,6761,1268,1071,9100
9/20/2018,2018,9,20, 4 ,6751,1242,1052,9045
9/20/2018,2018,9,20, 5 ,6924,1269,1109,9302
9/20/2018,2018,9,20, 6 ,6977,1264,1157,9398
9/20/2018,2018,9,20, 7 ,7068,1237,1078,9383
9/20/2018,2018,9,20, 8 ,7975,1397,1205,10577
9/20/2018,2018,9,20, 9 ,8894,1557,1441,11892
9/20/2018,2018,9,20, 10 ,9495,1691,1558,12744
9/20/2018,2018,9,20, 11 ,9795,1737,1593,13125
9/20/2018,2018,9,20, 12 ,9487,1701,1548,12736
9/20/2018,2018,9,20, 13 ,9429,1698,1513,12640
9/20/2018,2018,9,20, 14 ,9593,1751,1572,12916
9/20/2018,2018,9,20, 15 ,9480,1733,1557,12770
9/20/2018,2018,9,20, 16 ,9428,1718,1537,12683
9/20/2018,2018,9,20, 17 ,9017,1681,1501,12199
9/20/2018,2018,9,20, 18 ,9015,1820,1636,12471
9/20/2018,2018,9,20, 19 ,8995,1820,1576,12391
9/20/2018,2018,9,20, 20 ,8704,1756,1520,11980
9/20/2018,2018,9,20, 21 ,8533,1663,1427,11623
9/20/2018,2018,9,20, 22 ,8140,1539,1288,10967
9/20/2018,2018,9,20, 23 ,7690,1420,1195,10305
9/20/2018,2018,9,20, 24 ,7286,1328,1179,9793
9/21/2018,2018,9,21, 1 ,6941,1277,1064,9282
9/21/2018,2018,9,21, 2 ,6692,1240,1023,8955
9/21/2018,2018,9,21, 3 ,6474,1210,1004,8688
9/21/2018,2018,9,21, 4 ,6432,1190,993,8615
9/21/2018,2018,9,21, 5 ,6590,1233,1059,8882
9/21/2018,2018,9,21, 6 ,6693,1277,1119,9089
9/21/2018,2018,9,21, 7 ,6879,1248,1060,9187
9/21/2018,2018,9,21, 8 ,7715,1415,1230,10360
9/21/2018,2018,9,21, 9 ,8646,1639,1437,11722
9/21/2018,2018,9,21, 10 ,9227,1766,1555,12548
9/21/2018,2018,9,21, 11 ,9531,1839,1646,13016
9/21/2018,2018,9,21, 12 ,9264,1758,1620,12642
9/21/2018,2018,9,21, 13 ,9260,1761,1629,12650
9/21/2018,2018,9,21, 14 ,9446,1822,1680,12948
9/21/2018,2018,9,21, 15 ,9280,1756,1608,12644
9/21/2018,2018,9,21, 16 ,9158,1718,1573,12449
9/21/2018,2018,9,21, 17 ,8864,1656,1544,12064
9/21/2018,2018,9,21, 18 ,8814,1765,1625,12204
9/21/2018,2018,9,21, 19 ,8810,1749,1575,12134
9/21/2018,2018,9,21, 20 ,8656,1693,1528,11877
9/21/2018,2018,9,21, 21 ,8465,1610,1451,11526
9/21/2018,2018,9,21, 22 ,8148,1496,1319,10963
9/21/2018,2018,9,21, 23 ,7697,1383,1215,10295
9/21/2018,2018,9,21, 24 ,7271,1293,1110,9674
9/22/2018,2018,9,22, 1 ,7043,1252,1074,9369
9/22/2018,2018,9,22, 2 ,6822,1214,1044,9080
9/22/2018,2018,9,22, 3 ,6603,1182,1000,8785
9/22/2018,2018,9,22, 4 ,6467,1162,989,8618
9/22/2018,2018,9,22, 5 ,6470,1178,1005,8653
9/22/2018,2018,9,22, 6 ,6433,1189,1040,8662
9/22/2018,2018,9,22, 7 ,6611,1193,1051,8855
9/22/2018,2018,9,22, 8 ,7278,1341,1148,9767
9/22/2018,2018,9,22, 9 ,8063,1511,1276,10850
9/22/2018,2018,9,22, 10 ,8673,1622,1429,11724
9/22/2018,2018,9,22, 11 ,9014,1674,1537,12225
9/22/2018,2018,9,22, 12 ,8812,1612,1465,11889
9/22/2018,2018,9,22, 13 ,8793,1574,1483,11850
9/22/2018,2018,9,22, 14 ,9044,1587,1536,12167
9/22/2018,2018,9,22, 15 ,8818,1559,1522,11899
9/22/2018,2018,9,22, 16 ,8623,1534,1493,11650
9/22/2018,2018,9,22, 17 ,8292,1533,1451,11276
9/22/2018,2018,9,22, 18 ,8317,1653,1574,11544
9/22/2018,2018,9,22, 19 ,8633,1649,1565,11847
9/22/2018,2018,9,22, 20 ,8624,1598,1496,11718
9/22/2018,2018,9,22, 21 ,8495,1520,1432,11447
9/22/2018,2018,9,22, 22 ,8179,1441,1328,10948
9/22/2018,2018,9,22, 23 ,7815,1316,1220,10351
9/22/2018,2018,9,22, 24 ,7451,1237,1134,9822
9/23/2018,2018,9,23, 1 ,7074,1174,1086,9334
9/23/2018,2018,9,23, 2 ,6853,1140,1048,9041
9/23/2018,2018,9,23, 3 ,6597,1111,1009,8717
9/23/2018,2018,9,23, 4 ,6430,1097,990,8517
9/23/2018,2018,9,23, 5 ,6312,1111,1002,8425
9/23/2018,2018,9,23, 6 ,6118,1111,1027,8256
9/23/2018,2018,9,23, 7 ,6175,1141,1011,8327
9/23/2018,2018,9,23, 8 ,6551,1214,1054,8819
9/23/2018,2018,9,23, 9 ,7082,1311,1120,9513
9/23/2018,2018,9,23, 10 ,7639,1423,1245,10307
9/23/2018,2018,9,23, 11 ,7953,1478,1301,10732
9/23/2018,2018,9,23, 12 ,7962,1485,1320,10767
9/23/2018,2018,9,23, 13 ,7957,1483,1334,10774
9/23/2018,2018,9,23, 14 ,8057,1496,1344,10897
9/23/2018,2018,9,23, 15 ,8006,1471,1327,10804
9/23/2018,2018,9,23, 16 ,7803,1444,1304,10551
9/23/2018,2018,9,23, 17 ,7642,1455,1310,10407
9/23/2018,2018,9,23, 18 ,7878,1627,1509,11014
9/23/2018,2018,9,23, 19 ,8334,1666,1506,11506
9/23/2018,2018,9,23, 20 ,8436,1627,1460,11523
9/23/2018,2018,9,23, 21 ,8418,1549,1403,11370
9/23/2018,2018,9,23, 22 ,8166,1430,1288,10884
9/23/2018,2018,9,23, 23 ,7698,1332,1177,10207
9/23/2018,2018,9,23, 24 ,7225,1256,1169,9650
9/24/2018,2018,9,24, 1 ,6920,1189,1058,9167
9/24/2018,2018,9,24, 2 ,6604,1150,1017,8771
9/24/2018,2018,9,24, 3 ,6474,1119,999,8592
9/24/2018,2018,9,24, 4 ,6333,1113,1008,8454
9/24/2018,2018,9,24, 5 ,6460,1168,1053,8681
9/24/2018,2018,9,24, 6 ,6605,1236,1142,8983
9/24/2018,2018,9,24, 7 ,6827,1197,1045,9069
9/24/2018,2018,9,24, 8 ,7811,1367,1211,10389
9/24/2018,2018,9,24, 9 ,8816,1618,1455,11889
9/24/2018,2018,9,24, 10 ,9386,1758,1587,12731
9/24/2018,2018,9,24, 11 ,9767,1828,1681,13276
9/24/2018,2018,9,24, 12 ,9612,1797,1652,13061
9/24/2018,2018,9,24, 13 ,9604,1798,1637,13039
9/24/2018,2018,9,24, 14 ,9990,1891,1590,13471
9/24/2018,2018,9,24, 15 ,9876,1871,1671,13418
9/24/2018,2018,9,24, 16 ,9685,1819,1643,13147
9/24/2018,2018,9,24, 17 ,9284,1735,1587,12606
9/24/2018,2018,9,24, 18 ,9096,1878,1691,12665
9/24/2018,2018,9,24, 19 ,9320,1846,1656,12822
9/24/2018,2018,9,24, 20 ,9245,1818,1579,12642
9/24/2018,2018,9,24, 21 ,9038,1718,1510,12266
9/24/2018,2018,9,24, 22 ,8649,1586,1360,11595
9/24/2018,2018,9,24, 23 ,8136,1473,1258,10867
9/24/2018,2018,9,24, 24 ,7679,1391,1101,10171
9/25/2018,2018,9,25, 1 ,7412,1339,1117,9868
9/25/2018,2018,9,25, 2 ,7160,1290,1066,9516
9/25/2018,2018,9,25, 3 ,6987,1260,1046,9293
9/25/2018,2018,9,25, 4 ,6817,1249,1037,9103
9/25/2018,2018,9,25, 5 ,6959,1294,1107,9360
9/25/2018,2018,9,25, 6 ,6936,1333,1145,9414
9/25/2018,2018,9,25, 7 ,7099,1283,1078,9460
9/25/2018,2018,9,25, 8 ,8106,1464,1263,10833
9/25/2018,2018,9,25, 9 ,9042,1681,1495,12218
9/25/2018,2018,9,25, 10 ,9615,1804,1617,13036
9/25/2018,2018,9,25, 11 ,9941,1847,1682,13470
9/25/2018,2018,9,25, 12 ,9714,1811,1644,13169
9/25/2018,2018,9,25, 13 ,9673,1818,1614,13105
9/25/2018,2018,9,25, 14 ,9981,1929,1703,13613
9/25/2018,2018,9,25, 15 ,9818,1892,1660,13370
9/25/2018,2018,9,25, 16 ,9644,1858,1621,13123
9/25/2018,2018,9,25, 17 ,9180,1754,1563,12497
9/25/2018,2018,9,25, 18 ,9078,1874,1693,12645
9/25/2018,2018,9,25, 19 ,9228,1892,1657,12777
9/25/2018,2018,9,25, 20 ,9179,1827,1605,12611
9/25/2018,2018,9,25, 21 ,9082,1747,1526,12355
9/25/2018,2018,9,25, 22 ,8707,1613,1388,11708
9/25/2018,2018,9,25, 23 ,8147,1482,1279,10908
9/25/2018,2018,9,25, 24 ,7753,1416,1193,10362
9/26/2018,2018,9,26, 1 ,7457,1362,1138,9957
9/26/2018,2018,9,26, 2 ,7139,1324,1091,9554
9/26/2018,2018,9,26, 3 ,6938,1289,1063,9290
9/26/2018,2018,9,26, 4 ,6973,1273,1054,9300
9/26/2018,2018,9,26, 5 ,7092,1317,1112,9521
9/26/2018,2018,9,26, 6 ,7080,1345,1172,9597
9/26/2018,2018,9,26, 7 ,7161,1296,1096,9553
9/26/2018,2018,9,26, 8 ,8174,1478,1257,10909
9/26/2018,2018,9,26, 9 ,9069,1710,1478,12257
9/26/2018,2018,9,26, 10 ,9609,1840,1521,12970
9/26/2018,2018,9,26, 11 ,9820,1885,1689,13394
9/26/2018,2018,9,26, 12 ,9678,1856,1666,13200
9/26/2018,2018,9,26, 13 ,9718,1856,1645,13219
9/26/2018,2018,9,26, 14 ,10044,1928,1727,13699
9/26/2018,2018,9,26, 15 ,9853,1894,1688,13435
9/26/2018,2018,9,26, 16 ,9534,1870,1620,13024
9/26/2018,2018,9,26, 17 ,9246,1785,1589,12620
9/26/2018,2018,9,26, 18 ,9209,1918,1714,12841
9/26/2018,2018,9,26, 19 ,9198,1894,1667,12759
9/26/2018,2018,9,26, 20 ,9161,1833,1601,12595
9/26/2018,2018,9,26, 21 ,8957,1751,1509,12217
9/26/2018,2018,9,26, 22 ,8577,1608,1383,11568
9/26/2018,2018,9,26, 23 ,8024,1487,1262,10773
9/26/2018,2018,9,26, 24 ,7658,1411,1188,10257
9/27/2018,2018,9,27, 1 ,7306,1352,1139,9797
9/27/2018,2018,9,27, 2 ,7079,1311,1111,9501
9/27/2018,2018,9,27, 3 ,6902,1274,1077,9253
9/27/2018,2018,9,27, 4 ,6805,1264,1069,9138
9/27/2018,2018,9,27, 5 ,6924,1307,1123,9354
9/27/2018,2018,9,27, 6 ,7003,1322,1162,9487
9/27/2018,2018,9,27, 7 ,7136,1288,1093,9517
9/27/2018,2018,9,27, 8 ,8094,1490,1257,10841
9/27/2018,2018,9,27, 9 ,8971,1702,1474,12147
9/27/2018,2018,9,27, 10 ,9546,1831,1623,13000
9/27/2018,2018,9,27, 11 ,9772,1865,1701,13338
9/27/2018,2018,9,27, 12 ,9614,1825,1659,13098
9/27/2018,2018,9,27, 13 ,9531,1863,1652,13046
9/27/2018,2018,9,27, 14 ,9866,1929,1724,13519
9/27/2018,2018,9,27, 15 ,9764,1914,1697,13375
9/27/2018,2018,9,27, 16 ,9651,1860,1679,13190
9/27/2018,2018,9,27, 17 ,9289,1784,1605,12678
9/27/2018,2018,9,27, 18 ,9185,1923,1738,12846
9/27/2018,2018,9,27, 19 ,9291,1890,1684,12865
9/27/2018,2018,9,27, 20 ,9159,1829,1609,12597
9/27/2018,2018,9,27, 21 ,9001,1740,1576,12317
9/27/2018,2018,9,27, 22 ,8722,1608,1426,11756
9/27/2018,2018,9,27, 23 ,8215,1497,1315,11027
9/27/2018,2018,9,27, 24 ,7841,1411,1156,10408
9/28/2018,2018,9,28, 1 ,7444,1361,1170,9975
9/28/2018,2018,9,28, 2 ,7208,1320,1126,9654
9/28/2018,2018,9,28, 3 ,6984,1285,1099,9368
9/28/2018,2018,9,28, 4 ,6903,1271,1089,9263
9/28/2018,2018,9,28, 5 ,6959,1310,1130,9399
9/28/2018,2018,9,28, 6 ,7023,1331,1155,9509
9/28/2018,2018,9,28, 7 ,7149,1297,1104,9550
9/28/2018,2018,9,28, 8 ,8149,1473,1271,10893
9/28/2018,2018,9,28, 9 ,8901,1701,1496,12098
9/28/2018,2018,9,28, 10 ,9435,1822,1653,12910
9/28/2018,2018,9,28, 11 ,9700,1878,1705,13283
9/28/2018,2018,9,28, 12 ,9466,1833,1679,12978
9/28/2018,2018,9,28, 13 ,9505,1831,1666,13002
9/28/2018,2018,9,28, 14 ,9814,1898,1739,13451
9/28/2018,2018,9,28, 15 ,9752,1887,1712,13351
9/28/2018,2018,9,28, 16 ,9629,1834,1676,13139
9/28/2018,2018,9,28, 17 ,9111,1776,1601,12488
9/28/2018,2018,9,28, 18 ,9118,1904,1743,12765
9/28/2018,2018,9,28, 19 ,9235,1873,1682,12790
9/28/2018,2018,9,28, 20 ,9117,1816,1625,12558
9/28/2018,2018,9,28, 21 ,8969,1734,1566,12269
9/28/2018,2018,9,28, 22 ,8698,1620,1434,11752
9/28/2018,2018,9,28, 23 ,8233,1505,1332,11070
9/28/2018,2018,9,28, 24 ,7847,1432,1239,10518
9/29/2018,2018,9,29, 1 ,7488,1358,1188,10034
9/29/2018,2018,9,29, 2 ,7269,1321,1144,9734
9/29/2018,2018,9,29, 3 ,7061,1284,1104,9449
9/29/2018,2018,9,29, 4 ,6904,1256,1081,9241
9/29/2018,2018,9,29, 5 ,6814,1266,1092,9172
9/29/2018,2018,9,29, 6 ,6789,1266,1118,9173
9/29/2018,2018,9,29, 7 ,6842,1280,1124,9246
9/29/2018,2018,9,29, 8 ,7519,1409,1177,10105
9/29/2018,2018,9,29, 9 ,8141,1584,1370,11095
9/29/2018,2018,9,29, 10 ,8850,1709,1517,12076
9/29/2018,2018,9,29, 11 ,9137,1767,1592,12496
9/29/2018,2018,9,29, 12 ,8967,1728,1564,12259
9/29/2018,2018,9,29, 13 ,8909,1738,1573,12220
9/29/2018,2018,9,29, 14 ,9145,1789,1625,12559
9/29/2018,2018,9,29, 15 ,9038,1764,1568,12370
9/29/2018,2018,9,29, 16 ,8810,1716,1525,12051
9/29/2018,2018,9,29, 17 ,8393,1660,1515,11568
9/29/2018,2018,9,29, 18 ,8520,1814,1684,12018
9/29/2018,2018,9,29, 19 ,8811,1807,1627,12245
9/29/2018,2018,9,29, 20 ,8762,1770,1607,12139
9/29/2018,2018,9,29, 21 ,8704,1705,1542,11951
9/29/2018,2018,9,29, 22 ,8477,1630,1468,11575
9/29/2018,2018,9,29, 23 ,8122,1500,1336,10958
9/29/2018,2018,9,29, 24 ,7716,1421,1258,10395
9/30/2018,2018,9,30, 1 ,7330,1358,1183,9871
9/30/2018,2018,9,30, 2 ,7045,1320,1142,9507
9/30/2018,2018,9,30, 3 ,6849,1275,1085,9209
9/30/2018,2018,9,30, 4 ,6661,1250,1081,8992
9/30/2018,2018,9,30, 5 ,6602,1245,1082,8929
9/30/2018,2018,9,30, 6 ,6399,1214,1068,8681
9/30/2018,2018,9,30, 7 ,6370,1220,1071,8661
9/30/2018,2018,9,30, 8 ,6700,1303,1122,9125
9/30/2018,2018,9,30, 9 ,7094,1395,1227,9716
9/30/2018,2018,9,30, 10 ,7655,1476,1339,10470
9/30/2018,2018,9,30, 11 ,7945,1530,1402,10877
9/30/2018,2018,9,30, 12 ,7883,1528,1414,10825
9/30/2018,2018,9,30, 13 ,7945,1531,1410,10886
9/30/2018,2018,9,30, 14 ,8035,1543,1437,11015
9/30/2018,2018,9,30, 15 ,7970,1520,1411,10901
9/30/2018,2018,9,30, 16 ,7772,1502,1378,10652
9/30/2018,2018,9,30, 17 ,7631,1497,1383,10511
9/30/2018,2018,9,30, 18 ,7925,1709,1546,11180
9/30/2018,2018,9,30, 19 ,8396,1738,1520,11654
9/30/2018,2018,9,30, 20 ,8456,1718,1532,11706
9/30/2018,2018,9,30, 21 ,8441,1662,1482,11585
9/30/2018,2018,9,30, 22 ,8139,1570,1376,11085
9/30/2018,2018,9,30, 23 ,7731,1457,1257,10445
9/30/2018,2018,9,30, 24 ,7355,1365,1183,9903
10/1/2018,2018,10,1, 1 ,7014,1306,1130,9450
10/1/2018,2018,10,1, 2 ,6714,1271,1074,9059
10/1/2018,2018,10,1, 3 ,6596,1246,1049,8891
10/1/2018,2018,10,1, 4 ,6467,1229,1043,8739
10/1/2018,2018,10,1, 5 ,6572,1257,1087,8916
10/1/2018,2018,10,1, 6 ,6701,1302,1133,9136
10/1/2018,2018,10,1, 7 ,6878,1281,1061,9220
10/1/2018,2018,10,1, 8 ,7860,1456,1282,10598
10/1/2018,2018,10,1, 9 ,8805,1690,1470,11965
10/1/2018,2018,10,1, 10 ,9505,1777,1613,12895
10/1/2018,2018,10,1, 11 ,9864,1861,1650,13375
10/1/2018,2018,10,1, 12 ,9687,1811,1650,13148
10/1/2018,2018,10,1, 13 ,9673,1793,1662,13128
10/1/2018,2018,10,1, 14 ,10016,1780,1714,13510
10/1/2018,2018,10,1, 15 ,9751,1755,1720,13226
10/1/2018,2018,10,1, 16 ,9751,1761,1674,13186
10/1/2018,2018,10,1, 17 ,9168,1738,1631,12537
10/1/2018,2018,10,1, 18 ,9159,1869,1721,12749
10/1/2018,2018,10,1, 19 ,9254,1855,1670,12779
10/1/2018,2018,10,1, 20 ,9248,1797,1642,12687
10/1/2018,2018,10,1, 21 ,9025,1701,1574,12300
10/1/2018,2018,10,1, 22 ,8664,1563,1418,11645
10/1/2018,2018,10,1, 23 ,8219,1445,1306,10970
10/1/2018,2018,10,1, 24 ,7827,1367,1244,10438
10/2/2018,2018,10,2, 1 ,7489,1321,1178,9988
10/2/2018,2018,10,2, 2 ,7267,1279,1138,9684
10/2/2018,2018,10,2, 3 ,7121,1250,1099,9470
10/2/2018,2018,10,2, 4 ,6982,1231,1082,9295
10/2/2018,2018,10,2, 5 ,7074,1282,1139,9495
10/2/2018,2018,10,2, 6 ,7147,1313,1187,9647
10/2/2018,2018,10,2, 7 ,7233,1278,1102,9613
10/2/2018,2018,10,2, 8 ,8153,1461,1281,10895
10/2/2018,2018,10,2, 9 ,9046,1701,1498,12245
10/2/2018,2018,10,2, 10 ,9538,1817,1646,13001
10/2/2018,2018,10,2, 11 ,9817,1886,1737,13440
10/2/2018,2018,10,2, 12 ,9543,1856,1713,13112
10/2/2018,2018,10,2, 13 ,9530,1860,1712,13102
10/2/2018,2018,10,2, 14 ,9884,1936,1741,13561
10/2/2018,2018,10,2, 15 ,9423,1873,1711,13007
10/2/2018,2018,10,2, 16 ,9160,1810,1660,12630
10/2/2018,2018,10,2, 17 ,8915,1790,1631,12336
10/2/2018,2018,10,2, 18 ,8957,1924,1784,12665
10/2/2018,2018,10,2, 19 ,8982,1848,1666,12496
10/2/2018,2018,10,2, 20 ,8910,1819,1649,12378
10/2/2018,2018,10,2, 21 ,8746,1742,1591,12079
10/2/2018,2018,10,2, 22 ,8303,1601,1442,11346
10/2/2018,2018,10,2, 23 ,7911,1492,1336,10739
10/2/2018,2018,10,2, 24 ,7460,1407,1232,10099
10/3/2018,2018,10,3, 1 ,7162,1350,1160,9672
10/3/2018,2018,10,3, 2 ,6939,1304,1111,9354
10/3/2018,2018,10,3, 3 ,6753,1275,1076,9104
10/3/2018,2018,10,3, 4 ,6710,1261,1061,9032
10/3/2018,2018,10,3, 5 ,6848,1304,1121,9273
10/3/2018,2018,10,3, 6 ,6975,1340,1148,9463
10/3/2018,2018,10,3, 7 ,7007,1292,1087,9386
10/3/2018,2018,10,3, 8 ,7966,1448,1230,10644
10/3/2018,2018,10,3, 9 ,8797,1681,1448,11926
10/3/2018,2018,10,3, 10 ,9327,1805,1618,12750
10/3/2018,2018,10,3, 11 ,9682,1879,1700,13261
10/3/2018,2018,10,3, 12 ,9436,1817,1603,12856
10/3/2018,2018,10,3, 13 ,9441,1825,1656,12922
10/3/2018,2018,10,3, 14 ,9802,1893,1721,13416
10/3/2018,2018,10,3, 15 ,9653,1864,1708,13225
10/3/2018,2018,10,3, 16 ,9444,1817,1659,12920
10/3/2018,2018,10,3, 17 ,9143,1763,1580,12486
10/3/2018,2018,10,3, 18 ,9240,1909,1730,12879
10/3/2018,2018,10,3, 19 ,9232,1879,1667,12778
10/3/2018,2018,10,3, 20 ,9127,1810,1629,12566
10/3/2018,2018,10,3, 21 ,8870,1732,1547,12149
10/3/2018,2018,10,3, 22 ,8550,1589,1391,11530
10/3/2018,2018,10,3, 23 ,8009,1468,1286,10763
10/3/2018,2018,10,3, 24 ,7553,1388,1194,10135
10/4/2018,2018,10,4, 1 ,7165,1330,1126,9621
10/4/2018,2018,10,4, 2 ,6991,1290,1103,9384
10/4/2018,2018,10,4, 3 ,6729,1261,1069,9059
10/4/2018,2018,10,4, 4 ,6680,1246,1063,8989
10/4/2018,2018,10,4, 5 ,6752,1289,1126,9167
10/4/2018,2018,10,4, 6 ,6938,1321,1177,9436
10/4/2018,2018,10,4, 7 ,7058,1287,1092,9437
10/4/2018,2018,10,4, 8 ,8028,1455,1286,10769
10/4/2018,2018,10,4, 9 ,8782,1687,1501,11970
10/4/2018,2018,10,4, 10 ,9420,1810,1673,12903
10/4/2018,2018,10,4, 11 ,9652,1901,1701,13254
10/4/2018,2018,10,4, 12 ,9489,1861,1684,13034
10/4/2018,2018,10,4, 13 ,9542,1872,1683,13097
10/4/2018,2018,10,4, 14 ,9915,1925,1732,13572
10/4/2018,2018,10,4, 15 ,9750,1903,1696,13349
10/4/2018,2018,10,4, 16 ,9570,1852,1677,13099
10/4/2018,2018,10,4, 17 ,9095,1772,1645,12512
10/4/2018,2018,10,4, 18 ,9159,1921,1765,12845
10/4/2018,2018,10,4, 19 ,9162,1894,1671,12727
10/4/2018,2018,10,4, 20 ,9101,1846,1687,12634
10/4/2018,2018,10,4, 21 ,8900,1757,1567,12224
10/4/2018,2018,10,4, 22 ,8487,1629,1448,11564
10/4/2018,2018,10,4, 23 ,7990,1510,1323,10823
10/4/2018,2018,10,4, 24 ,7582,1433,1335,10350
10/5/2018,2018,10,5, 1 ,7311,1352,1179,9842
10/5/2018,2018,10,5, 2 ,7088,1315,1143,9546
10/5/2018,2018,10,5, 3 ,6870,1265,1112,9247
10/5/2018,2018,10,5, 4 ,6713,1256,1105,9074
10/5/2018,2018,10,5, 5 ,6804,1275,1133,9212
10/5/2018,2018,10,5, 6 ,6890,1300,1169,9359
10/5/2018,2018,10,5, 7 ,7076,1283,1125,9484
10/5/2018,2018,10,5, 8 ,7964,1468,1307,10739
10/5/2018,2018,10,5, 9 ,8834,1701,1534,12069
10/5/2018,2018,10,5, 10 ,9321,1818,1671,12810
10/5/2018,2018,10,5, 11 ,9681,1902,1730,13313
10/5/2018,2018,10,5, 12 ,9468,1862,1699,13029
10/5/2018,2018,10,5, 13 ,9534,1865,1672,13071
10/5/2018,2018,10,5, 14 ,9889,1928,1748,13565
10/5/2018,2018,10,5, 15 ,9748,1896,1739,13383
10/5/2018,2018,10,5, 16 ,9569,1870,1702,13141
10/5/2018,2018,10,5, 17 ,9148,1792,1643,12583
10/5/2018,2018,10,5, 18 ,9176,1921,1719,12816
10/5/2018,2018,10,5, 19 ,9199,1848,1669,12716
10/5/2018,2018,10,5, 20 ,9055,1814,1628,12497
10/5/2018,2018,10,5, 21 ,8884,1725,1559,12168
10/5/2018,2018,10,5, 22 ,8396,1616,1387,11399
10/5/2018,2018,10,5, 23 ,8064,1499,1298,10861
10/5/2018,2018,10,5, 24 ,7638,1414,1265,10317
10/6/2018,2018,10,6, 1 ,7341,1343,1167,9851
10/6/2018,2018,10,6, 2 ,7062,1298,1129,9489
10/6/2018,2018,10,6, 3 ,6853,1262,1099,9214
10/6/2018,2018,10,6, 4 ,6702,1233,1068,9003
10/6/2018,2018,10,6, 5 ,6619,1229,1099,8947
10/6/2018,2018,10,6, 6 ,6576,1219,1068,8863
10/6/2018,2018,10,6, 7 ,6791,1232,1095,9118
10/6/2018,2018,10,6, 8 ,7403,1329,1197,9929
10/6/2018,2018,10,6, 9 ,8203,1523,1348,11074
10/6/2018,2018,10,6, 10 ,8827,1638,1482,11947
10/6/2018,2018,10,6, 11 ,9203,1707,1562,12472
10/6/2018,2018,10,6, 12 ,8956,1675,1561,12192
10/6/2018,2018,10,6, 13 ,8920,1683,1555,12158
10/6/2018,2018,10,6, 14 ,9158,1709,1617,12484
10/6/2018,2018,10,6, 15 ,9032,1660,1579,12271
10/6/2018,2018,10,6, 16 ,8690,1636,1529,11855
10/6/2018,2018,10,6, 17 ,8297,1613,1447,11357
10/6/2018,2018,10,6, 18 ,9576,1790,1594,12960
10/6/2018,2018,10,6, 19 ,8742,1778,1527,12047
10/6/2018,2018,10,6, 20 ,8720,1724,1562,12006
10/6/2018,2018,10,6, 21 ,8629,1665,1526,11820
10/6/2018,2018,10,6, 22 ,8411,1563,1411,11385
10/6/2018,2018,10,6, 23 ,7978,1439,1283,10700
10/6/2018,2018,10,6, 24 ,7559,1353,1216,10128
10/7/2018,2018,10,7, 1 ,7253,1291,1145,9689
10/7/2018,2018,10,7, 2 ,7039,1251,1104,9394
10/7/2018,2018,10,7, 3 ,6766,1221,1076,9063
10/7/2018,2018,10,7, 4 ,6670,1200,1047,8917
10/7/2018,2018,10,7, 5 ,6548,1201,1043,8792
10/7/2018,2018,10,7, 6 ,6293,1163,1060,8516
10/7/2018,2018,10,7, 7 ,6286,1189,1052,8527
10/7/2018,2018,10,7, 8 ,6625,1261,1074,8960
10/7/2018,2018,10,7, 9 ,7131,1375,1150,9656
10/7/2018,2018,10,7, 10 ,7616,1489,1245,10350
10/7/2018,2018,10,7, 11 ,7967,1547,1306,10820
10/7/2018,2018,10,7, 12 ,7875,1548,1324,10747
10/7/2018,2018,10,7, 13 ,7953,1561,1352,10866
10/7/2018,2018,10,7, 14 ,8037,1563,1366,10966
10/7/2018,2018,10,7, 15 ,7967,1544,1311,10822
10/7/2018,2018,10,7, 16 ,7743,1520,1301,10564
10/7/2018,2018,10,7, 17 ,7620,1520,1272,10412
10/7/2018,2018,10,7, 18 ,8140,1733,1479,11352
10/7/2018,2018,10,7, 19 ,8384,1728,1528,11640
10/7/2018,2018,10,7, 20 ,8455,1697,1512,11664
10/7/2018,2018,10,7, 21 ,8394,1633,1482,11509
10/7/2018,2018,10,7, 22 ,8040,1524,1378,10942
10/7/2018,2018,10,7, 23 ,7641,1414,1298,10353
10/7/2018,2018,10,7, 24 ,7286,1335,1209,9830
10/8/2018,2018,10,8, 1 ,6978,1275,1119,9372
10/8/2018,2018,10,8, 2 ,6654,1241,1107,9002
10/8/2018,2018,10,8, 3 ,6504,1194,1065,8763
10/8/2018,2018,10,8, 4 ,6432,1175,1059,8666
10/8/2018,2018,10,8, 5 ,6550,1230,1129,8909
10/8/2018,2018,10,8, 6 ,6724,1268,1135,9127
10/8/2018,2018,10,8, 7 ,6900,1243,1071,9214
10/8/2018,2018,10,8, 8 ,7914,1438,1255,10607
10/8/2018,2018,10,8, 9 ,8933,1692,1514,12139
10/8/2018,2018,10,8, 10 ,9543,1832,1566,12941
10/8/2018,2018,10,8, 11 ,9922,1912,1719,13553
10/8/2018,2018,10,8, 12 ,9756,1867,1711,13334
10/8/2018,2018,10,8, 13 ,9725,1872,1703,13300
10/8/2018,2018,10,8, 14 ,10041,1944,1741,13726
10/8/2018,2018,10,8, 15 ,9919,1924,1760,13603
10/8/2018,2018,10,8, 16 ,9643,1877,1729,13249
10/8/2018,2018,10,8, 17 ,9201,1808,1643,12652
10/8/2018,2018,10,8, 18 ,9336,1933,1790,13059
10/8/2018,2018,10,8, 19 ,9281,1904,1716,12901
10/8/2018,2018,10,8, 20 ,9287,1834,1667,12788
10/8/2018,2018,10,8, 21 ,9070,1759,1602,12431
10/8/2018,2018,10,8, 22 ,8724,1625,1503,11852
10/8/2018,2018,10,8, 23 ,8234,1499,1386,11119
10/8/2018,2018,10,8, 24 ,7835,1420,1247,10502
10/9/2018,2018,10,9, 1 ,7464,1358,1197,10019
10/9/2018,2018,10,9, 2 ,7179,1318,1162,9659
10/9/2018,2018,10,9, 3 ,6988,1285,1137,9410
10/9/2018,2018,10,9, 4 ,6907,1261,1121,9289
10/9/2018,2018,10,9, 5 ,7025,1309,1149,9483
10/9/2018,2018,10,9, 6 ,7082,1345,1193,9620
10/9/2018,2018,10,9, 7 ,7194,1300,1101,9595
10/9/2018,2018,10,9, 8 ,8127,1498,1300,10925
10/9/2018,2018,10,9, 9 ,9083,1758,1555,12396
10/9/2018,2018,10,9, 10 ,9625,1858,1679,13162
10/9/2018,2018,10,9, 11 ,9933,1938,1769,13640
10/9/2018,2018,10,9, 12 ,9740,1886,1730,13356
10/9/2018,2018,10,9, 13 ,9670,1906,1756,13332
10/9/2018,2018,10,9, 14 ,10052,1962,1826,13840
10/9/2018,2018,10,9, 15 ,9907,1943,1793,13643
10/9/2018,2018,10,9, 16 ,9779,1903,1765,13447
10/9/2018,2018,10,9, 17 ,9353,1830,1664,12847
10/9/2018,2018,10,9, 18 ,9503,1982,1813,13298
10/9/2018,2018,10,9, 19 ,9510,1927,1745,13182
10/9/2018,2018,10,9, 20 ,9375,1877,1707,12959
10/9/2018,2018,10,9, 21 ,9200,1784,1640,12624
10/9/2018,2018,10,9, 22 ,8790,1643,1503,11936
10/9/2018,2018,10,9, 23 ,8390,1524,1388,11302
10/9/2018,2018,10,9, 24 ,7990,1429,1273,10692
10/10/2018,2018,10,10, 1 ,7596,1366,1212,10174
10/10/2018,2018,10,10, 2 ,7369,1323,1181,9873
10/10/2018,2018,10,10, 3 ,7136,1293,1134,9563
10/10/2018,2018,10,10, 4 ,7006,1271,1130,9407
10/10/2018,2018,10,10, 5 ,7132,1306,1179,9617
10/10/2018,2018,10,10, 6 ,7139,1324,1201,9664
10/10/2018,2018,10,10, 7 ,7244,1299,1136,9679
10/10/2018,2018,10,10, 8 ,8271,1506,1325,11102
10/10/2018,2018,10,10, 9 ,9137,1738,1582,12457
10/10/2018,2018,10,10, 10 ,9725,1862,1771,13358
10/10/2018,2018,10,10, 11 ,9993,1941,1785,13719
10/10/2018,2018,10,10, 12 ,9791,1883,1748,13422
10/10/2018,2018,10,10, 13 ,9805,1912,1761,13478
10/10/2018,2018,10,10, 14 ,10073,1981,1782,13836
10/10/2018,2018,10,10, 15 ,9952,1973,1801,13726
10/10/2018,2018,10,10, 16 ,9697,1906,1761,13364
10/10/2018,2018,10,10, 17 ,9257,1827,1666,12750
10/10/2018,2018,10,10, 18 ,9383,1985,1818,13186
10/10/2018,2018,10,10, 19 ,9408,1944,1752,13104
10/10/2018,2018,10,10, 20 ,9279,1893,1703,12875
10/10/2018,2018,10,10, 21 ,9100,1791,1644,12535
10/10/2018,2018,10,10, 22 ,8733,1655,1516,11904
10/10/2018,2018,10,10, 23 ,8313,1532,1376,11221
10/10/2018,2018,10,10, 24 ,7857,1449,1291,10597
10/11/2018,2018,10,11, 1 ,7497,1379,1228,10104
10/11/2018,2018,10,11, 2 ,7255,1332,1189,9776
10/11/2018,2018,10,11, 3 ,7087,1313,1146,9546
10/11/2018,2018,10,11, 4 ,6975,1297,1128,9400
10/11/2018,2018,10,11, 5 ,7061,1325,1177,9563
10/11/2018,2018,10,11, 6 ,7060,1361,1194,9615
10/11/2018,2018,10,11, 7 ,7158,1319,1134,9611
10/11/2018,2018,10,11, 8 ,8130,1515,1311,10956
10/11/2018,2018,10,11, 9 ,9071,1752,1568,12391
10/11/2018,2018,10,11, 10 ,9606,1880,1703,13189
10/11/2018,2018,10,11, 11 ,9970,1964,1788,13722
10/11/2018,2018,10,11, 12 ,9762,1918,1738,13418
10/11/2018,2018,10,11, 13 ,9782,1923,1754,13459
10/11/2018,2018,10,11, 14 ,10130,2008,1834,13972
10/11/2018,2018,10,11, 15 ,10061,1969,1813,13843
10/11/2018,2018,10,11, 16 ,9898,1945,1772,13615
10/11/2018,2018,10,11, 17 ,9505,1856,1685,13046
10/11/2018,2018,10,11, 18 ,9640,1993,1828,13461
10/11/2018,2018,10,11, 19 ,9449,1953,1761,13163
10/11/2018,2018,10,11, 20 ,9439,1906,1711,13056
10/11/2018,2018,10,11, 21 ,9216,1827,1655,12698
10/11/2018,2018,10,11, 22 ,8846,1689,1510,12045
10/11/2018,2018,10,11, 23 ,8411,1559,1395,11365
10/11/2018,2018,10,11, 24 ,8024,1485,1274,10783
10/12/2018,2018,10,12, 1 ,7678,1431,1229,10338
10/12/2018,2018,10,12, 2 ,7413,1385,1177,9975
10/12/2018,2018,10,12, 3 ,7236,1352,1141,9729
10/12/2018,2018,10,12, 4 ,7126,1335,1130,9591
10/12/2018,2018,10,12, 5 ,7185,1373,1167,9725
10/12/2018,2018,10,12, 6 ,7223,1365,1177,9765
10/12/2018,2018,10,12, 7 ,7344,1350,1138,9832
10/12/2018,2018,10,12, 8 ,8323,1548,1305,11176
10/12/2018,2018,10,12, 9 ,9219,1783,1534,12536
10/12/2018,2018,10,12, 10 ,9840,1907,1680,13427
10/12/2018,2018,10,12, 11 ,10124,1979,1772,13875
10/12/2018,2018,10,12, 12 ,9926,1923,1739,13588
10/12/2018,2018,10,12, 13 ,9929,1943,1740,13612
10/12/2018,2018,10,12, 14 ,10330,2015,1804,14149
10/12/2018,2018,10,12, 15 ,10165,1988,1754,13907
10/12/2018,2018,10,12, 16 ,10026,1962,1738,13726
10/12/2018,2018,10,12, 17 ,9497,1872,1669,13038
10/12/2018,2018,10,12, 18 ,9575,1997,1813,13385
10/12/2018,2018,10,12, 19 ,9445,1953,1735,13133
10/12/2018,2018,10,12, 20 ,9395,1914,1695,13004
10/12/2018,2018,10,12, 21 ,9235,1835,1639,12709
10/12/2018,2018,10,12, 22 ,8905,1719,1513,12137
10/12/2018,2018,10,12, 23 ,8446,1596,1410,11452
10/12/2018,2018,10,12, 24 ,8057,1513,1291,10861
10/13/2018,2018,10,13, 1 ,7715,1459,1252,10426
10/13/2018,2018,10,13, 2 ,7425,1403,1202,10030
10/13/2018,2018,10,13, 3 ,7212,1369,1170,9751
10/13/2018,2018,10,13, 4 ,7054,1346,1142,9542
10/13/2018,2018,10,13, 5 ,6994,1348,1151,9493
10/13/2018,2018,10,13, 6 ,6866,1329,1148,9343
10/13/2018,2018,10,13, 7 ,7045,1350,1145,9540
10/13/2018,2018,10,13, 8 ,7657,1485,1258,10400
10/13/2018,2018,10,13, 9 ,8496,1654,1427,11577
10/13/2018,2018,10,13, 10 ,9089,1731,1529,12349
10/13/2018,2018,10,13, 11 ,9388,1811,1620,12819
10/13/2018,2018,10,13, 12 ,9301,1754,1610,12665
10/13/2018,2018,10,13, 13 ,9336,1753,1609,12698
10/13/2018,2018,10,13, 14 ,9629,1820,1650,13099
10/13/2018,2018,10,13, 15 ,9444,1784,1587,12815
10/13/2018,2018,10,13, 16 ,9207,1718,1523,12448
10/13/2018,2018,10,13, 17 ,8740,1693,1535,11968
10/13/2018,2018,10,13, 18 ,9022,1886,1701,12609
10/13/2018,2018,10,13, 19 ,9053,1858,1612,12523
10/13/2018,2018,10,13, 20 ,9102,1820,1590,12512
10/13/2018,2018,10,13, 21 ,9079,1745,1522,12346
10/13/2018,2018,10,13, 22 ,8745,1659,1437,11841
10/13/2018,2018,10,13, 23 ,8312,1538,1350,11200
10/13/2018,2018,10,13, 24 ,8081,1457,1296,10834
10/14/2018,2018,10,14, 1 ,7668,1398,1161,10227
10/14/2018,2018,10,14, 2 ,7417,1354,1131,9902
10/14/2018,2018,10,14, 3 ,7217,1314,1091,9622
10/14/2018,2018,10,14, 4 ,7086,1274,1077,9437
10/14/2018,2018,10,14, 5 ,6882,1275,1086,9243
10/14/2018,2018,10,14, 6 ,6668,1250,1061,8979
10/14/2018,2018,10,14, 7 ,6641,1256,1064,8961
10/14/2018,2018,10,14, 8 ,7008,1341,1109,9458
10/14/2018,2018,10,14, 9 ,7427,1450,1195,10072
10/14/2018,2018,10,14, 10 ,7875,1559,1314,10748
10/14/2018,2018,10,14, 11 ,8193,1622,1381,11196
10/14/2018,2018,10,14, 12 ,8196,1623,1397,11216
10/14/2018,2018,10,14, 13 ,8206,1625,1412,11243
10/14/2018,2018,10,14, 14 ,8210,1621,1414,11245
10/14/2018,2018,10,14, 15 ,7968,1580,1310,10858
10/14/2018,2018,10,14, 16 ,7757,1548,1305,10610
10/14/2018,2018,10,14, 17 ,7658,1539,1354,10551
10/14/2018,2018,10,14, 18 ,8265,1769,1477,11511
10/14/2018,2018,10,14, 19 ,8402,1731,1446,11579
10/14/2018,2018,10,14, 20 ,8472,1697,1413,11582
10/14/2018,2018,10,14, 21 ,8423,1628,1367,11418
10/14/2018,2018,10,14, 22 ,8077,1535,1274,10886
10/14/2018,2018,10,14, 23 ,7705,1430,1199,10334
10/14/2018,2018,10,14, 24 ,7330,1355,1212,9897
10/15/2018,2018,10,15, 1 ,7003,1299,1029,9331
10/15/2018,2018,10,15, 2 ,6762,1257,1002,9021
10/15/2018,2018,10,15, 3 ,6596,1228,981,8805
10/15/2018,2018,10,15, 4 ,6498,1204,980,8682
10/15/2018,2018,10,15, 5 ,6629,1237,1041,8907
10/15/2018,2018,10,15, 6 ,6744,1286,1101,9131
10/15/2018,2018,10,15, 7 ,6971,1250,1025,9246
10/15/2018,2018,10,15, 8 ,7962,1413,1189,10564
10/15/2018,2018,10,15, 9 ,9035,1671,1435,12141
10/15/2018,2018,10,15, 10 ,9611,1779,1584,12974
10/15/2018,2018,10,15, 11 ,9858,1867,1669,13394
10/15/2018,2018,10,15, 12 ,9694,1831,1645,13170
10/15/2018,2018,10,15, 13 ,9687,1823,1664,13174
10/15/2018,2018,10,15, 14 ,10049,1884,1697,13630
10/15/2018,2018,10,15, 15 ,9620,1892,1676,13188
10/15/2018,2018,10,15, 16 ,9375,1851,1593,12819
10/15/2018,2018,10,15, 17 ,9062,1794,1542,12398
10/15/2018,2018,10,15, 18 ,9242,1955,1638,12835
10/15/2018,2018,10,15, 19 ,9111,1878,1591,12580
10/15/2018,2018,10,15, 20 ,9007,1834,1537,12378
10/15/2018,2018,10,15, 21 ,8829,1738,1473,12040
10/15/2018,2018,10,15, 22 ,8418,1597,1329,11344
10/15/2018,2018,10,15, 23 ,7934,1473,1228,10635
10/15/2018,2018,10,15, 24 ,7449,1401,1173,10023
10/16/2018,2018,10,16, 1 ,7253,1338,1149,9740
10/16/2018,2018,10,16, 2 ,6948,1293,1109,9350
10/16/2018,2018,10,16, 3 ,6751,1263,1082,9096
10/16/2018,2018,10,16, 4 ,6695,1240,1079,9014
10/16/2018,2018,10,16, 5 ,6836,1276,1134,9246
10/16/2018,2018,10,16, 6 ,6906,1318,1197,9421
10/16/2018,2018,10,16, 7 ,7026,1282,1129,9437
10/16/2018,2018,10,16, 8 ,7972,1447,1250,10669
10/16/2018,2018,10,16, 9 ,8968,1668,1414,12050
10/16/2018,2018,10,16, 10 ,9496,1793,1579,12868
10/16/2018,2018,10,16, 11 ,9954,1876,1626,13456
10/16/2018,2018,10,16, 12 ,9738,1829,1626,13193
10/16/2018,2018,10,16, 13 ,9733,1860,1627,13220
10/16/2018,2018,10,16, 14 ,9978,1909,1684,13571
10/16/2018,2018,10,16, 15 ,9828,1848,1635,13311
10/16/2018,2018,10,16, 16 ,9610,1819,1599,13028
10/16/2018,2018,10,16, 17 ,9232,1795,1585,12612
10/16/2018,2018,10,16, 18 ,9455,1905,1696,13056
10/16/2018,2018,10,16, 19 ,9390,1840,1618,12848
10/16/2018,2018,10,16, 20 ,9239,1787,1565,12591
10/16/2018,2018,10,16, 21 ,9026,1687,1444,12157
10/16/2018,2018,10,16, 22 ,8602,1546,1321,11469
10/16/2018,2018,10,16, 23 ,8152,1433,1165,10750
10/16/2018,2018,10,16, 24 ,7698,1368,1155,10221
10/17/2018,2018,10,17, 1 ,7407,1311,1106,9824
10/17/2018,2018,10,17, 2 ,7152,1275,1059,9486
10/17/2018,2018,10,17, 3 ,6954,1242,1047,9243
10/17/2018,2018,10,17, 4 ,6817,1229,1043,9089
10/17/2018,2018,10,17, 5 ,6967,1278,1106,9351
10/17/2018,2018,10,17, 6 ,7020,1321,1145,9486
10/17/2018,2018,10,17, 7 ,7156,1286,1066,9508
10/17/2018,2018,10,17, 8 ,8161,1472,1243,10876
10/17/2018,2018,10,17, 9 ,9037,1712,1494,12243
10/17/2018,2018,10,17, 10 ,9592,1851,1622,13065
10/17/2018,2018,10,17, 11 ,9954,1927,1705,13586
10/17/2018,2018,10,17, 12 ,9783,1868,1675,13326
10/17/2018,2018,10,17, 13 ,9765,1841,1681,13287
10/17/2018,2018,10,17, 14 ,10157,1886,1725,13768
10/17/2018,2018,10,17, 15 ,9999,1854,1693,13546
10/17/2018,2018,10,17, 16 ,9737,1830,1573,13140
10/17/2018,2018,10,17, 17 ,9241,1788,1579,12608
10/17/2018,2018,10,17, 18 ,9462,1939,1617,13018
10/17/2018,2018,10,17, 19 ,9281,1866,1592,12739
10/17/2018,2018,10,17, 20 ,9205,1798,1547,12550
10/17/2018,2018,10,17, 21 ,8904,1698,1464,12066
10/17/2018,2018,10,17, 22 ,8546,1553,1341,11440
10/17/2018,2018,10,17, 23 ,8121,1439,1214,10774
10/17/2018,2018,10,17, 24 ,7719,1376,1160,10255
10/18/2018,2018,10,18, 1 ,7325,1305,1111,9741
10/18/2018,2018,10,18, 2 ,7125,1270,1074,9469
10/18/2018,2018,10,18, 3 ,6889,1244,1045,9178
10/18/2018,2018,10,18, 4 ,6824,1219,1047,9090
10/18/2018,2018,10,18, 5 ,6990,1264,1104,9358
10/18/2018,2018,10,18, 6 ,7000,1307,1146,9453
10/18/2018,2018,10,18, 7 ,7100,1272,1073,9445
10/18/2018,2018,10,18, 8 ,8014,1460,1244,10718
10/18/2018,2018,10,18, 9 ,8999,1706,1446,12151
10/18/2018,2018,10,18, 10 ,9605,1838,1602,13045
10/18/2018,2018,10,18, 11 ,9925,1915,1686,13526
10/18/2018,2018,10,18, 12 ,9747,1873,1633,13253
10/18/2018,2018,10,18, 13 ,9759,1887,1641,13287
10/18/2018,2018,10,18, 14 ,10189,1943,1732,13864
10/18/2018,2018,10,18, 15 ,10053,1923,1700,13676
10/18/2018,2018,10,18, 16 ,9823,1878,1658,13359
10/18/2018,2018,10,18, 17 ,9341,1811,1623,12775
10/18/2018,2018,10,18, 18 ,9577,1959,1755,13291
10/18/2018,2018,10,18, 19 ,9470,1887,1677,13034
10/18/2018,2018,10,18, 20 ,9372,1815,1613,12800
10/18/2018,2018,10,18, 21 ,9188,1727,1511,12426
10/18/2018,2018,10,18, 22 ,8767,1588,1384,11739
10/18/2018,2018,10,18, 23 ,8229,1466,1302,10997
10/18/2018,2018,10,18, 24 ,7832,1394,1208,10434
10/19/2018,2018,10,19, 1 ,7467,1335,1165,9967
10/19/2018,2018,10,19, 2 ,7280,1294,1124,9698
10/19/2018,2018,10,19, 3 ,7012,1256,1088,9356
10/19/2018,2018,10,19, 4 ,6865,1234,1082,9181
10/19/2018,2018,10,19, 5 ,6978,1275,1132,9385
10/19/2018,2018,10,19, 6 ,7016,1299,1198,9513
10/19/2018,2018,10,19, 7 ,7104,1273,1118,9495
10/19/2018,2018,10,19, 8 ,8073,1475,1258,10806
10/19/2018,2018,10,19, 9 ,9047,1689,1467,12203
10/19/2018,2018,10,19, 10 ,9511,1792,1597,12900
10/19/2018,2018,10,19, 11 ,9855,1863,1627,13345
10/19/2018,2018,10,19, 12 ,9682,1844,1599,13125
10/19/2018,2018,10,19, 13 ,9633,1870,1609,13112
10/19/2018,2018,10,19, 14 ,9983,1849,1664,13496
10/19/2018,2018,10,19, 15 ,9872,1867,1641,13380
10/19/2018,2018,10,19, 16 ,9707,1824,1607,13138
10/19/2018,2018,10,19, 17 ,9199,1753,1542,12494
10/19/2018,2018,10,19, 18 ,9367,1920,1721,13008
10/19/2018,2018,10,19, 19 ,9295,1854,1633,12782
10/19/2018,2018,10,19, 20 ,9125,1804,1571,12500
10/19/2018,2018,10,19, 21 ,8992,1723,1493,12208
10/19/2018,2018,10,19, 22 ,8704,1593,1377,11674
10/19/2018,2018,10,19, 23 ,8226,1466,1283,10975
10/19/2018,2018,10,19, 24 ,7804,1375,1224,10403
10/20/2018,2018,10,20, 1 ,7544,1307,1114,9965
10/20/2018,2018,10,20, 2 ,7293,1273,1088,9654
10/20/2018,2018,10,20, 3 ,7043,1242,1060,9345
10/20/2018,2018,10,20, 4 ,6875,1224,1045,9144
10/20/2018,2018,10,20, 5 ,6744,1231,1058,9033
10/20/2018,2018,10,20, 6 ,6722,1238,1104,9064
10/20/2018,2018,10,20, 7 ,6847,1270,1101,9218
10/20/2018,2018,10,20, 8 ,7594,1398,1210,10202
10/20/2018,2018,10,20, 9 ,8371,1585,1393,11349
10/20/2018,2018,10,20, 10 ,8909,1683,1513,12105
10/20/2018,2018,10,20, 11 ,9220,1750,1580,12550
10/20/2018,2018,10,20, 12 ,9027,1698,1564,12289
10/20/2018,2018,10,20, 13 ,9032,1669,1551,12252
10/20/2018,2018,10,20, 14 ,9209,1728,1605,12542
10/20/2018,2018,10,20, 15 ,9097,1702,1488,12287
10/20/2018,2018,10,20, 16 ,8884,1668,1522,12074
10/20/2018,2018,10,20, 17 ,8607,1652,1522,11781
10/20/2018,2018,10,20, 18 ,8939,1823,1658,12420
10/20/2018,2018,10,20, 19 ,8885,1775,1576,12236
10/20/2018,2018,10,20, 20 ,8907,1706,1519,12132
10/20/2018,2018,10,20, 21 ,8802,1621,1436,11859
10/20/2018,2018,10,20, 22 ,8459,1535,1341,11335
10/20/2018,2018,10,20, 23 ,8051,1429,1256,10736
10/20/2018,2018,10,20, 24 ,7666,1357,1188,10211
10/21/2018,2018,10,21, 1 ,7394,1305,1111,9810
10/21/2018,2018,10,21, 2 ,7157,1258,1069,9484
10/21/2018,2018,10,21, 3 ,6895,1237,1035,9167
10/21/2018,2018,10,21, 4 ,6696,1209,1022,8927
10/21/2018,2018,10,21, 5 ,6590,1202,1040,8832
10/21/2018,2018,10,21, 6 ,6395,1188,1050,8633
10/21/2018,2018,10,21, 7 ,6335,1207,1035,8577
10/21/2018,2018,10,21, 8 ,6540,1289,1086,8915
10/21/2018,2018,10,21, 9 ,7015,1403,1195,9613
10/21/2018,2018,10,21, 10 ,7472,1477,1291,10240
10/21/2018,2018,10,21, 11 ,7775,1565,1382,10722
10/21/2018,2018,10,21, 12 ,7682,1540,1380,10602
10/21/2018,2018,10,21, 13 ,7608,1561,1362,10531
10/21/2018,2018,10,21, 14 ,7698,1561,1359,10618
10/21/2018,2018,10,21, 15 ,7552,1532,1292,10376
10/21/2018,2018,10,21, 16 ,7386,1499,1274,10159
10/21/2018,2018,10,21, 17 ,7358,1518,1332,10208
10/21/2018,2018,10,21, 18 ,8000,1755,1493,11248
10/21/2018,2018,10,21, 19 ,8180,1729,1487,11396
10/21/2018,2018,10,21, 20 ,8188,1693,1444,11325
10/21/2018,2018,10,21, 21 ,8182,1623,1360,11165
10/21/2018,2018,10,21, 22 ,7901,1537,1264,10702
10/21/2018,2018,10,21, 23 ,7477,1420,1177,10074
10/21/2018,2018,10,21, 24 ,7123,1335,1106,9564
10/22/2018,2018,10,22, 1 ,6819,1285,1052,9156
10/22/2018,2018,10,22, 2 ,6582,1207,1017,8806
10/22/2018,2018,10,22, 3 ,6362,1193,980,8535
10/22/2018,2018,10,22, 4 ,6251,1183,987,8421
10/22/2018,2018,10,22, 5 ,6377,1213,1034,8624
10/22/2018,2018,10,22, 6 ,6559,1248,1091,8898
10/22/2018,2018,10,22, 7 ,6856,1266,1070,9192
10/22/2018,2018,10,22, 8 ,7879,1452,1248,10579
10/22/2018,2018,10,22, 9 ,8817,1700,1465,11982
10/22/2018,2018,10,22, 10 ,9497,1839,1607,12943
10/22/2018,2018,10,22, 11 ,9782,1881,1696,13359
10/22/2018,2018,10,22, 12 ,9596,1903,1664,13163
10/22/2018,2018,10,22, 13 ,9643,1882,1595,13120
10/22/2018,2018,10,22, 14 ,9992,1931,1634,13557
10/22/2018,2018,10,22, 15 ,9767,1900,1622,13289
10/22/2018,2018,10,22, 16 ,9671,1819,1551,13041
10/22/2018,2018,10,22, 17 ,9137,1805,1539,12481
10/22/2018,2018,10,22, 18 ,9282,1928,1612,12822
10/22/2018,2018,10,22, 19 ,9152,1883,1564,12599
10/22/2018,2018,10,22, 20 ,9088,1824,1505,12417
10/22/2018,2018,10,22, 21 ,8897,1727,1416,12040
10/22/2018,2018,10,22, 22 ,8506,1598,1306,11410
10/22/2018,2018,10,22, 23 ,8052,1481,1198,10731
10/22/2018,2018,10,22, 24 ,7584,1387,1114,10085
10/23/2018,2018,10,23, 1 ,7259,1347,1054,9660
10/23/2018,2018,10,23, 2 ,7025,1300,1020,9345
10/23/2018,2018,10,23, 3 ,6819,1260,998,9077
10/23/2018,2018,10,23, 4 ,6699,1240,986,8925
10/23/2018,2018,10,23, 5 ,6711,1268,1025,9004
10/23/2018,2018,10,23, 6 ,6779,1288,1092,9159
10/23/2018,2018,10,23, 7 ,7038,1304,1085,9427
10/23/2018,2018,10,23, 8 ,7928,1495,1244,10667
10/23/2018,2018,10,23, 9 ,8851,1700,1460,12011
10/23/2018,2018,10,23, 10 ,9382,1842,1586,12810
10/23/2018,2018,10,23, 11 ,9750,1893,1587,13230
10/23/2018,2018,10,23, 12 ,9584,1854,1654,13092
10/23/2018,2018,10,23, 13 ,9584,1853,1666,13103
10/23/2018,2018,10,23, 14 ,9974,1918,1750,13642
10/23/2018,2018,10,23, 15 ,9870,1866,1722,13458
10/23/2018,2018,10,23, 16 ,9653,1829,1641,13123
10/23/2018,2018,10,23, 17 ,9166,1771,1592,12529
10/23/2018,2018,10,23, 18 ,9442,1909,1727,13078
10/23/2018,2018,10,23, 19 ,9308,1835,1646,12789
10/23/2018,2018,10,23, 20 ,9115,1784,1598,12497
10/23/2018,2018,10,23, 21 ,8974,1697,1523,12194
10/23/2018,2018,10,23, 22 ,8570,1552,1394,11516
10/23/2018,2018,10,23, 23 ,8059,1449,1275,10783
10/23/2018,2018,10,23, 24 ,7734,1365,1179,10278
10/24/2018,2018,10,24, 1 ,7376,1319,1129,9824
10/24/2018,2018,10,24, 2 ,7055,1274,1090,9419
10/24/2018,2018,10,24, 3 ,6891,1239,1059,9189
10/24/2018,2018,10,24, 4 ,6781,1221,1044,9046
10/24/2018,2018,10,24, 5 ,6829,1251,1081,9161
10/24/2018,2018,10,24, 6 ,6976,1277,1116,9369
10/24/2018,2018,10,24, 7 ,7146,1288,1106,9540
10/24/2018,2018,10,24, 8 ,8046,1473,1262,10781
10/24/2018,2018,10,24, 9 ,8897,1712,1498,12107
10/24/2018,2018,10,24, 10 ,9440,1836,1637,12913
10/24/2018,2018,10,24, 11 ,9842,1900,1726,13468
10/24/2018,2018,10,24, 12 ,9665,1857,1680,13202
10/24/2018,2018,10,24, 13 ,9654,1882,1671,13207
10/24/2018,2018,10,24, 14 ,9983,1950,1734,13667
10/24/2018,2018,10,24, 15 ,9827,1913,1709,13449
10/24/2018,2018,10,24, 16 ,9696,1864,1658,13218
10/24/2018,2018,10,24, 17 ,9186,1785,1598,12569
10/24/2018,2018,10,24, 18 ,9437,1959,1651,13047
10/24/2018,2018,10,24, 19 ,9219,1887,1617,12723
10/24/2018,2018,10,24, 20 ,9090,1828,1552,12470
10/24/2018,2018,10,24, 21 ,8922,1743,1469,12134
10/24/2018,2018,10,24, 22 ,8516,1605,1350,11471
10/24/2018,2018,10,24, 23 ,8081,1486,1246,10813
10/24/2018,2018,10,24, 24 ,7657,1401,1210,10268
10/25/2018,2018,10,25, 1 ,7386,1352,1107,9845
10/25/2018,2018,10,25, 2 ,7139,1308,1071,9518
10/25/2018,2018,10,25, 3 ,6940,1266,1040,9246
10/25/2018,2018,10,25, 4 ,6813,1240,1040,9093
10/25/2018,2018,10,25, 5 ,6835,1264,1077,9176
10/25/2018,2018,10,25, 6 ,6882,1276,1122,9280
10/25/2018,2018,10,25, 7 ,7147,1299,1109,9555
10/25/2018,2018,10,25, 8 ,8100,1468,1271,10839
10/25/2018,2018,10,25, 9 ,8932,1689,1496,12117
10/25/2018,2018,10,25, 10 ,9472,1787,1635,12894
10/25/2018,2018,10,25, 11 ,9876,1874,1719,13469
10/25/2018,2018,10,25, 12 ,9680,1841,1685,13206
10/25/2018,2018,10,25, 13 ,9630,1869,1648,13147
10/25/2018,2018,10,25, 14 ,10047,1943,1744,13734
10/25/2018,2018,10,25, 15 ,9873,1908,1716,13497
10/25/2018,2018,10,25, 16 ,9684,1875,1692,13251
10/25/2018,2018,10,25, 17 ,9207,1788,1598,12593
10/25/2018,2018,10,25, 18 ,9466,1945,1728,13139
10/25/2018,2018,10,25, 19 ,9274,1869,1676,12819
10/25/2018,2018,10,25, 20 ,9247,1804,1619,12670
10/25/2018,2018,10,25, 21 ,8023,1727,1521,11271
10/25/2018,2018,10,25, 22 ,8659,1604,1404,11667
10/25/2018,2018,10,25, 23 ,8242,1488,1291,11021
10/25/2018,2018,10,25, 24 ,7878,1404,1176,10458
10/26/2018,2018,10,26, 1 ,7487,1357,1148,9992
10/26/2018,2018,10,26, 2 ,8257,1309,1115,10681
10/26/2018,2018,10,26, 3 ,7030,1274,1078,9382
10/26/2018,2018,10,26, 4 ,6966,1243,1066,9275
10/26/2018,2018,10,26, 5 ,6942,1266,1102,9310
10/26/2018,2018,10,26, 6 ,7045,1286,1135,9466
10/26/2018,2018,10,26, 7 ,7249,1300,1119,9668
10/26/2018,2018,10,26, 8 ,8079,1482,1280,10841
10/26/2018,2018,10,26, 9 ,8955,1726,1502,12183
10/26/2018,2018,10,26, 10 ,9562,1863,1612,13037
10/26/2018,2018,10,26, 11 ,9871,1926,1714,13511
10/26/2018,2018,10,26, 12 ,9668,1883,1687,13238
10/26/2018,2018,10,26, 13 ,9618,1903,1679,13200
10/26/2018,2018,10,26, 14 ,10056,1949,1763,13768
10/26/2018,2018,10,26, 15 ,9917,1909,1725,13551
10/26/2018,2018,10,26, 16 ,9751,1885,1699,13335
10/26/2018,2018,10,26, 17 ,9188,1779,1628,12595
10/26/2018,2018,10,26, 18 ,9384,1931,1757,13072
10/26/2018,2018,10,26, 19 ,9194,1859,1653,12706
10/26/2018,2018,10,26, 20 ,9121,1790,1587,12498
10/26/2018,2018,10,26, 21 ,8939,1721,1517,12177
10/26/2018,2018,10,26, 22 ,8596,1606,1408,11610
10/26/2018,2018,10,26, 23 ,8194,1486,1290,10970
10/26/2018,2018,10,26, 24 ,7832,1405,1213,10450
10/27/2018,2018,10,27, 1 ,7494,1349,1154,9997
10/27/2018,2018,10,27, 2 ,7256,1312,1128,9696
10/27/2018,2018,10,27, 3 ,7074,1271,1069,9414
10/27/2018,2018,10,27, 4 ,6883,1251,1066,9200
10/27/2018,2018,10,27, 5 ,6868,1256,1086,9210
10/27/2018,2018,10,27, 6 ,6773,1276,1096,9145
10/27/2018,2018,10,27, 7 ,6878,1281,1084,9243
10/27/2018,2018,10,27, 8 ,7495,1407,1178,10080
10/27/2018,2018,10,27, 9 ,8162,1604,1337,11103
10/27/2018,2018,10,27, 10 ,8678,1729,1456,11863
10/27/2018,2018,10,27, 11 ,8953,1802,1532,12287
10/27/2018,2018,10,27, 12 ,8866,1752,1515,12133
10/27/2018,2018,10,27, 13 ,8873,1750,1533,12156
10/27/2018,2018,10,27, 14 ,9152,1807,1567,12526
10/27/2018,2018,10,27, 15 ,9041,1768,1450,12259
10/27/2018,2018,10,27, 16 ,8783,1704,1519,12006
10/27/2018,2018,10,27, 17 ,8457,1671,1529,11657
10/27/2018,2018,10,27, 18 ,8825,1858,1695,12378
10/27/2018,2018,10,27, 19 ,8849,1806,1609,12264
10/27/2018,2018,10,27, 20 ,8829,1760,1576,12165
10/27/2018,2018,10,27, 21 ,8596,1685,1506,11787
10/27/2018,2018,10,27, 22 ,8337,1579,1399,11315
10/27/2018,2018,10,27, 23 ,7927,1469,1291,10687
10/27/2018,2018,10,27, 24 ,7627,1389,1209,10225
10/28/2018,2018,10,28, 1 ,7323,1334,1150,9807
10/28/2018,2018,10,28, 2 ,7113,1284,1106,9503
10/28/2018,2018,10,28, 3 ,6888,1257,1074,9219
10/28/2018,2018,10,28, 4 ,6669,1229,1050,8948
10/28/2018,2018,10,28, 5 ,6621,1225,1059,8905
10/28/2018,2018,10,28, 6 ,6423,1215,1054,8692
10/28/2018,2018,10,28, 7 ,6429,1228,1053,8710
10/28/2018,2018,10,28, 8 ,6695,1290,1098,9083
10/28/2018,2018,10,28, 9 ,7197,1399,1193,9789
10/28/2018,2018,10,28, 10 ,7771,1500,1324,10595
10/28/2018,2018,10,28, 11 ,8049,1548,1402,10999
10/28/2018,2018,10,28, 12 ,7993,1528,1399,10920
10/28/2018,2018,10,28, 13 ,7988,1529,1381,10898
10/28/2018,2018,10,28, 14 ,8047,1518,1415,10980
10/28/2018,2018,10,28, 15 ,7947,1504,1413,10864
10/28/2018,2018,10,28, 16 ,7770,1481,1368,10619
10/28/2018,2018,10,28, 17 ,7642,1523,1352,10517
10/28/2018,2018,10,28, 18 ,8329,1730,1612,11671
10/28/2018,2018,10,28, 19 ,8352,1702,1560,11614
10/28/2018,2018,10,28, 20 ,8350,1686,1526,11562
10/28/2018,2018,10,28, 21 ,8165,1591,1442,11198
10/28/2018,2018,10,28, 22 ,7849,1489,1330,10668
10/28/2018,2018,10,28, 23 ,7518,1413,1237,10168
10/28/2018,2018,10,28, 24 ,7133,1332,1143,9608
10/29/2018,2018,10,29, 1 ,6764,1268,1136,9168
10/29/2018,2018,10,29, 2 ,6504,1231,1070,8805
10/29/2018,2018,10,29, 3 ,6295,1203,1035,8533
10/29/2018,2018,10,29, 4 ,6190,1196,1016,8402
10/29/2018,2018,10,29, 5 ,6282,1231,1079,8592
10/29/2018,2018,10,29, 6 ,6392,1274,1112,8778
10/29/2018,2018,10,29, 7 ,6647,1273,1088,9008
10/29/2018,2018,10,29, 8 ,7379,1445,1258,10082
10/29/2018,2018,10,29, 9 ,8149,1698,1508,11355
10/29/2018,2018,10,29, 10 ,8665,1815,1658,12138
10/29/2018,2018,10,29, 11 ,9029,1877,1741,12647
10/29/2018,2018,10,29, 12 ,8895,1827,1736,12458
10/29/2018,2018,10,29, 13 ,8885,1822,1713,12420
10/29/2018,2018,10,29, 14 ,9260,1877,1801,12938
10/29/2018,2018,10,29, 15 ,9115,1872,1773,12760
10/29/2018,2018,10,29, 16 ,8945,1818,1743,12506
10/29/2018,2018,10,29, 17 ,8605,1775,1655,12035
10/29/2018,2018,10,29, 18 ,8886,1909,1785,12580
10/29/2018,2018,10,29, 19 ,8659,1841,1694,12194
10/29/2018,2018,10,29, 20 ,8589,1791,1658,12038
10/29/2018,2018,10,29, 21 ,8373,1676,1573,11622
10/29/2018,2018,10,29, 22 ,7981,1527,1456,10964
10/29/2018,2018,10,29, 23 ,7531,1430,1333,10294
10/29/2018,2018,10,29, 24 ,7170,1369,1240,9779
10/30/2018,2018,10,30, 1 ,6820,1314,1177,9311
10/30/2018,2018,10,30, 2 ,6613,1285,1129,9027
10/30/2018,2018,10,30, 3 ,6434,1254,1106,8794
10/30/2018,2018,10,30, 4 ,6395,1249,1097,8741
10/30/2018,2018,10,30, 5 ,6418,1281,1136,8835
10/30/2018,2018,10,30, 6 ,6589,1308,1173,9070
10/30/2018,2018,10,30, 7 ,6725,1301,1130,9156
10/30/2018,2018,10,30, 8 ,7389,1473,1324,10186
10/30/2018,2018,10,30, 9 ,8032,1692,1526,11250
10/30/2018,2018,10,30, 10 ,8401,1825,1674,11900
10/30/2018,2018,10,30, 11 ,8565,1876,1726,12167
10/30/2018,2018,10,30, 12 ,8340,1838,1734,11912
10/30/2018,2018,10,30, 13 ,8140,1862,1707,11709
10/30/2018,2018,10,30, 14 ,8271,1911,1803,11985
10/30/2018,2018,10,30, 15 ,8178,1878,1773,11829
10/30/2018,2018,10,30, 16 ,8145,1854,1744,11743
10/30/2018,2018,10,30, 17 ,8131,1766,1650,11547
10/30/2018,2018,10,30, 18 ,8309,1945,1774,12028
10/30/2018,2018,10,30, 19 ,8051,1879,1695,11625
10/30/2018,2018,10,30, 20 ,7925,1813,1637,11375
10/30/2018,2018,10,30, 21 ,7742,1728,1582,11052
10/30/2018,2018,10,30, 22 ,7413,1606,1452,10471
10/30/2018,2018,10,30, 23 ,7067,1488,1350,9905
10/30/2018,2018,10,30, 24 ,6710,1406,1249,9365
10/31/2018,2018,10,31, 1 ,6477,1348,1186,9011
10/31/2018,2018,10,31, 2 ,6313,1304,1149,8766
10/31/2018,2018,10,31, 3 ,6205,1262,1117,8584
10/31/2018,2018,10,31, 4 ,6174,1248,1108,8530
10/31/2018,2018,10,31, 5 ,6210,1259,1130,8599
10/31/2018,2018,10,31, 6 ,6300,1276,1158,8734
10/31/2018,2018,10,31, 7 ,6620,1297,1142,9059
10/31/2018,2018,10,31, 8 ,7467,1479,1294,10240
10/31/2018,2018,10,31, 9 ,8244,1719,1523,11486
10/31/2018,2018,10,31, 10 ,8776,1832,1658,12266
10/31/2018,2018,10,31, 11 ,9107,1908,1729,12744
10/31/2018,2018,10,31, 12 ,8824,1866,1671,12361
10/31/2018,2018,10,31, 13 ,8740,1849,1624,12213
10/31/2018,2018,10,31, 14 ,8981,1901,1744,12626
10/31/2018,2018,10,31, 15 ,8781,1822,1711,12314
10/31/2018,2018,10,31, 16 ,8554,1766,1626,11946
10/31/2018,2018,10,31, 17 ,8122,1716,1581,11419
10/31/2018,2018,10,31, 18 ,8485,1898,1726,12109
10/31/2018,2018,10,31, 19 ,8315,1826,1640,11781
10/31/2018,2018,10,31, 20 ,8218,1770,1586,11574
10/31/2018,2018,10,31, 21 ,8064,1691,1539,11294
10/31/2018,2018,10,31, 22 ,7708,1587,1424,10719
10/31/2018,2018,10,31, 23 ,7296,1472,1311,10079
10/31/2018,2018,10,31, 24 ,6951,1388,1219,9558
11/1/2018,2018,11,1, 1 ,6662,1333,1160,9155
11/1/2018,2018,11,1, 2 ,6456,1294,1118,8868
11/1/2018,2018,11,1, 3 ,6260,1251,1083,8594
11/1/2018,2018,11,1, 4 ,6104,1220,1055,8379
11/1/2018,2018,11,1, 5 ,5953,1215,1059,8227
11/1/2018,2018,11,1, 6 ,5679,1180,1049,7908
11/1/2018,2018,11,1, 7 ,5620,1185,1042,7847
11/1/2018,2018,11,1, 8 ,5777,1223,1056,8056
11/1/2018,2018,11,1, 9 ,6025,1311,1160,8496
11/1/2018,2018,11,1, 10 ,6355,1392,1243,8990
11/1/2018,2018,11,1, 11 ,6632,1457,1298,9387
11/1/2018,2018,11,1, 12 ,6778,1505,1327,9610
11/1/2018,2018,11,1, 13 ,6881,1514,1324,9719
11/1/2018,2018,11,1, 14 ,6983,1516,1356,9855
11/1/2018,2018,11,1, 15 ,6901,1483,1320,9704
11/1/2018,2018,11,1, 16 ,6758,1448,1289,9495
11/1/2018,2018,11,1, 17 ,6548,1430,1295,9273
11/1/2018,2018,11,1, 18 ,7098,1646,1477,10221
11/1/2018,2018,11,1, 19 ,7146,1626,1447,10219
11/1/2018,2018,11,1, 20 ,7224,1607,1412,10243
11/1/2018,2018,11,1, 21 ,7239,1580,1367,10186
11/1/2018,2018,11,1, 22 ,7162,1499,1258,9919
11/1/2018,2018,11,1, 23 ,6922,1423,1177,9522
11/1/2018,2018,11,1, 24 ,6640,1338,1114,9092
11/2/2018,2018,11,2, 1 ,6406,1299,1055,8760
11/2/2018,2018,11,2, 2 ,6138,1264,1023,8425
11/2/2018,2018,11,2, 3 ,5938,1231,988,8157
11/2/2018,2018,11,2, 4 ,5813,1199,967,7979
11/2/2018,2018,11,2, 5 ,5781,1196,986,7963
11/2/2018,2018,11,2, 6 ,5719,1175,994,7888
11/2/2018,2018,11,2, 7 ,5732,1180,994,7906
11/2/2018,2018,11,2, 8 ,6104,1265,1069,8438
11/2/2018,2018,11,2, 9 ,6706,1381,1154,9241
11/2/2018,2018,11,2, 10 ,7322,1489,1265,10076
11/2/2018,2018,11,2, 11 ,7553,1545,1344,10442
11/2/2018,2018,11,2, 12 ,7614,1542,1349,10505
11/2/2018,2018,11,2, 13 ,7681,1548,1357,10586
11/2/2018,2018,11,2, 14 ,7818,1570,1377,10765
11/2/2018,2018,11,2, 15 ,7729,1544,1354,10627
11/2/2018,2018,11,2, 16 ,7633,1508,1349,10490
11/2/2018,2018,11,2, 17 ,7404,1490,1346,10240
11/2/2018,2018,11,2, 18 ,7992,1721,1528,11241
11/2/2018,2018,11,2, 19 ,8026,1700,1519,11245
11/2/2018,2018,11,2, 20 ,8065,1674,1483,11222
11/2/2018,2018,11,2, 21 ,7977,1631,1414,11022
11/2/2018,2018,11,2, 22 ,7727,1551,1304,10582
11/2/2018,2018,11,2, 23 ,7376,1444,1204,10024
11/2/2018,2018,11,2, 24 ,7060,1366,1146,9572
11/3/2018,2018,11,3, 1 ,6755,1313,1097,9165
11/3/2018,2018,11,3, 2 ,6517,1268,1061,8846
11/3/2018,2018,11,3, 3 ,6282,1235,1026,8543
11/3/2018,2018,11,3, 4 ,6094,1218,1009,8321
11/3/2018,2018,11,3, 5 ,6061,1219,1017,8297
11/3/2018,2018,11,3, 6 ,5989,1203,1030,8222
11/3/2018,2018,11,3, 7 ,6170,1229,1045,8444
11/3/2018,2018,11,3, 8 ,6767,1324,1166,9257
11/3/2018,2018,11,3, 9 ,7451,1499,1320,10270
11/3/2018,2018,11,3, 10 ,8097,1599,1420,11116
11/3/2018,2018,11,3, 11 ,8422,1651,1480,11553
11/3/2018,2018,11,3, 12 ,8352,1647,1480,11479
11/3/2018,2018,11,3, 13 ,8329,1664,1480,11473
11/3/2018,2018,11,3, 14 ,8542,1682,1458,11682
11/3/2018,2018,11,3, 15 ,8421,1669,1406,11496
11/3/2018,2018,11,3, 16 ,8173,1611,1373,11157
11/3/2018,2018,11,3, 17 ,7944,1606,1415,10965
11/3/2018,2018,11,3, 18 ,8442,1809,1511,11762
11/3/2018,2018,11,3, 19 ,8359,1776,1507,11642
11/3/2018,2018,11,3, 20 ,8379,1727,1466,11572
11/3/2018,2018,11,3, 21 ,8344,1621,1408,11373
11/3/2018,2018,11,3, 22 ,8046,1541,1305,10892
11/3/2018,2018,11,3, 23 ,7701,1445,1220,10366
11/3/2018,2018,11,3, 24 ,7322,1356,1160,9838
11/4/2018,2018,11,4, 1 ,7116,1295,1081,9492
11/4/2018,2018,11,4, 2 ,6832,1253,1059,9144
11/4/2018,2018,11,4, 3 ,6619,1223,1019,8861
11/4/2018,2018,11,4, 4 ,6408,1200,1015,8623
11/4/2018,2018,11,4, 5 ,6344,1202,1028,8574
11/4/2018,2018,11,4, 6 ,6172,1188,1037,8397
11/4/2018,2018,11,4, 7 ,6208,1199,1039,8446
11/4/2018,2018,11,4, 8 ,6588,1261,1094,8943
11/4/2018,2018,11,4, 9 ,7188,1382,1216,9786
11/4/2018,2018,11,4, 10 ,7720,1467,1322,10509
11/4/2018,2018,11,4, 11 ,7998,1524,1385,10907
11/4/2018,2018,11,4, 12 ,7969,1523,1392,10884
11/4/2018,2018,11,4, 13 ,7912,1518,1378,10808
11/4/2018,2018,11,4, 14 ,8006,1530,1389,10925
11/4/2018,2018,11,4, 15 ,7929,1508,1348,10785
11/4/2018,2018,11,4, 16 ,7744,1476,1340,10560
11/4/2018,2018,11,4, 17 ,7632,1497,1381,10510
11/4/2018,2018,11,4, 18 ,8268,1736,1502,11506
11/4/2018,2018,11,4, 19 ,8302,1698,1489,11489
11/4/2018,2018,11,4, 20 ,8331,1666,1408,11405
11/4/2018,2018,11,4, 21 ,8272,1615,1350,11237
11/4/2018,2018,11,4, 22 ,7993,1515,1236,10744
11/4/2018,2018,11,4, 23 ,7549,1415,1120,10084
11/4/2018,2018,11,4, 24 ,7224,1334,1065,9623
11/5/2018,2018,11,5, 1 ,6877,1276,1086,9239
11/5/2018,2018,11,5, 2 ,6628,1237,1049,8914
11/5/2018,2018,11,5, 3 ,6503,1200,1026,8729
11/5/2018,2018,11,5, 4 ,6407,1186,1026,8619
11/5/2018,2018,11,5, 5 ,6534,1227,1092,8853
11/5/2018,2018,11,5, 6 ,6702,1271,1118,9091
11/5/2018,2018,11,5, 7 ,6889,1252,1050,9191
11/5/2018,2018,11,5, 8 ,7869,1392,1254,10515
11/5/2018,2018,11,5, 9 ,8814,1605,1467,11886
11/5/2018,2018,11,5, 10 ,9335,1715,1599,12649
11/5/2018,2018,11,5, 11 ,9763,1765,1676,13204
11/5/2018,2018,11,5, 12 ,9596,1710,1678,12984
11/5/2018,2018,11,5, 13 ,9527,1712,1623,12862
11/5/2018,2018,11,5, 14 ,9862,1775,1701,13338
11/5/2018,2018,11,5, 15 ,9789,1760,1669,13218
11/5/2018,2018,11,5, 16 ,9636,1763,1640,13039
11/5/2018,2018,11,5, 17 ,9176,1748,1621,12545
11/5/2018,2018,11,5, 18 ,9391,1885,1708,12984
11/5/2018,2018,11,5, 19 ,9221,1814,1651,12686
11/5/2018,2018,11,5, 20 ,9070,1762,1551,12383
11/5/2018,2018,11,5, 21 ,8942,1670,1504,12116
11/5/2018,2018,11,5, 22 ,8616,1546,1386,11548
11/5/2018,2018,11,5, 23 ,8139,1428,1259,10826
11/5/2018,2018,11,5, 24 ,7719,1350,1186,10255
11/6/2018,2018,11,6, 1 ,7407,1296,1137,9840
11/6/2018,2018,11,6, 2 ,7123,1262,1097,9482
11/6/2018,2018,11,6, 3 ,6961,1227,1073,9261
11/6/2018,2018,11,6, 4 ,6831,1214,1072,9117
11/6/2018,2018,11,6, 5 ,6951,1259,1130,9340
11/6/2018,2018,11,6, 6 ,7035,1313,1177,9525
11/6/2018,2018,11,6, 7 ,7162,1283,1084,9529
11/6/2018,2018,11,6, 8 ,8104,1445,1248,10797
11/6/2018,2018,11,6, 9 ,8877,1663,1444,11984
11/6/2018,2018,11,6, 10 ,9403,1762,1618,12783
11/6/2018,2018,11,6, 11 ,9767,1829,1684,13280
11/6/2018,2018,11,6, 12 ,9598,1768,1685,13051
11/6/2018,2018,11,6, 13 ,9595,1769,1703,13067
11/6/2018,2018,11,6, 14 ,9941,1824,1741,13506
11/6/2018,2018,11,6, 15 ,9907,1806,1717,13430
11/6/2018,2018,11,6, 16 ,9718,1799,1697,13214
11/6/2018,2018,11,6, 17 ,9342,1750,1653,12745
11/6/2018,2018,11,6, 18 ,9527,1926,1752,13205
11/6/2018,2018,11,6, 19 ,9342,1850,1685,12877
11/6/2018,2018,11,6, 20 ,9244,1773,1620,12637
11/6/2018,2018,11,6, 21 ,9060,1681,1531,12272
11/6/2018,2018,11,6, 22 ,8695,1551,1398,11644
11/6/2018,2018,11,6, 23 ,8258,1434,1275,10967
11/6/2018,2018,11,6, 24 ,7806,1350,1202,10358
11/7/2018,2018,11,7, 1 ,7488,1309,1153,9950
11/7/2018,2018,11,7, 2 ,7271,1261,1118,9650
11/7/2018,2018,11,7, 3 ,7129,1225,1077,9431
11/7/2018,2018,11,7, 4 ,7000,1203,1076,9279
11/7/2018,2018,11,7, 5 ,7142,1261,1136,9539
11/7/2018,2018,11,7, 6 ,7147,1315,1182,9644
11/7/2018,2018,11,7, 7 ,7299,1280,1113,9692
11/7/2018,2018,11,7, 8 ,8134,1452,1286,10872
11/7/2018,2018,11,7, 9 ,8959,1694,1502,12155
11/7/2018,2018,11,7, 10 ,9466,1807,1670,12943
11/7/2018,2018,11,7, 11 ,9742,1885,1720,13347
11/7/2018,2018,11,7, 12 ,9457,1836,1673,12966
11/7/2018,2018,11,7, 13 ,9402,1861,1712,12975
11/7/2018,2018,11,7, 14 ,9854,1921,1721,13496
11/7/2018,2018,11,7, 15 ,9732,1908,1708,13348
11/7/2018,2018,11,7, 16 ,9633,1857,1680,13170
11/7/2018,2018,11,7, 17 ,9181,1797,1639,12617
11/7/2018,2018,11,7, 18 ,9484,1945,1767,13196
11/7/2018,2018,11,7, 19 ,9129,1877,1667,12673
11/7/2018,2018,11,7, 20 ,9134,1815,1605,12554
11/7/2018,2018,11,7, 21 ,8858,1744,1537,12139
11/7/2018,2018,11,7, 22 ,8461,1626,1419,11506
11/7/2018,2018,11,7, 23 ,8093,1503,1316,10912
11/7/2018,2018,11,7, 24 ,7679,1404,1233,10316
11/8/2018,2018,11,8, 1 ,7312,1350,1175,9837
11/8/2018,2018,11,8, 2 ,7044,1308,1135,9487
11/8/2018,2018,11,8, 3 ,6871,1275,1096,9242
11/8/2018,2018,11,8, 4 ,6777,1250,1098,9125
11/8/2018,2018,11,8, 5 ,6913,1284,1157,9354
11/8/2018,2018,11,8, 6 ,6983,1320,1196,9499
11/8/2018,2018,11,8, 7 ,7032,1297,1121,9450
11/8/2018,2018,11,8, 8 ,8021,1472,1306,10799
11/8/2018,2018,11,8, 9 ,8843,1723,1525,12091
11/8/2018,2018,11,8, 10 ,9395,1831,1631,12857
11/8/2018,2018,11,8, 11 ,9716,1914,1025,12655
11/8/2018,2018,11,8, 12 ,9535,1850,1180,12565
11/8/2018,2018,11,8, 13 ,9555,1860,1315,12730
11/8/2018,2018,11,8, 14 ,9959,1944,1594,13497
11/8/2018,2018,11,8, 15 ,9818,1895,1662,13375
11/8/2018,2018,11,8, 16 ,9544,1867,1643,13054
11/8/2018,2018,11,8, 17 ,9057,1800,1641,12498
11/8/2018,2018,11,8, 18 ,9370,1959,1770,13099
11/8/2018,2018,11,8, 19 ,9156,1882,1695,12733
11/8/2018,2018,11,8, 20 ,9015,1827,1598,12440
11/8/2018,2018,11,8, 21 ,8808,1726,1546,12080
11/8/2018,2018,11,8, 22 ,8507,1609,1419,11535
11/8/2018,2018,11,8, 23 ,7964,1495,1309,10768
11/8/2018,2018,11,8, 24 ,7538,1403,1216,10157
11/9/2018,2018,11,9, 1 ,7263,1341,1076,9680
11/9/2018,2018,11,9, 2 ,7046,1284,1088,9418
11/9/2018,2018,11,9, 3 ,6888,1253,1091,9232
11/9/2018,2018,11,9, 4 ,6787,1241,1088,9116
11/9/2018,2018,11,9, 5 ,6848,1290,1088,9226
11/9/2018,2018,11,9, 6 ,6863,1319,1173,9355
11/9/2018,2018,11,9, 7 ,7073,1283,1118,9474
11/9/2018,2018,11,9, 8 ,7879,1480,1280,10639
11/9/2018,2018,11,9, 9 ,8812,1731,1514,12057
11/9/2018,2018,11,9, 10 ,9228,1867,1643,12738
11/9/2018,2018,11,9, 11 ,9513,1913,1667,13093
11/9/2018,2018,11,9, 12 ,9203,1874,1684,12761
11/9/2018,2018,11,9, 13 ,9186,1878,1646,12710
11/9/2018,2018,11,9, 14 ,9534,1932,1742,13208
11/9/2018,2018,11,9, 15 ,9273,1916,1701,12890
11/9/2018,2018,11,9, 16 ,9185,1880,1679,12744
11/9/2018,2018,11,9, 17 ,8908,1796,1614,12318
11/9/2018,2018,11,9, 18 ,9197,1948,1775,12920
11/9/2018,2018,11,9, 19 ,8980,1871,1676,12527
11/9/2018,2018,11,9, 20 ,8895,1810,1597,12302
11/9/2018,2018,11,9, 21 ,8741,1720,1537,11998
11/9/2018,2018,11,9, 22 ,8291,1598,1422,11311
11/9/2018,2018,11,9, 23 ,7983,1480,1306,10769
11/9/2018,2018,11,9, 24 ,7551,1394,1206,10151
11/10/2018,2018,11,10, 1 ,7276,1340,1167,9783
11/10/2018,2018,11,10, 2 ,7020,1292,1119,9431
11/10/2018,2018,11,10, 3 ,6868,1254,1081,9203
11/10/2018,2018,11,10, 4 ,6679,1239,1073,8991
11/10/2018,2018,11,10, 5 ,6651,1262,1076,8989
11/10/2018,2018,11,10, 6 ,6689,1273,1100,9062
11/10/2018,2018,11,10, 7 ,6830,1275,1105,9210
11/10/2018,2018,11,10, 8 ,7510,1383,1218,10111
11/10/2018,2018,11,10, 9 ,8238,1554,1371,11163
11/10/2018,2018,11,10, 10 ,8748,1646,1527,11921
11/10/2018,2018,11,10, 11 ,8972,1689,1596,12257
11/10/2018,2018,11,10, 12 ,8756,1667,1482,11905
11/10/2018,2018,11,10, 13 ,8695,1654,1591,11940
11/10/2018,2018,11,10, 14 ,8856,1685,1651,12192
11/10/2018,2018,11,10, 15 ,8782,1672,1632,12086
11/10/2018,2018,11,10, 16 ,8550,1649,1590,11789
11/10/2018,2018,11,10, 17 ,8186,1634,1566,11386
11/10/2018,2018,11,10, 18 ,8538,1808,1715,12061
11/10/2018,2018,11,10, 19 ,8517,1764,1639,11920
11/10/2018,2018,11,10, 20 ,8489,1723,1587,11799
11/10/2018,2018,11,10, 21 ,8334,1644,1536,11514
11/10/2018,2018,11,10, 22 ,7968,1544,1412,10924
11/10/2018,2018,11,10, 23 ,7578,1426,1307,10311
11/10/2018,2018,11,10, 24 ,7297,1348,1224,9869
11/11/2018,2018,11,11, 1 ,6922,1306,1175,9403
11/11/2018,2018,11,11, 2 ,6708,1272,1139,9119
11/11/2018,2018,11,11, 3 ,6502,1226,1085,8813
11/11/2018,2018,11,11, 4 ,6365,1211,1069,8645
11/11/2018,2018,11,11, 5 ,6302,1222,1082,8606
11/11/2018,2018,11,11, 6 ,6140,1224,1099,8463
11/11/2018,2018,11,11, 7 ,6103,1231,1074,8408
11/11/2018,2018,11,11, 8 ,6549,1263,1121,8933
11/11/2018,2018,11,11, 9 ,6977,1379,1202,9558
11/11/2018,2018,11,11, 10 ,7552,1445,1289,10286
11/11/2018,2018,11,11, 11 ,7860,1509,1341,10710
11/11/2018,2018,11,11, 12 ,7751,1495,1317,10563
11/11/2018,2018,11,11, 13 ,7836,1518,1332,10686
11/11/2018,2018,11,11, 14 ,7849,1518,1336,10703
11/11/2018,2018,11,11, 15 ,7788,1506,1313,10607
11/11/2018,2018,11,11, 16 ,7607,1500,1308,10415
11/11/2018,2018,11,11, 17 ,7507,1520,1217,10244
11/11/2018,2018,11,11, 18 ,8135,1658,1438,11231
11/11/2018,2018,11,11, 19 ,8160,1698,1406,11264
11/11/2018,2018,11,11, 20 ,8143,1674,1463,11280
11/11/2018,2018,11,11, 21 ,8002,1603,1416,11021
11/11/2018,2018,11,11, 22 ,7708,1504,1313,10525
11/11/2018,2018,11,11, 23 ,7318,1399,1208,9925
11/11/2018,2018,11,11, 24 ,7010,1323,1114,9447
11/12/2018,2018,11,12, 1 ,6634,1264,1082,8980
11/12/2018,2018,11,12, 2 ,6383,1226,1044,8653
11/12/2018,2018,11,12, 3 ,6271,1196,1028,8495
11/12/2018,2018,11,12, 4 ,6158,1182,1024,8364
11/12/2018,2018,11,12, 5 ,6337,1235,1090,8662
11/12/2018,2018,11,12, 6 ,6532,1294,1180,9006
11/12/2018,2018,11,12, 7 ,6746,1252,1092,9090
11/12/2018,2018,11,12, 8 ,7681,1427,1264,10372
11/12/2018,2018,11,12, 9 ,8617,1671,1419,11707
11/12/2018,2018,11,12, 10 ,9265,1779,1603,12647
11/12/2018,2018,11,12, 11 ,9598,1871,1643,13112
11/12/2018,2018,11,12, 12 ,9420,1820,1604,12844
11/12/2018,2018,11,12, 13 ,9425,1815,1585,12825
11/12/2018,2018,11,12, 14 ,9791,1884,1641,13316
11/12/2018,2018,11,12, 15 ,9674,1862,1610,13146
11/12/2018,2018,11,12, 16 ,9515,1822,1596,12933
11/12/2018,2018,11,12, 17 ,9094,1783,1626,12503
11/12/2018,2018,11,12, 18 ,9479,1937,1722,13138
11/12/2018,2018,11,12, 19 ,9274,1870,1625,12769
11/12/2018,2018,11,12, 20 ,9103,1817,1556,12476
11/12/2018,2018,11,12, 21 ,8957,1719,1474,12150
11/12/2018,2018,11,12, 22 ,8589,1583,1346,11518
11/12/2018,2018,11,12, 23 ,8091,1467,1247,10805
11/12/2018,2018,11,12, 24 ,7658,1384,1149,10191
11/13/2018,2018,11,13, 1 ,7284,1327,1103,9714
11/13/2018,2018,11,13, 2 ,7082,1287,1069,9438
11/13/2018,2018,11,13, 3 ,6797,1264,1045,9106
11/13/2018,2018,11,13, 4 ,6732,1252,1045,9029
11/13/2018,2018,11,13, 5 ,6850,1311,1111,9272
11/13/2018,2018,11,13, 6 ,7018,1343,1196,9557
11/13/2018,2018,11,13, 7 ,7100,1290,1112,9502
11/13/2018,2018,11,13, 8 ,7999,1475,1255,10729
11/13/2018,2018,11,13, 9 ,8937,1703,1455,12095
11/13/2018,2018,11,13, 10 ,9466,1837,1593,12896
11/13/2018,2018,11,13, 11 ,9786,1871,1658,13315
11/13/2018,2018,11,13, 12 ,9492,1812,1626,12930
11/13/2018,2018,11,13, 13 ,9439,1824,1585,12848
11/13/2018,2018,11,13, 14 ,9834,1903,1669,13406
11/13/2018,2018,11,13, 15 ,9726,1869,1632,13227
11/13/2018,2018,11,13, 16 ,9562,1837,1623,13022
11/13/2018,2018,11,13, 17 ,9212,1808,1547,12567
11/13/2018,2018,11,13, 18 ,9527,1945,1712,13184
11/13/2018,2018,11,13, 19 ,9303,1864,1612,12779
11/13/2018,2018,11,13, 20 ,9198,1802,1548,12548
11/13/2018,2018,11,13, 21 ,8962,1714,1492,12168
11/13/2018,2018,11,13, 22 ,8507,1586,1364,11457
11/13/2018,2018,11,13, 23 ,8056,1466,1282,10804
11/13/2018,2018,11,13, 24 ,7660,1378,1186,10224
11/14/2018,2018,11,14, 1 ,7255,1331,1115,9701
11/14/2018,2018,11,14, 2 ,7074,1292,1073,9439
11/14/2018,2018,11,14, 3 ,6848,1264,1045,9157
11/14/2018,2018,11,14, 4 ,6742,1256,1044,9042
11/14/2018,2018,11,14, 5 ,6925,1304,1126,9355
11/14/2018,2018,11,14, 6 ,7034,1343,1192,9569
11/14/2018,2018,11,14, 7 ,7162,1298,1097,9557
11/14/2018,2018,11,14, 8 ,8093,1463,1267,10823
11/14/2018,2018,11,14, 9 ,9002,1698,1484,12184
11/14/2018,2018,11,14, 10 ,9541,1829,1617,12987
11/14/2018,2018,11,14, 11 ,9877,1896,1684,13457
11/14/2018,2018,11,14, 12 ,9675,1828,1665,13168
11/14/2018,2018,11,14, 13 ,9629,1801,1658,13088
11/14/2018,2018,11,14, 14 ,10047,1858,1747,13652
11/14/2018,2018,11,14, 15 ,9898,1834,1699,13431
11/14/2018,2018,11,14, 16 ,9741,1813,1662,13216
11/14/2018,2018,11,14, 17 ,9248,1799,1619,12666
11/14/2018,2018,11,14, 18 ,9535,1931,1761,13227
11/14/2018,2018,11,14, 19 ,9297,1846,1683,12826
11/14/2018,2018,11,14, 20 ,9169,1790,1589,12548
11/14/2018,2018,11,14, 21 ,8995,1695,1551,12241
11/14/2018,2018,11,14, 22 ,8595,1562,1418,11575
11/14/2018,2018,11,14, 23 ,8163,1452,1312,10927
11/14/2018,2018,11,14, 24 ,7684,1378,1178,10240
11/15/2018,2018,11,15, 1 ,7364,1324,1158,9846
11/15/2018,2018,11,15, 2 ,7145,1296,1118,9559
11/15/2018,2018,11,15, 3 ,6882,1273,1100,9255
11/15/2018,2018,11,15, 4 ,6848,1252,1099,9199
11/15/2018,2018,11,15, 5 ,6967,1311,1144,9422
11/15/2018,2018,11,15, 6 ,7026,1358,1202,9586
11/15/2018,2018,11,15, 7 ,7186,1321,1121,9628
11/15/2018,2018,11,15, 8 ,8048,1459,1265,10772
11/15/2018,2018,11,15, 9 ,8918,1698,1505,12121
11/15/2018,2018,11,15, 10 ,9483,1815,1651,12949
11/15/2018,2018,11,15, 11 ,9859,1875,1719,13453
11/15/2018,2018,11,15, 12 ,9602,1793,1707,13102
11/15/2018,2018,11,15, 13 ,9541,1830,1703,13074
11/15/2018,2018,11,15, 14 ,9979,1881,1786,13646
11/15/2018,2018,11,15, 15 ,9825,1857,1687,13369
11/15/2018,2018,11,15, 16 ,9657,1844,1645,13146
11/15/2018,2018,11,15, 17 ,9157,1811,1668,12636
11/15/2018,2018,11,15, 18 ,9479,1926,1756,13161
11/15/2018,2018,11,15, 19 ,9252,1832,1654,12738
11/15/2018,2018,11,15, 20 ,9136,1773,1588,12497
11/15/2018,2018,11,15, 21 ,8943,1661,1519,12123
11/15/2018,2018,11,15, 22 ,8581,1532,1414,11527
11/15/2018,2018,11,15, 23 ,8117,1426,1293,10836
11/15/2018,2018,11,15, 24 ,7711,1343,1207,10261
11/16/2018,2018,11,16, 1 ,7334,1292,1139,9765
11/16/2018,2018,11,16, 2 ,7089,1259,1115,9463
11/16/2018,2018,11,16, 3 ,6863,1238,1091,9192
11/16/2018,2018,11,16, 4 ,6734,1217,1079,9030
11/16/2018,2018,11,16, 5 ,6870,1261,1124,9255
11/16/2018,2018,11,16, 6 ,6939,1316,1173,9428
11/16/2018,2018,11,16, 7 ,7038,1283,1096,9417
11/16/2018,2018,11,16, 8 ,7810,1449,1239,10498
11/16/2018,2018,11,16, 9 ,8820,1696,1501,12017
11/16/2018,2018,11,16, 10 ,9386,1827,1622,12835
11/16/2018,2018,11,16, 11 ,9671,1906,1678,13255
11/16/2018,2018,11,16, 12 ,9537,1850,1677,13064
11/16/2018,2018,11,16, 13 ,9511,1870,1668,13049
11/16/2018,2018,11,16, 14 ,9842,1943,1761,13546
11/16/2018,2018,11,16, 15 ,9650,1914,1737,13301
11/16/2018,2018,11,16, 16 ,9524,1878,1695,13097
11/16/2018,2018,11,16, 17 ,9095,1802,1636,12533
11/16/2018,2018,11,16, 18 ,9396,1971,1743,13110
11/16/2018,2018,11,16, 19 ,9158,1887,1632,12677
11/16/2018,2018,11,16, 20 ,9046,1828,1634,12508
11/16/2018,2018,11,16, 21 ,8886,1751,1564,12201
11/16/2018,2018,11,16, 22 ,8493,1622,1440,11555
11/16/2018,2018,11,16, 23 ,8033,1509,1313,10855
11/16/2018,2018,11,16, 24 ,7652,1429,1175,10256
11/17/2018,2018,11,17, 1 ,7298,1365,1185,9848
11/17/2018,2018,11,17, 2 ,7025,1313,1140,9478
11/17/2018,2018,11,17, 3 ,6793,1276,1108,9177
11/17/2018,2018,11,17, 4 ,6662,1259,1084,9005
11/17/2018,2018,11,17, 5 ,6646,1275,1093,9014
11/17/2018,2018,11,17, 6 ,6544,1290,1127,8961
11/17/2018,2018,11,17, 7 ,6685,1296,1122,9103
11/17/2018,2018,11,17, 8 ,7386,1406,1188,9980
11/17/2018,2018,11,17, 9 ,8074,1564,1373,11011
11/17/2018,2018,11,17, 10 ,8660,1665,1504,11829
11/17/2018,2018,11,17, 11 ,8971,1715,1581,12267
11/17/2018,2018,11,17, 12 ,8777,1716,1538,12031
11/17/2018,2018,11,17, 13 ,8762,1708,1534,12004
11/17/2018,2018,11,17, 14 ,8965,1771,1593,12329
11/17/2018,2018,11,17, 15 ,8870,1730,1581,12181
11/17/2018,2018,11,17, 16 ,8637,1686,1543,11866
11/17/2018,2018,11,17, 17 ,8294,1654,1506,11454
11/17/2018,2018,11,17, 18 ,8766,1867,1713,12346
11/17/2018,2018,11,17, 19 ,8630,1804,1623,12057
11/17/2018,2018,11,17, 20 ,8533,1757,1535,11825
11/17/2018,2018,11,17, 21 ,8520,1673,1521,11714
11/17/2018,2018,11,17, 22 ,8196,1589,1404,11189
11/17/2018,2018,11,17, 23 ,7879,1464,1299,10642
11/17/2018,2018,11,17, 24 ,7507,1390,1222,10119
11/18/2018,2018,11,18, 1 ,7143,1318,1151,9612
11/18/2018,2018,11,18, 2 ,6877,1258,1045,9180
11/18/2018,2018,11,18, 3 ,6646,1225,1012,8883
11/18/2018,2018,11,18, 4 ,6521,1207,993,8721
11/18/2018,2018,11,18, 5 ,6454,1218,995,8667
11/18/2018,2018,11,18, 6 ,6293,1205,1035,8533
11/18/2018,2018,11,18, 7 ,6223,1216,1046,8485
11/18/2018,2018,11,18, 8 ,6599,1289,1092,8980
11/18/2018,2018,11,18, 9 ,7159,1396,1217,9772
11/18/2018,2018,11,18, 10 ,7691,1467,1314,10472
11/18/2018,2018,11,18, 11 ,7932,1537,1366,10835
11/18/2018,2018,11,18, 12 ,7847,1546,1391,10784
11/18/2018,2018,11,18, 13 ,7898,1545,1389,10832
11/18/2018,2018,11,18, 14 ,7916,1555,1403,10874
11/18/2018,2018,11,18, 15 ,7752,1519,1385,10656
11/18/2018,2018,11,18, 16 ,7602,1490,1363,10455
11/18/2018,2018,11,18, 17 ,7563,1524,1370,10457
11/18/2018,2018,11,18, 18 ,8155,1762,1554,11471
11/18/2018,2018,11,18, 19 ,8195,1735,1549,11479
11/18/2018,2018,11,18, 20 ,8092,1684,1516,11292
11/18/2018,2018,11,18, 21 ,8001,1594,1458,11053
11/18/2018,2018,11,18, 22 ,7662,1501,1353,10516
11/18/2018,2018,11,18, 23 ,7268,1393,1235,9896
11/18/2018,2018,11,18, 24 ,6876,1329,1194,9399
11/19/2018,2018,11,19, 1 ,6558,1275,1097,8930
11/19/2018,2018,11,19, 2 ,6357,1224,1077,8658
11/19/2018,2018,11,19, 3 ,6188,1191,1043,8422
11/19/2018,2018,11,19, 4 ,6073,1177,1046,8296
11/19/2018,2018,11,19, 5 ,6277,1229,1107,8613
11/19/2018,2018,11,19, 6 ,6565,1301,1171,9037
11/19/2018,2018,11,19, 7 ,6732,1254,1087,9073
11/19/2018,2018,11,19, 8 ,7650,1411,1234,10295
11/19/2018,2018,11,19, 9 ,8576,1657,1437,11670
11/19/2018,2018,11,19, 10 ,9143,1790,1483,12416
11/19/2018,2018,11,19, 11 ,9498,1835,1565,12898
11/19/2018,2018,11,19, 12 ,9252,1785,1563,12600
11/19/2018,2018,11,19, 13 ,9344,1761,1524,12629
11/19/2018,2018,11,19, 14 ,9699,1821,1578,13098
11/19/2018,2018,11,19, 15 ,9636,1806,1552,12994
11/19/2018,2018,11,19, 16 ,9487,1803,1545,12835
11/19/2018,2018,11,19, 17 ,9024,1814,1538,12376
11/19/2018,2018,11,19, 18 ,9377,1900,1653,12930
11/19/2018,2018,11,19, 19 ,9105,1827,1567,12499
11/19/2018,2018,11,19, 20 ,8945,1737,1462,12144
11/19/2018,2018,11,19, 21 ,8727,1637,1278,11642
11/19/2018,2018,11,19, 22 ,8343,1496,1216,11055
11/19/2018,2018,11,19, 23 ,7868,1382,1155,10405
11/19/2018,2018,11,19, 24 ,7469,1302,1066,9837
11/20/2018,2018,11,20, 1 ,7122,1249,1027,9398
11/20/2018,2018,11,20, 2 ,6922,1213,1012,9147
11/20/2018,2018,11,20, 3 ,6749,1172,970,8891
11/20/2018,2018,11,20, 4 ,6619,1159,979,8757
11/20/2018,2018,11,20, 5 ,6769,1208,1014,8991
11/20/2018,2018,11,20, 6 ,6934,1287,1089,9310
11/20/2018,2018,11,20, 7 ,7028,1284,1059,9371
11/20/2018,2018,11,20, 8 ,7670,1391,1159,10220
11/20/2018,2018,11,20, 9 ,8469,1559,1375,11403
11/20/2018,2018,11,20, 10 ,8881,1662,1479,12022
11/20/2018,2018,11,20, 11 ,9239,1707,1543,12489
11/20/2018,2018,11,20, 12 ,9053,1633,1535,12221
11/20/2018,2018,11,20, 13 ,8936,1613,1531,12080
11/20/2018,2018,11,20, 14 ,9252,1661,1604,12517
11/20/2018,2018,11,20, 15 ,9114,1647,1571,12332
11/20/2018,2018,11,20, 16 ,8966,1641,1558,12165
11/20/2018,2018,11,20, 17 ,8741,1656,1527,11924
11/20/2018,2018,11,20, 18 ,9020,1763,1683,12466
11/20/2018,2018,11,20, 19 ,8849,1686,1586,12121
11/20/2018,2018,11,20, 20 ,8757,1608,1495,11860
11/20/2018,2018,11,20, 21 ,8539,1492,1409,11440
11/20/2018,2018,11,20, 22 ,8175,1380,1280,10835
11/20/2018,2018,11,20, 23 ,7690,1288,1161,10139
11/20/2018,2018,11,20, 24 ,7298,1216,1121,9635
11/21/2018,2018,11,21, 1 ,6997,1187,1077,9261
11/21/2018,2018,11,21, 2 ,6776,1158,1049,8983
11/21/2018,2018,11,21, 3 ,6593,1143,1022,8758
11/21/2018,2018,11,21, 4 ,6534,1135,1014,8683
11/21/2018,2018,11,21, 5 ,6722,1170,1093,8985
11/21/2018,2018,11,21, 6 ,6930,1239,1163,9332
11/21/2018,2018,11,21, 7 ,7034,1257,1099,9390
11/21/2018,2018,11,21, 8 ,7753,1381,1254,10388
11/21/2018,2018,11,21, 9 ,8523,1573,1457,11553
11/21/2018,2018,11,21, 10 ,8968,1675,1588,12231
11/21/2018,2018,11,21, 11 ,9208,1741,1686,12635
11/21/2018,2018,11,21, 12 ,8784,1683,1651,12118
11/21/2018,2018,11,21, 13 ,8654,1664,1640,11958
11/21/2018,2018,11,21, 14 ,8848,1721,1721,12290
11/21/2018,2018,11,21, 15 ,8663,1723,1689,12075
11/21/2018,2018,11,21, 16 ,8604,1722,1675,12001
11/21/2018,2018,11,21, 17 ,8492,1712,1599,11803
11/21/2018,2018,11,21, 18 ,8867,1856,1757,12480
11/21/2018,2018,11,21, 19 ,8645,1777,1690,12112
11/21/2018,2018,11,21, 20 ,8497,1713,1612,11822
11/21/2018,2018,11,21, 21 ,8241,1600,1526,11367
11/21/2018,2018,11,21, 22 ,7863,1491,1408,10762
11/21/2018,2018,11,21, 23 ,7389,1380,1300,10069
11/21/2018,2018,11,21, 24 ,7030,1304,1199,9533
11/22/2018,2018,11,22, 1 ,6761,1263,1158,9182
11/22/2018,2018,11,22, 2 ,6571,1227,1108,8906
11/22/2018,2018,11,22, 3 ,6459,1206,1092,8757
11/22/2018,2018,11,22, 4 ,6410,1213,1084,8707
11/22/2018,2018,11,22, 5 ,6586,1244,1137,8967
11/22/2018,2018,11,22, 6 ,6791,1315,1187,9293
11/22/2018,2018,11,22, 7 ,6915,1284,1115,9314
11/22/2018,2018,11,22, 8 ,7755,1452,1276,10483
11/22/2018,2018,11,22, 9 ,8514,1698,1501,11713
11/22/2018,2018,11,22, 10 ,8963,1801,1593,12357
11/22/2018,2018,11,22, 11 ,9304,1874,1732,12910
11/22/2018,2018,11,22, 12 ,9115,1823,1684,12622
11/22/2018,2018,11,22, 13 ,9174,1820,1718,12712
11/22/2018,2018,11,22, 14 ,9476,1878,1774,13128
11/22/2018,2018,11,22, 15 ,9377,1846,1756,12979
11/22/2018,2018,11,22, 16 ,9280,1811,1716,12807
11/22/2018,2018,11,22, 17 ,8959,1765,1657,12381
11/22/2018,2018,11,22, 18 ,9278,1918,1802,12998
11/22/2018,2018,11,22, 19 ,9039,1842,1719,12600
11/22/2018,2018,11,22, 20 ,8919,1777,1671,12367
11/22/2018,2018,11,22, 21 ,8657,1658,1601,11916
11/22/2018,2018,11,22, 22 ,8263,1541,1416,11220
11/22/2018,2018,11,22, 23 ,7827,1433,1335,10595
11/22/2018,2018,11,22, 24 ,7408,1338,1215,9961
11/23/2018,2018,11,23, 1 ,7079,1284,1207,9570
11/23/2018,2018,11,23, 2 ,6824,1247,1171,9242
11/23/2018,2018,11,23, 3 ,6667,1213,1138,9018
11/23/2018,2018,11,23, 4 ,6558,1203,1121,8882
11/23/2018,2018,11,23, 5 ,6776,1254,1178,9208
11/23/2018,2018,11,23, 6 ,6857,1288,1234,9379
11/23/2018,2018,11,23, 7 ,6950,1259,1160,9369
11/23/2018,2018,11,23, 8 ,7840,1420,1296,10556
11/23/2018,2018,11,23, 9 ,8758,1685,1490,11933
11/23/2018,2018,11,23, 10 ,9288,1764,1683,12735
11/23/2018,2018,11,23, 11 ,9620,1853,1753,13226
11/23/2018,2018,11,23, 12 ,9438,1825,1719,12982
11/23/2018,2018,11,23, 13 ,9421,1819,1701,12941
11/23/2018,2018,11,23, 14 ,9713,1898,1772,13383
11/23/2018,2018,11,23, 15 ,9522,1828,1729,13079
11/23/2018,2018,11,23, 16 ,9342,1793,1708,12843
11/23/2018,2018,11,23, 17 ,8948,1748,1639,12335
11/23/2018,2018,11,23, 18 ,9259,1899,1775,12933
11/23/2018,2018,11,23, 19 ,8990,1833,1702,12525
11/23/2018,2018,11,23, 20 ,8831,1770,1649,12250
11/23/2018,2018,11,23, 21 ,8619,1675,1570,11864
11/23/2018,2018,11,23, 22 ,8306,1561,1435,11302
11/23/2018,2018,11,23, 23 ,7919,1440,1322,10681
11/23/2018,2018,11,23, 24 ,7425,1350,1270,10045
11/24/2018,2018,11,24, 1 ,7108,1297,1166,9571
11/24/2018,2018,11,24, 2 ,6829,1254,1121,9204
11/24/2018,2018,11,24, 3 ,6669,1225,1082,8976
11/24/2018,2018,11,24, 4 ,6515,1214,1070,8799
11/24/2018,2018,11,24, 5 ,6564,1230,1100,8894
11/24/2018,2018,11,24, 6 ,6523,1241,1138,8902
11/24/2018,2018,11,24, 7 ,6626,1268,1132,9026
11/24/2018,2018,11,24, 8 ,7337,1389,1201,9927
11/24/2018,2018,11,24, 9 ,8027,1566,1369,10962
11/24/2018,2018,11,24, 10 ,8641,1680,1469,11790
11/24/2018,2018,11,24, 11 ,8916,1730,1551,12197
11/24/2018,2018,11,24, 12 ,8722,1690,1526,11938
11/24/2018,2018,11,24, 13 ,8618,1703,1561,11882
11/24/2018,2018,11,24, 14 ,8767,1756,1575,12098
11/24/2018,2018,11,24, 15 ,8682,1734,1600,12016
11/24/2018,2018,11,24, 16 ,8494,1679,1522,11695
11/24/2018,2018,11,24, 17 ,8227,1639,1507,11373
11/24/2018,2018,11,24, 18 ,8707,1845,1692,12244
11/24/2018,2018,11,24, 19 ,8546,1788,1634,11968
11/24/2018,2018,11,24, 20 ,8545,1730,1590,11865
11/24/2018,2018,11,24, 21 ,8382,1651,1510,11543
11/24/2018,2018,11,24, 22 ,8018,1544,1425,10987
11/24/2018,2018,11,24, 23 ,7694,1433,1306,10433
11/24/2018,2018,11,24, 24 ,7301,1347,1198,9846
11/25/2018,2018,11,25, 1 ,6945,1292,1150,9387
11/25/2018,2018,11,25, 2 ,6721,1250,1111,9082
11/25/2018,2018,11,25, 3 ,6545,1220,1084,8849
11/25/2018,2018,11,25, 4 ,6365,1202,1066,8633
11/25/2018,2018,11,25, 5 ,6288,1206,1076,8570
11/25/2018,2018,11,25, 6 ,6207,1193,1057,8457
11/25/2018,2018,11,25, 7 ,6191,1204,1061,8456
11/25/2018,2018,11,25, 8 ,6561,1272,1109,8942
11/25/2018,2018,11,25, 9 ,7021,1367,1203,9591
11/25/2018,2018,11,25, 10 ,7543,1470,1306,10319
11/25/2018,2018,11,25, 11 ,7646,1510,1370,10526
11/25/2018,2018,11,25, 12 ,7579,1522,1390,10491
11/25/2018,2018,11,25, 13 ,7590,1516,1412,10518
11/25/2018,2018,11,25, 14 ,7513,1532,1424,10469
11/25/2018,2018,11,25, 15 ,7425,1497,1409,10331
11/25/2018,2018,11,25, 16 ,7269,1468,1363,10100
11/25/2018,2018,11,25, 17 ,7318,1506,1363,10187
11/25/2018,2018,11,25, 18 ,8013,1745,1580,11338
11/25/2018,2018,11,25, 19 ,7969,1709,1548,11226
11/25/2018,2018,11,25, 20 ,7970,1650,1503,11123
11/25/2018,2018,11,25, 21 ,7844,1593,1453,10890
11/25/2018,2018,11,25, 22 ,7510,1494,1350,10354
11/25/2018,2018,11,25, 23 ,7079,1385,1238,9702
11/25/2018,2018,11,25, 24 ,6680,1310,1192,9182
11/26/2018,2018,11,26, 1 ,6437,1253,1112,8802
11/26/2018,2018,11,26, 2 ,6226,1210,1063,8499
11/26/2018,2018,11,26, 3 ,6004,1181,1032,8217
11/26/2018,2018,11,26, 4 ,5989,1172,1037,8198
11/26/2018,2018,11,26, 5 ,6216,1224,1090,8530
11/26/2018,2018,11,26, 6 ,6426,1290,1159,8875
11/26/2018,2018,11,26, 7 ,6531,1245,1083,8859
11/26/2018,2018,11,26, 8 ,7404,1424,1209,10037
11/26/2018,2018,11,26, 9 ,8368,1666,1466,11500
11/26/2018,2018,11,26, 10 ,8963,1805,1597,12365
11/26/2018,2018,11,26, 11 ,9331,1875,1674,12880
11/26/2018,2018,11,26, 12 ,9138,1839,1650,12627
11/26/2018,2018,11,26, 13 ,9142,1836,1640,12618
11/26/2018,2018,11,26, 14 ,9546,1906,1704,13156
11/26/2018,2018,11,26, 15 ,9403,1891,1686,12980
11/26/2018,2018,11,26, 16 ,9300,1864,1666,12830
11/26/2018,2018,11,26, 17 ,8993,1787,1641,12421
11/26/2018,2018,11,26, 18 ,9315,1957,1775,13047
11/26/2018,2018,11,26, 19 ,9035,1868,1700,12603
11/26/2018,2018,11,26, 20 ,8930,1802,1634,12366
11/26/2018,2018,11,26, 21 ,8674,1716,1539,11929
11/26/2018,2018,11,26, 22 ,8304,1561,1414,11279
11/26/2018,2018,11,26, 23 ,7781,1454,1299,10534
11/26/2018,2018,11,26, 24 ,7355,1371,1234,9960
11/27/2018,2018,11,27, 1 ,7006,1313,1165,9484
11/27/2018,2018,11,27, 2 ,6798,1280,1124,9202
11/27/2018,2018,11,27, 3 ,6609,1247,1095,8951
11/27/2018,2018,11,27, 4 ,6544,1231,1092,8867
11/27/2018,2018,11,27, 5 ,6745,1271,1150,9166
11/27/2018,2018,11,27, 6 ,6843,1307,1219,9369
11/27/2018,2018,11,27, 7 ,6890,1266,1129,9285
11/27/2018,2018,11,27, 8 ,7752,1436,1267,10455
11/27/2018,2018,11,27, 9 ,8661,1682,1525,11868
11/27/2018,2018,11,27, 10 ,9184,1805,1654,12643
11/27/2018,2018,11,27, 11 ,9531,1871,1710,13112
11/27/2018,2018,11,27, 12 ,9273,1818,1680,12771
11/27/2018,2018,11,27, 13 ,9263,1827,1701,12791
11/27/2018,2018,11,27, 14 ,9652,1888,1767,13307
11/27/2018,2018,11,27, 15 ,9494,1862,1738,13094
11/27/2018,2018,11,27, 16 ,9310,1836,1717,12863
11/27/2018,2018,11,27, 17 ,8892,1787,1653,12332
11/27/2018,2018,11,27, 18 ,9219,1944,1816,12979
11/27/2018,2018,11,27, 19 ,9032,1885,1720,12637
11/27/2018,2018,11,27, 20 ,8937,1817,1647,12401
11/27/2018,2018,11,27, 21 ,8765,1716,1584,12065
11/27/2018,2018,11,27, 22 ,8304,1581,1452,11337
11/27/2018,2018,11,27, 23 ,7854,1456,1327,10637
11/27/2018,2018,11,27, 24 ,7350,1380,1256,9986
11/28/2018,2018,11,28, 1 ,7123,1324,1182,9629
11/28/2018,2018,11,28, 2 ,6880,1274,1146,9300
11/28/2018,2018,11,28, 3 ,6730,1253,1108,9091
11/28/2018,2018,11,28, 4 ,6643,1241,1087,8971
11/28/2018,2018,11,28, 5 ,6831,1291,1159,9281
11/28/2018,2018,11,28, 6 ,6972,1335,1213,9520
11/28/2018,2018,11,28, 7 ,7033,1290,1142,9465
11/28/2018,2018,11,28, 8 ,7826,1469,1283,10578
11/28/2018,2018,11,28, 9 ,8757,1717,1524,11998
11/28/2018,2018,11,28, 10 ,9213,1833,1680,12726
11/28/2018,2018,11,28, 11 ,9536,1914,1754,13204
11/28/2018,2018,11,28, 12 ,9263,1869,1704,12836
11/28/2018,2018,11,28, 13 ,9254,1891,1665,12810
11/28/2018,2018,11,28, 14 ,9620,1945,1791,13356
11/28/2018,2018,11,28, 15 ,9453,1912,1762,13127
11/28/2018,2018,11,28, 16 ,9315,1874,1728,12917
11/28/2018,2018,11,28, 17 ,8990,1803,1681,12474
11/28/2018,2018,11,28, 18 ,9289,1978,1817,13084
11/28/2018,2018,11,28, 19 ,9076,1902,1724,12702
11/28/2018,2018,11,28, 20 ,8975,1834,1691,12500
11/28/2018,2018,11,28, 21 ,8801,1752,1598,12151
11/28/2018,2018,11,28, 22 ,8378,1621,1367,11366
11/28/2018,2018,11,28, 23 ,7833,1500,1256,10589
11/28/2018,2018,11,28, 24 ,7430,1412,1164,10006
11/29/2018,2018,11,29, 1 ,7098,1354,1179,9631
11/29/2018,2018,11,29, 2 ,6914,1308,1161,9383
11/29/2018,2018,11,29, 3 ,6713,1276,1123,9112
11/29/2018,2018,11,29, 4 ,6657,1268,1113,9038
11/29/2018,2018,11,29, 5 ,6767,1316,1161,9244
11/29/2018,2018,11,29, 6 ,6926,1356,1208,9490
11/29/2018,2018,11,29, 7 ,6933,1310,1138,9381
11/29/2018,2018,11,29, 8 ,7773,1478,1294,10545
11/29/2018,2018,11,29, 9 ,8691,1651,1495,11837
11/29/2018,2018,11,29, 10 ,9144,1747,1638,12529
11/29/2018,2018,11,29, 11 ,9577,1883,1731,13191
11/29/2018,2018,11,29, 12 ,9323,1823,1691,12837
11/29/2018,2018,11,29, 13 ,9271,1841,1674,12786
11/29/2018,2018,11,29, 14 ,9606,1922,1771,13299
11/29/2018,2018,11,29, 15 ,9438,1909,1733,13080
11/29/2018,2018,11,29, 16 ,9326,1844,1703,12873
11/29/2018,2018,11,29, 17 ,8884,1778,1644,12306
11/29/2018,2018,11,29, 18 ,9229,1940,1768,12937
11/29/2018,2018,11,29, 19 ,8961,1863,1703,12527
11/29/2018,2018,11,29, 20 ,8792,1800,1628,12220
11/29/2018,2018,11,29, 21 ,8623,1712,1557,11892
11/29/2018,2018,11,29, 22 ,8186,1582,1441,11209
11/29/2018,2018,11,29, 23 ,7802,1483,1323,10608
11/29/2018,2018,11,29, 24 ,7345,1387,1220,9952
11/30/2018,2018,11,30, 1 ,7071,1337,1170,9578
11/30/2018,2018,11,30, 2 ,6837,1291,1125,9253
11/30/2018,2018,11,30, 3 ,6687,1256,1090,9033
11/30/2018,2018,11,30, 4 ,6525,1242,1068,8835
11/30/2018,2018,11,30, 5 ,6414,1258,1089,8761
11/30/2018,2018,11,30, 6 ,6278,1256,1102,8636
11/30/2018,2018,11,30, 7 ,6242,1265,1099,8606
11/30/2018,2018,11,30, 8 ,6693,1360,1159,9212
11/30/2018,2018,11,30, 9 ,7188,1515,1301,10004
11/30/2018,2018,11,30, 10 ,7684,1616,1440,10740
11/30/2018,2018,11,30, 11 ,7958,1706,1519,11183
11/30/2018,2018,11,30, 12 ,7834,1663,1489,10986
11/30/2018,2018,11,30, 13 ,7821,1653,1498,10972
11/30/2018,2018,11,30, 14 ,7954,1688,1524,11166
11/30/2018,2018,11,30, 15 ,7828,1672,1497,10997
11/30/2018,2018,11,30, 16 ,7696,1649,1477,10822
11/30/2018,2018,11,30, 17 ,7553,1624,1443,10620
11/30/2018,2018,11,30, 18 ,8245,1831,1671,11747
11/30/2018,2018,11,30, 19 ,8205,1773,1642,11620
11/30/2018,2018,11,30, 20 ,8172,1719,1594,11485
11/30/2018,2018,11,30, 21 ,8014,1642,1537,11193
11/30/2018,2018,11,30, 22 ,7690,1538,1407,10635
11/30/2018,2018,11,30, 23 ,7237,1412,1313,9962
11/30/2018,2018,11,30, 24 ,6835,1335,1234,9404
12/1/2018,2018,12,1, 1 ,6554,1280,1131,8965
12/1/2018,2018,12,1, 2 ,6340,1247,1117,8704
12/1/2018,2018,12,1, 3 ,6182,1214,1101,8497
12/1/2018,2018,12,1, 4 ,6125,1195,1070,8390
12/1/2018,2018,12,1, 5 ,6047,1215,1076,8338
12/1/2018,2018,12,1, 6 ,6076,1245,1114,8435
12/1/2018,2018,12,1, 7 ,6284,1267,1108,8659
12/1/2018,2018,12,1, 8 ,6936,1348,1162,9446
12/1/2018,2018,12,1, 9 ,7544,1516,1294,10354
12/1/2018,2018,12,1, 10 ,8141,1625,1414,11180
12/1/2018,2018,12,1, 11 ,8518,1696,1484,11698
12/1/2018,2018,12,1, 12 ,8360,1657,1451,11468
12/1/2018,2018,12,1, 13 ,8283,1660,1455,11398
12/1/2018,2018,12,1, 14 ,8457,1686,1511,11654
12/1/2018,2018,12,1, 15 ,8299,1666,1475,11440
12/1/2018,2018,12,1, 16 ,8074,1621,1429,11124
12/1/2018,2018,12,1, 17 ,7840,1620,1418,10878
12/1/2018,2018,12,1, 18 ,8343,1823,1644,11810
12/1/2018,2018,12,1, 19 ,8245,1765,1588,11598
12/1/2018,2018,12,1, 20 ,8214,1711,1562,11487
12/1/2018,2018,12,1, 21 ,8076,1639,1512,11227
12/1/2018,2018,12,1, 22 ,7830,1549,1417,10796
12/1/2018,2018,12,1, 23 ,7443,1435,1291,10169
12/1/2018,2018,12,1, 24 ,7059,1340,1212,9611
12/2/2018,2018,12,2, 1 ,6733,1290,1141,9164
12/2/2018,2018,12,2, 2 ,6549,1246,1112,8907
12/2/2018,2018,12,2, 3 ,6340,1213,1074,8627
12/2/2018,2018,12,2, 4 ,6249,1199,1061,8509
12/2/2018,2018,12,2, 5 ,6202,1199,1068,8469
12/2/2018,2018,12,2, 6 ,6111,1196,1081,8388
12/2/2018,2018,12,2, 7 ,6124,1211,1081,8416
12/2/2018,2018,12,2, 8 ,6431,1262,1128,8821
12/2/2018,2018,12,2, 9 ,6845,1361,1222,9428
12/2/2018,2018,12,2, 10 ,7400,1440,1315,10155
12/2/2018,2018,12,2, 11 ,7651,1494,1381,10526
12/2/2018,2018,12,2, 12 ,7668,1493,1393,10554
12/2/2018,2018,12,2, 13 ,7646,1508,1368,10522
12/2/2018,2018,12,2, 14 ,7657,1512,1380,10549
12/2/2018,2018,12,2, 15 ,7554,1493,1350,10397
12/2/2018,2018,12,2, 16 ,7347,1475,1336,10158
12/2/2018,2018,12,2, 17 ,7310,1491,1371,10172
12/2/2018,2018,12,2, 18 ,7966,1721,1574,11261
12/2/2018,2018,12,2, 19 ,8056,1693,1549,11298
12/2/2018,2018,12,2, 20 ,8036,1651,1517,11204
12/2/2018,2018,12,2, 21 ,7984,1575,1463,11022
12/2/2018,2018,12,2, 22 ,7662,1488,1355,10505
12/2/2018,2018,12,2, 23 ,7280,1364,1252,9896
12/2/2018,2018,12,2, 24 ,6827,1290,1179,9296
12/3/2018,2018,12,3, 1 ,6541,1229,1112,8882
12/3/2018,2018,12,3, 2 ,6302,1182,1073,8557
12/3/2018,2018,12,3, 3 ,6095,1151,1034,8280
12/3/2018,2018,12,3, 4 ,6074,1143,1025,8242
12/3/2018,2018,12,3, 5 ,6263,1221,1077,8561
12/3/2018,2018,12,3, 6 ,6453,1298,1135,8886
12/3/2018,2018,12,3, 7 ,6661,1267,1074,9002
12/3/2018,2018,12,3, 8 ,7544,1432,1222,10198
12/3/2018,2018,12,3, 9 ,8461,1659,1491,11611
12/3/2018,2018,12,3, 10 ,9109,1810,1637,12556
12/3/2018,2018,12,3, 11 ,9458,1851,1704,13013
12/3/2018,2018,12,3, 12 ,9334,1863,1701,12898
12/3/2018,2018,12,3, 13 ,9289,1848,1683,12820
12/3/2018,2018,12,3, 14 ,9663,1910,1779,13352
12/3/2018,2018,12,3, 15 ,9620,1931,1766,13317
12/3/2018,2018,12,3, 16 ,9410,1857,1742,13009
12/3/2018,2018,12,3, 17 ,9031,1791,1675,12497
12/3/2018,2018,12,3, 18 ,9288,1949,1815,13052
12/3/2018,2018,12,3, 19 ,9100,1875,1736,12711
12/3/2018,2018,12,3, 20 ,8925,1827,1683,12435
12/3/2018,2018,12,3, 21 ,8808,1742,1604,12154
12/3/2018,2018,12,3, 22 ,8489,1597,1464,11550
12/3/2018,2018,12,3, 23 ,7966,1471,1334,10771
12/3/2018,2018,12,3, 24 ,7559,1377,1235,10171
12/4/2018,2018,12,4, 1 ,7221,1330,1182,9733
12/4/2018,2018,12,4, 2 ,7001,1289,1144,9434
12/4/2018,2018,12,4, 3 ,6829,1256,1106,9191
12/4/2018,2018,12,4, 4 ,6761,1243,1095,9099
12/4/2018,2018,12,4, 5 ,6866,1294,1156,9316
12/4/2018,2018,12,4, 6 ,7039,1345,1217,9601
12/4/2018,2018,12,4, 7 ,7108,1300,1131,9539
12/4/2018,2018,12,4, 8 ,7926,1470,1281,10677
12/4/2018,2018,12,4, 9 ,8606,1738,1539,11883
12/4/2018,2018,12,4, 10 ,8973,1841,1663,12477
12/4/2018,2018,12,4, 11 ,9342,1909,1741,12992
12/4/2018,2018,12,4, 12 ,9098,1864,1697,12659
12/4/2018,2018,12,4, 13 ,9147,1887,1704,12738
12/4/2018,2018,12,4, 14 ,9448,1956,1754,13158
12/4/2018,2018,12,4, 15 ,9380,1935,1724,13039
12/4/2018,2018,12,4, 16 ,9296,1906,1703,12905
12/4/2018,2018,12,4, 17 ,8986,1829,1668,12483
12/4/2018,2018,12,4, 18 ,9425,2007,1804,13236
12/4/2018,2018,12,4, 19 ,9221,1939,1728,12888
12/4/2018,2018,12,4, 20 ,9003,1873,1667,12543
12/4/2018,2018,12,4, 21 ,8882,1796,1592,12270
12/4/2018,2018,12,4, 22 ,8440,1668,1464,11572
12/4/2018,2018,12,4, 23 ,7941,1520,1340,10801
12/4/2018,2018,12,4, 24 ,7489,1433,1233,10155
12/5/2018,2018,12,5, 1 ,7215,1367,1188,9770
12/5/2018,2018,12,5, 2 ,6965,1330,1157,9452
12/5/2018,2018,12,5, 3 ,6778,1294,1101,9173
12/5/2018,2018,12,5, 4 ,6626,1277,1114,9017
12/5/2018,2018,12,5, 5 ,6831,1329,1170,9330
12/5/2018,2018,12,5, 6 ,7069,1382,1227,9678
12/5/2018,2018,12,5, 7 ,7159,1329,1136,9624
12/5/2018,2018,12,5, 8 ,8013,1494,1248,10755
12/5/2018,2018,12,5, 9 ,8775,1742,1488,12005
12/5/2018,2018,12,5, 10 ,9297,1839,1605,12741
12/5/2018,2018,12,5, 11 ,9655,1940,1672,13267
12/5/2018,2018,12,5, 12 ,9361,1882,1657,12900
12/5/2018,2018,12,5, 13 ,9425,1877,1697,12999
12/5/2018,2018,12,5, 14 ,9849,1954,1780,13583
12/5/2018,2018,12,5, 15 ,9712,1931,1733,13376
12/5/2018,2018,12,5, 16 ,9609,1904,1721,13234
12/5/2018,2018,12,5, 17 ,9182,1845,1657,12684
12/5/2018,2018,12,5, 18 ,9583,2020,1808,13411
12/5/2018,2018,12,5, 19 ,9352,1953,1736,13041
12/5/2018,2018,12,5, 20 ,9188,1902,1680,12770
12/5/2018,2018,12,5, 21 ,9035,1814,1604,12453
12/5/2018,2018,12,5, 22 ,8641,1690,1473,11804
12/5/2018,2018,12,5, 23 ,8049,1556,1340,10945
12/5/2018,2018,12,5, 24 ,7580,1467,1250,10297
12/6/2018,2018,12,6, 1 ,7198,1411,1180,9789
12/6/2018,2018,12,6, 2 ,6956,1356,1159,9471
12/6/2018,2018,12,6, 3 ,6817,1331,1120,9268
12/6/2018,2018,12,6, 4 ,6720,1300,1113,9133
12/6/2018,2018,12,6, 5 ,6868,1342,1157,9367
12/6/2018,2018,12,6, 6 ,6992,1380,1210,9582
12/6/2018,2018,12,6, 7 ,7021,1343,1136,9500
12/6/2018,2018,12,6, 8 ,7843,1480,1303,10626
12/6/2018,2018,12,6, 9 ,8821,1707,1533,12061
12/6/2018,2018,12,6, 10 ,9340,1830,1684,12854
12/6/2018,2018,12,6, 11 ,9733,1900,1762,13395
12/6/2018,2018,12,6, 12 ,9538,1849,1723,13110
12/6/2018,2018,12,6, 13 ,9547,1871,1700,13118
12/6/2018,2018,12,6, 14 ,9886,1915,1785,13586
12/6/2018,2018,12,6, 15 ,9811,1887,1751,13449
12/6/2018,2018,12,6, 16 ,9673,1860,1720,13253
12/6/2018,2018,12,6, 17 ,9159,1796,1649,12604
12/6/2018,2018,12,6, 18 ,9435,2004,1802,13241
12/6/2018,2018,12,6, 19 ,9328,1929,1718,12975
12/6/2018,2018,12,6, 20 ,9177,1877,1670,12724
12/6/2018,2018,12,6, 21 ,9109,1796,1595,12500
12/6/2018,2018,12,6, 22 ,8641,1663,1458,11762
12/6/2018,2018,12,6, 23 ,8132,1540,1357,11029
12/6/2018,2018,12,6, 24 ,7636,1449,1250,10335
12/7/2018,2018,12,7, 1 ,7299,1403,1212,9914
12/7/2018,2018,12,7, 2 ,6990,1351,1163,9504
12/7/2018,2018,12,7, 3 ,6831,1321,1137,9289
12/7/2018,2018,12,7, 4 ,6757,1300,1121,9178
12/7/2018,2018,12,7, 5 ,6861,1335,1165,9361
12/7/2018,2018,12,7, 6 ,6954,1379,1223,9556
12/7/2018,2018,12,7, 7 ,7024,1336,1156,9516
12/7/2018,2018,12,7, 8 ,7867,1437,1282,10586
12/7/2018,2018,12,7, 9 ,8868,1694,1516,12078
12/7/2018,2018,12,7, 10 ,9320,1826,1683,12829
12/7/2018,2018,12,7, 11 ,9717,1896,1752,13365
12/7/2018,2018,12,7, 12 ,9456,1852,1732,13040
12/7/2018,2018,12,7, 13 ,9450,1862,1746,13058
12/7/2018,2018,12,7, 14 ,9672,1918,1821,13411
12/7/2018,2018,12,7, 15 ,9495,1873,1780,13148
12/7/2018,2018,12,7, 16 ,9301,1866,1739,12906
12/7/2018,2018,12,7, 17 ,8897,1795,1676,12368
12/7/2018,2018,12,7, 18 ,9259,1970,1812,13041
12/7/2018,2018,12,7, 19 ,9045,1894,1725,12664
12/7/2018,2018,12,7, 20 ,8939,1831,1686,12456
12/7/2018,2018,12,7, 21 ,8757,1749,1617,12123
12/7/2018,2018,12,7, 22 ,8367,1620,1502,11489
12/7/2018,2018,12,7, 23 ,8000,1520,1392,10912
12/7/2018,2018,12,7, 24 ,7552,1439,1260,10251
12/8/2018,2018,12,8, 1 ,7249,1389,1224,9862
12/8/2018,2018,12,8, 2 ,6984,1354,1178,9516
12/8/2018,2018,12,8, 3 ,6732,1315,1146,9193
12/8/2018,2018,12,8, 4 ,6652,1292,1118,9062
12/8/2018,2018,12,8, 5 ,6592,1294,1131,9017
12/8/2018,2018,12,8, 6 ,6543,1310,1156,9009
12/8/2018,2018,12,8, 7 ,6462,1316,1135,8913
12/8/2018,2018,12,8, 8 ,7006,1384,1193,9583
12/8/2018,2018,12,8, 9 ,7643,1537,1337,10517
12/8/2018,2018,12,8, 10 ,8277,1623,1400,11300
12/8/2018,2018,12,8, 11 ,8541,1687,1487,11715
12/8/2018,2018,12,8, 12 ,8435,1674,1469,11578
12/8/2018,2018,12,8, 13 ,8390,1682,1479,11551
12/8/2018,2018,12,8, 14 ,8535,1714,1540,11789
12/8/2018,2018,12,8, 15 ,8465,1705,1523,11693
12/8/2018,2018,12,8, 16 ,8229,1657,1503,11389
12/8/2018,2018,12,8, 17 ,7948,1652,1496,11096
12/8/2018,2018,12,8, 18 ,8480,1870,1678,12028
12/8/2018,2018,12,8, 19 ,8453,1816,1623,11892
12/8/2018,2018,12,8, 20 ,8417,1776,1591,11784
12/8/2018,2018,12,8, 21 ,8290,1702,1536,11528
12/8/2018,2018,12,8, 22 ,8024,1622,1428,11074
12/8/2018,2018,12,8, 23 ,7664,1500,1313,10477
12/8/2018,2018,12,8, 24 ,7278,1442,1283,10003
12/9/2018,2018,12,9, 1 ,6960,1392,1165,9517
12/9/2018,2018,12,9, 2 ,6733,1356,1099,9188
12/9/2018,2018,12,9, 3 ,6476,1324,1049,8849
12/9/2018,2018,12,9, 4 ,6334,1303,1039,8676
12/9/2018,2018,12,9, 5 ,6326,1282,1046,8654
12/9/2018,2018,12,9, 6 ,6138,1275,1086,8499
12/9/2018,2018,12,9, 7 ,6205,1285,1075,8565
12/9/2018,2018,12,9, 8 ,6526,1319,1100,8945
12/9/2018,2018,12,9, 9 ,6962,1408,1191,9561
12/9/2018,2018,12,9, 10 ,7594,1503,1279,10376
12/9/2018,2018,12,9, 11 ,7752,1554,1349,10655
12/9/2018,2018,12,9, 12 ,7696,1557,1376,10629
12/9/2018,2018,12,9, 13 ,7621,1564,1385,10570
12/9/2018,2018,12,9, 14 ,7689,1551,1385,10625
12/9/2018,2018,12,9, 15 ,7555,1513,1370,10438
12/9/2018,2018,12,9, 16 ,7516,1507,1352,10375
12/9/2018,2018,12,9, 17 ,7482,1538,1354,10374
12/9/2018,2018,12,9, 18 ,8126,1825,1575,11526
12/9/2018,2018,12,9, 19 ,8221,1805,1572,11598
12/9/2018,2018,12,9, 20 ,8234,1778,1531,11543
12/9/2018,2018,12,9, 21 ,8095,1721,1475,11291
12/9/2018,2018,12,9, 22 ,7721,1615,1374,10710
12/9/2018,2018,12,9, 23 ,7365,1512,1255,10132
12/9/2018,2018,12,9, 24 ,6914,1404,1207,9525
12/10/2018,2018,12,10, 1 ,6613,1327,1105,9045
12/10/2018,2018,12,10, 2 ,6374,1302,1041,8717
12/10/2018,2018,12,10, 3 ,6184,1267,1030,8481
12/10/2018,2018,12,10, 4 ,6152,1247,1015,8414
12/10/2018,2018,12,10, 5 ,6368,1290,1073,8731
12/10/2018,2018,12,10, 6 ,6506,1358,1161,9025
12/10/2018,2018,12,10, 7 ,6749,1324,1083,9156
12/10/2018,2018,12,10, 8 ,7659,1484,1191,10334
12/10/2018,2018,12,10, 9 ,8602,1738,1490,11830
12/10/2018,2018,12,10, 10 ,9262,1880,1652,12794
12/10/2018,2018,12,10, 11 ,9623,1936,1739,13298
12/10/2018,2018,12,10, 12 ,9432,1912,1707,13051
12/10/2018,2018,12,10, 13 ,9379,1925,1723,13027
12/10/2018,2018,12,10, 14 ,9692,1952,1809,13453
12/10/2018,2018,12,10, 15 ,9588,1952,1801,13341
12/10/2018,2018,12,10, 16 ,9422,1923,1750,13095
12/10/2018,2018,12,10, 17 ,9069,1854,1673,12596
12/10/2018,2018,12,10, 18 ,9393,2011,1835,13239
12/10/2018,2018,12,10, 19 ,9224,1962,1766,12952
12/10/2018,2018,12,10, 20 ,9141,1894,1693,12728
12/10/2018,2018,12,10, 21 ,8983,1821,1646,12450
12/10/2018,2018,12,10, 22 ,8635,1686,1505,11826
12/10/2018,2018,12,10, 23 ,8085,1558,1389,11032
12/10/2018,2018,12,10, 24 ,7641,1470,1264,10375
12/11/2018,2018,12,11, 1 ,7291,1400,1215,9906
12/11/2018,2018,12,11, 2 ,7059,1355,1173,9587
12/11/2018,2018,12,11, 3 ,6859,1323,1123,9305
12/11/2018,2018,12,11, 4 ,6768,1300,1101,9169
12/11/2018,2018,12,11, 5 ,6926,1340,1153,9419
12/11/2018,2018,12,11, 6 ,7072,1382,1213,9667
12/11/2018,2018,12,11, 7 ,7162,1350,1125,9637
12/11/2018,2018,12,11, 8 ,7967,1484,1285,10736
12/11/2018,2018,12,11, 9 ,8889,1726,1525,12140
12/11/2018,2018,12,11, 10 ,9380,1865,1643,12888
12/11/2018,2018,12,11, 11 ,9691,1936,1711,13338
12/11/2018,2018,12,11, 12 ,9465,1891,1726,13082
12/11/2018,2018,12,11, 13 ,9402,1903,1724,13029
12/11/2018,2018,12,11, 14 ,9710,1995,1778,13483
12/11/2018,2018,12,11, 15 ,9651,1949,1753,13353
12/11/2018,2018,12,11, 16 ,9513,1904,1742,13159
12/11/2018,2018,12,11, 17 ,9134,1831,1683,12648
12/11/2018,2018,12,11, 18 ,9497,1996,1812,13305
12/11/2018,2018,12,11, 19 ,9279,1949,1720,12948
12/11/2018,2018,12,11, 20 ,9226,1881,1683,12790
12/11/2018,2018,12,11, 21 ,9074,1787,1628,12489
12/11/2018,2018,12,11, 22 ,8612,1670,1494,11776
12/11/2018,2018,12,11, 23 ,8179,1544,1371,11094
12/11/2018,2018,12,11, 24 ,7654,1434,1262,10350
12/12/2018,2018,12,12, 1 ,7339,1377,1225,9941
12/12/2018,2018,12,12, 2 ,7047,1329,1172,9548
12/12/2018,2018,12,12, 3 ,6881,1289,1137,9307
12/12/2018,2018,12,12, 4 ,6777,1267,1122,9166
12/12/2018,2018,12,12, 5 ,6875,1309,1178,9362
12/12/2018,2018,12,12, 6 ,7053,1366,1244,9663
12/12/2018,2018,12,12, 7 ,7089,1330,1165,9584
12/12/2018,2018,12,12, 8 ,7922,1492,1313,10727
12/12/2018,2018,12,12, 9 ,8742,1740,1518,12000
12/12/2018,2018,12,12, 10 ,9367,1851,1633,12851
12/12/2018,2018,12,12, 11 ,9749,1910,1713,13372
12/12/2018,2018,12,12, 12 ,9524,1840,1691,13055
12/12/2018,2018,12,12, 13 ,9489,1889,1709,13087
12/12/2018,2018,12,12, 14 ,9845,1952,1760,13557
12/12/2018,2018,12,12, 15 ,9727,1883,1721,13331
12/12/2018,2018,12,12, 16 ,9563,1860,1710,13133
12/12/2018,2018,12,12, 17 ,9109,1816,1650,12575
12/12/2018,2018,12,12, 18 ,9460,1967,1830,13257
12/12/2018,2018,12,12, 19 ,9274,1886,1683,12843
12/12/2018,2018,12,12, 20 ,9198,1837,1687,12722
12/12/2018,2018,12,12, 21 ,9066,1759,1628,12453
12/12/2018,2018,12,12, 22 ,8677,1627,1491,11795
12/12/2018,2018,12,12, 23 ,8108,1498,1350,10956
12/12/2018,2018,12,12, 24 ,7685,1409,1266,10360
12/13/2018,2018,12,13, 1 ,7310,1353,1198,9861
12/13/2018,2018,12,13, 2 ,7107,1313,1141,9561
12/13/2018,2018,12,13, 3 ,6895,1288,1104,9287
12/13/2018,2018,12,13, 4 ,6795,1264,1101,9160
12/13/2018,2018,12,13, 5 ,6903,1305,1132,9340
12/13/2018,2018,12,13, 6 ,7047,1354,1189,9590
12/13/2018,2018,12,13, 7 ,7109,1335,1134,9578
12/13/2018,2018,12,13, 8 ,7865,1478,1299,10642
12/13/2018,2018,12,13, 9 ,8739,1714,1538,11991
12/13/2018,2018,12,13, 10 ,9135,1814,1684,12633
12/13/2018,2018,12,13, 11 ,9423,1875,1747,13045
12/13/2018,2018,12,13, 12 ,9002,1803,1752,12557
12/13/2018,2018,12,13, 13 ,8947,1799,1769,12515
12/13/2018,2018,12,13, 14 ,9178,1851,1816,12845
12/13/2018,2018,12,13, 15 ,9082,1801,1806,12689
12/13/2018,2018,12,13, 16 ,9054,1774,1769,12597
12/13/2018,2018,12,13, 17 ,8810,1730,1698,12238
12/13/2018,2018,12,13, 18 ,9204,1919,1853,12976
12/13/2018,2018,12,13, 19 ,8955,1862,1755,12572
12/13/2018,2018,12,13, 20 ,8832,1795,1714,12341
12/13/2018,2018,12,13, 21 ,8650,1713,1629,11992
12/13/2018,2018,12,13, 22 ,8315,1593,1511,11419
12/13/2018,2018,12,13, 23 ,7885,1488,1384,10757
12/13/2018,2018,12,13, 24 ,7462,1389,1274,10125
12/14/2018,2018,12,14, 1 ,7123,1331,1235,9689
12/14/2018,2018,12,14, 2 ,6887,1291,1189,9367
12/14/2018,2018,12,14, 3 ,6670,1264,1140,9074
12/14/2018,2018,12,14, 4 ,6566,1254,1148,8968
12/14/2018,2018,12,14, 5 ,6706,1287,1177,9170
12/14/2018,2018,12,14, 6 ,6901,1342,1235,9478
12/14/2018,2018,12,14, 7 ,6991,1316,1170,9477
12/14/2018,2018,12,14, 8 ,7666,1463,1291,10420
12/14/2018,2018,12,14, 9 ,8332,1685,1521,11538
12/14/2018,2018,12,14, 10 ,8799,1780,1603,12182
12/14/2018,2018,12,14, 11 ,9184,1854,1706,12744
12/14/2018,2018,12,14, 12 ,8933,1831,1656,12420
12/14/2018,2018,12,14, 13 ,8867,1827,1684,12378
12/14/2018,2018,12,14, 14 ,8934,1895,1765,12594
12/14/2018,2018,12,14, 15 ,8717,1883,1731,12331
12/14/2018,2018,12,14, 16 ,8598,1852,1697,12147
12/14/2018,2018,12,14, 17 ,8424,1786,1651,11861
12/14/2018,2018,12,14, 18 ,8854,1947,1784,12585
12/14/2018,2018,12,14, 19 ,8634,1895,1735,12264
12/14/2018,2018,12,14, 20 ,8502,1839,1686,12027
12/14/2018,2018,12,14, 21 ,8344,1770,1619,11733
12/14/2018,2018,12,14, 22 ,8064,1658,1506,11228
12/14/2018,2018,12,14, 23 ,7627,1532,1380,10539
12/14/2018,2018,12,14, 24 ,7164,1431,1260,9855
12/15/2018,2018,12,15, 1 ,6756,1370,1213,9339
12/15/2018,2018,12,15, 2 ,6497,1330,1187,9014
12/15/2018,2018,12,15, 3 ,6350,1286,1144,8780
12/15/2018,2018,12,15, 4 ,6268,1273,1143,8684
12/15/2018,2018,12,15, 5 ,6329,1297,1150,8776
12/15/2018,2018,12,15, 6 ,6348,1315,1185,8848
12/15/2018,2018,12,15, 7 ,6438,1316,1156,8910
12/15/2018,2018,12,15, 8 ,6963,1392,1252,9607
12/15/2018,2018,12,15, 9 ,7618,1581,1347,10546
12/15/2018,2018,12,15, 10 ,8212,1687,1544,11443
12/15/2018,2018,12,15, 11 ,8481,1734,1652,11867
12/15/2018,2018,12,15, 12 ,8313,1691,1631,11635
12/15/2018,2018,12,15, 13 ,8149,1699,1623,11471
12/15/2018,2018,12,15, 14 ,8253,1752,1672,11677
12/15/2018,2018,12,15, 15 ,8083,1725,1638,11446
12/15/2018,2018,12,15, 16 ,7949,1682,1608,11239
12/15/2018,2018,12,15, 17 ,7746,1667,1562,10975
12/15/2018,2018,12,15, 18 ,8286,1861,1765,11912
12/15/2018,2018,12,15, 19 ,8237,1817,1709,11763
12/15/2018,2018,12,15, 20 ,8129,1774,1667,11570
12/15/2018,2018,12,15, 21 ,8048,1712,1611,11371
12/15/2018,2018,12,15, 22 ,7804,1612,1516,10932
12/15/2018,2018,12,15, 23 ,7485,1503,1387,10375
12/15/2018,2018,12,15, 24 ,7012,1394,1308,9714
12/16/2018,2018,12,16, 1 ,6686,1317,1202,9205
12/16/2018,2018,12,16, 2 ,6462,1271,1166,8899
12/16/2018,2018,12,16, 3 ,6286,1246,1129,8661
12/16/2018,2018,12,16, 4 ,6133,1211,1110,8454
12/16/2018,2018,12,16, 5 ,6092,1207,1099,8398
12/16/2018,2018,12,16, 6 ,6123,1215,1120,8458
12/16/2018,2018,12,16, 7 ,6113,1237,1100,8450
12/16/2018,2018,12,16, 8 ,6425,1299,1116,8840
12/16/2018,2018,12,16, 9 ,6895,1407,1215,9517
12/16/2018,2018,12,16, 10 ,7356,1499,1244,10099
12/16/2018,2018,12,16, 11 ,7586,1534,1324,10444
12/16/2018,2018,12,16, 12 ,7509,1546,1363,10418
12/16/2018,2018,12,16, 13 ,7377,1553,1367,10297
12/16/2018,2018,12,16, 14 ,7442,1569,1385,10396
12/16/2018,2018,12,16, 15 ,7368,1547,1326,10241
12/16/2018,2018,12,16, 16 ,7217,1515,1361,10093
12/16/2018,2018,12,16, 17 ,7286,1540,1376,10202
12/16/2018,2018,12,16, 18 ,7958,1765,1603,11326
12/16/2018,2018,12,16, 19 ,7965,1754,1597,11316
12/16/2018,2018,12,16, 20 ,7958,1717,1554,11229
12/16/2018,2018,12,16, 21 ,7864,1637,1491,10992
12/16/2018,2018,12,16, 22 ,7514,1507,1380,10401
12/16/2018,2018,12,16, 23 ,7209,1397,1281,9887
12/16/2018,2018,12,16, 24 ,6752,1295,1280,9327
12/17/2018,2018,12,17, 1 ,6430,1238,1132,8800
12/17/2018,2018,12,17, 2 ,6149,1194,1096,8439
12/17/2018,2018,12,17, 3 ,5997,1172,1077,8246
12/17/2018,2018,12,17, 4 ,5978,1172,1039,8189
12/17/2018,2018,12,17, 5 ,6041,1181,1051,8273
12/17/2018,2018,12,17, 6 ,6270,1228,1112,8610
12/17/2018,2018,12,17, 7 ,6604,1263,1132,8999
12/17/2018,2018,12,17, 8 ,7474,1437,1299,10210
12/17/2018,2018,12,17, 9 ,8478,1689,1552,11719
12/17/2018,2018,12,17, 10 ,9036,1822,1696,12554
12/17/2018,2018,12,17, 11 ,9407,1892,1745,13044
12/17/2018,2018,12,17, 12 ,9199,1841,1734,12774
12/17/2018,2018,12,17, 13 ,9032,1833,1716,12581
12/17/2018,2018,12,17, 14 ,9281,1897,1772,12950
12/17/2018,2018,12,17, 15 ,9174,1873,1737,12784
12/17/2018,2018,12,17, 16 ,9003,1844,1677,12524
12/17/2018,2018,12,17, 17 ,8742,1800,1628,12170
12/17/2018,2018,12,17, 18 ,9069,1956,1760,12785
12/17/2018,2018,12,17, 19 ,8857,1910,1637,12404
12/17/2018,2018,12,17, 20 ,8692,1849,1619,12160
12/17/2018,2018,12,17, 21 ,8530,1754,1548,11832
12/17/2018,2018,12,17, 22 ,8179,1636,1420,11235
12/17/2018,2018,12,17, 23 ,7659,1513,1317,10489
12/17/2018,2018,12,17, 24 ,7136,1415,1214,9765
12/18/2018,2018,12,18, 1 ,6834,1366,1158,9358
12/18/2018,2018,12,18, 2 ,6657,1316,1120,9093
12/18/2018,2018,12,18, 3 ,6455,1292,1087,8834
12/18/2018,2018,12,18, 4 ,6370,1287,1076,8733
12/18/2018,2018,12,18, 5 ,6438,1290,1076,8804
12/18/2018,2018,12,18, 6 ,6585,1327,1126,9038
12/18/2018,2018,12,18, 7 ,6810,1334,1109,9253
12/18/2018,2018,12,18, 8 ,7617,1454,1239,10310
12/18/2018,2018,12,18, 9 ,8475,1664,1488,11627
12/18/2018,2018,12,18, 10 ,8936,1753,1606,12295
12/18/2018,2018,12,18, 11 ,9383,1814,1683,12880
12/18/2018,2018,12,18, 12 ,9231,1751,1645,12627
12/18/2018,2018,12,18, 13 ,9135,1733,1656,12524
12/18/2018,2018,12,18, 14 ,9392,1803,1710,12905
12/18/2018,2018,12,18, 15 ,9266,1786,1689,12741
12/18/2018,2018,12,18, 16 ,9111,1786,1652,12549
12/18/2018,2018,12,18, 17 ,8771,1762,1644,12177
12/18/2018,2018,12,18, 18 ,9108,1922,1786,12816
12/18/2018,2018,12,18, 19 ,8876,1861,1695,12432
12/18/2018,2018,12,18, 20 ,8687,1804,1644,12135
12/18/2018,2018,12,18, 21 ,8542,1731,1593,11866
12/18/2018,2018,12,18, 22 ,8168,1591,1457,11216
12/18/2018,2018,12,18, 23 ,7687,1462,1327,10476
12/18/2018,2018,12,18, 24 ,7260,1381,1192,9833
12/19/2018,2018,12,19, 1 ,6933,1318,1179,9430
12/19/2018,2018,12,19, 2 ,6742,1272,1131,9145
12/19/2018,2018,12,19, 3 ,6608,1252,1095,8955
12/19/2018,2018,12,19, 4 ,6512,1238,1084,8834
12/19/2018,2018,12,19, 5 ,6581,1247,1085,8913
12/19/2018,2018,12,19, 6 ,6764,1292,1145,9201
12/19/2018,2018,12,19, 7 ,6903,1311,1133,9347
12/19/2018,2018,12,19, 8 ,7544,1467,1203,10214
12/19/2018,2018,12,19, 9 ,8227,1685,1410,11322
12/19/2018,2018,12,19, 10 ,8785,1806,1531,12122
12/19/2018,2018,12,19, 11 ,9118,1849,1602,12569
12/19/2018,2018,12,19, 12 ,9029,1815,1564,12408
12/19/2018,2018,12,19, 13 ,8949,1791,1548,12288
12/19/2018,2018,12,19, 14 ,9221,1856,1614,12691
12/19/2018,2018,12,19, 15 ,9093,1839,1602,12534
12/19/2018,2018,12,19, 16 ,8942,1819,1600,12361
12/19/2018,2018,12,19, 17 ,8668,1784,1575,12027
12/19/2018,2018,12,19, 18 ,8980,1935,1672,12587
12/19/2018,2018,12,19, 19 ,8799,1878,1628,12305
12/19/2018,2018,12,19, 20 ,8568,1813,1589,11970
12/19/2018,2018,12,19, 21 ,8377,1732,1519,11628
12/19/2018,2018,12,19, 22 ,8004,1597,1377,10978
12/19/2018,2018,12,19, 23 ,7518,1457,1258,10233
12/19/2018,2018,12,19, 24 ,7106,1380,1147,9633
12/20/2018,2018,12,20, 1 ,6792,1315,1109,9216
12/20/2018,2018,12,20, 2 ,6550,1283,1071,8904
12/20/2018,2018,12,20, 3 ,6416,1267,1042,8725
12/20/2018,2018,12,20, 4 ,6302,1253,1032,8587
12/20/2018,2018,12,20, 5 ,6372,1270,1035,8677
12/20/2018,2018,12,20, 6 ,6546,1306,1095,8947
12/20/2018,2018,12,20, 7 ,6681,1323,1123,9127
12/20/2018,2018,12,20, 8 ,7368,1431,1211,10010
12/20/2018,2018,12,20, 9 ,8203,1588,1400,11191
12/20/2018,2018,12,20, 10 ,8634,1682,1528,11844
12/20/2018,2018,12,20, 11 ,9041,1705,1608,12354
12/20/2018,2018,12,20, 12 ,8804,1621,1574,11999
12/20/2018,2018,12,20, 13 ,8713,1578,1525,11816
12/20/2018,2018,12,20, 14 ,8951,1619,1586,12156
12/20/2018,2018,12,20, 15 ,8845,1605,1561,12011
12/20/2018,2018,12,20, 16 ,8744,1632,1571,11947
12/20/2018,2018,12,20, 17 ,8572,1655,1576,11803
12/20/2018,2018,12,20, 18 ,8960,1796,1699,12455
12/20/2018,2018,12,20, 19 ,8711,1733,1618,12062
12/20/2018,2018,12,20, 20 ,8461,1673,1542,11676
12/20/2018,2018,12,20, 21 ,8306,1580,1494,11380
12/20/2018,2018,12,20, 22 ,7992,1472,1371,10835
12/20/2018,2018,12,20, 23 ,7486,1340,1223,10049
12/20/2018,2018,12,20, 24 ,7084,1252,1166,9502
12/21/2018,2018,12,21, 1 ,6812,1222,1111,9145
12/21/2018,2018,12,21, 2 ,6629,1188,1067,8884
12/21/2018,2018,12,21, 3 ,6425,1181,1045,8651
12/21/2018,2018,12,21, 4 ,6345,1166,1032,8543
12/21/2018,2018,12,21, 5 ,6379,1188,1064,8631
12/21/2018,2018,12,21, 6 ,6521,1242,1110,8873
12/21/2018,2018,12,21, 7 ,6713,1274,1139,9126
12/21/2018,2018,12,21, 8 ,7413,1401,1201,10015
12/21/2018,2018,12,21, 9 ,8612,1610,1423,11645
12/21/2018,2018,12,21, 10 ,8583,1711,1527,11821
12/21/2018,2018,12,21, 11 ,8939,1773,1607,12319
12/21/2018,2018,12,21, 12 ,8657,1722,1600,11979
12/21/2018,2018,12,21, 13 ,8521,1729,1604,11854
12/21/2018,2018,12,21, 14 ,8788,1780,1671,12239
12/21/2018,2018,12,21, 15 ,8680,1758,1630,12068
12/21/2018,2018,12,21, 16 ,8619,1729,1613,11961
12/21/2018,2018,12,21, 17 ,8387,1721,1543,11651
12/21/2018,2018,12,21, 18 ,8762,1874,1724,12360
12/21/2018,2018,12,21, 19 ,8616,1841,1616,12073
12/21/2018,2018,12,21, 20 ,8465,1786,1574,11825
12/21/2018,2018,12,21, 21 ,8300,1686,1517,11503
12/21/2018,2018,12,21, 22 ,7967,1559,1393,10919
12/21/2018,2018,12,21, 23 ,7527,1444,1264,10235
12/21/2018,2018,12,21, 24 ,7109,1358,1166,9633
12/22/2018,2018,12,22, 1 ,6738,1284,1124,9146
12/22/2018,2018,12,22, 2 ,6523,1250,1085,8858
12/22/2018,2018,12,22, 3 ,6336,1224,1055,8615
12/22/2018,2018,12,22, 4 ,6217,1213,1042,8472
12/22/2018,2018,12,22, 5 ,6187,1207,1053,8447
12/22/2018,2018,12,22, 6 ,6239,1245,1090,8574
12/22/2018,2018,12,22, 7 ,6246,1263,1111,8620
12/22/2018,2018,12,22, 8 ,6690,1318,1176,9184
12/22/2018,2018,12,22, 9 ,7273,1472,1315,10060
12/22/2018,2018,12,22, 10 ,7861,1573,1356,10790
12/22/2018,2018,12,22, 11 ,8124,1618,1461,11203
12/22/2018,2018,12,22, 12 ,7970,1584,1464,11018
12/22/2018,2018,12,22, 13 ,7951,1557,1482,10990
12/22/2018,2018,12,22, 14 ,8013,1589,1497,11099
12/22/2018,2018,12,22, 15 ,7747,1565,1474,10786
12/22/2018,2018,12,22, 16 ,7593,1561,1442,10596
12/22/2018,2018,12,22, 17 ,7546,1585,1431,10562
12/22/2018,2018,12,22, 18 ,8040,1772,1618,11430
12/22/2018,2018,12,22, 19 ,7968,1731,1573,11272
12/22/2018,2018,12,22, 20 ,7911,1681,1532,11124
12/22/2018,2018,12,22, 21 ,7839,1605,1479,10923
12/22/2018,2018,12,22, 22 ,7611,1505,1372,10488
12/22/2018,2018,12,22, 23 ,7291,1393,1275,9959
12/22/2018,2018,12,22, 24 ,6854,1292,1190,9336
12/23/2018,2018,12,23, 1 ,6519,1218,1093,8830
12/23/2018,2018,12,23, 2 ,6310,1187,1075,8572
12/23/2018,2018,12,23, 3 ,6148,1164,1034,8346
12/23/2018,2018,12,23, 4 ,6032,1150,1029,8211
12/23/2018,2018,12,23, 5 ,5961,1144,1020,8125
12/23/2018,2018,12,23, 6 ,5961,1172,1063,8196
12/23/2018,2018,12,23, 7 ,5975,1195,1060,8230
12/23/2018,2018,12,23, 8 ,6201,1241,1107,8549
12/23/2018,2018,12,23, 9 ,6461,1325,1210,8996
12/23/2018,2018,12,23, 10 ,6763,1408,1289,9460
12/23/2018,2018,12,23, 11 ,6919,1449,1357,9725
12/23/2018,2018,12,23, 12 ,6808,1438,1342,9588
12/23/2018,2018,12,23, 13 ,6689,1433,1356,9478
12/23/2018,2018,12,23, 14 ,6570,1413,1392,9375
12/23/2018,2018,12,23, 15 ,6496,1409,1368,9273
12/23/2018,2018,12,23, 16 ,6415,1406,1347,9168
12/23/2018,2018,12,23, 17 ,6615,1472,1379,9466
12/23/2018,2018,12,23, 18 ,7238,1682,1514,10434
12/23/2018,2018,12,23, 19 ,7183,1638,1494,10315
12/23/2018,2018,12,23, 20 ,7059,1600,1490,10149
12/23/2018,2018,12,23, 21 ,6899,1542,1448,9889
12/23/2018,2018,12,23, 22 ,6633,1458,1361,9452
12/23/2018,2018,12,23, 23 ,6313,1352,1258,8923
12/23/2018,2018,12,23, 24 ,5937,1278,1080,8295
12/24/2018,2018,12,24, 1 ,5570,1180,1111,7861
12/24/2018,2018,12,24, 2 ,5416,1142,1067,7625
12/24/2018,2018,12,24, 3 ,5235,1127,1050,7412
12/24/2018,2018,12,24, 4 ,5146,1109,1032,7287
12/24/2018,2018,12,24, 5 ,5150,1103,1035,7288
12/24/2018,2018,12,24, 6 ,5216,1135,1067,7418
12/24/2018,2018,12,24, 7 ,5236,1145,1063,7444
12/24/2018,2018,12,24, 8 ,5489,1216,1108,7813
12/24/2018,2018,12,24, 9 ,5915,1352,1203,8470
12/24/2018,2018,12,24, 10 ,6264,1432,1293,8989
12/24/2018,2018,12,24, 11 ,6440,1472,1340,9252
12/24/2018,2018,12,24, 12 ,6401,1489,1344,9234
12/24/2018,2018,12,24, 13 ,6295,1508,1317,9120
12/24/2018,2018,12,24, 14 ,6220,1506,1316,9042
12/24/2018,2018,12,24, 15 ,6186,1495,1321,9002
12/24/2018,2018,12,24, 16 ,6085,1474,1311,8870
12/24/2018,2018,12,24, 17 ,6119,1492,1341,8952
12/24/2018,2018,12,24, 18 ,6745,1708,1508,9961
12/24/2018,2018,12,24, 19 ,6693,1671,1445,9809
12/24/2018,2018,12,24, 20 ,6294,1578,1343,9215
12/24/2018,2018,12,24, 21 ,6065,1498,1292,8855
12/24/2018,2018,12,24, 22 ,5832,1420,1224,8476
12/24/2018,2018,12,24, 23 ,5654,1366,1143,8163
12/24/2018,2018,12,24, 24 ,5466,1324,1148,7938
12/25/2018,2018,12,25, 1 ,5301,1272,1086,7659
12/25/2018,2018,12,25, 2 ,5145,1214,1031,7390
12/25/2018,2018,12,25, 3 ,4979,1168,987,7134
12/25/2018,2018,12,25, 4 ,4848,1129,959,6936
12/25/2018,2018,12,25, 5 ,4815,1117,951,6883
12/25/2018,2018,12,25, 6 ,4843,1111,932,6886
12/25/2018,2018,12,25, 7 ,4799,1096,948,6843
12/25/2018,2018,12,25, 8 ,4916,1130,956,7002
12/25/2018,2018,12,25, 9 ,5200,1210,1012,7422
12/25/2018,2018,12,25, 10 ,5535,1275,1057,7867
12/25/2018,2018,12,25, 11 ,5801,1339,1167,8307
12/25/2018,2018,12,25, 12 ,5957,1377,1195,8529
12/25/2018,2018,12,25, 13 ,6007,1396,1210,8613
12/25/2018,2018,12,25, 14 ,6094,1376,1197,8667
12/25/2018,2018,12,25, 15 ,6099,1372,1186,8657
12/25/2018,2018,12,25, 16 ,6023,1378,1186,8587
12/25/2018,2018,12,25, 17 ,5990,1388,1207,8585
12/25/2018,2018,12,25, 18 ,6598,1628,1429,9655
12/25/2018,2018,12,25, 19 ,6767,1635,1401,9803
12/25/2018,2018,12,25, 20 ,6732,1599,1370,9701
12/25/2018,2018,12,25, 21 ,6664,1543,1283,9490
12/25/2018,2018,12,25, 22 ,6460,1442,1198,9100
12/25/2018,2018,12,25, 23 ,6119,1337,1117,8573
12/25/2018,2018,12,25, 24 ,5808,1262,1102,8172
12/26/2018,2018,12,26, 1 ,5533,1218,993,7744
12/26/2018,2018,12,26, 2 ,5318,1174,963,7455
12/26/2018,2018,12,26, 3 ,5155,1141,934,7230
12/26/2018,2018,12,26, 4 ,5037,1125,924,7086
12/26/2018,2018,12,26, 5 ,5063,1131,931,7125
12/26/2018,2018,12,26, 6 ,5231,1161,974,7366
12/26/2018,2018,12,26, 7 ,5448,1187,995,7630
12/26/2018,2018,12,26, 8 ,6097,1304,1089,8490
12/26/2018,2018,12,26, 9 ,6886,1499,1256,9641
12/26/2018,2018,12,26, 10 ,7431,1631,1417,10479
12/26/2018,2018,12,26, 11 ,7835,1691,1488,11014
12/26/2018,2018,12,26, 12 ,7738,1682,1481,10901
12/26/2018,2018,12,26, 13 ,7696,1673,1496,10865
12/26/2018,2018,12,26, 14 ,7866,1720,1540,11126
12/26/2018,2018,12,26, 15 ,7811,1698,1524,11033
12/26/2018,2018,12,26, 16 ,7829,1676,1502,11007
12/26/2018,2018,12,26, 17 ,7674,1651,1467,10792
12/26/2018,2018,12,26, 18 ,8063,1855,1646,11564
12/26/2018,2018,12,26, 19 ,7990,1803,1582,11375
12/26/2018,2018,12,26, 20 ,7910,1745,1532,11187
12/26/2018,2018,12,26, 21 ,7827,1668,1458,10953
12/26/2018,2018,12,26, 22 ,7483,1553,1354,10390
12/26/2018,2018,12,26, 23 ,6985,1427,1266,9678
12/26/2018,2018,12,26, 24 ,6618,1331,1172,9121
12/27/2018,2018,12,27, 1 ,6269,1271,1081,8621
12/27/2018,2018,12,27, 2 ,6079,1229,1049,8357
12/27/2018,2018,12,27, 3 ,5872,1202,1016,8090
12/27/2018,2018,12,27, 4 ,5774,1187,999,7960
12/27/2018,2018,12,27, 5 ,5745,1198,1013,7956
12/27/2018,2018,12,27, 6 ,5938,1223,1054,8215
12/27/2018,2018,12,27, 7 ,6104,1245,1063,8412
12/27/2018,2018,12,27, 8 ,6711,1365,1177,9253
12/27/2018,2018,12,27, 9 ,7512,1581,1412,10505
12/27/2018,2018,12,27, 10 ,7959,1677,1535,11171
12/27/2018,2018,12,27, 11 ,8337,1744,1599,11680
12/27/2018,2018,12,27, 12 ,8215,1703,1580,11498
12/27/2018,2018,12,27, 13 ,8210,1693,1536,11439
12/27/2018,2018,12,27, 14 ,8408,1752,1629,11789
12/27/2018,2018,12,27, 15 ,8349,1726,1608,11683
12/27/2018,2018,12,27, 16 ,8337,1700,1588,11625
12/27/2018,2018,12,27, 17 ,8044,1661,1532,11237
12/27/2018,2018,12,27, 18 ,8342,1838,1656,11836
12/27/2018,2018,12,27, 19 ,8245,1800,1619,11664
12/27/2018,2018,12,27, 20 ,8088,1734,1572,11394
12/27/2018,2018,12,27, 21 ,7916,1644,1507,11067
12/27/2018,2018,12,27, 22 ,7561,1533,1395,10489
12/27/2018,2018,12,27, 23 ,7127,1411,1270,9808
12/27/2018,2018,12,27, 24 ,6753,1333,1212,9298
12/28/2018,2018,12,28, 1 ,6456,1279,1114,8849
12/28/2018,2018,12,28, 2 ,6217,1235,1077,8529
12/28/2018,2018,12,28, 3 ,6020,1206,1041,8267
12/28/2018,2018,12,28, 4 ,5954,1189,1025,8168
12/28/2018,2018,12,28, 5 ,5930,1195,1034,8159
12/28/2018,2018,12,28, 6 ,6036,1224,1069,8329
12/28/2018,2018,12,28, 7 ,6253,1258,1072,8583
12/28/2018,2018,12,28, 8 ,6827,1341,1189,9357
12/28/2018,2018,12,28, 9 ,7446,1507,1368,10321
12/28/2018,2018,12,28, 10 ,7753,1576,1493,10822
12/28/2018,2018,12,28, 11 ,8143,1612,1587,11342
12/28/2018,2018,12,28, 12 ,7891,1564,1555,11010
12/28/2018,2018,12,28, 13 ,7794,1559,1564,10917
12/28/2018,2018,12,28, 14 ,7723,1588,1601,10912
12/28/2018,2018,12,28, 15 ,7585,1567,1587,10739
12/28/2018,2018,12,28, 16 ,7547,1585,1567,10699
12/28/2018,2018,12,28, 17 ,7451,1617,1545,10613
12/28/2018,2018,12,28, 18 ,7815,1736,1662,11213
12/28/2018,2018,12,28, 19 ,7667,1676,1619,10962
12/28/2018,2018,12,28, 20 ,7415,1601,1557,10573
12/28/2018,2018,12,28, 21 ,7475,1503,1513,10491
12/28/2018,2018,12,28, 22 ,6869,1389,1394,9652
12/28/2018,2018,12,28, 23 ,6419,1274,1279,8972
12/28/2018,2018,12,28, 24 ,6045,1207,1257,8509
12/29/2018,2018,12,29, 1 ,5797,1163,1135,8095
12/29/2018,2018,12,29, 2 ,5619,1132,1115,7866
12/29/2018,2018,12,29, 3 ,5424,1101,1083,7608
12/29/2018,2018,12,29, 4 ,5303,1089,1069,7461
12/29/2018,2018,12,29, 5 ,5337,1110,1078,7525
12/29/2018,2018,12,29, 6 ,5382,1139,1078,7599
12/29/2018,2018,12,29, 7 ,5484,1162,1109,7755
12/29/2018,2018,12,29, 8 ,5807,1231,1183,8221
12/29/2018,2018,12,29, 9 ,6158,1377,1359,8894
12/29/2018,2018,12,29, 10 ,6508,1472,1486,9466
12/29/2018,2018,12,29, 11 ,6671,1520,1553,9744
12/29/2018,2018,12,29, 12 ,6421,1506,1527,9454
12/29/2018,2018,12,29, 13 ,6230,1493,1538,9261
12/29/2018,2018,12,29, 14 ,6231,1510,1595,9336
12/29/2018,2018,12,29, 15 ,6155,1486,1585,9226
12/29/2018,2018,12,29, 16 ,6078,1475,1540,9093
12/29/2018,2018,12,29, 17 ,6153,1476,1505,9134
12/29/2018,2018,12,29, 18 ,6629,1684,1686,9999
12/29/2018,2018,12,29, 19 ,6650,1653,1659,9962
12/29/2018,2018,12,29, 20 ,6494,1598,1639,9731
12/29/2018,2018,12,29, 21 ,6247,1513,1576,9336
12/29/2018,2018,12,29, 22 ,5958,1420,1486,8864
12/29/2018,2018,12,29, 23 ,5599,1317,1358,8274
12/29/2018,2018,12,29, 24 ,5236,1238,1243,7717
12/30/2018,2018,12,30, 1 ,5073,1183,1183,7439
12/30/2018,2018,12,30, 2 ,4957,1144,1116,7217
12/30/2018,2018,12,30, 3 ,4787,1119,1087,6993
12/30/2018,2018,12,30, 4 ,4764,1096,1061,6921
12/30/2018,2018,12,30, 5 ,4796,1109,1069,6974
12/30/2018,2018,12,30, 6 ,4848,1119,1067,7034
12/30/2018,2018,12,30, 7 ,4916,1122,1062,7100
12/30/2018,2018,12,30, 8 ,5169,1160,1104,7433
12/30/2018,2018,12,30, 9 ,5543,1272,1216,8031
12/30/2018,2018,12,30, 10 ,5902,1364,1294,8560
12/30/2018,2018,12,30, 11 ,6077,1411,1348,8836
12/30/2018,2018,12,30, 12 ,5971,1397,1375,8743
12/30/2018,2018,12,30, 13 ,5791,1397,1381,8569
12/30/2018,2018,12,30, 14 ,5786,1396,1377,8559
12/30/2018,2018,12,30, 15 ,5812,1383,1358,8553
12/30/2018,2018,12,30, 16 ,5862,1383,1317,8562
12/30/2018,2018,12,30, 17 ,5966,1426,1348,8740
12/30/2018,2018,12,30, 18 ,6572,1631,1539,9742
12/30/2018,2018,12,30, 19 ,6626,1635,1524,9785
12/30/2018,2018,12,30, 20 ,6427,1597,1481,9505
12/30/2018,2018,12,30, 21 ,6230,1536,1430,9196
12/30/2018,2018,12,30, 22 ,5948,1446,1356,8750
12/30/2018,2018,12,30, 23 ,5531,1341,1231,8103
12/30/2018,2018,12,30, 24 ,5220,1254,1142,7616
12/31/2018,2018,12,31, 1 ,5003,1184,1043,7230
12/31/2018,2018,12,31, 2 ,4834,1142,1031,7007
12/31/2018,2018,12,31, 3 ,4686,1107,999,6792
12/31/2018,2018,12,31, 4 ,4618,1089,988,6695
12/31/2018,2018,12,31, 5 ,4599,1088,996,6683
12/31/2018,2018,12,31, 6 ,4777,1106,1024,6907
12/31/2018,2018,12,31, 7 ,4851,1130,1039,7020
12/31/2018,2018,12,31, 8 ,4977,1187,1075,7239
12/31/2018,2018,12,31, 9 ,5395,1300,1200,7895
12/31/2018,2018,12,31, 10 ,5678,1377,1280,8335
12/31/2018,2018,12,31, 11 ,5835,1427,1338,8600
12/31/2018,2018,12,31, 12 ,5792,1457,1365,8614
12/31/2018,2018,12,31, 13 ,5694,1457,1374,8525
12/31/2018,2018,12,31, 14 ,5666,1481,1386,8533
12/31/2018,2018,12,31, 15 ,5594,1469,1386,8449
12/31/2018,2018,12,31, 16 ,5584,1465,1349,8398
12/31/2018,2018,12,31, 17 ,5618,1473,1334,8425
12/31/2018,2018,12,31, 18 ,6235,1688,1521,9444
12/31/2018,2018,12,31, 19 ,6221,1665,1484,9370
12/31/2018,2018,12,31, 20 ,5383,1571,1390,8344
12/31/2018,2018,12,31, 21 ,5708,1521,1352,8581
12/31/2018,2018,12,31, 22 ,5532,1490,1322,8344
12/31/2018,2018,12,31, 23 ,5361,1462,1284,8107
12/31/2018,2018,12,31, 24 ,5259,1479,1287,8025
1/1/2019,2019,1,1, 1 ,5130,1414,1178,7722
1/1/2019,2019,1,1, 2 ,4847,1303,1104,7254
1/1/2019,2019,1,1, 3 ,4613,1224,1044,6881
1/1/2019,2019,1,1, 4 ,4475,1176,1012,6663
1/1/2019,2019,1,1, 5 ,4374,1144,982,6500
1/1/2019,2019,1,1, 6 ,4336,1106,947,6389
1/1/2019,2019,1,1, 7 ,4286,1080,923,6289
1/1/2019,2019,1,1, 8 ,4375,1085,936,6396
1/1/2019,2019,1,1, 9 ,4570,1122,965,6657
1/1/2019,2019,1,1, 10 ,4834,1150,1000,6984
1/1/2019,2019,1,1, 11 ,5092,1213,1046,7351
1/1/2019,2019,1,1, 12 ,5370,1282,1113,7765
1/1/2019,2019,1,1, 13 ,5393,1307,1131,7831
1/1/2019,2019,1,1, 14 ,5405,1302,1149,7856
1/1/2019,2019,1,1, 15 ,5367,1295,1148,7810
1/1/2019,2019,1,1, 16 ,5352,1286,1135,7773
1/1/2019,2019,1,1, 17 ,5418,1292,1123,7833
1/1/2019,2019,1,1, 18 ,6043,1533,1345,8921
1/1/2019,2019,1,1, 19 ,6097,1547,1355,8999
1/1/2019,2019,1,1, 20 ,6047,1515,1338,8900
1/1/2019,2019,1,1, 21 ,5918,1455,1266,8639
1/1/2019,2019,1,1, 22 ,5624,1357,1184,8165
1/1/2019,2019,1,1, 23 ,5329,1288,1097,7714
1/1/2019,2019,1,1, 24 ,5055,1212,1035,7302
1/2/2019,2019,1,2, 1 ,4833,1162,998,6993
1/2/2019,2019,1,2, 2 ,4695,1125,956,6776
1/2/2019,2019,1,2, 3 ,4596,1092,928,6616
1/2/2019,2019,1,2, 4 ,4539,1085,915,6539
1/2/2019,2019,1,2, 5 ,4594,1084,923,6601
1/2/2019,2019,1,2, 6 ,4812,1113,949,6874
1/2/2019,2019,1,2, 7 ,5114,1149,974,7237
1/2/2019,2019,1,2, 8 ,5686,1247,1069,8002
1/2/2019,2019,1,2, 9 ,6428,1427,1222,9077
1/2/2019,2019,1,2, 10 ,6964,1541,1343,9848
1/2/2019,2019,1,2, 11 ,7380,1588,1435,10403
1/2/2019,2019,1,2, 12 ,7391,1588,1436,10415
1/2/2019,2019,1,2, 13 ,7341,1593,1448,10382
1/2/2019,2019,1,2, 14 ,7452,1598,1498,10548
1/2/2019,2019,1,2, 15 ,7437,1602,1491,10530
1/2/2019,2019,1,2, 16 ,7383,1593,1481,10457
1/2/2019,2019,1,2, 17 ,7207,1564,1445,10216
1/2/2019,2019,1,2, 18 ,7630,1784,1628,11042
1/2/2019,2019,1,2, 19 ,7597,1756,1583,10936
1/2/2019,2019,1,2, 20 ,7367,1687,1520,10574
1/2/2019,2019,1,2, 21 ,7191,1613,1476,10280
1/2/2019,2019,1,2, 22 ,6842,1488,1351,9681
1/2/2019,2019,1,2, 23 ,6484,1389,1255,9128
1/2/2019,2019,1,2, 24 ,6111,1311,1162,8584
1/3/2019,2019,1,3, 1 ,5901,1259,1125,8285
1/3/2019,2019,1,3, 2 ,5636,1202,1077,7915
1/3/2019,2019,1,3, 3 ,5517,1174,1054,7745
1/3/2019,2019,1,3, 4 ,5528,1164,1036,7728
1/3/2019,2019,1,3, 5 ,5604,1193,1055,7852
1/3/2019,2019,1,3, 6 ,5872,1233,1120,8225
1/3/2019,2019,1,3, 7 ,6154,1239,1091,8484
1/3/2019,2019,1,3, 8 ,6861,1360,1216,9437
1/3/2019,2019,1,3, 9 ,7657,1587,1439,10683
1/3/2019,2019,1,3, 10 ,8192,1696,1573,11461
1/3/2019,2019,1,3, 11 ,8657,1767,1643,12067
1/3/2019,2019,1,3, 12 ,8464,1742,1638,11844
1/3/2019,2019,1,3, 13 ,8394,1745,1642,11781
1/3/2019,2019,1,3, 14 ,8646,1802,1717,12165
1/3/2019,2019,1,3, 15 ,8605,1791,1705,12101
1/3/2019,2019,1,3, 16 ,8455,1761,1675,11891
1/3/2019,2019,1,3, 17 ,8210,1715,1577,11502
1/3/2019,2019,1,3, 18 ,8466,1842,1710,12018
1/3/2019,2019,1,3, 19 ,8262,1793,1611,11666
1/3/2019,2019,1,3, 20 ,8114,1719,1576,11409
1/3/2019,2019,1,3, 21 ,7831,1643,1488,10962
1/3/2019,2019,1,3, 22 ,7537,1496,1386,10419
1/3/2019,2019,1,3, 23 ,7073,1397,1274,9744
1/3/2019,2019,1,3, 24 ,6715,1314,1183,9212
1/4/2019,2019,1,4, 1 ,6389,1258,1146,8793
1/4/2019,2019,1,4, 2 ,6217,1230,1093,8540
1/4/2019,2019,1,4, 3 ,6050,1209,1069,8328
1/4/2019,2019,1,4, 4 ,5963,1202,1045,8210
1/4/2019,2019,1,4, 5 ,6073,1232,1083,8388
1/4/2019,2019,1,4, 6 ,6236,1276,1130,8642
1/4/2019,2019,1,4, 7 ,6413,1263,1120,8796
1/4/2019,2019,1,4, 8 ,7174,1387,1235,9796
1/4/2019,2019,1,4, 9 ,7951,1617,1434,11002
1/4/2019,2019,1,4, 10 ,8427,1699,1579,11705
1/4/2019,2019,1,4, 11 ,8784,1730,1680,12194
1/4/2019,2019,1,4, 12 ,8633,1672,1655,11960
1/4/2019,2019,1,4, 13 ,8573,1650,1654,11877
1/4/2019,2019,1,4, 14 ,8835,1679,1700,12214
1/4/2019,2019,1,4, 15 ,8751,1665,1687,12103
1/4/2019,2019,1,4, 16 ,8647,1666,1622,11935
1/4/2019,2019,1,4, 17 ,8237,1665,1582,11484
1/4/2019,2019,1,4, 18 ,8502,1782,1692,11976
1/4/2019,2019,1,4, 19 ,8310,1712,1631,11653
1/4/2019,2019,1,4, 20 ,8128,1645,1576,11349
1/4/2019,2019,1,4, 21 ,7896,1525,1515,10936
1/4/2019,2019,1,4, 22 ,7534,1445,1393,10372
1/4/2019,2019,1,4, 23 ,7140,1351,1307,9798
1/4/2019,2019,1,4, 24 ,6740,1274,1205,9219
1/5/2019,2019,1,5, 1 ,6440,1231,1142,8813
1/5/2019,2019,1,5, 2 ,6253,1191,1118,8562
1/5/2019,2019,1,5, 3 ,6065,1170,1077,8312
1/5/2019,2019,1,5, 4 ,5972,1157,1056,8185
1/5/2019,2019,1,5, 5 ,5943,1166,1066,8175
1/5/2019,2019,1,5, 6 ,6079,1192,1086,8357
1/5/2019,2019,1,5, 7 ,6158,1222,1088,8468
1/5/2019,2019,1,5, 8 ,6675,1312,1168,9155
1/5/2019,2019,1,5, 9 ,7310,1495,1366,10171
1/5/2019,2019,1,5, 10 ,7821,1587,1479,10887
1/5/2019,2019,1,5, 11 ,8208,1620,1551,11379
1/5/2019,2019,1,5, 12 ,8091,1641,1549,11281
1/5/2019,2019,1,5, 13 ,8050,1623,1540,11213
1/5/2019,2019,1,5, 14 ,8227,1667,1582,11476
1/5/2019,2019,1,5, 15 ,8088,1633,1557,11278
1/5/2019,2019,1,5, 16 ,7941,1608,1538,11087
1/5/2019,2019,1,5, 17 ,7651,1593,1506,10750
1/5/2019,2019,1,5, 18 ,7995,1772,1659,11426
1/5/2019,2019,1,5, 19 ,8085,1741,1618,11444
1/5/2019,2019,1,5, 20 ,7965,1675,1533,11173
1/5/2019,2019,1,5, 21 ,7787,1606,1507,10900
1/5/2019,2019,1,5, 22 ,7467,1500,1409,10376
1/5/2019,2019,1,5, 23 ,7076,1399,1313,9788
1/5/2019,2019,1,5, 24 ,6708,1313,1220,9241
1/6/2019,2019,1,6, 1 ,6414,1265,1168,8847
1/6/2019,2019,1,6, 2 ,6239,1221,1133,8593
1/6/2019,2019,1,6, 3 ,6061,1181,1098,8340
1/6/2019,2019,1,6, 4 ,5960,1164,1062,8186
1/6/2019,2019,1,6, 5 ,5852,1171,1081,8104
1/6/2019,2019,1,6, 6 ,5825,1179,1104,8108
1/6/2019,2019,1,6, 7 ,5815,1187,1087,8089
1/6/2019,2019,1,6, 8 ,6102,1245,1143,8490
1/6/2019,2019,1,6, 9 ,6552,1333,1230,9115
1/6/2019,2019,1,6, 10 ,6997,1424,1306,9727
1/6/2019,2019,1,6, 11 ,7308,1486,1362,10156
1/6/2019,2019,1,6, 12 ,7233,1482,1355,10070
1/6/2019,2019,1,6, 13 ,7163,1484,1328,9975
1/6/2019,2019,1,6, 14 ,7162,1483,1350,9995
1/6/2019,2019,1,6, 15 ,7111,1472,1349,9932
1/6/2019,2019,1,6, 16 ,7044,1456,1335,9835
1/6/2019,2019,1,6, 17 ,6939,1466,1366,9771
1/6/2019,2019,1,6, 18 ,7406,1657,1535,10598
1/6/2019,2019,1,6, 19 ,7675,1686,1490,10851
1/6/2019,2019,1,6, 20 ,7574,1624,1478,10676
1/6/2019,2019,1,6, 21 ,7348,1541,1422,10311
1/6/2019,2019,1,6, 22 ,7060,1440,1319,9819
1/6/2019,2019,1,6, 23 ,6590,1332,1228,9150
1/6/2019,2019,1,6, 24 ,6186,1244,1214,8644
1/7/2019,2019,1,7, 1 ,5981,1163,1064,8208
1/7/2019,2019,1,7, 2 ,5809,1120,1044,7973
1/7/2019,2019,1,7, 3 ,5592,1089,1012,7693
1/7/2019,2019,1,7, 4 ,5554,1076,1001,7631
1/7/2019,2019,1,7, 5 ,5793,1144,1064,8001
1/7/2019,2019,1,7, 6 ,6083,1226,1165,8474
1/7/2019,2019,1,7, 7 ,6244,1190,1080,8514
1/7/2019,2019,1,7, 8 ,7004,1323,1199,9526
1/7/2019,2019,1,7, 9 ,7791,1530,1421,10742
1/7/2019,2019,1,7, 10 ,8383,1662,1562,11607
1/7/2019,2019,1,7, 11 ,8772,1732,1647,12151
1/7/2019,2019,1,7, 12 ,8543,1708,1622,11873
1/7/2019,2019,1,7, 13 ,8447,1710,1645,11802
1/7/2019,2019,1,7, 14 ,8772,1788,1711,12271
1/7/2019,2019,1,7, 15 ,8659,1772,1697,12128
1/7/2019,2019,1,7, 16 ,8548,1757,1673,11978
1/7/2019,2019,1,7, 17 ,8232,1694,1594,11520
1/7/2019,2019,1,7, 18 ,8367,1829,1697,11893
1/7/2019,2019,1,7, 19 ,8316,1809,1667,11792
1/7/2019,2019,1,7, 20 ,8077,1715,1606,11398
1/7/2019,2019,1,7, 21 ,7842,1628,1518,10988
1/7/2019,2019,1,7, 22 ,7447,1487,1390,10324
1/7/2019,2019,1,7, 23 ,7022,1376,1267,9665
1/7/2019,2019,1,7, 24 ,6630,1288,1166,9084
1/8/2019,2019,1,8, 1 ,6295,1237,1118,8650
1/8/2019,2019,1,8, 2 ,6047,1209,1080,8336
1/8/2019,2019,1,8, 3 ,5972,1186,1041,8199
1/8/2019,2019,1,8, 4 ,5889,1176,1035,8100
1/8/2019,2019,1,8, 5 ,6074,1236,1090,8400
1/8/2019,2019,1,8, 6 ,6396,1313,1198,8907
1/8/2019,2019,1,8, 7 ,6474,1268,1098,8840
1/8/2019,2019,1,8, 8 ,7151,1391,1234,9776
1/8/2019,2019,1,8, 9 ,7962,1633,1450,11045
1/8/2019,2019,1,8, 10 ,8534,1733,1545,11812
1/8/2019,2019,1,8, 11 ,8884,1818,1652,12354
1/8/2019,2019,1,8, 12 ,8680,1760,1616,12056
1/8/2019,2019,1,8, 13 ,8689,1752,1631,12072
1/8/2019,2019,1,8, 14 ,9000,1832,1695,12527
1/8/2019,2019,1,8, 15 ,8891,1829,1688,12408
1/8/2019,2019,1,8, 16 ,8810,1738,1659,12207
1/8/2019,2019,1,8, 17 ,8404,1663,1582,11649
1/8/2019,2019,1,8, 18 ,8544,1793,1702,12039
1/8/2019,2019,1,8, 19 ,8465,1789,1664,11918
1/8/2019,2019,1,8, 20 ,8267,1718,1598,11583
1/8/2019,2019,1,8, 21 ,7948,1640,1521,11109
1/8/2019,2019,1,8, 22 ,7574,1525,1364,10463
1/8/2019,2019,1,8, 23 ,7177,1403,1251,9831
1/8/2019,2019,1,8, 24 ,6768,1319,1136,9223
1/9/2019,2019,1,9, 1 ,6458,1270,1109,8837
1/9/2019,2019,1,9, 2 ,6267,1242,1078,8587
1/9/2019,2019,1,9, 3 ,6059,1208,1052,8319
1/9/2019,2019,1,9, 4 ,6032,1205,1024,8261
1/9/2019,2019,1,9, 5 ,6231,1252,1086,8569
1/9/2019,2019,1,9, 6 ,6494,1320,1165,8979
1/9/2019,2019,1,9, 7 ,6577,1279,1070,8926
1/9/2019,2019,1,9, 8 ,7268,1390,1206,9864
1/9/2019,2019,1,9, 9 ,8082,1612,1392,11086
1/9/2019,2019,1,9, 10 ,8590,1702,1512,11804
1/9/2019,2019,1,9, 11 ,8928,1788,1620,12336
1/9/2019,2019,1,9, 12 ,8697,1754,1592,12043
1/9/2019,2019,1,9, 13 ,8598,1745,1605,11948
1/9/2019,2019,1,9, 14 ,8831,1827,1687,12345
1/9/2019,2019,1,9, 15 ,8798,1824,1682,12304
1/9/2019,2019,1,9, 16 ,8724,1786,1649,12159
1/9/2019,2019,1,9, 17 ,8387,1725,1593,11705
1/9/2019,2019,1,9, 18 ,8536,1849,1698,12083
1/9/2019,2019,1,9, 19 ,8502,1832,1671,12005
1/9/2019,2019,1,9, 20 ,8326,1749,1590,11665
1/9/2019,2019,1,9, 21 ,8092,1657,1512,11261
1/9/2019,2019,1,9, 22 ,7649,1529,1400,10578
1/9/2019,2019,1,9, 23 ,7227,1418,1294,9939
1/9/2019,2019,1,9, 24 ,6784,1339,1198,9321
1/10/2019,2019,1,10, 1 ,6437,1282,1162,8881
1/10/2019,2019,1,10, 2 ,6259,1238,1118,8615
1/10/2019,2019,1,10, 3 ,6129,1206,1079,8414
1/10/2019,2019,1,10, 4 ,6099,1193,1068,8360
1/10/2019,2019,1,10, 5 ,6294,1252,1104,8650
1/10/2019,2019,1,10, 6 ,6604,1316,1199,9119
1/10/2019,2019,1,10, 7 ,6698,1286,1122,9106
1/10/2019,2019,1,10, 8 ,7308,1403,1221,9932
1/10/2019,2019,1,10, 9 ,8077,1607,1426,11110
1/10/2019,2019,1,10, 10 ,8655,1705,1556,11916
1/10/2019,2019,1,10, 11 ,8985,1742,1631,12358
1/10/2019,2019,1,10, 12 ,8765,1688,1599,12052
1/10/2019,2019,1,10, 13 ,8655,1679,1596,11930
1/10/2019,2019,1,10, 14 ,9030,1706,1665,12401
1/10/2019,2019,1,10, 15 ,8980,1675,1637,12292
1/10/2019,2019,1,10, 16 ,8868,1682,1605,12155
1/10/2019,2019,1,10, 17 ,8562,1676,1591,11829
1/10/2019,2019,1,10, 18 ,8669,1770,1677,12116
1/10/2019,2019,1,10, 19 ,8597,1727,1655,11979
1/10/2019,2019,1,10, 20 ,8431,1638,1606,11675
1/10/2019,2019,1,10, 21 ,8186,1534,1522,11242
1/10/2019,2019,1,10, 22 ,7741,1406,1385,10532
1/10/2019,2019,1,10, 23 ,7327,1314,1295,9936
1/10/2019,2019,1,10, 24 ,6904,1231,1204,9339
1/11/2019,2019,1,11, 1 ,6632,1189,1150,8971
1/11/2019,2019,1,11, 2 ,6435,1170,1117,8722
1/11/2019,2019,1,11, 3 ,6305,1145,1074,8524
1/11/2019,2019,1,11, 4 ,6211,1137,1068,8416
1/11/2019,2019,1,11, 5 ,6393,1200,1121,8714
1/11/2019,2019,1,11, 6 ,6672,1275,1214,9161
1/11/2019,2019,1,11, 7 ,6736,1251,1157,9144
1/11/2019,2019,1,11, 8 ,7374,1350,1226,9950
1/11/2019,2019,1,11, 9 ,8153,1577,1420,11150
1/11/2019,2019,1,11, 10 ,8629,1699,1516,11844
1/11/2019,2019,1,11, 11 ,9001,1770,1562,12333
1/11/2019,2019,1,11, 12 ,8754,1714,1501,11969
1/11/2019,2019,1,11, 13 ,8697,1704,1478,11879
1/11/2019,2019,1,11, 14 ,9061,1759,1514,12334
1/11/2019,2019,1,11, 15 ,8973,1745,1500,12218
1/11/2019,2019,1,11, 16 ,8867,1700,1496,12063
1/11/2019,2019,1,11, 17 ,8477,1657,1494,11628
1/11/2019,2019,1,11, 18 ,8670,1789,1608,12067
1/11/2019,2019,1,11, 19 ,8606,1774,1541,11921
1/11/2019,2019,1,11, 20 ,8400,1701,1471,11572
1/11/2019,2019,1,11, 21 ,8159,1628,1392,11179
1/11/2019,2019,1,11, 22 ,7802,1498,1272,10572
1/11/2019,2019,1,11, 23 ,7470,1384,1179,10033
1/11/2019,2019,1,11, 24 ,7001,1306,1182,9489
1/12/2019,2019,1,12, 1 ,6715,1255,1074,9044
1/12/2019,2019,1,12, 2 ,6536,1211,1010,8757
1/12/2019,2019,1,12, 3 ,6404,1196,995,8595
1/12/2019,2019,1,12, 4 ,6242,1180,987,8409
1/12/2019,2019,1,12, 5 ,6262,1200,1020,8482
1/12/2019,2019,1,12, 6 ,6316,1241,1072,8629
1/12/2019,2019,1,12, 7 ,6372,1255,1103,8730
1/12/2019,2019,1,12, 8 ,7041,1366,1153,9560
1/12/2019,2019,1,12, 9 ,7641,1535,1284,10460
1/12/2019,2019,1,12, 10 ,8285,1637,1398,11320
1/12/2019,2019,1,12, 11 ,8552,1706,1471,11729
1/12/2019,2019,1,12, 12 ,8387,1663,1429,11479
1/12/2019,2019,1,12, 13 ,8338,1673,1437,11448
1/12/2019,2019,1,12, 14 ,8525,1713,1450,11688
1/12/2019,2019,1,12, 15 ,8400,1676,1449,11525
1/12/2019,2019,1,12, 16 ,8236,1633,1436,11305
1/12/2019,2019,1,12, 17 ,7907,1589,1454,10950
1/12/2019,2019,1,12, 18 ,8160,1761,1575,11496
1/12/2019,2019,1,12, 19 ,8195,1759,1534,11488
1/12/2019,2019,1,12, 20 ,8164,1704,1492,11360
1/12/2019,2019,1,12, 21 ,7923,1617,1415,10955
1/12/2019,2019,1,12, 22 ,7682,1526,1331,10539
1/12/2019,2019,1,12, 23 ,7301,1419,1216,9936
1/12/2019,2019,1,12, 24 ,6925,1339,1137,9401
1/13/2019,2019,1,13, 1 ,6613,1282,1043,8938
1/13/2019,2019,1,13, 2 ,6478,1256,1030,8764
1/13/2019,2019,1,13, 3 ,6246,1224,998,8468
1/13/2019,2019,1,13, 4 ,6114,1202,987,8303
1/13/2019,2019,1,13, 5 ,6036,1202,1005,8243
1/13/2019,2019,1,13, 6 ,6076,1214,1029,8319
1/13/2019,2019,1,13, 7 ,6007,1223,1052,8282
1/13/2019,2019,1,13, 8 ,6262,1263,1067,8592
1/13/2019,2019,1,13, 9 ,6681,1348,1141,9170
1/13/2019,2019,1,13, 10 ,7180,1421,1213,9814
1/13/2019,2019,1,13, 11 ,7394,1479,1265,10138
1/13/2019,2019,1,13, 12 ,7243,1487,1287,10017
1/13/2019,2019,1,13, 13 ,7124,1511,1286,9921
1/13/2019,2019,1,13, 14 ,7122,1504,1293,9919
1/13/2019,2019,1,13, 15 ,7053,1478,1299,9830
1/13/2019,2019,1,13, 16 ,6917,1470,1262,9649
1/13/2019,2019,1,13, 17 ,6922,1471,1271,9664
1/13/2019,2019,1,13, 18 ,7417,1672,1478,10567
1/13/2019,2019,1,13, 19 ,7698,1712,1506,10916
1/13/2019,2019,1,13, 20 ,7570,1668,1455,10693
1/13/2019,2019,1,13, 21 ,7391,1603,1399,10393
1/13/2019,2019,1,13, 22 ,7025,1490,1293,9808
1/13/2019,2019,1,13, 23 ,6565,1389,1174,9128
1/13/2019,2019,1,13, 24 ,6305,1295,1100,8700
1/14/2019,2019,1,14, 1 ,5958,1249,1046,8253
1/14/2019,2019,1,14, 2 ,5775,1213,1019,8007
1/14/2019,2019,1,14, 3 ,5615,1183,985,7783
1/14/2019,2019,1,14, 4 ,5617,1150,978,7745
1/14/2019,2019,1,14, 5 ,5889,1217,1035,8141
1/14/2019,2019,1,14, 6 ,6184,1299,1151,8634
1/14/2019,2019,1,14, 7 ,6411,1265,1058,8734
1/14/2019,2019,1,14, 8 ,7046,1391,1146,9583
1/14/2019,2019,1,14, 9 ,8071,1611,1417,11099
1/14/2019,2019,1,14, 10 ,8685,1731,1502,11918
1/14/2019,2019,1,14, 11 ,8907,1799,1582,12288
1/14/2019,2019,1,14, 12 ,8792,1742,1558,12092
1/14/2019,2019,1,14, 13 ,8705,1773,1594,12072
1/14/2019,2019,1,14, 14 ,9069,1827,1664,12560
1/14/2019,2019,1,14, 15 ,8993,1827,1638,12458
1/14/2019,2019,1,14, 16 ,8873,1813,1611,12297
1/14/2019,2019,1,14, 17 ,8509,1728,1567,11804
1/14/2019,2019,1,14, 18 ,8567,1853,1669,12089
1/14/2019,2019,1,14, 19 ,8532,1842,1642,12016
1/14/2019,2019,1,14, 20 ,8379,1761,1560,11700
1/14/2019,2019,1,14, 21 ,8092,1673,1514,11279
1/14/2019,2019,1,14, 22 ,7678,1535,1390,10603
1/14/2019,2019,1,14, 23 ,7232,1437,1274,9943
1/14/2019,2019,1,14, 24 ,6754,1346,1144,9244
1/15/2019,2019,1,15, 1 ,6491,1281,1132,8904
1/15/2019,2019,1,15, 2 ,6264,1244,1096,8604
1/15/2019,2019,1,15, 3 ,6110,1222,1073,8405
1/15/2019,2019,1,15, 4 ,6047,1194,1048,8289
1/15/2019,2019,1,15, 5 ,6240,1244,1099,8583
1/15/2019,2019,1,15, 6 ,6544,1323,1200,9067
1/15/2019,2019,1,15, 7 ,6616,1288,1114,9018
1/15/2019,2019,1,15, 8 ,7274,1403,1194,9871
1/15/2019,2019,1,15, 9 ,8123,1628,1421,11172
1/15/2019,2019,1,15, 10 ,8695,1758,1549,12002
1/15/2019,2019,1,15, 11 ,8988,1799,1614,12401
1/15/2019,2019,1,15, 12 ,8782,1756,1558,12096
1/15/2019,2019,1,15, 13 ,8730,1773,1568,12071
1/15/2019,2019,1,15, 14 ,9059,1840,1664,12563
1/15/2019,2019,1,15, 15 ,9003,1818,1614,12435
1/15/2019,2019,1,15, 16 ,8896,1783,1575,12254
1/15/2019,2019,1,15, 17 ,8560,1711,1565,11836
1/15/2019,2019,1,15, 18 ,8620,1832,1660,12112
1/15/2019,2019,1,15, 19 ,8555,1829,1618,12002
1/15/2019,2019,1,15, 20 ,8327,1759,1556,11642
1/15/2019,2019,1,15, 21 ,8075,1662,1500,11237
1/15/2019,2019,1,15, 22 ,7678,1541,1377,10596
1/15/2019,2019,1,15, 23 ,7234,1433,1260,9927
1/15/2019,2019,1,15, 24 ,6910,1341,1171,9422
1/16/2019,2019,1,16, 1 ,6595,1285,1106,8986
1/16/2019,2019,1,16, 2 ,6378,1243,1070,8691
1/16/2019,2019,1,16, 3 ,6236,1208,1040,8484
1/16/2019,2019,1,16, 4 ,6155,1188,1031,8374
1/16/2019,2019,1,16, 5 ,6358,1241,1080,8679
1/16/2019,2019,1,16, 6 ,6635,1308,1196,9139
1/16/2019,2019,1,16, 7 ,6675,1277,1110,9062
1/16/2019,2019,1,16, 8 ,7341,1387,1194,9922
1/16/2019,2019,1,16, 9 ,8124,1601,1398,11123
1/16/2019,2019,1,16, 10 ,8729,1734,1505,11968
1/16/2019,2019,1,16, 11 ,8943,1785,1561,12289
1/16/2019,2019,1,16, 12 ,8747,1749,1537,12033
1/16/2019,2019,1,16, 13 ,8715,1724,1537,11976
1/16/2019,2019,1,16, 14 ,9010,1795,1601,12406
1/16/2019,2019,1,16, 15 ,8938,1783,1583,12304
1/16/2019,2019,1,16, 16 ,8828,1756,1583,12167
1/16/2019,2019,1,16, 17 ,8416,1700,1570,11686
1/16/2019,2019,1,16, 18 ,8534,1823,1675,12032
1/16/2019,2019,1,16, 19 ,8601,1827,1643,12071
1/16/2019,2019,1,16, 20 ,8371,1757,1580,11708
1/16/2019,2019,1,16, 21 ,8025,1659,1487,11171
1/16/2019,2019,1,16, 22 ,7596,1532,1365,10493
1/16/2019,2019,1,16, 23 ,7115,1432,1262,9809
1/16/2019,2019,1,16, 24 ,6719,1342,1204,9265
1/17/2019,2019,1,17, 1 ,6370,1299,1104,8773
1/17/2019,2019,1,17, 2 ,6261,1261,1073,8595
1/17/2019,2019,1,17, 3 ,6002,1227,1045,8274
1/17/2019,2019,1,17, 4 ,5936,1214,1038,8188
1/17/2019,2019,1,17, 5 ,6153,1264,1081,8498
1/17/2019,2019,1,17, 6 ,6442,1329,1205,8976
1/17/2019,2019,1,17, 7 ,6503,1295,1131,8929
1/17/2019,2019,1,17, 8 ,7103,1405,1204,9712
1/17/2019,2019,1,17, 9 ,7877,1613,1420,10910
1/17/2019,2019,1,17, 10 ,8395,1713,1560,11668
1/17/2019,2019,1,17, 11 ,8795,1766,1629,12190
1/17/2019,2019,1,17, 12 ,8575,1728,1597,11900
1/17/2019,2019,1,17, 13 ,8557,1753,1604,11914
1/17/2019,2019,1,17, 14 ,8937,1820,1679,12436
1/17/2019,2019,1,17, 15 ,8852,1787,1653,12292
1/17/2019,2019,1,17, 16 ,8721,1757,1633,12111
1/17/2019,2019,1,17, 17 ,8394,1695,1589,11678
1/17/2019,2019,1,17, 18 ,8471,1799,1669,11939
1/17/2019,2019,1,17, 19 ,8405,1791,1649,11845
1/17/2019,2019,1,17, 20 ,8154,1733,1597,11484
1/17/2019,2019,1,17, 21 ,7901,1636,1529,11066
1/17/2019,2019,1,17, 22 ,7425,1519,1399,10343
1/17/2019,2019,1,17, 23 ,7005,1416,1291,9712
1/17/2019,2019,1,17, 24 ,6617,1337,1135,9089
1/18/2019,2019,1,18, 1 ,6334,1285,1114,8733
1/18/2019,2019,1,18, 2 ,6176,1249,1083,8508
1/18/2019,2019,1,18, 3 ,6068,1216,1051,8335
1/18/2019,2019,1,18, 4 ,5994,1195,1059,8248
1/18/2019,2019,1,18, 5 ,6135,1242,1105,8482
1/18/2019,2019,1,18, 6 ,6405,1300,1198,8903
1/18/2019,2019,1,18, 7 ,6562,1286,1141,8989
1/18/2019,2019,1,18, 8 ,7194,1399,1210,9803
1/18/2019,2019,1,18, 9 ,7997,1614,1466,11077
1/18/2019,2019,1,18, 10 ,8496,1730,1574,11800
1/18/2019,2019,1,18, 11 ,8831,1769,1634,12234
1/18/2019,2019,1,18, 12 ,8546,1700,1564,11810
1/18/2019,2019,1,18, 13 ,8449,1704,1566,11719
1/18/2019,2019,1,18, 14 ,8744,1756,1622,12122
1/18/2019,2019,1,18, 15 ,8657,1720,1592,11969
1/18/2019,2019,1,18, 16 ,8536,1707,1587,11830
1/18/2019,2019,1,18, 17 ,8183,1659,1520,11362
1/18/2019,2019,1,18, 18 ,8228,1775,1627,11630
1/18/2019,2019,1,18, 19 ,8277,1768,1628,11673
1/18/2019,2019,1,18, 20 ,8011,1704,1558,11273
1/18/2019,2019,1,18, 21 ,7742,1607,1469,10818
1/18/2019,2019,1,18, 22 ,7324,1485,1350,10159
1/18/2019,2019,1,18, 23 ,6952,1391,1243,9586
1/18/2019,2019,1,18, 24 ,6555,1310,1202,9067
1/19/2019,2019,1,19, 1 ,6264,1265,1105,8634
1/19/2019,2019,1,19, 2 ,6082,1226,1069,8377
1/19/2019,2019,1,19, 3 ,5963,1194,1038,8195
1/19/2019,2019,1,19, 4 ,5896,1191,1024,8111
1/19/2019,2019,1,19, 5 ,5909,1213,1036,8158
1/19/2019,2019,1,19, 6 ,6033,1246,1084,8363
1/19/2019,2019,1,19, 7 ,6140,1257,1105,8502
1/19/2019,2019,1,19, 8 ,6684,1349,1138,9171
1/19/2019,2019,1,19, 9 ,7363,1486,1269,10118
1/19/2019,2019,1,19, 10 ,7931,1560,1405,10896
1/19/2019,2019,1,19, 11 ,8255,1600,1458,11313
1/19/2019,2019,1,19, 12 ,8057,1560,1431,11048
1/19/2019,2019,1,19, 13 ,7940,1563,1453,10956
1/19/2019,2019,1,19, 14 ,8140,1596,1487,11223
1/19/2019,2019,1,19, 15 ,8068,1574,1455,11097
1/19/2019,2019,1,19, 16 ,7876,1540,1444,10860
1/19/2019,2019,1,19, 17 ,7693,1534,1443,10670
1/19/2019,2019,1,19, 18 ,7932,1670,1582,11184
1/19/2019,2019,1,19, 19 ,8067,1691,1573,11331
1/19/2019,2019,1,19, 20 ,7937,1626,1515,11078
1/19/2019,2019,1,19, 21 ,7744,1562,1412,10718
1/19/2019,2019,1,19, 22 ,7411,1487,1344,10242
1/19/2019,2019,1,19, 23 ,7003,1367,1196,9566
1/19/2019,2019,1,19, 24 ,6636,1307,1144,9087
1/20/2019,2019,1,20, 1 ,6337,1256,1078,8671
1/20/2019,2019,1,20, 2 ,6081,1224,1058,8363
1/20/2019,2019,1,20, 3 ,6032,1199,1034,8265
1/20/2019,2019,1,20, 4 ,5900,1189,1019,8108
1/20/2019,2019,1,20, 5 ,5847,1184,1024,8055
1/20/2019,2019,1,20, 6 ,5836,1205,1031,8072
1/20/2019,2019,1,20, 7 ,5818,1208,1066,8092
1/20/2019,2019,1,20, 8 ,6142,1243,1085,8470
1/20/2019,2019,1,20, 9 ,6606,1322,1152,9080
1/20/2019,2019,1,20, 10 ,7087,1393,1237,9717
1/20/2019,2019,1,20, 11 ,7342,1430,1295,10067
1/20/2019,2019,1,20, 12 ,7258,1411,1311,9980
1/20/2019,2019,1,20, 13 ,7272,1388,1301,9961
1/20/2019,2019,1,20, 14 ,7312,1377,1296,9985
1/20/2019,2019,1,20, 15 ,7231,1377,1301,9909
1/20/2019,2019,1,20, 16 ,7095,1379,1312,9786
1/20/2019,2019,1,20, 17 ,6889,1386,1297,9572
1/20/2019,2019,1,20, 18 ,7178,1553,1486,10217
1/20/2019,2019,1,20, 19 ,7544,1555,1481,10580
1/20/2019,2019,1,20, 20 ,7505,1513,1413,10431
1/20/2019,2019,1,20, 21 ,7340,1430,1349,10119
1/20/2019,2019,1,20, 22 ,7039,1336,1234,9609
1/20/2019,2019,1,20, 23 ,6605,1262,1137,9004
1/20/2019,2019,1,20, 24 ,6324,1193,1091,8608
1/21/2019,2019,1,21, 1 ,5991,1149,1047,8187
1/21/2019,2019,1,21, 2 ,5841,1123,998,7962
1/21/2019,2019,1,21, 3 ,5723,1099,966,7788
1/21/2019,2019,1,21, 4 ,5676,1100,978,7754
1/21/2019,2019,1,21, 5 ,5949,1162,1003,8114
1/21/2019,2019,1,21, 6 ,6230,1242,1126,8598
1/21/2019,2019,1,21, 7 ,6440,1268,1084,8792
1/21/2019,2019,1,21, 8 ,7139,1367,1153,9659
1/21/2019,2019,1,21, 9 ,7992,1586,1398,10976
1/21/2019,2019,1,21, 10 ,8524,1715,1532,11771
1/21/2019,2019,1,21, 11 ,8847,1764,1611,12222
1/21/2019,2019,1,21, 12 ,8580,1722,1595,11897
1/21/2019,2019,1,21, 13 ,8426,1691,1484,11601
1/21/2019,2019,1,21, 14 ,8619,1765,1544,11928
1/21/2019,2019,1,21, 15 ,8557,1746,1614,11917
1/21/2019,2019,1,21, 16 ,8492,1730,1599,11821
1/21/2019,2019,1,21, 17 ,8242,1687,1551,11480
1/21/2019,2019,1,21, 18 ,8363,1813,1650,11826
1/21/2019,2019,1,21, 19 ,8386,1780,1638,11804
1/21/2019,2019,1,21, 20 ,8212,1715,1586,11513
1/21/2019,2019,1,21, 21 ,7984,1614,1509,11107
1/21/2019,2019,1,21, 22 ,7552,1501,1383,10436
1/21/2019,2019,1,21, 23 ,7151,1388,1279,9818
1/21/2019,2019,1,21, 24 ,6693,1312,1098,9103
1/22/2019,2019,1,22, 1 ,6401,1264,1161,8826
1/22/2019,2019,1,22, 2 ,6244,1232,1124,8600
1/22/2019,2019,1,22, 3 ,6173,1207,1090,8470
1/22/2019,2019,1,22, 4 ,6123,1178,1084,8385
1/22/2019,2019,1,22, 5 ,6308,1249,1144,8701
1/22/2019,2019,1,22, 6 ,6581,1324,1219,9124
1/22/2019,2019,1,22, 7 ,6680,1314,1163,9157
1/22/2019,2019,1,22, 8 ,7335,1400,1229,9964
1/22/2019,2019,1,22, 9 ,8149,1622,1437,11208
1/22/2019,2019,1,22, 10 ,8666,1729,1577,11972
1/22/2019,2019,1,22, 11 ,8916,1776,1675,12367
1/22/2019,2019,1,22, 12 ,8686,1718,1641,12045
1/22/2019,2019,1,22, 13 ,8585,1719,1663,11967
1/22/2019,2019,1,22, 14 ,8912,1813,1692,12417
1/22/2019,2019,1,22, 15 ,8835,1808,1680,12323
1/22/2019,2019,1,22, 16 ,8787,1785,1660,12232
1/22/2019,2019,1,22, 17 ,8454,1749,1607,11810
1/22/2019,2019,1,22, 18 ,8485,1838,1684,12007
1/22/2019,2019,1,22, 19 ,8517,1819,1671,12007
1/22/2019,2019,1,22, 20 ,8359,1737,1618,11714
1/22/2019,2019,1,22, 21 ,8112,1632,1552,11296
1/22/2019,2019,1,22, 22 ,7665,1499,1408,10572
1/22/2019,2019,1,22, 23 ,7209,1397,1300,9906
1/22/2019,2019,1,22, 24 ,6821,1329,1201,9351
1/23/2019,2019,1,23, 1 ,6566,1275,1133,8974
1/23/2019,2019,1,23, 2 ,6406,1241,1094,8741
1/23/2019,2019,1,23, 3 ,6274,1217,1059,8550
1/23/2019,2019,1,23, 4 ,6224,1212,1050,8486
1/23/2019,2019,1,23, 5 ,6429,1259,1116,8804
1/23/2019,2019,1,23, 6 ,6714,1325,1175,9214
1/23/2019,2019,1,23, 7 ,6788,1307,1121,9216
1/23/2019,2019,1,23, 8 ,7401,1431,1222,10054
1/23/2019,2019,1,23, 9 ,8202,1598,1428,11228
1/23/2019,2019,1,23, 10 ,8634,1709,1583,11926
1/23/2019,2019,1,23, 11 ,8851,1764,1640,12255
1/23/2019,2019,1,23, 12 ,8566,1699,1618,11883
1/23/2019,2019,1,23, 13 ,8482,1661,1640,11783
1/23/2019,2019,1,23, 14 ,8757,1700,1698,12155
1/23/2019,2019,1,23, 15 ,8636,1707,1697,12040
1/23/2019,2019,1,23, 16 ,8509,1739,1651,11899
1/23/2019,2019,1,23, 17 ,8295,1716,1605,11616
1/23/2019,2019,1,23, 18 ,8443,1820,1688,11951
1/23/2019,2019,1,23, 19 ,8494,1811,1673,11978
1/23/2019,2019,1,23, 20 ,8252,1744,1606,11602
1/23/2019,2019,1,23, 21 ,8025,1661,1543,11229
1/23/2019,2019,1,23, 22 ,7582,1524,1408,10514
1/23/2019,2019,1,23, 23 ,7143,1419,1297,9859
1/23/2019,2019,1,23, 24 ,6702,1325,1212,9239
1/24/2019,2019,1,24, 1 ,6439,1288,1150,8877
1/24/2019,2019,1,24, 2 ,6255,1252,1136,8643
1/24/2019,2019,1,24, 3 ,6133,1226,1096,8455
1/24/2019,2019,1,24, 4 ,6047,1223,1081,8351
1/24/2019,2019,1,24, 5 ,6334,1272,1141,8747
1/24/2019,2019,1,24, 6 ,6637,1343,1226,9206
1/24/2019,2019,1,24, 7 ,6688,1353,1148,9189
1/24/2019,2019,1,24, 8 ,7407,1421,1256,10084
1/24/2019,2019,1,24, 9 ,8138,1633,1472,11243
1/24/2019,2019,1,24, 10 ,8624,1753,1595,11972
1/24/2019,2019,1,24, 11 ,8975,1823,1689,12487
1/24/2019,2019,1,24, 12 ,8725,1748,1649,12122
1/24/2019,2019,1,24, 13 ,8644,1759,1640,12043
1/24/2019,2019,1,24, 14 ,8892,1820,1699,12411
1/24/2019,2019,1,24, 15 ,8805,1793,1676,12274
1/24/2019,2019,1,24, 16 ,8710,1784,1655,12149
1/24/2019,2019,1,24, 17 ,8436,1744,1604,11784
1/24/2019,2019,1,24, 18 ,8513,1822,1703,12038
1/24/2019,2019,1,24, 19 ,8542,1817,1673,12032
1/24/2019,2019,1,24, 20 ,8381,1751,1629,11761
1/24/2019,2019,1,24, 21 ,8113,1652,1543,11308
1/24/2019,2019,1,24, 22 ,7693,1526,1417,10636
1/24/2019,2019,1,24, 23 ,7302,1434,1307,10043
1/24/2019,2019,1,24, 24 ,6899,1348,1194,9441
1/25/2019,2019,1,25, 1 ,6599,1302,1146,9047
1/25/2019,2019,1,25, 2 ,6469,1263,1145,8877
1/25/2019,2019,1,25, 3 ,6284,1236,1116,8636
1/25/2019,2019,1,25, 4 ,6263,1231,1091,8585
1/25/2019,2019,1,25, 5 ,6447,1276,1124,8847
1/25/2019,2019,1,25, 6 ,6719,1341,1218,9278
1/25/2019,2019,1,25, 7 ,6745,1320,1175,9240
1/25/2019,2019,1,25, 8 ,7379,1424,1239,10042
1/25/2019,2019,1,25, 9 ,8127,1603,1473,11203
1/25/2019,2019,1,25, 10 ,8615,1691,1635,11941
1/25/2019,2019,1,25, 11 ,8835,1761,1697,12293
1/25/2019,2019,1,25, 12 ,8557,1699,1679,11935
1/25/2019,2019,1,25, 13 ,8524,1699,1692,11915
1/25/2019,2019,1,25, 14 ,8788,1761,1747,12296
1/25/2019,2019,1,25, 15 ,8647,1734,1748,12129
1/25/2019,2019,1,25, 16 ,8544,1723,1710,11977
1/25/2019,2019,1,25, 17 ,8292,1681,1636,11609
1/25/2019,2019,1,25, 18 ,8346,1769,1699,11814
1/25/2019,2019,1,25, 19 ,8398,1765,1682,11845
1/25/2019,2019,1,25, 20 ,8223,1684,1602,11509
1/25/2019,2019,1,25, 21 ,7992,1602,1559,11153
1/25/2019,2019,1,25, 22 ,7573,1480,1436,10489
1/25/2019,2019,1,25, 23 ,7136,1375,1331,9842
1/25/2019,2019,1,25, 24 ,6717,1294,1226,9237
1/26/2019,2019,1,26, 1 ,6444,1250,1168,8862
1/26/2019,2019,1,26, 2 ,6285,1218,1132,8635
1/26/2019,2019,1,26, 3 ,6142,1188,1074,8404
1/26/2019,2019,1,26, 4 ,6037,1187,1072,8296
1/26/2019,2019,1,26, 5 ,6008,1195,1081,8284
1/26/2019,2019,1,26, 6 ,6125,1229,1116,8470
1/26/2019,2019,1,26, 7 ,6312,1255,1146,8713
1/26/2019,2019,1,26, 8 ,6797,1335,1183,9315
1/26/2019,2019,1,26, 9 ,7408,1482,1302,10192
1/26/2019,2019,1,26, 10 ,7894,1540,1351,10785
1/26/2019,2019,1,26, 11 ,8133,1615,1336,11084
1/26/2019,2019,1,26, 12 ,7920,1572,1387,10879
1/26/2019,2019,1,26, 13 ,7791,1580,1383,10754
1/26/2019,2019,1,26, 14 ,7866,1607,1380,10853
1/26/2019,2019,1,26, 15 ,7783,1579,1374,10736
1/26/2019,2019,1,26, 16 ,7601,1548,1380,10529
1/26/2019,2019,1,26, 17 ,7390,1537,1383,10310
1/26/2019,2019,1,26, 18 ,7608,1664,1498,10770
1/26/2019,2019,1,26, 19 ,7739,1679,1474,10892
1/26/2019,2019,1,26, 20 ,7561,1616,1388,10565
1/26/2019,2019,1,26, 21 ,7341,1531,1310,10182
1/26/2019,2019,1,26, 22 ,6981,1439,1246,9666
1/26/2019,2019,1,26, 23 ,6637,1330,1134,9101
1/26/2019,2019,1,26, 24 ,6243,1246,1166,8655
1/27/2019,2019,1,27, 1 ,5962,1192,991,8145
1/27/2019,2019,1,27, 2 ,5760,1163,936,7859
1/27/2019,2019,1,27, 3 ,5643,1129,933,7705
1/27/2019,2019,1,27, 4 ,5532,1119,924,7575
1/27/2019,2019,1,27, 5 ,5474,1126,937,7537
1/27/2019,2019,1,27, 6 ,5498,1145,977,7620
1/27/2019,2019,1,27, 7 ,5544,1171,996,7711
1/27/2019,2019,1,27, 8 ,5842,1215,998,8055
1/27/2019,2019,1,27, 9 ,6226,1305,1041,8572
1/27/2019,2019,1,27, 10 ,6597,1379,1096,9072
1/27/2019,2019,1,27, 11 ,6821,1416,1173,9410
1/27/2019,2019,1,27, 12 ,6769,1408,1163,9340
1/27/2019,2019,1,27, 13 ,6661,1391,1163,9215
1/27/2019,2019,1,27, 14 ,6592,1381,1157,9130
1/27/2019,2019,1,27, 15 ,6531,1385,1146,9062
1/27/2019,2019,1,27, 16 ,6549,1367,1112,9028
1/27/2019,2019,1,27, 17 ,6479,1387,1145,9011
1/27/2019,2019,1,27, 18 ,6846,1560,1310,9716
1/27/2019,2019,1,27, 19 ,7175,1597,1380,10152
1/27/2019,2019,1,27, 20 ,7032,1549,1319,9900
1/27/2019,2019,1,27, 21 ,6807,1454,1267,9528
1/27/2019,2019,1,27, 22 ,6489,1360,1166,9015
1/27/2019,2019,1,27, 23 ,6050,1251,1056,8357
1/27/2019,2019,1,27, 24 ,5706,1173,1003,7882
1/28/2019,2019,1,28, 1 ,5464,1131,939,7534
1/28/2019,2019,1,28, 2 ,5266,1092,917,7275
1/28/2019,2019,1,28, 3 ,5173,1068,903,7144
1/28/2019,2019,1,28, 4 ,5175,1067,903,7145
1/28/2019,2019,1,28, 5 ,5509,1125,970,7604
1/28/2019,2019,1,28, 6 ,5959,1220,1103,8282
1/28/2019,2019,1,28, 7 ,6170,1206,1037,8413
1/28/2019,2019,1,28, 8 ,6788,1305,1121,9214
1/28/2019,2019,1,28, 9 ,7482,1520,1336,10338
1/28/2019,2019,1,28, 10 ,8073,1643,1441,11157
1/28/2019,2019,1,28, 11 ,8268,1717,1519,11504
1/28/2019,2019,1,28, 12 ,8031,1673,1480,11184
1/28/2019,2019,1,28, 13 ,7910,1646,1481,11037
1/28/2019,2019,1,28, 14 ,8151,1732,1543,11426
1/28/2019,2019,1,28, 15 ,8140,1722,1528,11390
1/28/2019,2019,1,28, 16 ,8049,1698,1514,11261
1/28/2019,2019,1,28, 17 ,7810,1636,1469,10915
1/28/2019,2019,1,28, 18 ,7826,1731,1545,11102
1/28/2019,2019,1,28, 19 ,7927,1750,1572,11249
1/28/2019,2019,1,28, 20 ,7657,1669,1483,10809
1/28/2019,2019,1,28, 21 ,7289,1588,1388,10265
1/28/2019,2019,1,28, 22 ,6805,1438,1275,9518
1/28/2019,2019,1,28, 23 ,6403,1330,1177,8910
1/28/2019,2019,1,28, 24 ,6041,1237,1053,8331
1/29/2019,2019,1,29, 1 ,5784,1189,1038,8011
1/29/2019,2019,1,29, 2 ,5668,1156,1012,7836
1/29/2019,2019,1,29, 3 ,5557,1127,982,7666
1/29/2019,2019,1,29, 4 ,5554,1123,980,7657
1/29/2019,2019,1,29, 5 ,5871,1186,1039,8096
1/29/2019,2019,1,29, 6 ,6276,1270,1109,8655
1/29/2019,2019,1,29, 7 ,6375,1240,1077,8692
1/29/2019,2019,1,29, 8 ,6857,1341,1153,9351
1/29/2019,2019,1,29, 9 ,7735,1535,1352,10622
1/29/2019,2019,1,29, 10 ,8034,1631,1436,11101
1/29/2019,2019,1,29, 11 ,8271,1689,1523,11483
1/29/2019,2019,1,29, 12 ,7998,1647,1468,11113
1/29/2019,2019,1,29, 13 ,7886,1620,1446,10952
1/29/2019,2019,1,29, 14 ,8166,1715,1517,11398
1/29/2019,2019,1,29, 15 ,8008,1700,1496,11204
1/29/2019,2019,1,29, 16 ,7921,1681,1485,11087
1/29/2019,2019,1,29, 17 ,7747,1605,1460,10812
1/29/2019,2019,1,29, 18 ,7859,1701,1552,11112
1/29/2019,2019,1,29, 19 ,7897,1744,1556,11197
1/29/2019,2019,1,29, 20 ,7733,1667,1492,10892
1/29/2019,2019,1,29, 21 ,7388,1564,1405,10357
1/29/2019,2019,1,29, 22 ,6841,1415,1256,9512
1/29/2019,2019,1,29, 23 ,6488,1317,1170,8975
1/29/2019,2019,1,29, 24 ,6104,1244,1089,8437
1/30/2019,2019,1,30, 1 ,5876,1193,1048,8117
1/30/2019,2019,1,30, 2 ,5756,1161,1007,7924
1/30/2019,2019,1,30, 3 ,5615,1140,993,7748
1/30/2019,2019,1,30, 4 ,5620,1135,976,7731
1/30/2019,2019,1,30, 5 ,5916,1192,1036,8144
1/30/2019,2019,1,30, 6 ,6276,1275,1168,8719
1/30/2019,2019,1,30, 7 ,6326,1247,1088,8661
1/30/2019,2019,1,30, 8 ,6914,1342,1140,9396
1/30/2019,2019,1,30, 9 ,7553,1536,1348,10437
1/30/2019,2019,1,30, 10 ,8050,1663,1459,11172
1/30/2019,2019,1,30, 11 ,8284,1725,1493,11502
1/30/2019,2019,1,30, 12 ,8064,1675,1449,11188
1/30/2019,2019,1,30, 13 ,7909,1660,1413,10982
1/30/2019,2019,1,30, 14 ,8214,1745,1474,11433
1/30/2019,2019,1,30, 15 ,8234,1717,1464,11415
1/30/2019,2019,1,30, 16 ,8178,1702,1464,11344
1/30/2019,2019,1,30, 17 ,8007,1655,1472,11134
1/30/2019,2019,1,30, 18 ,8076,1767,1560,11403
1/30/2019,2019,1,30, 19 ,8211,1783,1530,11524
1/30/2019,2019,1,30, 20 ,7905,1710,1464,11079
1/30/2019,2019,1,30, 21 ,7591,1610,1367,10568
1/30/2019,2019,1,30, 22 ,7070,1473,1251,9794
1/30/2019,2019,1,30, 23 ,6679,1363,1144,9186
1/30/2019,2019,1,30, 24 ,6285,1278,1060,8623
1/31/2019,2019,1,31, 1 ,5995,1224,1009,8228
1/31/2019,2019,1,31, 2 ,5891,1196,977,8064
1/31/2019,2019,1,31, 3 ,5718,1174,951,7843
1/31/2019,2019,1,31, 4 ,5771,1169,963,7903
1/31/2019,2019,1,31, 5 ,6046,1230,1023,8299
1/31/2019,2019,1,31, 6 ,6400,1314,1150,8864
1/31/2019,2019,1,31, 7 ,6430,1290,1074,8794
1/31/2019,2019,1,31, 8 ,6967,1388,1170,9525
1/31/2019,2019,1,31, 9 ,7645,1587,1355,10587
1/31/2019,2019,1,31, 10 ,8154,1704,1471,11329
1/31/2019,2019,1,31, 11 ,8445,1757,1524,11726
1/31/2019,2019,1,31, 12 ,8198,1726,1510,11434
1/31/2019,2019,1,31, 13 ,8067,1700,1516,11283
1/31/2019,2019,1,31, 14 ,8358,1795,1591,11744
1/31/2019,2019,1,31, 15 ,8280,1768,1588,11636
1/31/2019,2019,1,31, 16 ,8272,1754,1557,11583
1/31/2019,2019,1,31, 17 ,8076,1689,1528,11293
1/31/2019,2019,1,31, 18 ,8174,1789,1613,11576
1/31/2019,2019,1,31, 19 ,8239,1800,1603,11642
1/31/2019,2019,1,31, 20 ,7998,1738,1512,11248
1/31/2019,2019,1,31, 21 ,7673,1648,1446,10767
1/31/2019,2019,1,31, 22 ,7215,1507,1307,10029
1/31/2019,2019,1,31, 23 ,6796,1405,1205,9406
1/31/2019,2019,1,31, 24 ,6442,1311,1118,8871
2/1/2019,2019,2,1, 1 ,6140,1256,1073,8469
2/1/2019,2019,2,1, 2 ,5998,1217,1023,8238
2/1/2019,2019,2,1, 3 ,5886,1190,1020,8096
2/1/2019,2019,2,1, 4 ,5841,1183,1000,8024
2/1/2019,2019,2,1, 5 ,6056,1228,1054,8338
2/1/2019,2019,2,1, 6 ,6363,1313,1139,8815
2/1/2019,2019,2,1, 7 ,6526,1274,1089,8889
2/1/2019,2019,2,1, 8 ,7023,1379,1187,9589
2/1/2019,2019,2,1, 9 ,7765,1587,1390,10742
2/1/2019,2019,2,1, 10 ,8285,1684,1519,11488
2/1/2019,2019,2,1, 11 ,8458,1761,1589,11808
2/1/2019,2019,2,1, 12 ,8152,1699,1567,11418
2/1/2019,2019,2,1, 13 ,8031,1689,1555,11275
2/1/2019,2019,2,1, 14 ,8326,1768,1641,11735
2/1/2019,2019,2,1, 15 ,8264,1759,1626,11649
2/1/2019,2019,2,1, 16 ,8200,1738,1586,11524
2/1/2019,2019,2,1, 17 ,7905,1648,1508,11061
2/1/2019,2019,2,1, 18 ,7935,1731,1565,11231
2/1/2019,2019,2,1, 19 ,8101,1767,1573,11441
2/1/2019,2019,2,1, 20 ,7861,1678,1495,11034
2/1/2019,2019,2,1, 21 ,7546,1601,1434,10581
2/1/2019,2019,2,1, 22 ,7094,1475,1274,9843
2/1/2019,2019,2,1, 23 ,6697,1371,1167,9235
2/1/2019,2019,2,1, 24 ,6277,1281,1083,8641
2/2/2019,2019,2,2, 1 ,6033,1223,1033,8289
2/2/2019,2019,2,2, 2 ,5880,1173,999,8052
2/2/2019,2019,2,2, 3 ,5730,1148,969,7847
2/2/2019,2019,2,2, 4 ,5677,1139,971,7787
2/2/2019,2019,2,2, 5 ,5758,1157,985,7900
2/2/2019,2019,2,2, 6 ,5871,1190,1038,8099
2/2/2019,2019,2,2, 7 ,6073,1227,1066,8366
2/2/2019,2019,2,2, 8 ,6628,1319,1135,9082
2/2/2019,2019,2,2, 9 ,7297,1483,1259,10039
2/2/2019,2019,2,2, 10 ,7840,1588,1358,10786
2/2/2019,2019,2,2, 11 ,8115,1634,1449,11198
2/2/2019,2019,2,2, 12 ,7893,1601,1416,10910
2/2/2019,2019,2,2, 13 ,7798,1582,1428,10808
2/2/2019,2019,2,2, 14 ,7947,1617,1505,11069
2/2/2019,2019,2,2, 15 ,7857,1596,1489,10942
2/2/2019,2019,2,2, 16 ,7738,1568,1474,10780
2/2/2019,2019,2,2, 17 ,7497,1556,1466,10519
2/2/2019,2019,2,2, 18 ,7669,1663,1557,10889
2/2/2019,2019,2,2, 19 ,7871,1699,1564,11134
2/2/2019,2019,2,2, 20 ,7666,1643,1522,10831
2/2/2019,2019,2,2, 21 ,7466,1574,1396,10436
2/2/2019,2019,2,2, 22 ,7152,1467,1310,9929
2/2/2019,2019,2,2, 23 ,6722,1349,1219,9290
2/2/2019,2019,2,2, 24 ,6346,1260,1117,8723
2/3/2019,2019,2,3, 1 ,6058,1210,1107,8375
2/3/2019,2019,2,3, 2 ,5900,1169,1062,8131
2/3/2019,2019,2,3, 3 ,5712,1130,1029,7871
2/3/2019,2019,2,3, 4 ,5545,1119,1013,7677
2/3/2019,2019,2,3, 5 ,5513,1124,1021,7658
2/3/2019,2019,2,3, 6 ,5513,1133,1054,7700
2/3/2019,2019,2,3, 7 ,5615,1153,1062,7830
2/3/2019,2019,2,3, 8 ,5932,1215,1090,8237
2/3/2019,2019,2,3, 9 ,6344,1299,1176,8819
2/3/2019,2019,2,3, 10 ,6823,1368,1241,9432
2/3/2019,2019,2,3, 11 ,7149,1437,1309,9895
2/3/2019,2019,2,3, 12 ,7036,1456,1323,9815
2/3/2019,2019,2,3, 13 ,7031,1451,1312,9794
2/3/2019,2019,2,3, 14 ,7084,1472,1318,9874
2/3/2019,2019,2,3, 15 ,7053,1453,1307,9813
2/3/2019,2019,2,3, 16 ,6936,1420,1303,9659
2/3/2019,2019,2,3, 17 ,6925,1419,1309,9653
2/3/2019,2019,2,3, 18 ,7249,1588,1454,10291
2/3/2019,2019,2,3, 19 ,7594,1651,1502,10747
2/3/2019,2019,2,3, 20 ,7583,1599,1485,10667
2/3/2019,2019,2,3, 21 ,7357,1534,1405,10296
2/3/2019,2019,2,3, 22 ,7024,1424,1290,9738
2/3/2019,2019,2,3, 23 ,6627,1329,1186,9142
2/3/2019,2019,2,3, 24 ,6257,1250,1116,8623
2/4/2019,2019,2,4, 1 ,5971,1204,1050,8225
2/4/2019,2019,2,4, 2 ,5736,1163,1017,7916
2/4/2019,2019,2,4, 3 ,5596,1134,997,7727
2/4/2019,2019,2,4, 4 ,5588,1131,986,7705
2/4/2019,2019,2,4, 5 ,5913,1185,1045,8143
2/4/2019,2019,2,4, 6 ,6256,1273,1141,8670
2/4/2019,2019,2,4, 7 ,6473,1237,1057,8767
2/4/2019,2019,2,4, 8 ,6983,1356,1185,9524
2/4/2019,2019,2,4, 9 ,7799,1593,1399,10791
2/4/2019,2019,2,4, 10 ,8354,1718,1512,11584
2/4/2019,2019,2,4, 11 ,8694,1782,1581,12057
2/4/2019,2019,2,4, 12 ,8504,1732,1549,11785
2/4/2019,2019,2,4, 13 ,8469,1731,1546,11746
2/4/2019,2019,2,4, 14 ,8763,1797,1596,12156
2/4/2019,2019,2,4, 15 ,8722,1786,1580,12088
2/4/2019,2019,2,4, 16 ,8604,1781,1573,11958
2/4/2019,2019,2,4, 17 ,8226,1701,1521,11448
2/4/2019,2019,2,4, 18 ,8122,1773,1576,11471
2/4/2019,2019,2,4, 19 ,8329,1830,1588,11747
2/4/2019,2019,2,4, 20 ,8005,1750,1509,11264
2/4/2019,2019,2,4, 21 ,7703,1661,1458,10822
2/4/2019,2019,2,4, 22 ,7276,1542,1338,10156
2/4/2019,2019,2,4, 23 ,6807,1435,1227,9469
2/4/2019,2019,2,4, 24 ,6440,1357,1157,8954
2/5/2019,2019,2,5, 1 ,6122,1299,1101,8522
2/5/2019,2019,2,5, 2 ,5917,1254,1073,8244
2/5/2019,2019,2,5, 3 ,5732,1224,1028,7984
2/5/2019,2019,2,5, 4 ,5666,1206,1023,7895
2/5/2019,2019,2,5, 5 ,5657,1223,1031,7911
2/5/2019,2019,2,5, 6 ,5690,1247,1093,8030
2/5/2019,2019,2,5, 7 ,5801,1271,1123,8195
2/5/2019,2019,2,5, 8 ,6218,1362,1152,8732
2/5/2019,2019,2,5, 9 ,6795,1500,1307,9602
2/5/2019,2019,2,5, 10 ,7426,1604,1406,10436
2/5/2019,2019,2,5, 11 ,7833,1678,1509,11020
2/5/2019,2019,2,5, 12 ,7711,1654,1489,10854
2/5/2019,2019,2,5, 13 ,7708,1668,1493,10869
2/5/2019,2019,2,5, 14 ,7914,1706,1524,11144
2/5/2019,2019,2,5, 15 ,7852,1693,1511,11056
2/5/2019,2019,2,5, 16 ,7741,1679,1500,10920
2/5/2019,2019,2,5, 17 ,7499,1638,1471,10608
2/5/2019,2019,2,5, 18 ,7714,1749,1575,11038
2/5/2019,2019,2,5, 19 ,8117,1815,1600,11532
2/5/2019,2019,2,5, 20 ,8033,1765,1559,11357
2/5/2019,2019,2,5, 21 ,7761,1685,1486,10932
2/5/2019,2019,2,5, 22 ,7335,1575,1359,10269
2/5/2019,2019,2,5, 23 ,6875,1469,1247,9591
2/5/2019,2019,2,5, 24 ,6448,1375,1162,8985
2/6/2019,2019,2,6, 1 ,6132,1321,1103,8556
2/6/2019,2019,2,6, 2 ,5954,1286,1064,8304
2/6/2019,2019,2,6, 3 ,5766,1253,1033,8052
2/6/2019,2019,2,6, 4 ,5775,1229,1028,8032
2/6/2019,2019,2,6, 5 ,5962,1282,1083,8327
2/6/2019,2019,2,6, 6 ,6302,1355,1201,8858
2/6/2019,2019,2,6, 7 ,6467,1326,1108,8901
2/6/2019,2019,2,6, 8 ,7081,1430,1227,9738
2/6/2019,2019,2,6, 9 ,7857,1645,1445,10947
2/6/2019,2019,2,6, 10 ,8411,1773,1552,11736
2/6/2019,2019,2,6, 11 ,8847,1842,1617,12306
2/6/2019,2019,2,6, 12 ,8692,1799,1606,12097
2/6/2019,2019,2,6, 13 ,8637,1800,1608,12045
2/6/2019,2019,2,6, 14 ,8995,1862,1662,12519
2/6/2019,2019,2,6, 15 ,8904,1846,1628,12378
2/6/2019,2019,2,6, 16 ,8777,1830,1613,12220
2/6/2019,2019,2,6, 17 ,8432,1750,1565,11747
2/6/2019,2019,2,6, 18 ,8344,1818,1622,11784
2/6/2019,2019,2,6, 19 ,8518,1850,1641,12009
2/6/2019,2019,2,6, 20 ,8267,1779,1598,11644
2/6/2019,2019,2,6, 21 ,7982,1685,1506,11173
2/6/2019,2019,2,6, 22 ,7539,1551,1390,10480
2/6/2019,2019,2,6, 23 ,7040,1410,1263,9713
2/6/2019,2019,2,6, 24 ,6599,1322,1187,9108
2/7/2019,2019,2,7, 1 ,6270,1262,1093,8625
2/7/2019,2019,2,7, 2 ,6052,1214,1057,8323
2/7/2019,2019,2,7, 3 ,5961,1198,1027,8186
2/7/2019,2019,2,7, 4 ,5945,1188,1013,8146
2/7/2019,2019,2,7, 5 ,6140,1238,1069,8447
2/7/2019,2019,2,7, 6 ,6372,1324,1159,8855
2/7/2019,2019,2,7, 7 ,6436,1291,1094,8821
2/7/2019,2019,2,7, 8 ,7051,1403,1200,9654
2/7/2019,2019,2,7, 9 ,7906,1626,1430,10962
2/7/2019,2019,2,7, 10 ,8451,1746,1576,11773
2/7/2019,2019,2,7, 11 ,8825,1817,1631,12273
2/7/2019,2019,2,7, 12 ,8637,1756,1604,11997
2/7/2019,2019,2,7, 13 ,8626,1774,1613,12013
2/7/2019,2019,2,7, 14 ,9002,1851,1661,12514
2/7/2019,2019,2,7, 15 ,8942,1854,1664,12460
2/7/2019,2019,2,7, 16 ,8825,1828,1648,12301
2/7/2019,2019,2,7, 17 ,8454,1752,1573,11779
2/7/2019,2019,2,7, 18 ,8358,1799,1619,11776
2/7/2019,2019,2,7, 19 ,8549,1864,1663,12076
2/7/2019,2019,2,7, 20 ,8309,1789,1599,11697
2/7/2019,2019,2,7, 21 ,8020,1685,1512,11217
2/7/2019,2019,2,7, 22 ,7572,1560,1388,10520
2/7/2019,2019,2,7, 23 ,7113,1428,1255,9796
2/7/2019,2019,2,7, 24 ,6673,1353,1166,9192
2/8/2019,2019,2,8, 1 ,6388,1297,1112,8797
2/8/2019,2019,2,8, 2 ,6182,1250,1075,8507
2/8/2019,2019,2,8, 3 ,6029,1223,1039,8291
2/8/2019,2019,2,8, 4 ,5906,1217,1039,8162
2/8/2019,2019,2,8, 5 ,6156,1255,1082,8493
2/8/2019,2019,2,8, 6 ,6432,1348,1183,8963
2/8/2019,2019,2,8, 7 ,6526,1313,1108,8947
2/8/2019,2019,2,8, 8 ,7141,1442,1221,9804
2/8/2019,2019,2,8, 9 ,7999,1682,1452,11133
2/8/2019,2019,2,8, 10 ,8516,1767,1586,11869
2/8/2019,2019,2,8, 11 ,8940,1851,1675,12466
2/8/2019,2019,2,8, 12 ,8702,1821,1623,12146
2/8/2019,2019,2,8, 13 ,8669,1821,1610,12100
2/8/2019,2019,2,8, 14 ,9081,1894,1706,12681
2/8/2019,2019,2,8, 15 ,9044,1880,1687,12611
2/8/2019,2019,2,8, 16 ,8909,1854,1664,12427
2/8/2019,2019,2,8, 17 ,8531,1760,1586,11877
2/8/2019,2019,2,8, 18 ,8393,1804,1620,11817
2/8/2019,2019,2,8, 19 ,8618,1882,1667,12167
2/8/2019,2019,2,8, 20 ,8389,1803,1598,11790
2/8/2019,2019,2,8, 21 ,8123,1728,1524,11375
2/8/2019,2019,2,8, 22 ,7725,1605,1394,10724
2/8/2019,2019,2,8, 23 ,7247,1493,1265,10005
2/8/2019,2019,2,8, 24 ,6797,1400,1152,9349
2/9/2019,2019,2,9, 1 ,6522,1344,1120,8986
2/9/2019,2019,2,9, 2 ,6255,1298,1080,8633
2/9/2019,2019,2,9, 3 ,6114,1267,1031,8412
2/9/2019,2019,2,9, 4 ,6007,1244,1016,8267
2/9/2019,2019,2,9, 5 ,6007,1257,1038,8302
2/9/2019,2019,2,9, 6 ,6091,1287,1076,8454
2/9/2019,2019,2,9, 7 ,6160,1314,1088,8562
2/9/2019,2019,2,9, 8 ,6683,1415,1155,9253
2/9/2019,2019,2,9, 9 ,7330,1583,1307,10220
2/9/2019,2019,2,9, 10 ,7944,1676,1418,11038
2/9/2019,2019,2,9, 11 ,8305,1761,1509,11575
2/9/2019,2019,2,9, 12 ,8210,1698,1501,11409
2/9/2019,2019,2,9, 13 ,8209,1683,1335,11227
2/9/2019,2019,2,9, 14 ,8485,1724,1560,11769
2/9/2019,2019,2,9, 15 ,8413,1704,1523,11640
2/9/2019,2019,2,9, 16 ,8242,1674,1518,11434
2/9/2019,2019,2,9, 17 ,7916,1644,1450,11010
2/9/2019,2019,2,9, 18 ,7959,1741,1537,11237
2/9/2019,2019,2,9, 19 ,8307,1780,1566,11653
2/9/2019,2019,2,9, 20 ,8094,1707,1533,11334
2/9/2019,2019,2,9, 21 ,7929,1622,1464,11015
2/9/2019,2019,2,9, 22 ,7559,1521,1351,10431
2/9/2019,2019,2,9, 23 ,7228,1416,1243,9887
2/9/2019,2019,2,9, 24 ,6826,1323,1172,9321
2/10/2019,2019,2,10, 1 ,6445,1283,1092,8820
2/10/2019,2019,2,10, 2 ,6313,1257,1055,8625
2/10/2019,2019,2,10, 3 ,6163,1214,1022,8399
2/10/2019,2019,2,10, 4 ,6033,1190,1004,8227
2/10/2019,2019,2,10, 5 ,5976,1194,1013,8183
2/10/2019,2019,2,10, 6 ,5955,1209,1045,8209
2/10/2019,2019,2,10, 7 ,5909,1242,1063,8214
2/10/2019,2019,2,10, 8 ,6176,1299,1083,8558
2/10/2019,2019,2,10, 9 ,6649,1403,1150,9202
2/10/2019,2019,2,10, 10 ,7207,1490,1242,9939
2/10/2019,2019,2,10, 11 ,7416,1539,1319,10274
2/10/2019,2019,2,10, 12 ,7319,1533,1342,10194
2/10/2019,2019,2,10, 13 ,7285,1523,1357,10165
2/10/2019,2019,2,10, 14 ,7366,1528,1366,10260
2/10/2019,2019,2,10, 15 ,7240,1519,1350,10109
2/10/2019,2019,2,10, 16 ,7174,1502,1317,9993
2/10/2019,2019,2,10, 17 ,7066,1502,1295,9863
2/10/2019,2019,2,10, 18 ,7328,1608,1450,10386
2/10/2019,2019,2,10, 19 ,7741,1719,1523,10983
2/10/2019,2019,2,10, 20 ,7686,1666,1479,10831
2/10/2019,2019,2,10, 21 ,7573,1592,1414,10579
2/10/2019,2019,2,10, 22 ,7225,1478,1331,10034
2/10/2019,2019,2,10, 23 ,6817,1387,1217,9421
2/10/2019,2019,2,10, 24 ,6493,1290,1180,8963
2/11/2019,2019,2,11, 1 ,6113,1218,1075,8406
2/11/2019,2019,2,11, 2 ,5944,1185,1039,8168
2/11/2019,2019,2,11, 3 ,5831,1156,1001,7988
2/11/2019,2019,2,11, 4 ,5846,1154,992,7992
2/11/2019,2019,2,11, 5 ,6045,1201,1051,8297
2/11/2019,2019,2,11, 6 ,6397,1226,1147,8770
2/11/2019,2019,2,11, 7 ,6514,1233,1050,8797
2/11/2019,2019,2,11, 8 ,7277,1366,1188,9831
2/11/2019,2019,2,11, 9 ,8177,1589,1333,11099
2/11/2019,2019,2,11, 10 ,8799,1683,1556,12038
2/11/2019,2019,2,11, 11 ,9108,1736,1558,12402
2/11/2019,2019,2,11, 12 ,8964,1726,1519,12209
2/11/2019,2019,2,11, 13 ,8907,1732,1496,12135
2/11/2019,2019,2,11, 14 ,9245,1810,1523,12578
2/11/2019,2019,2,11, 15 ,9217,1809,1567,12593
2/11/2019,2019,2,11, 16 ,9037,1788,1598,12423
2/11/2019,2019,2,11, 17 ,8629,1707,1539,11875
2/11/2019,2019,2,11, 18 ,8466,1742,1581,11789
2/11/2019,2019,2,11, 19 ,8683,1834,1618,12135
2/11/2019,2019,2,11, 20 ,8461,1783,1560,11804
2/11/2019,2019,2,11, 21 ,8225,1708,1462,11395
2/11/2019,2019,2,11, 22 ,7820,1580,1347,10747
2/11/2019,2019,2,11, 23 ,7355,1456,1218,10029
2/11/2019,2019,2,11, 24 ,6941,1330,1076,9347
2/12/2019,2019,2,12, 1 ,6599,1306,1050,8955
2/12/2019,2019,2,12, 2 ,6401,1268,1006,8675
2/12/2019,2019,2,12, 3 ,6224,1239,981,8444
2/12/2019,2019,2,12, 4 ,6133,1222,934,8289
2/12/2019,2019,2,12, 5 ,6289,1268,1031,8588
2/12/2019,2019,2,12, 6 ,6615,1346,1145,9106
2/12/2019,2019,2,12, 7 ,6675,1299,1072,9046
2/12/2019,2019,2,12, 8 ,7306,1414,1172,9892
2/12/2019,2019,2,12, 9 ,8108,1621,1398,11127
2/12/2019,2019,2,12, 10 ,8663,1742,1494,11899
2/12/2019,2019,2,12, 11 ,8929,1804,1560,12293
2/12/2019,2019,2,12, 12 ,8619,1743,1529,11891
2/12/2019,2019,2,12, 13 ,8580,1758,1533,11871
2/12/2019,2019,2,12, 14 ,9014,1860,1621,12495
2/12/2019,2019,2,12, 15 ,8975,1845,1626,12446
2/12/2019,2019,2,12, 16 ,8834,1821,1619,12274
2/12/2019,2019,2,12, 17 ,8515,1724,1555,11794
2/12/2019,2019,2,12, 18 ,8411,1798,1591,11800
2/12/2019,2019,2,12, 19 ,8628,1870,1623,12121
2/12/2019,2019,2,12, 20 ,8401,1795,1548,11744
2/12/2019,2019,2,12, 21 ,8125,1702,1460,11287
2/12/2019,2019,2,12, 22 ,7637,1561,1306,10504
2/12/2019,2019,2,12, 23 ,7318,1453,1184,9955
2/12/2019,2019,2,12, 24 ,6918,1355,1111,9384
2/13/2019,2019,2,13, 1 ,6640,1304,1059,9003
2/13/2019,2019,2,13, 2 ,6464,1259,1027,8750
2/13/2019,2019,2,13, 3 ,6268,1218,985,8471
2/13/2019,2019,2,13, 4 ,6205,1215,996,8416
2/13/2019,2019,2,13, 5 ,6432,1278,1059,8769
2/13/2019,2019,2,13, 6 ,6715,1343,1182,9240
2/13/2019,2019,2,13, 7 ,6786,1311,1086,9183
2/13/2019,2019,2,13, 8 ,7480,1448,1185,10113
2/13/2019,2019,2,13, 9 ,8204,1664,1401,11269
2/13/2019,2019,2,13, 10 ,8649,1770,1511,11930
2/13/2019,2019,2,13, 11 ,8902,1835,1577,12314
2/13/2019,2019,2,13, 12 ,8584,1806,1587,11977
2/13/2019,2019,2,13, 13 ,8493,1816,1612,11921
2/13/2019,2019,2,13, 14 ,8697,1892,1668,12257
2/13/2019,2019,2,13, 15 ,8590,1885,1663,12138
2/13/2019,2019,2,13, 16 ,8573,1858,1652,12083
2/13/2019,2019,2,13, 17 ,8310,1775,1571,11656
2/13/2019,2019,2,13, 18 ,8319,1844,1623,11786
2/13/2019,2019,2,13, 19 ,8460,1892,1626,11978
2/13/2019,2019,2,13, 20 ,8249,1831,1524,11604
2/13/2019,2019,2,13, 21 ,8005,1742,1474,11221
2/13/2019,2019,2,13, 22 ,7554,1611,1333,10498
2/13/2019,2019,2,13, 23 ,7053,1495,1162,9710
2/13/2019,2019,2,13, 24 ,6608,1398,1116,9122
2/14/2019,2019,2,14, 1 ,6349,1336,1057,8742
2/14/2019,2019,2,14, 2 ,6185,1299,1019,8503
2/14/2019,2019,2,14, 3 ,5993,1271,985,8249
2/14/2019,2019,2,14, 4 ,5959,1265,967,8191
2/14/2019,2019,2,14, 5 ,6138,1302,1063,8503
2/14/2019,2019,2,14, 6 ,6450,1373,1141,8964
2/14/2019,2019,2,14, 7 ,6516,1337,1073,8926
2/14/2019,2019,2,14, 8 ,7177,1417,1181,9775
2/14/2019,2019,2,14, 9 ,7975,1567,1425,10967
2/14/2019,2019,2,14, 10 ,8571,1693,1535,11799
2/14/2019,2019,2,14, 11 ,8796,1762,1621,12179
2/14/2019,2019,2,14, 12 ,8663,1715,1596,11974
2/14/2019,2019,2,14, 13 ,8658,1695,1632,11985
2/14/2019,2019,2,14, 14 ,9021,1751,1691,12463
2/14/2019,2019,2,14, 15 ,8949,1745,1678,12372
2/14/2019,2019,2,14, 16 ,8779,1731,1532,12042
2/14/2019,2019,2,14, 17 ,8400,1692,1597,11689
2/14/2019,2019,2,14, 18 ,8143,1744,1619,11506
2/14/2019,2019,2,14, 19 ,8342,1756,1616,11714
2/14/2019,2019,2,14, 20 ,8115,1682,1582,11379
2/14/2019,2019,2,14, 21 ,7895,1617,1507,11019
2/14/2019,2019,2,14, 22 ,7434,1489,1386,10309
2/14/2019,2019,2,14, 23 ,7021,1383,1292,9696
2/14/2019,2019,2,14, 24 ,6637,1310,1158,9105
2/15/2019,2019,2,15, 1 ,6310,1257,1221,8788
2/15/2019,2019,2,15, 2 ,6131,1228,1186,8545
2/15/2019,2019,2,15, 3 ,5952,1204,1160,8316
2/15/2019,2019,2,15, 4 ,5889,1204,1152,8245
2/15/2019,2019,2,15, 5 ,6088,1245,1106,8439
2/15/2019,2019,2,15, 6 ,6334,1316,1157,8807
2/15/2019,2019,2,15, 7 ,6430,1298,1077,8805
2/15/2019,2019,2,15, 8 ,7034,1388,1203,9625
2/15/2019,2019,2,15, 9 ,7859,1598,1414,10871
2/15/2019,2019,2,15, 10 ,8386,1682,1532,11600
2/15/2019,2019,2,15, 11 ,8725,1714,1623,12062
2/15/2019,2019,2,15, 12 ,8599,1674,1605,11878
2/15/2019,2019,2,15, 13 ,8547,1643,1596,11786
2/15/2019,2019,2,15, 14 ,8889,1713,1674,12276
2/15/2019,2019,2,15, 15 ,8834,1692,1668,12194
2/15/2019,2019,2,15, 16 ,8724,1689,1645,12058
2/15/2019,2019,2,15, 17 ,8402,1627,1543,11572
2/15/2019,2019,2,15, 18 ,8255,1706,1591,11552
2/15/2019,2019,2,15, 19 ,8510,1729,1600,11839
2/15/2019,2019,2,15, 20 ,8320,1644,1573,11537
2/15/2019,2019,2,15, 21 ,8026,1564,1486,11076
2/15/2019,2019,2,15, 22 ,7676,1433,1347,10456
2/15/2019,2019,2,15, 23 ,7223,1326,1232,9781
2/15/2019,2019,2,15, 24 ,6784,1248,1291,9323
2/16/2019,2019,2,16, 1 ,6466,1216,1087,8769
2/16/2019,2019,2,16, 2 ,6253,1187,1053,8493
2/16/2019,2019,2,16, 3 ,6117,1173,1027,8317
2/16/2019,2019,2,16, 4 ,6015,1161,1016,8192
2/16/2019,2019,2,16, 5 ,6007,1176,1034,8217
2/16/2019,2019,2,16, 6 ,6085,1219,1084,8388
2/16/2019,2019,2,16, 7 ,6184,1246,1107,8537
2/16/2019,2019,2,16, 8 ,6673,1331,1199,9203
2/16/2019,2019,2,16, 9 ,7388,1515,1352,10255
2/16/2019,2019,2,16, 10 ,7923,1617,1458,10998
2/16/2019,2019,2,16, 11 ,8252,1682,1506,11440
2/16/2019,2019,2,16, 12 ,8154,1657,1492,11303
2/16/2019,2019,2,16, 13 ,8158,1653,1476,11287
2/16/2019,2019,2,16, 14 ,8365,1718,1511,11594
2/16/2019,2019,2,16, 15 ,8311,1692,1488,11491
2/16/2019,2019,2,16, 16 ,8105,1657,1467,11229
2/16/2019,2019,2,16, 17 ,7767,1609,1442,10818
2/16/2019,2019,2,16, 18 ,7748,1692,1538,10978
2/16/2019,2019,2,16, 19 ,8153,1792,1530,11475
2/16/2019,2019,2,16, 20 ,7954,1726,1477,11157
2/16/2019,2019,2,16, 21 ,7762,1661,1378,10801
2/16/2019,2019,2,16, 22 ,7437,1570,1285,10292
2/16/2019,2019,2,16, 23 ,7020,1433,1176,9629
2/16/2019,2019,2,16, 24 ,6642,1333,1093,9068
2/17/2019,2019,2,17, 1 ,6330,1280,1042,8652
2/17/2019,2019,2,17, 2 ,6095,1234,1019,8348
2/17/2019,2019,2,17, 3 ,5966,1204,973,8143
2/17/2019,2019,2,17, 4 ,5813,1183,965,7961
2/17/2019,2019,2,17, 5 ,5743,1182,967,7892
2/17/2019,2019,2,17, 6 ,5641,1194,1015,7850
2/17/2019,2019,2,17, 7 ,5676,1222,1017,7915
2/17/2019,2019,2,17, 8 ,6024,1258,1047,8329
2/17/2019,2019,2,17, 9 ,6461,1362,1107,8930
2/17/2019,2019,2,17, 10 ,6966,1443,1231,9640
2/17/2019,2019,2,17, 11 ,7317,1513,1306,10136
2/17/2019,2019,2,17, 12 ,7261,1503,1340,10104
2/17/2019,2019,2,17, 13 ,7303,1515,1339,10157
2/17/2019,2019,2,17, 14 ,7337,1527,1371,10235
2/17/2019,2019,2,17, 15 ,7366,1527,1359,10252
2/17/2019,2019,2,17, 16 ,7217,1511,1338,10066
2/17/2019,2019,2,17, 17 ,7022,1512,1287,9821
2/17/2019,2019,2,17, 18 ,7276,1610,1391,10277
2/17/2019,2019,2,17, 19 ,7777,1732,1524,11033
2/17/2019,2019,2,17, 20 ,7719,1680,1471,10870
2/17/2019,2019,2,17, 21 ,7526,1610,1386,10522
2/17/2019,2019,2,17, 22 ,7242,1494,1282,10018
2/17/2019,2019,2,17, 23 ,6808,1362,1158,9328
2/17/2019,2019,2,17, 24 ,6412,1290,1101,8803
2/18/2019,2019,2,18, 1 ,6080,1235,1025,8340
2/18/2019,2019,2,18, 2 ,5852,1195,979,8026
2/18/2019,2019,2,18, 3 ,5754,1168,943,7865
2/18/2019,2019,2,18, 4 ,5741,1156,936,7833
2/18/2019,2019,2,18, 5 ,5962,1207,997,8166
2/18/2019,2019,2,18, 6 ,6342,1300,1120,8762
2/18/2019,2019,2,18, 7 ,6469,1264,1048,8781
2/18/2019,2019,2,18, 8 ,7259,1389,1166,9814
2/18/2019,2019,2,18, 9 ,8174,1611,1394,11179
2/18/2019,2019,2,18, 10 ,8737,1747,1531,12015
2/18/2019,2019,2,18, 11 ,9052,1827,1609,12488
2/18/2019,2019,2,18, 12 ,8928,1793,1578,12299
2/18/2019,2019,2,18, 13 ,8894,1799,1582,12275
2/18/2019,2019,2,18, 14 ,9226,1873,1696,12795
2/18/2019,2019,2,18, 15 ,9173,1855,1683,12711
2/18/2019,2019,2,18, 16 ,9036,1846,1652,12534
2/18/2019,2019,2,18, 17 ,8587,1758,1597,11942
2/18/2019,2019,2,18, 18 ,8349,1793,1621,11763
2/18/2019,2019,2,18, 19 ,8659,1890,1670,12219
2/18/2019,2019,2,18, 20 ,8422,1813,1651,11886
2/18/2019,2019,2,18, 21 ,8151,1727,1534,11412
2/18/2019,2019,2,18, 22 ,7735,1586,1386,10707
2/18/2019,2019,2,18, 23 ,7273,1461,1258,9992
2/18/2019,2019,2,18, 24 ,6767,1360,1168,9295
2/19/2019,2019,2,19, 1 ,6516,1308,1107,8931
2/19/2019,2019,2,19, 2 ,6280,1259,1069,8608
2/19/2019,2019,2,19, 3 ,6078,1226,1034,8338
2/19/2019,2019,2,19, 4 ,6039,1217,1026,8282
2/19/2019,2019,2,19, 5 ,6256,1275,1092,8623
2/19/2019,2019,2,19, 6 ,6472,1350,1204,9026
2/19/2019,2019,2,19, 7 ,6504,1306,1115,8925
2/19/2019,2019,2,19, 8 ,7201,1408,1217,9826
2/19/2019,2019,2,19, 9 ,8147,1655,1400,11202
2/19/2019,2019,2,19, 10 ,8668,1768,1567,12003
2/19/2019,2019,2,19, 11 ,8996,1840,1625,12461
2/19/2019,2019,2,19, 12 ,8801,1783,1595,12179
2/19/2019,2019,2,19, 13 ,8829,1786,1569,12184
2/19/2019,2019,2,19, 14 ,9247,1860,1679,12786
2/19/2019,2019,2,19, 15 ,9191,1853,1687,12731
2/19/2019,2019,2,19, 16 ,9054,1836,1648,12538
2/19/2019,2019,2,19, 17 ,8665,1766,1583,12014
2/19/2019,2019,2,19, 18 ,8491,1795,1639,11925
2/19/2019,2019,2,19, 19 ,8734,1874,1671,12279
2/19/2019,2019,2,19, 20 ,8549,1815,1603,11967
2/19/2019,2019,2,19, 21 ,8322,1718,1530,11570
2/19/2019,2019,2,19, 22 ,7861,1581,1385,10827
2/19/2019,2019,2,19, 23 ,7376,1467,1269,10112
2/19/2019,2019,2,19, 24 ,6903,1357,1190,9450
2/20/2019,2019,2,20, 1 ,6657,1300,1113,9070
2/20/2019,2019,2,20, 2 ,6431,1260,1078,8769
2/20/2019,2019,2,20, 3 ,6206,1234,1039,8479
2/20/2019,2019,2,20, 4 ,6138,1228,1043,8409
2/20/2019,2019,2,20, 5 ,6388,1278,1101,8767
2/20/2019,2019,2,20, 6 ,6606,1351,1206,9163
2/20/2019,2019,2,20, 7 ,6682,1300,1123,9105
2/20/2019,2019,2,20, 8 ,7372,1435,1228,10035
2/20/2019,2019,2,20, 9 ,8188,1647,1461,11296
2/20/2019,2019,2,20, 10 ,8700,1766,1577,12043
2/20/2019,2019,2,20, 11 ,9008,1832,1644,12484
2/20/2019,2019,2,20, 12 ,8759,1783,1641,12183
2/20/2019,2019,2,20, 13 ,8708,1788,1674,12170
2/20/2019,2019,2,20, 14 ,9038,1874,1698,12610
2/20/2019,2019,2,20, 15 ,8933,1860,1708,12501
2/20/2019,2019,2,20, 16 ,8813,1823,1669,12305
2/20/2019,2019,2,20, 17 ,8445,1745,1588,11778
2/20/2019,2019,2,20, 18 ,8315,1784,1650,11749
2/20/2019,2019,2,20, 19 ,8606,1869,1652,12127
2/20/2019,2019,2,20, 20 ,8410,1779,1618,11807
2/20/2019,2019,2,20, 21 ,8079,1692,1569,11340
2/20/2019,2019,2,20, 22 ,7667,1542,1416,10625
2/20/2019,2019,2,20, 23 ,7091,1430,1288,9809
2/20/2019,2019,2,20, 24 ,6688,1346,1191,9225
2/21/2019,2019,2,21, 1 ,6416,1288,1143,8847
2/21/2019,2019,2,21, 2 ,6198,1241,1108,8547
2/21/2019,2019,2,21, 3 ,6050,1216,1074,8340
2/21/2019,2019,2,21, 4 ,6015,1206,1055,8276
2/21/2019,2019,2,21, 5 ,6213,1265,1116,8594
2/21/2019,2019,2,21, 6 ,6443,1334,1208,8985
2/21/2019,2019,2,21, 7 ,6527,1295,1107,8929
2/21/2019,2019,2,21, 8 ,7163,1422,1230,9815
2/21/2019,2019,2,21, 9 ,7945,1640,1434,11019
2/21/2019,2019,2,21, 10 ,8457,1769,1570,11796
2/21/2019,2019,2,21, 11 ,8891,1836,1643,12370
2/21/2019,2019,2,21, 12 ,8661,1789,1615,12065
2/21/2019,2019,2,21, 13 ,8658,1794,1631,12083
2/21/2019,2019,2,21, 14 ,9055,1875,1706,12636
2/21/2019,2019,2,21, 15 ,8989,1867,1698,12554
2/21/2019,2019,2,21, 16 ,8881,1832,1663,12376
2/21/2019,2019,2,21, 17 ,8514,1743,1567,11824
2/21/2019,2019,2,21, 18 ,8357,1781,1603,11741
2/21/2019,2019,2,21, 19 ,8704,1865,1677,12246
2/21/2019,2019,2,21, 20 ,8477,1788,1593,11858
2/21/2019,2019,2,21, 21 ,8212,1688,1483,11383
2/21/2019,2019,2,21, 22 ,7740,1550,1351,10641
2/21/2019,2019,2,21, 23 ,7275,1420,1242,9937
2/21/2019,2019,2,21, 24 ,6850,1330,1165,9345
2/22/2019,2019,2,22, 1 ,6563,1270,1118,8951
2/22/2019,2019,2,22, 2 ,6336,1226,1074,8636
2/22/2019,2019,2,22, 3 ,6137,1202,1046,8385
2/22/2019,2019,2,22, 4 ,5995,1196,1037,8228
2/22/2019,2019,2,22, 5 ,6245,1257,1109,8611
2/22/2019,2019,2,22, 6 ,6475,1326,1198,8999
2/22/2019,2019,2,22, 7 ,6556,1293,1100,8949
2/22/2019,2019,2,22, 8 ,7228,1427,1223,9878
2/22/2019,2019,2,22, 9 ,8055,1675,1440,11170
2/22/2019,2019,2,22, 10 ,8638,1784,1591,12013
2/22/2019,2019,2,22, 11 ,8983,1873,1665,12521
2/22/2019,2019,2,22, 12 ,8728,1816,1629,12173
2/22/2019,2019,2,22, 13 ,8760,1833,1587,12180
2/22/2019,2019,2,22, 14 ,9147,1919,1727,12793
2/22/2019,2019,2,22, 15 ,9018,1902,1699,12619
2/22/2019,2019,2,22, 16 ,8958,1857,1671,12486
2/22/2019,2019,2,22, 17 ,8639,1765,1588,11992
2/22/2019,2019,2,22, 18 ,8482,1806,1606,11894
2/22/2019,2019,2,22, 19 ,8706,1888,1681,12275
2/22/2019,2019,2,22, 20 ,8462,1820,1619,11901
2/22/2019,2019,2,22, 21 ,8225,1722,1517,11464
2/22/2019,2019,2,22, 22 ,7813,1597,1406,10816
2/22/2019,2019,2,22, 23 ,7377,1480,1264,10121
2/22/2019,2019,2,22, 24 ,6912,1397,1220,9529
2/23/2019,2019,2,23, 1 ,6606,1343,1139,9088
2/23/2019,2019,2,23, 2 ,6384,1293,1096,8773
2/23/2019,2019,2,23, 3 ,6226,1247,1065,8538
2/23/2019,2019,2,23, 4 ,6080,1228,1061,8369
2/23/2019,2019,2,23, 5 ,6089,1245,1073,8407
2/23/2019,2019,2,23, 6 ,6230,1271,1125,8626
2/23/2019,2019,2,23, 7 ,6317,1279,1125,8721
2/23/2019,2019,2,23, 8 ,6846,1409,1209,9464
2/23/2019,2019,2,23, 9 ,7518,1578,1378,10474
2/23/2019,2019,2,23, 10 ,8016,1644,1477,11137
2/23/2019,2019,2,23, 11 ,8396,1711,1587,11694
2/23/2019,2019,2,23, 12 ,8250,1669,1573,11492
2/23/2019,2019,2,23, 13 ,8158,1676,1602,11436
2/23/2019,2019,2,23, 14 ,8439,1726,1673,11838
2/23/2019,2019,2,23, 15 ,8352,1699,1654,11705
2/23/2019,2019,2,23, 16 ,8200,1673,1618,11491
2/23/2019,2019,2,23, 17 ,7796,1620,1527,10943
2/23/2019,2019,2,23, 18 ,7811,1689,1600,11100
2/23/2019,2019,2,23, 19 ,8192,1788,1633,11613
2/23/2019,2019,2,23, 20 ,8034,1728,1596,11358
2/23/2019,2019,2,23, 21 ,7823,1664,1505,10992
2/23/2019,2019,2,23, 22 ,7480,1576,1419,10475
2/23/2019,2019,2,23, 23 ,7017,1451,1308,9776
2/23/2019,2019,2,23, 24 ,6620,1360,1212,9192
2/24/2019,2019,2,24, 1 ,6304,1292,1118,8714
2/24/2019,2019,2,24, 2 ,6091,1247,1091,8429
2/24/2019,2019,2,24, 3 ,5870,1214,1046,8130
2/24/2019,2019,2,24, 4 ,5712,1187,1025,7924
2/24/2019,2019,2,24, 5 ,5719,1193,1045,7957
2/24/2019,2019,2,24, 6 ,5667,1199,1054,7920
2/24/2019,2019,2,24, 7 ,5621,1208,1072,7901
2/24/2019,2019,2,24, 8 ,5941,1265,1107,8313
2/24/2019,2019,2,24, 9 ,6364,1361,1219,8944
2/24/2019,2019,2,24, 10 ,6839,1453,1315,9607
2/24/2019,2019,2,24, 11 ,7152,1495,1391,10038
2/24/2019,2019,2,24, 12 ,7138,1504,1399,10041
2/24/2019,2019,2,24, 13 ,7126,1519,1410,10055
2/24/2019,2019,2,24, 14 ,7188,1520,1444,10152
2/24/2019,2019,2,24, 15 ,7091,1503,1426,10020
2/24/2019,2019,2,24, 16 ,7059,1480,1402,9941
2/24/2019,2019,2,24, 17 ,6958,1461,1369,9788
2/24/2019,2019,2,24, 18 ,7145,1574,1428,10147
2/24/2019,2019,2,24, 19 ,7633,1694,1554,10881
2/24/2019,2019,2,24, 20 ,7590,1640,1505,10735
2/24/2019,2019,2,24, 21 ,7426,1566,1455,10447
2/24/2019,2019,2,24, 22 ,7123,1469,1347,9939
2/24/2019,2019,2,24, 23 ,6713,1355,1228,9296
2/24/2019,2019,2,24, 24 ,6326,1269,1209,8804
2/25/2019,2019,2,25, 1 ,6037,1224,1078,8339
2/25/2019,2019,2,25, 2 ,5821,1176,1039,8036
2/25/2019,2019,2,25, 3 ,5617,1142,1005,7764
2/25/2019,2019,2,25, 4 ,5490,1124,984,7598
2/25/2019,2019,2,25, 5 ,5504,1139,1009,7652
2/25/2019,2019,2,25, 6 ,5636,1175,1049,7860
2/25/2019,2019,2,25, 7 ,5753,1196,1074,8023
2/25/2019,2019,2,25, 8 ,6181,1281,1120,8582
2/25/2019,2019,2,25, 9 ,6762,1425,1284,9471
2/25/2019,2019,2,25, 10 ,7389,1539,1411,10339
2/25/2019,2019,2,25, 11 ,7704,1606,1498,10808
2/25/2019,2019,2,25, 12 ,7633,1598,1505,10736
2/25/2019,2019,2,25, 13 ,7593,1594,1507,10694
2/25/2019,2019,2,25, 14 ,7790,1644,1553,10987
2/25/2019,2019,2,25, 15 ,7745,1620,1543,10908
2/25/2019,2019,2,25, 16 ,7672,1595,1529,10796
2/25/2019,2019,2,25, 17 ,7508,1544,1441,10493
2/25/2019,2019,2,25, 18 ,7611,1630,1537,10778
2/25/2019,2019,2,25, 19 ,8082,1739,1599,11420
2/25/2019,2019,2,25, 20 ,7990,1656,1548,11194
2/25/2019,2019,2,25, 21 ,7762,1558,1514,10834
2/25/2019,2019,2,25, 22 ,7380,1443,1369,10192
2/25/2019,2019,2,25, 23 ,6912,1318,1240,9470
2/25/2019,2019,2,25, 24 ,6500,1243,1094,8837
2/26/2019,2019,2,26, 1 ,6227,1195,1106,8528
2/26/2019,2019,2,26, 2 ,6066,1163,1063,8292
2/26/2019,2019,2,26, 3 ,5886,1131,1025,8042
2/26/2019,2019,2,26, 4 ,5816,1135,1012,7963
2/26/2019,2019,2,26, 5 ,6087,1202,1049,8338
2/26/2019,2019,2,26, 6 ,6300,1292,1173,8765
2/26/2019,2019,2,26, 7 ,6439,1244,1106,8789
2/26/2019,2019,2,26, 8 ,7283,1385,1233,9901
2/26/2019,2019,2,26, 9 ,8197,1603,1445,11245
2/26/2019,2019,2,26, 10 ,8763,1743,1573,12079
2/26/2019,2019,2,26, 11 ,9045,1804,1667,12516
2/26/2019,2019,2,26, 12 ,8878,1753,1645,12276
2/26/2019,2019,2,26, 13 ,8813,1749,1654,12216
2/26/2019,2019,2,26, 14 ,9142,1817,1730,12689
2/26/2019,2019,2,26, 15 ,9057,1796,1728,12581
2/26/2019,2019,2,26, 16 ,8931,1763,1708,12402
2/26/2019,2019,2,26, 17 ,8531,1674,1619,11824
2/26/2019,2019,2,26, 18 ,8306,1708,1624,11638
2/26/2019,2019,2,26, 19 ,8573,1788,1698,12059
2/26/2019,2019,2,26, 20 ,8312,1697,1617,11626
2/26/2019,2019,2,26, 21 ,8146,1605,1547,11298
2/26/2019,2019,2,26, 22 ,7570,1475,1397,10442
2/26/2019,2019,2,26, 23 ,7160,1348,1264,9772
2/26/2019,2019,2,26, 24 ,6760,1266,1215,9241
2/27/2019,2019,2,27, 1 ,6421,1214,1114,8749
2/27/2019,2019,2,27, 2 ,6278,1178,1064,8520
2/27/2019,2019,2,27, 3 ,6085,1144,1019,8248
2/27/2019,2019,2,27, 4 ,5994,1134,1023,8151
2/27/2019,2019,2,27, 5 ,6243,1190,1088,8521
2/27/2019,2019,2,27, 6 ,6491,1270,1185,8946
2/27/2019,2019,2,27, 7 ,6496,1235,1112,8843
2/27/2019,2019,2,27, 8 ,7279,1356,1200,9835
2/27/2019,2019,2,27, 9 ,8013,1580,1450,11043
2/27/2019,2019,2,27, 10 ,8597,1718,1540,11855
2/27/2019,2019,2,27, 11 ,8908,1790,1632,12330
2/27/2019,2019,2,27, 12 ,8771,1740,1610,12121
2/27/2019,2019,2,27, 13 ,8733,1755,1640,12128
2/27/2019,2019,2,27, 14 ,9174,1831,1711,12716
2/27/2019,2019,2,27, 15 ,9031,1821,1706,12558
2/27/2019,2019,2,27, 16 ,8866,1792,1670,12328
2/27/2019,2019,2,27, 17 ,8431,1695,1604,11730
2/27/2019,2019,2,27, 18 ,8327,1729,1634,11690
2/27/2019,2019,2,27, 19 ,8596,1824,1664,12084
2/27/2019,2019,2,27, 20 ,8414,1734,1586,11734
2/27/2019,2019,2,27, 21 ,8172,1643,1508,11323
2/27/2019,2019,2,27, 22 ,7695,1513,1378,10586
2/27/2019,2019,2,27, 23 ,7274,1400,1255,9929
2/27/2019,2019,2,27, 24 ,6817,1307,1157,9281
2/28/2019,2019,2,28, 1 ,6520,1247,1109,8876
2/28/2019,2019,2,28, 2 ,6397,1213,1070,8680
2/28/2019,2019,2,28, 3 ,6201,1184,1027,8412
2/28/2019,2019,2,28, 4 ,6178,1174,1009,8361
2/28/2019,2019,2,28, 5 ,6396,1222,1082,8700
2/28/2019,2019,2,28, 6 ,6595,1302,1191,9088
2/28/2019,2019,2,28, 7 ,6614,1256,1106,8976
2/28/2019,2019,2,28, 8 ,7301,1392,1217,9910
2/28/2019,2019,2,28, 9 ,8027,1615,1440,11082
2/28/2019,2019,2,28, 10 ,8559,1752,1576,11887
2/28/2019,2019,2,28, 11 ,8856,1831,1655,12342
2/28/2019,2019,2,28, 12 ,8662,1783,1628,12073
2/28/2019,2019,2,28, 13 ,8676,1791,1622,12089
2/28/2019,2019,2,28, 14 ,8976,1878,1711,12565
2/28/2019,2019,2,28, 15 ,9016,1836,1715,12567
2/28/2019,2019,2,28, 16 ,8922,1812,1679,12413
2/28/2019,2019,2,28, 17 ,8542,1729,1616,11887
2/28/2019,2019,2,28, 18 ,8376,1790,1657,11823
2/28/2019,2019,2,28, 19 ,8656,1864,1699,12219
2/28/2019,2019,2,28, 20 ,8508,1798,1663,11969
2/28/2019,2019,2,28, 21 ,8294,1705,1584,11583
2/28/2019,2019,2,28, 22 ,7849,1566,1449,10864
2/28/2019,2019,2,28, 23 ,7372,1467,1335,10174
2/28/2019,2019,2,28, 24 ,6969,1370,1218,9557
3/1/2019,2019,3,1, 1 ,6630,1347,1169,9146
3/1/2019,2019,3,1, 2 ,6422,1307,1124,8853
3/1/2019,2019,3,1, 3 ,6265,1277,1079,8621
3/1/2019,2019,3,1, 4 ,6141,1256,1073,8470
3/1/2019,2019,3,1, 5 ,6285,1304,1128,8717
3/1/2019,2019,3,1, 6 ,6550,1369,1197,9116
3/1/2019,2019,3,1, 7 ,6500,1325,1117,8942
3/1/2019,2019,3,1, 8 ,7270,1460,1258,9988
3/1/2019,2019,3,1, 9 ,8085,1678,1481,11244
3/1/2019,2019,3,1, 10 ,8637,1785,1621,12043
3/1/2019,2019,3,1, 11 ,9020,1877,1703,12600
3/1/2019,2019,3,1, 12 ,8829,1813,1661,12303
3/1/2019,2019,3,1, 13 ,8824,1824,1677,12325
3/1/2019,2019,3,1, 14 ,9171,1894,1729,12794
3/1/2019,2019,3,1, 15 ,9133,1881,1746,12760
3/1/2019,2019,3,1, 16 ,8994,1850,1721,12565
3/1/2019,2019,3,1, 17 ,8588,1758,1631,11977
3/1/2019,2019,3,1, 18 ,8306,1792,1645,11743
3/1/2019,2019,3,1, 19 ,8653,1883,1690,12226
3/1/2019,2019,3,1, 20 ,8467,1804,1642,11913
3/1/2019,2019,3,1, 21 ,8203,1731,1564,11498
3/1/2019,2019,3,1, 22 ,7860,1605,1458,10923
3/1/2019,2019,3,1, 23 ,7458,1474,1328,10260
3/1/2019,2019,3,1, 24 ,7021,1392,1244,9657
3/2/2019,2019,3,2, 1 ,6718,1340,1182,9240
3/2/2019,2019,3,2, 2 ,6486,1296,1151,8933
3/2/2019,2019,3,2, 3 ,6295,1256,1120,8671
3/2/2019,2019,3,2, 4 ,6189,1233,1069,8491
3/2/2019,2019,3,2, 5 ,6167,1239,1098,8504
3/2/2019,2019,3,2, 6 ,6241,1268,1155,8664
3/2/2019,2019,3,2, 7 ,6313,1292,1153,8758
3/2/2019,2019,3,2, 8 ,6880,1390,1247,9517
3/2/2019,2019,3,2, 9 ,7608,1566,1341,10515
3/2/2019,2019,3,2, 10 ,8164,1686,1526,11376
3/2/2019,2019,3,2, 11 ,8468,1739,1624,11831
3/2/2019,2019,3,2, 12 ,8245,1716,1603,11564
3/2/2019,2019,3,2, 13 ,8169,1716,1562,11447
3/2/2019,2019,3,2, 14 ,8443,1770,1639,11852
3/2/2019,2019,3,2, 15 ,8432,1755,1606,11793
3/2/2019,2019,3,2, 16 ,8258,1720,1563,11541
3/2/2019,2019,3,2, 17 ,7924,1651,1576,11151
3/2/2019,2019,3,2, 18 ,7784,1711,1598,11093
3/2/2019,2019,3,2, 19 ,8278,1825,1622,11725
3/2/2019,2019,3,2, 20 ,8120,1770,1583,11473
3/2/2019,2019,3,2, 21 ,7963,1681,1499,11143
3/2/2019,2019,3,2, 22 ,7594,1597,1406,10597
3/2/2019,2019,3,2, 23 ,7178,1477,1282,9937
3/2/2019,2019,3,2, 24 ,6728,1394,1213,9335
3/3/2019,2019,3,3, 1 ,6437,1342,1133,8912
3/3/2019,2019,3,3, 2 ,6245,1293,1115,8653
3/3/2019,2019,3,3, 3 ,5986,1248,1085,8319
3/3/2019,2019,3,3, 4 ,5827,1220,1060,8107
3/3/2019,2019,3,3, 5 ,5799,1219,1053,8071
3/3/2019,2019,3,3, 6 ,5686,1224,1071,7981
3/3/2019,2019,3,3, 7 ,5698,1235,1068,8001
3/3/2019,2019,3,3, 8 ,5987,1293,1111,8391
3/3/2019,2019,3,3, 9 ,6477,1399,1211,9087
3/3/2019,2019,3,3, 10 ,7034,1496,1300,9830
3/3/2019,2019,3,3, 11 ,7336,1557,1394,10287
3/3/2019,2019,3,3, 12 ,7287,1553,1418,10258
3/3/2019,2019,3,3, 13 ,7392,1550,1425,10367
3/3/2019,2019,3,3, 14 ,7431,1571,1447,10449
3/3/2019,2019,3,3, 15 ,7425,1553,1428,10406
3/3/2019,2019,3,3, 16 ,7363,1542,1401,10306
3/3/2019,2019,3,3, 17 ,7242,1522,1363,10127
3/3/2019,2019,3,3, 18 ,7366,1624,1491,10481
3/3/2019,2019,3,3, 19 ,7985,1767,1554,11306
3/3/2019,2019,3,3, 20 ,7957,1725,1533,11215
3/3/2019,2019,3,3, 21 ,7860,1657,1486,11003
3/3/2019,2019,3,3, 22 ,7545,1552,1387,10484
3/3/2019,2019,3,3, 23 ,7131,1445,1267,9843
3/3/2019,2019,3,3, 24 ,6741,1346,1166,9253
3/4/2019,2019,3,4, 1 ,6430,1283,1126,8839
3/4/2019,2019,3,4, 2 ,6169,1241,1074,8484
3/4/2019,2019,3,4, 3 ,5974,1217,1040,8231
3/4/2019,2019,3,4, 4 ,5904,1212,1032,8148
3/4/2019,2019,3,4, 5 ,6088,1261,1083,8432
3/4/2019,2019,3,4, 6 ,6392,1336,1195,8923
3/4/2019,2019,3,4, 7 ,6576,1291,1110,8977
3/4/2019,2019,3,4, 8 ,7452,1443,1261,10156
3/4/2019,2019,3,4, 9 ,8391,1682,1500,11573
3/4/2019,2019,3,4, 10 ,9039,1810,1620,12469
3/4/2019,2019,3,4, 11 ,9354,1889,1701,12944
3/4/2019,2019,3,4, 12 ,9224,1848,1685,12757
3/4/2019,2019,3,4, 13 ,9262,1863,1703,12828
3/4/2019,2019,3,4, 14 ,9608,1938,1772,13318
3/4/2019,2019,3,4, 15 ,9569,1905,1747,13221
3/4/2019,2019,3,4, 16 ,8480,1876,1726,12082
3/4/2019,2019,3,4, 17 ,9016,1780,1637,12433
3/4/2019,2019,3,4, 18 ,8748,1801,1662,12211
3/4/2019,2019,3,4, 19 ,9094,1903,1727,12724
3/4/2019,2019,3,4, 20 ,8869,1840,1660,12369
3/4/2019,2019,3,4, 21 ,8760,1764,1506,12030
3/4/2019,2019,3,4, 22 ,8299,1635,1436,11370
3/4/2019,2019,3,4, 23 ,7814,1515,1333,10662
3/4/2019,2019,3,4, 24 ,7333,1428,1222,9983
3/5/2019,2019,3,5, 1 ,7000,1373,1182,9555
3/5/2019,2019,3,5, 2 ,6821,1334,1130,9285
3/5/2019,2019,3,5, 3 ,6616,1296,1095,9007
3/5/2019,2019,3,5, 4 ,6579,1279,1072,8930
3/5/2019,2019,3,5, 5 ,6682,1319,1144,9145
3/5/2019,2019,3,5, 6 ,6968,1393,1236,9597
3/5/2019,2019,3,5, 7 ,6960,1334,1142,9436
3/5/2019,2019,3,5, 8 ,7566,1468,1259,10293
3/5/2019,2019,3,5, 9 ,8375,1693,1514,11582
3/5/2019,2019,3,5, 10 ,8868,1809,1608,12285
3/5/2019,2019,3,5, 11 ,9276,1854,1713,12843
3/5/2019,2019,3,5, 12 ,8999,1811,1675,12485
3/5/2019,2019,3,5, 13 ,8975,1824,1677,12476
3/5/2019,2019,3,5, 14 ,9369,1894,1683,12946
3/5/2019,2019,3,5, 15 ,9351,1873,1619,12843
3/5/2019,2019,3,5, 16 ,9247,1852,1620,12719
3/5/2019,2019,3,5, 17 ,8813,1767,1589,12169
3/5/2019,2019,3,5, 18 ,8640,1840,1635,12115
3/5/2019,2019,3,5, 19 ,8949,1919,1686,12554
3/5/2019,2019,3,5, 20 ,8758,1852,1635,12245
3/5/2019,2019,3,5, 21 ,8572,1758,1573,11903
3/5/2019,2019,3,5, 22 ,8124,1631,1434,11189
3/5/2019,2019,3,5, 23 ,7631,1518,1314,10463
3/5/2019,2019,3,5, 24 ,7257,1429,1250,9936
3/6/2019,2019,3,6, 1 ,6935,1388,1156,9479
3/6/2019,2019,3,6, 2 ,6704,1341,1123,9168
3/6/2019,2019,3,6, 3 ,6531,1307,1088,8926
3/6/2019,2019,3,6, 4 ,6437,1282,1074,8793
3/6/2019,2019,3,6, 5 ,6649,1327,1133,9109
3/6/2019,2019,3,6, 6 ,6895,1391,1219,9505
3/6/2019,2019,3,6, 7 ,6930,1330,1117,9377
3/6/2019,2019,3,6, 8 ,7674,1456,1260,10390
3/6/2019,2019,3,6, 9 ,8500,1694,1487,11681
3/6/2019,2019,3,6, 10 ,9166,1806,1624,12596
3/6/2019,2019,3,6, 11 ,9528,1892,1700,13120
3/6/2019,2019,3,6, 12 ,9359,1853,1684,12896
3/6/2019,2019,3,6, 13 ,9359,1865,1719,12943
3/6/2019,2019,3,6, 14 ,9774,1940,1753,13467
3/6/2019,2019,3,6, 15 ,9700,1920,1724,13344
3/6/2019,2019,3,6, 16 ,9581,1902,1717,13200
3/6/2019,2019,3,6, 17 ,9157,1797,1637,12591
3/6/2019,2019,3,6, 18 ,8892,1800,1669,12361
3/6/2019,2019,3,6, 19 ,9239,1910,1720,12869
3/6/2019,2019,3,6, 20 ,9058,1840,1660,12558
3/6/2019,2019,3,6, 21 ,8877,1762,1617,12256
3/6/2019,2019,3,6, 22 ,8532,1630,1479,11641
3/6/2019,2019,3,6, 23 ,8090,1514,1370,10974
3/6/2019,2019,3,6, 24 ,7605,1430,1220,10255
3/7/2019,2019,3,7, 1 ,7301,1366,1215,9882
3/7/2019,2019,3,7, 2 ,7083,1327,1182,9592
3/7/2019,2019,3,7, 3 ,6882,1293,1138,9313
3/7/2019,2019,3,7, 4 ,6798,1274,1119,9191
3/7/2019,2019,3,7, 5 ,6934,1311,1149,9394
3/7/2019,2019,3,7, 6 ,7083,1385,1224,9692
3/7/2019,2019,3,7, 7 ,7082,1318,1155,9555
3/7/2019,2019,3,7, 8 ,7880,1469,1250,10599
3/7/2019,2019,3,7, 9 ,8803,1700,1448,11951
3/7/2019,2019,3,7, 10 ,9344,1848,1572,12764
3/7/2019,2019,3,7, 11 ,9597,1929,1655,13181
3/7/2019,2019,3,7, 12 ,9465,1878,1654,12997
3/7/2019,2019,3,7, 13 ,9513,1884,1675,13072
3/7/2019,2019,3,7, 14 ,9845,1978,1747,13570
3/7/2019,2019,3,7, 15 ,9767,1959,1731,13457
3/7/2019,2019,3,7, 16 ,9707,1911,1702,13320
3/7/2019,2019,3,7, 17 ,9281,1823,1638,12742
3/7/2019,2019,3,7, 18 ,8995,1839,1662,12496
3/7/2019,2019,3,7, 19 ,9254,1927,1683,12864
3/7/2019,2019,3,7, 20 ,9089,1864,1611,12564
3/7/2019,2019,3,7, 21 ,8885,1786,1539,12210
3/7/2019,2019,3,7, 22 ,8476,1649,1420,11545
3/7/2019,2019,3,7, 23 ,8032,1524,1307,10863
3/7/2019,2019,3,7, 24 ,7549,1425,1211,10185
3/8/2019,2019,3,8, 1 ,7257,1365,1155,9777
3/8/2019,2019,3,8, 2 ,7054,1313,1096,9463
3/8/2019,2019,3,8, 3 ,6850,1280,1067,9197
3/8/2019,2019,3,8, 4 ,6714,1257,1062,9033
3/8/2019,2019,3,8, 5 ,6865,1286,1109,9260
3/8/2019,2019,3,8, 6 ,7056,1364,1212,9632
3/8/2019,2019,3,8, 7 ,7081,1327,1128,9536
3/8/2019,2019,3,8, 8 ,7900,1469,1260,10629
3/8/2019,2019,3,8, 9 ,8741,1718,1468,11927
3/8/2019,2019,3,8, 10 ,9232,1813,1595,12640
3/8/2019,2019,3,8, 11 ,9601,1893,1640,13134
3/8/2019,2019,3,8, 12 ,9408,1839,1633,12880
3/8/2019,2019,3,8, 13 ,9385,1844,1658,12887
3/8/2019,2019,3,8, 14 ,9778,1934,1697,13409
3/8/2019,2019,3,8, 15 ,9687,1905,1667,13259
3/8/2019,2019,3,8, 16 ,9557,1871,1656,13084
3/8/2019,2019,3,8, 17 ,9061,1761,1603,12425
3/8/2019,2019,3,8, 18 ,8751,1783,1637,12171
3/8/2019,2019,3,8, 19 ,9126,1857,1697,12680
3/8/2019,2019,3,8, 20 ,8958,1793,1639,12390
3/8/2019,2019,3,8, 21 ,8811,1718,1552,12081
3/8/2019,2019,3,8, 22 ,8426,1606,1440,11472
3/8/2019,2019,3,8, 23 ,7965,1497,1317,10779
3/8/2019,2019,3,8, 24 ,7586,1406,1246,10238
3/9/2019,2019,3,9, 1 ,7165,1334,1178,9677
3/9/2019,2019,3,9, 2 ,6956,1286,1129,9371
3/9/2019,2019,3,9, 3 ,6685,1252,1093,9030
3/9/2019,2019,3,9, 4 ,6549,1237,1079,8865
3/9/2019,2019,3,9, 5 ,6509,1250,1095,8854
3/9/2019,2019,3,9, 6 ,6540,1281,1133,8954
3/9/2019,2019,3,9, 7 ,6631,1296,1133,9060
3/9/2019,2019,3,9, 8 ,7184,1395,1221,9800
3/9/2019,2019,3,9, 9 ,7897,1563,1370,10830
3/9/2019,2019,3,9, 10 ,8450,1701,1471,11622
3/9/2019,2019,3,9, 11 ,8873,1770,1554,12197
3/9/2019,2019,3,9, 12 ,8710,1725,1560,11995
3/9/2019,2019,3,9, 13 ,8711,1732,1575,12018
3/9/2019,2019,3,9, 14 ,8957,1790,1617,12364
3/9/2019,2019,3,9, 15 ,8892,1779,1605,12276
3/9/2019,2019,3,9, 16 ,8708,1739,1572,12019
3/9/2019,2019,3,9, 17 ,8270,1668,1502,11440
3/9/2019,2019,3,9, 18 ,8165,1717,1573,11455
3/9/2019,2019,3,9, 19 ,8659,1836,1629,12124
3/9/2019,2019,3,9, 20 ,8494,1775,1589,11858
3/9/2019,2019,3,9, 21 ,8393,1708,1531,11632
3/9/2019,2019,3,9, 22 ,8142,1611,1430,11183
3/9/2019,2019,3,9, 23 ,7716,1475,1300,10491
3/9/2019,2019,3,9, 24 ,7342,1379,1184,9905
3/10/2019,2019,3,10, 1 ,7044,1323,1172,9539
3/10/2019,2019,3,10, 2 ,6748,1271,1121,9140
3/10/2019,2019,3,10, 3 ,6486,1239,1081,8806
3/10/2019,2019,3,10, 4 ,6272,1206,1054,8532
3/10/2019,2019,3,10, 5 ,6168,1204,1067,8439
3/10/2019,2019,3,10, 6 ,6022,1203,1095,8320
3/10/2019,2019,3,10, 7 ,5977,1202,1096,8275
3/10/2019,2019,3,10, 8 ,6383,1263,1126,8772
3/10/2019,2019,3,10, 9 ,6854,1379,1229,9462
3/10/2019,2019,3,10, 10 ,7400,1486,1321,10207
3/10/2019,2019,3,10, 11 ,7727,1541,1401,10669
3/10/2019,2019,3,10, 12 ,7647,1557,1422,10626
3/10/2019,2019,3,10, 13 ,7734,1569,1424,10727
3/10/2019,2019,3,10, 14 ,7788,1573,1482,10843
3/10/2019,2019,3,10, 15 ,7671,1560,1396,10627
3/10/2019,2019,3,10, 16 ,7585,1535,1362,10482
3/10/2019,2019,3,10, 17 ,7415,1520,1340,10275
3/10/2019,2019,3,10, 18 ,7504,1606,1478,10588
3/10/2019,2019,3,10, 19 ,8164,1741,1604,11509
3/10/2019,2019,3,10, 20 ,8109,1713,1522,11344
3/10/2019,2019,3,10, 21 ,8052,1632,1487,11171
3/10/2019,2019,3,10, 22 ,7796,1518,1382,10696
3/10/2019,2019,3,10, 23 ,7385,1405,1281,10071
3/10/2019,2019,3,10, 24 ,7039,1317,1173,9529
3/11/2019,2019,3,11, 1 ,6583,1245,1102,8930
3/11/2019,2019,3,11, 2 ,6352,1199,1080,8631
3/11/2019,2019,3,11, 3 ,6104,1161,1053,8318
3/11/2019,2019,3,11, 4 ,6075,1150,1038,8263
3/11/2019,2019,3,11, 5 ,6253,1212,1097,8562
3/11/2019,2019,3,11, 6 ,6536,1296,1197,9029
3/11/2019,2019,3,11, 7 ,6678,1252,1116,9046
3/11/2019,2019,3,11, 8 ,7544,1402,1231,10177
3/11/2019,2019,3,11, 9 ,8523,1639,1477,11639
3/11/2019,2019,3,11, 10 ,9134,1791,1601,12526
3/11/2019,2019,3,11, 11 ,9565,1884,1703,13152
3/11/2019,2019,3,11, 12 ,9400,1843,1690,12933
3/11/2019,2019,3,11, 13 ,9385,1861,1703,12949
3/11/2019,2019,3,11, 14 ,9781,1941,1736,13458
3/11/2019,2019,3,11, 15 ,9735,1913,1718,13366
3/11/2019,2019,3,11, 16 ,9597,1901,1672,13170
3/11/2019,2019,3,11, 17 ,9132,1791,1611,12534
3/11/2019,2019,3,11, 18 ,8884,1831,1643,12358
3/11/2019,2019,3,11, 19 ,9182,1904,1665,12751
3/11/2019,2019,3,11, 20 ,9086,1834,1635,12555
3/11/2019,2019,3,11, 21 ,8900,1747,1555,12202
3/11/2019,2019,3,11, 22 ,8526,1609,1407,11542
3/11/2019,2019,3,11, 23 ,8073,1495,1284,10852
3/11/2019,2019,3,11, 24 ,7636,1401,1186,10223
3/12/2019,2019,3,12, 1 ,7258,1345,1134,9737
3/12/2019,2019,3,12, 2 ,7003,1310,1092,9405
3/12/2019,2019,3,12, 3 ,6774,1267,1048,9089
3/12/2019,2019,3,12, 4 ,6681,1259,1040,8980
3/12/2019,2019,3,12, 5 ,6808,1308,1077,9193
3/12/2019,2019,3,12, 6 ,7017,1375,1191,9583
3/12/2019,2019,3,12, 7 ,7055,1318,1098,9471
3/12/2019,2019,3,12, 8 ,7839,1455,1234,10528
3/12/2019,2019,3,12, 9 ,8753,1695,1455,11903
3/12/2019,2019,3,12, 10 ,9323,1829,1611,12763
3/12/2019,2019,3,12, 11 ,9732,1882,1690,13304
3/12/2019,2019,3,12, 12 ,9545,1845,1579,12969
3/12/2019,2019,3,12, 13 ,9583,1878,1664,13125
3/12/2019,2019,3,12, 14 ,10052,1954,1706,13712
3/12/2019,2019,3,12, 15 ,9951,1918,1700,13569
3/12/2019,2019,3,12, 16 ,9829,1915,1694,13438
3/12/2019,2019,3,12, 17 ,9350,1806,1622,12778
3/12/2019,2019,3,12, 18 ,9169,1856,1659,12684
3/12/2019,2019,3,12, 19 ,9447,1905,1675,13027
3/12/2019,2019,3,12, 20 ,9296,1840,1657,12793
3/12/2019,2019,3,12, 21 ,9095,1734,1591,12420
3/12/2019,2019,3,12, 22 ,8815,1602,1457,11874
3/12/2019,2019,3,12, 23 ,8351,1458,1321,11130
3/12/2019,2019,3,12, 24 ,7891,1383,1201,10475
3/13/2019,2019,3,13, 1 ,7562,1321,1177,10060
3/13/2019,2019,3,13, 2 ,7271,1273,1139,9683
3/13/2019,2019,3,13, 3 ,7027,1250,1098,9375
3/13/2019,2019,3,13, 4 ,6858,1232,1090,9180
3/13/2019,2019,3,13, 5 ,6990,1289,1140,9419
3/13/2019,2019,3,13, 6 ,7236,1374,1232,9842
3/13/2019,2019,3,13, 7 ,7055,1317,1148,9520
3/13/2019,2019,3,13, 8 ,7839,1470,1277,10586
3/13/2019,2019,3,13, 9 ,8753,1723,1504,11980
3/13/2019,2019,3,13, 10 ,9323,1843,1654,12820
3/13/2019,2019,3,13, 11 ,9732,1908,1726,13366
3/13/2019,2019,3,13, 12 ,9545,1880,1710,13135
3/13/2019,2019,3,13, 13 ,9583,1890,1718,13191
3/13/2019,2019,3,13, 14 ,9932,1982,1786,13700
3/13/2019,2019,3,13, 15 ,9846,1954,1779,13579
3/13/2019,2019,3,13, 16 ,9693,1916,1742,13351
3/13/2019,2019,3,13, 17 ,9267,1815,1687,12769
3/13/2019,2019,3,13, 18 ,8991,1835,1704,12530
3/13/2019,2019,3,13, 19 ,9228,1942,1713,12883
3/13/2019,2019,3,13, 20 ,9087,1867,1671,12625
3/13/2019,2019,3,13, 21 ,8945,1772,1615,12332
3/13/2019,2019,3,13, 22 ,8565,1632,1484,11681
3/13/2019,2019,3,13, 23 ,8092,1519,1357,10968
3/13/2019,2019,3,13, 24 ,7647,1417,1231,10295
3/14/2019,2019,3,14, 1 ,7266,1359,1188,9813
3/14/2019,2019,3,14, 2 ,6977,1314,1111,9402
3/14/2019,2019,3,14, 3 ,6778,1273,1126,9177
3/14/2019,2019,3,14, 4 ,6716,1255,1095,9066
3/14/2019,2019,3,14, 5 ,6855,1289,1214,9358
3/14/2019,2019,3,14, 6 ,7019,1385,1241,9645
3/14/2019,2019,3,14, 7 ,7010,1311,1146,9467
3/14/2019,2019,3,14, 8 ,7782,1468,1288,10538
3/14/2019,2019,3,14, 9 ,8670,1702,1493,11865
3/14/2019,2019,3,14, 10 ,9239,1845,1622,12706
3/14/2019,2019,3,14, 11 ,9660,1916,1693,13269
3/14/2019,2019,3,14, 12 ,9457,1859,1669,12985
3/14/2019,2019,3,14, 13 ,9427,1878,1694,12999
3/14/2019,2019,3,14, 14 ,9862,1958,1720,13540
3/14/2019,2019,3,14, 15 ,9795,1947,1680,13422
3/14/2019,2019,3,14, 16 ,9696,1910,1770,13376
3/14/2019,2019,3,14, 17 ,9258,1811,1601,12670
3/14/2019,2019,3,14, 18 ,8938,1824,1690,12452
3/14/2019,2019,3,14, 19 ,9364,1926,1665,12955
3/14/2019,2019,3,14, 20 ,9212,1839,1624,12675
3/14/2019,2019,3,14, 21 ,9104,1755,1523,12382
3/14/2019,2019,3,14, 22 ,8735,1617,1423,11775
3/14/2019,2019,3,14, 23 ,8354,1490,1315,11159
3/14/2019,2019,3,14, 24 ,7952,1418,1253,10623
3/15/2019,2019,3,15, 1 ,7568,1357,1168,10093
3/15/2019,2019,3,15, 2 ,7297,1310,1116,9723
3/15/2019,2019,3,15, 3 ,7056,1279,1093,9428
3/15/2019,2019,3,15, 4 ,6976,1252,1090,9318
3/15/2019,2019,3,15, 5 ,7059,1307,1150,9516
3/15/2019,2019,3,15, 6 ,7218,1351,1241,9810
3/15/2019,2019,3,15, 7 ,7221,1311,1155,9687
3/15/2019,2019,3,15, 8 ,8038,1473,1283,10794
3/15/2019,2019,3,15, 9 ,8851,1704,1512,12067
3/15/2019,2019,3,15, 10 ,9354,1825,1643,12822
3/15/2019,2019,3,15, 11 ,9729,1895,1697,13321
3/15/2019,2019,3,15, 12 ,9532,1845,1681,13058
3/15/2019,2019,3,15, 13 ,9533,1863,1691,13087
3/15/2019,2019,3,15, 14 ,9939,1937,1720,13596
3/15/2019,2019,3,15, 15 ,9794,1901,1715,13410
3/15/2019,2019,3,15, 16 ,9621,1867,1697,13185
3/15/2019,2019,3,15, 17 ,9104,1769,1624,12497
3/15/2019,2019,3,15, 18 ,8861,1781,1629,12271
3/15/2019,2019,3,15, 19 ,9120,1881,1670,12671
3/15/2019,2019,3,15, 20 ,8996,1825,1620,12441
3/15/2019,2019,3,15, 21 ,8859,1725,1563,12147
3/15/2019,2019,3,15, 22 ,8523,1621,1476,11620
3/15/2019,2019,3,15, 23 ,8098,1499,1344,10941
3/15/2019,2019,3,15, 24 ,7682,1406,1212,10300
3/16/2019,2019,3,16, 1 ,7406,1344,1153,9903
3/16/2019,2019,3,16, 2 ,7104,1308,1106,9518
3/16/2019,2019,3,16, 3 ,6919,1268,1067,9254
3/16/2019,2019,3,16, 4 ,6768,1247,1048,9063
3/16/2019,2019,3,16, 5 ,6768,1255,1063,9086
3/16/2019,2019,3,16, 6 ,6758,1284,1132,9174
3/16/2019,2019,3,16, 7 ,6745,1297,1127,9169
3/16/2019,2019,3,16, 8 ,7334,1340,1291,9965
3/16/2019,2019,3,16, 9 ,7937,1575,1423,10935
3/16/2019,2019,3,16, 10 ,8447,1686,1522,11655
3/16/2019,2019,3,16, 11 ,8740,1763,1571,12074
3/16/2019,2019,3,16, 12 ,8613,1713,1569,11895
3/16/2019,2019,3,16, 13 ,8564,1759,1576,11899
3/16/2019,2019,3,16, 14 ,8820,1811,1633,12264
3/16/2019,2019,3,16, 15 ,8783,1817,1504,12104
3/16/2019,2019,3,16, 16 ,8634,1782,1477,11893
3/16/2019,2019,3,16, 17 ,8257,1725,1438,11420
3/16/2019,2019,3,16, 18 ,8155,1715,1499,11369
3/16/2019,2019,3,16, 19 ,8638,1836,1537,12011
3/16/2019,2019,3,16, 20 ,8541,1792,1564,11897
3/16/2019,2019,3,16, 21 ,8448,1719,1545,11712
3/16/2019,2019,3,16, 22 ,8187,1644,1458,11289
3/16/2019,2019,3,16, 23 ,7734,1516,1360,10610
3/16/2019,2019,3,16, 24 ,7228,1420,1349,9997
3/17/2019,2019,3,17, 1 ,7069,1355,1186,9610
3/17/2019,2019,3,17, 2 ,6814,1311,1157,9282
3/17/2019,2019,3,17, 3 ,6560,1274,1138,8972
3/17/2019,2019,3,17, 4 ,6355,1244,1113,8712
3/17/2019,2019,3,17, 5 ,6314,1245,1113,8672
3/17/2019,2019,3,17, 6 ,6150,1200,1131,8481
3/17/2019,2019,3,17, 7 ,6126,1253,1116,8495
3/17/2019,2019,3,17, 8 ,6507,1324,1130,8961
3/17/2019,2019,3,17, 9 ,7057,1409,1209,9675
3/17/2019,2019,3,17, 10 ,7592,1457,1275,10324
3/17/2019,2019,3,17, 11 ,7799,1484,1329,10612
3/17/2019,2019,3,17, 12 ,7764,1461,1342,10567
3/17/2019,2019,3,17, 13 ,7842,1476,1362,10680
3/17/2019,2019,3,17, 14 ,7891,1486,1357,10734
3/17/2019,2019,3,17, 15 ,7785,1495,1333,10613
3/17/2019,2019,3,17, 16 ,7650,1479,1303,10432
3/17/2019,2019,3,17, 17 ,7538,1478,1298,10314
3/17/2019,2019,3,17, 18 ,7708,1623,1407,10738
3/17/2019,2019,3,17, 19 ,8200,1751,1494,11445
3/17/2019,2019,3,17, 20 ,8252,1709,1508,11469
3/17/2019,2019,3,17, 21 ,8149,1622,1460,11231
3/17/2019,2019,3,17, 22 ,7978,1507,1303,10788
3/17/2019,2019,3,17, 23 ,7540,1396,1257,10193
3/17/2019,2019,3,17, 24 ,7113,1320,1168,9601
3/18/2019,2019,3,18, 1 ,6793,1257,1115,9165
3/18/2019,2019,3,18, 2 ,6543,1215,1072,8830
3/18/2019,2019,3,18, 3 ,6324,1184,1025,8533
3/18/2019,2019,3,18, 4 ,6252,1170,1038,8460
3/18/2019,2019,3,18, 5 ,6372,1213,1080,8665
3/18/2019,2019,3,18, 6 ,6668,1280,1129,9077
3/18/2019,2019,3,18, 7 ,6832,1266,1108,9206
3/18/2019,2019,3,18, 8 ,7744,1433,1215,10392
3/18/2019,2019,3,18, 9 ,8706,1657,1439,11802
3/18/2019,2019,3,18, 10 ,9327,1787,1568,12682
3/18/2019,2019,3,18, 11 ,9702,1864,1620,13186
3/18/2019,2019,3,18, 12 ,9499,1822,1598,12919
3/18/2019,2019,3,18, 13 ,9588,1815,1574,12977
3/18/2019,2019,3,18, 14 ,9963,1882,1570,13415
3/18/2019,2019,3,18, 15 ,9938,1883,1558,13379
3/18/2019,2019,3,18, 16 ,9857,1864,1564,13285
3/18/2019,2019,3,18, 17 ,9334,1808,1565,12707
3/18/2019,2019,3,18, 18 ,8968,1847,1594,12409
3/18/2019,2019,3,18, 19 ,9319,1913,1560,12792
3/18/2019,2019,3,18, 20 ,9173,1855,1543,12571
3/18/2019,2019,3,18, 21 ,9015,1779,1461,12255
3/18/2019,2019,3,18, 22 ,8624,1643,1347,11614
3/18/2019,2019,3,18, 23 ,8187,1539,1257,10983
3/18/2019,2019,3,18, 24 ,7723,1445,1170,10338
3/19/2019,2019,3,19, 1 ,7329,1359,1119,9807
3/19/2019,2019,3,19, 2 ,7034,1321,1086,9441
3/19/2019,2019,3,19, 3 ,6892,1285,1062,9239
3/19/2019,2019,3,19, 4 ,6765,1267,1029,9061
3/19/2019,2019,3,19, 5 ,6865,1308,1061,9234
3/19/2019,2019,3,19, 6 ,7010,1378,1128,9516
3/19/2019,2019,3,19, 7 ,7104,1330,1130,9564
3/19/2019,2019,3,19, 8 ,7970,1448,1210,10628
3/19/2019,2019,3,19, 9 ,8927,1648,1362,11937
3/19/2019,2019,3,19, 10 ,9475,1782,1436,12693
3/19/2019,2019,3,19, 11 ,9802,1844,1489,13135
3/19/2019,2019,3,19, 12 ,9649,1794,1489,12932
3/19/2019,2019,3,19, 13 ,9671,1780,1490,12941
3/19/2019,2019,3,19, 14 ,10026,1849,1561,13436
3/19/2019,2019,3,19, 15 ,9966,1835,1556,13357
3/19/2019,2019,3,19, 16 ,9897,1819,1545,13261
3/19/2019,2019,3,19, 17 ,9369,1757,1535,12661
3/19/2019,2019,3,19, 18 ,8991,1812,1602,12405
3/19/2019,2019,3,19, 19 ,9312,1833,1583,12728
3/19/2019,2019,3,19, 20 ,9122,1759,1533,12414
3/19/2019,2019,3,19, 21 ,8996,1685,1460,12141
3/19/2019,2019,3,19, 22 ,8654,1555,1336,11545
3/19/2019,2019,3,19, 23 ,8233,1440,1222,10895
3/19/2019,2019,3,19, 24 ,7798,1349,1156,10303
3/20/2019,2019,3,20, 1 ,7441,1346,1107,9894
3/20/2019,2019,3,20, 2 ,7161,1314,1084,9559
3/20/2019,2019,3,20, 3 ,6936,1276,1047,9259
3/20/2019,2019,3,20, 4 ,6821,1262,1060,9143
3/20/2019,2019,3,20, 5 ,6938,1305,1103,9346
3/20/2019,2019,3,20, 6 ,7084,1379,1220,9683
3/20/2019,2019,3,20, 7 ,7197,1325,1134,9656
3/20/2019,2019,3,20, 8 ,7991,1475,1240,10706
3/20/2019,2019,3,20, 9 ,8926,1707,1440,12073
3/20/2019,2019,3,20, 10 ,9484,1837,1589,12910
3/20/2019,2019,3,20, 11 ,9817,1898,1651,13366
3/20/2019,2019,3,20, 12 ,9608,1865,1601,13074
3/20/2019,2019,3,20, 13 ,9647,1853,1601,13101
3/20/2019,2019,3,20, 14 ,10027,1935,1663,13625
3/20/2019,2019,3,20, 15 ,9969,1919,1653,13541
3/20/2019,2019,3,20, 16 ,9838,1882,1637,13357
3/20/2019,2019,3,20, 17 ,9338,1804,1606,12748
3/20/2019,2019,3,20, 18 ,9016,1815,1648,12479
3/20/2019,2019,3,20, 19 ,9366,1906,1634,12906
3/20/2019,2019,3,20, 20 ,9201,1847,1574,12622
3/20/2019,2019,3,20, 21 ,9014,1772,1500,12286
3/20/2019,2019,3,20, 22 ,8672,1665,1385,11722
3/20/2019,2019,3,20, 23 ,8227,1556,1248,11031
3/20/2019,2019,3,20, 24 ,7797,1461,1183,10441
3/21/2019,2019,3,21, 1 ,7472,1392,1122,9986
3/21/2019,2019,3,21, 2 ,7190,1357,1082,9629
3/21/2019,2019,3,21, 3 ,6952,1319,1055,9326
3/21/2019,2019,3,21, 4 ,6829,1285,1057,9171
3/21/2019,2019,3,21, 5 ,6887,1334,1097,9318
3/21/2019,2019,3,21, 6 ,7039,1386,1196,9621
3/21/2019,2019,3,21, 7 ,7079,1334,1118,9531
3/21/2019,2019,3,21, 8 ,8024,1493,1247,10764
3/21/2019,2019,3,21, 9 ,8865,1722,1474,12061
3/21/2019,2019,3,21, 10 ,9411,1851,1578,12840
3/21/2019,2019,3,21, 11 ,9792,1937,1667,13396
3/21/2019,2019,3,21, 12 ,9657,1880,1655,13192
3/21/2019,2019,3,21, 13 ,9643,1894,1661,13198
3/21/2019,2019,3,21, 14 ,10095,1993,1750,13838
3/21/2019,2019,3,21, 15 ,10034,1972,1738,13744
3/21/2019,2019,3,21, 16 ,9926,1949,1709,13584
3/21/2019,2019,3,21, 17 ,9419,1847,1637,12903
3/21/2019,2019,3,21, 18 ,9129,1847,1662,12638
3/21/2019,2019,3,21, 19 ,9451,1950,1695,13096
3/21/2019,2019,3,21, 20 ,9278,1876,1663,12817
3/21/2019,2019,3,21, 21 ,9127,1796,1562,12485
3/21/2019,2019,3,21, 22 ,8813,1673,1461,11947
3/21/2019,2019,3,21, 23 ,8363,1558,1304,11225
3/21/2019,2019,3,21, 24 ,7936,1459,1227,10622
3/22/2019,2019,3,22, 1 ,7532,1407,1154,10093
3/22/2019,2019,3,22, 2 ,7295,1355,1111,9761
3/22/2019,2019,3,22, 3 ,7007,1313,1083,9403
3/22/2019,2019,3,22, 4 ,6863,1294,1060,9217
3/22/2019,2019,3,22, 5 ,6966,1325,1103,9394
3/22/2019,2019,3,22, 6 ,7052,1377,1187,9616
3/22/2019,2019,3,22, 7 ,7166,1334,1123,9623
3/22/2019,2019,3,22, 8 ,7927,1515,1292,10734
3/22/2019,2019,3,22, 9 ,8761,1747,1499,12007
3/22/2019,2019,3,22, 10 ,9370,1871,1638,12879
3/22/2019,2019,3,22, 11 ,9729,1964,1712,13405
3/22/2019,2019,3,22, 12 ,9598,1925,1700,13223
3/22/2019,2019,3,22, 13 ,9621,1931,1735,13287
3/22/2019,2019,3,22, 14 ,10022,2010,1786,13818
3/22/2019,2019,3,22, 15 ,9912,1975,1775,13662
3/22/2019,2019,3,22, 16 ,9768,1932,1698,13398
3/22/2019,2019,3,22, 17 ,9264,1815,1627,12706
3/22/2019,2019,3,22, 18 ,8942,1817,1672,12431
3/22/2019,2019,3,22, 19 ,9295,1925,1711,12931
3/22/2019,2019,3,22, 20 ,9166,1867,1657,12690
3/22/2019,2019,3,22, 21 ,9128,1793,1609,12530
3/22/2019,2019,3,22, 22 ,8753,1667,1501,11921
3/22/2019,2019,3,22, 23 ,8317,1547,1372,11236
3/22/2019,2019,3,22, 24 ,7896,1459,1245,10600
3/23/2019,2019,3,23, 1 ,7624,1391,1211,10226
3/23/2019,2019,3,23, 2 ,7331,1354,1156,9841
3/23/2019,2019,3,23, 3 ,7087,1315,1126,9528
3/23/2019,2019,3,23, 4 ,6899,1275,1113,9287
3/23/2019,2019,3,23, 5 ,6829,1283,1122,9234
3/23/2019,2019,3,23, 6 ,6753,1293,1170,9216
3/23/2019,2019,3,23, 7 ,6764,1316,1178,9258
3/23/2019,2019,3,23, 8 ,7340,1417,1260,10017
3/23/2019,2019,3,23, 9 ,8139,1624,1416,11179
3/23/2019,2019,3,23, 10 ,8758,1730,1523,12011
3/23/2019,2019,3,23, 11 ,9058,1802,1601,12461
3/23/2019,2019,3,23, 12 ,9000,1767,1588,12355
3/23/2019,2019,3,23, 13 ,8916,1771,1602,12289
3/23/2019,2019,3,23, 14 ,9242,1821,1651,12714
3/23/2019,2019,3,23, 15 ,9148,1802,1621,12571
3/23/2019,2019,3,23, 16 ,8911,1722,1592,12225
3/23/2019,2019,3,23, 17 ,8497,1685,1533,11715
3/23/2019,2019,3,23, 18 ,8376,1744,1619,11739
3/23/2019,2019,3,23, 19 ,8784,1853,1674,12311
3/23/2019,2019,3,23, 20 ,8744,1810,1621,12175
3/23/2019,2019,3,23, 21 ,8621,1748,1574,11943
3/23/2019,2019,3,23, 22 ,8332,1653,1501,11486
3/23/2019,2019,3,23, 23 ,7982,1530,1367,10879
3/23/2019,2019,3,23, 24 ,7689,1427,1266,10382
3/24/2019,2019,3,24, 1 ,7285,1367,1213,9865
3/24/2019,2019,3,24, 2 ,7065,1311,1162,9538
3/24/2019,2019,3,24, 3 ,6876,1283,1117,9276
3/24/2019,2019,3,24, 4 ,6669,1252,1089,9010
3/24/2019,2019,3,24, 5 ,6584,1238,1079,8901
3/24/2019,2019,3,24, 6 ,6374,1232,1099,8705
3/24/2019,2019,3,24, 7 ,6374,1243,1081,8698
3/24/2019,2019,3,24, 8 ,6633,1295,1118,9046
3/24/2019,2019,3,24, 9 ,7145,1412,1213,9770
3/24/2019,2019,3,24, 10 ,7602,1491,1307,10400
3/24/2019,2019,3,24, 11 ,7853,1540,1386,10779
3/24/2019,2019,3,24, 12 ,7776,1551,1402,10729
3/24/2019,2019,3,24, 13 ,7736,1547,1411,10694
3/24/2019,2019,3,24, 14 ,7853,1556,1433,10842
3/24/2019,2019,3,24, 15 ,7758,1551,1408,10717
3/24/2019,2019,3,24, 16 ,7662,1534,1371,10567
3/24/2019,2019,3,24, 17 ,7492,1512,1353,10357
3/24/2019,2019,3,24, 18 ,7505,1612,1467,10584
3/24/2019,2019,3,24, 19 ,8146,1748,1537,11431
3/24/2019,2019,3,24, 20 ,8125,1704,1520,11349
3/24/2019,2019,3,24, 21 ,8090,1643,1482,11215
3/24/2019,2019,3,24, 22 ,7824,1529,1372,10725
3/24/2019,2019,3,24, 23 ,7471,1429,1273,10173
3/24/2019,2019,3,24, 24 ,7100,1333,1185,9618
3/25/2019,2019,3,25, 1 ,6783,1269,1137,9189
3/25/2019,2019,3,25, 2 ,6554,1231,1101,8886
3/25/2019,2019,3,25, 3 ,6333,1199,1062,8594
3/25/2019,2019,3,25, 4 ,6269,1196,1052,8517
3/25/2019,2019,3,25, 5 ,6387,1231,1107,8725
3/25/2019,2019,3,25, 6 ,6606,1285,1170,9061
3/25/2019,2019,3,25, 7 ,6837,1275,1165,9277
3/25/2019,2019,3,25, 8 ,7788,1432,1300,10520
3/25/2019,2019,3,25, 9 ,8718,1678,1527,11923
3/25/2019,2019,3,25, 10 ,9384,1812,1687,12883
3/25/2019,2019,3,25, 11 ,9698,1886,1760,13344
3/25/2019,2019,3,25, 12 ,9570,1839,1731,13140
3/25/2019,2019,3,25, 13 ,9578,1850,1739,13167
3/25/2019,2019,3,25, 14 ,9935,1926,1816,13677
3/25/2019,2019,3,25, 15 ,9867,1909,1811,13587
3/25/2019,2019,3,25, 16 ,9757,1892,1768,13417
3/25/2019,2019,3,25, 17 ,9286,1782,1675,12743
3/25/2019,2019,3,25, 18 ,8873,1781,1694,12348
3/25/2019,2019,3,25, 19 ,9251,1857,1707,12815
3/25/2019,2019,3,25, 20 ,9112,1813,1677,12602
3/25/2019,2019,3,25, 21 ,8961,1738,1624,12323
3/25/2019,2019,3,25, 22 ,8607,1612,1505,11724
3/25/2019,2019,3,25, 23 ,8158,1494,1385,11037
3/25/2019,2019,3,25, 24 ,7673,1403,1270,10346
3/26/2019,2019,3,26, 1 ,7326,1322,1223,9871
3/26/2019,2019,3,26, 2 ,7099,1296,1165,9560
3/26/2019,2019,3,26, 3 ,6831,1257,1145,9233
3/26/2019,2019,3,26, 4 ,6737,1241,1117,9095
3/26/2019,2019,3,26, 5 ,6758,1283,1168,9209
3/26/2019,2019,3,26, 6 ,6939,1316,1239,9494
3/26/2019,2019,3,26, 7 ,7066,1307,1146,9519
3/26/2019,2019,3,26, 8 ,7962,1470,1291,10723
3/26/2019,2019,3,26, 9 ,8847,1691,1499,12037
3/26/2019,2019,3,26, 10 ,9446,1799,1630,12875
3/26/2019,2019,3,26, 11 ,9809,1904,1701,13414
3/26/2019,2019,3,26, 12 ,9646,1869,1758,13273
3/26/2019,2019,3,26, 13 ,9647,1884,1774,13305
3/26/2019,2019,3,26, 14 ,10021,1968,1848,13837
3/26/2019,2019,3,26, 15 ,9910,1951,1843,13704
3/26/2019,2019,3,26, 16 ,9785,1945,1803,13533
3/26/2019,2019,3,26, 17 ,9282,1848,1701,12831
3/26/2019,2019,3,26, 18 ,8936,1839,1715,12490
3/26/2019,2019,3,26, 19 ,9240,1927,1741,12908
3/26/2019,2019,3,26, 20 ,9059,1867,1705,12631
3/26/2019,2019,3,26, 21 ,8911,1778,1615,12304
3/26/2019,2019,3,26, 22 ,8591,1654,1530,11775
3/26/2019,2019,3,26, 23 ,8214,1524,1401,11139
3/26/2019,2019,3,26, 24 ,7792,1430,1306,10528
3/27/2019,2019,3,27, 1 ,7487,1364,1249,10100
3/27/2019,2019,3,27, 2 ,7253,1319,1211,9783
3/27/2019,2019,3,27, 3 ,7007,1300,1153,9460
3/27/2019,2019,3,27, 4 ,6913,1284,1143,9340
3/27/2019,2019,3,27, 5 ,6994,1318,1173,9485
3/27/2019,2019,3,27, 6 ,7148,1371,1246,9765
3/27/2019,2019,3,27, 7 ,7238,1338,1201,9777
3/27/2019,2019,3,27, 8 ,8044,1476,1327,10847
3/27/2019,2019,3,27, 9 ,8960,1693,1574,12227
3/27/2019,2019,3,27, 10 ,9521,1810,1726,13057
3/27/2019,2019,3,27, 11 ,9879,1856,1793,13528
3/27/2019,2019,3,27, 12 ,9643,1811,1746,13200
3/27/2019,2019,3,27, 13 ,9651,1794,1758,13203
3/27/2019,2019,3,27, 14 ,10065,1852,1818,13735
3/27/2019,2019,3,27, 15 ,9939,1826,1786,13551
3/27/2019,2019,3,27, 16 ,9813,1811,1766,13390
3/27/2019,2019,3,27, 17 ,9329,1783,1697,12809
3/27/2019,2019,3,27, 18 ,8953,1791,1672,12416
3/27/2019,2019,3,27, 19 ,9319,1842,1693,12854
3/27/2019,2019,3,27, 20 ,9232,1765,1675,12672
3/27/2019,2019,3,27, 21 ,9112,1700,1609,12421
3/27/2019,2019,3,27, 22 ,8787,1572,1489,11848
3/27/2019,2019,3,27, 23 ,8445,1451,1401,11297
3/27/2019,2019,3,27, 24 ,7964,1356,1315,10635
3/28/2019,2019,3,28, 1 ,7602,1315,1253,10170
3/28/2019,2019,3,28, 2 ,7354,1274,1211,9839
3/28/2019,2019,3,28, 3 ,7107,1244,1165,9516
3/28/2019,2019,3,28, 4 ,6974,1228,1141,9343
3/28/2019,2019,3,28, 5 ,7004,1247,1190,9441
3/28/2019,2019,3,28, 6 ,7118,1304,1247,9669
3/28/2019,2019,3,28, 7 ,7289,1294,1200,9783
3/28/2019,2019,3,28, 8 ,8165,1452,1315,10932
3/28/2019,2019,3,28, 9 ,9036,1680,1515,12231
3/28/2019,2019,3,28, 10 ,9677,1817,1648,13142
3/28/2019,2019,3,28, 11 ,9984,1903,1720,13607
3/28/2019,2019,3,28, 12 ,9898,1868,1712,13478
3/28/2019,2019,3,28, 13 ,9869,1882,1714,13465
3/28/2019,2019,3,28, 14 ,10304,1773,1768,13845
3/28/2019,2019,3,28, 15 ,10236,1916,1743,13895
3/28/2019,2019,3,28, 16 ,10147,1920,1723,13790
3/28/2019,2019,3,28, 17 ,9609,1829,1684,13122
3/28/2019,2019,3,28, 18 ,9284,1842,1704,12830
3/28/2019,2019,3,28, 19 ,9617,1949,1704,13270
3/28/2019,2019,3,28, 20 ,9501,1875,1661,13037
3/28/2019,2019,3,28, 21 ,9353,1798,1609,12760
3/28/2019,2019,3,28, 22 ,9070,1681,1474,12225
3/28/2019,2019,3,28, 23 ,8664,1556,1336,11556
3/28/2019,2019,3,28, 24 ,8237,1467,1263,10967
3/29/2019,2019,3,29, 1 ,7880,1398,1211,10489
3/29/2019,2019,3,29, 2 ,7595,1351,1175,10121
3/29/2019,2019,3,29, 3 ,7371,1318,1142,9831
3/29/2019,2019,3,29, 4 ,7197,1290,1120,9607
3/29/2019,2019,3,29, 5 ,7197,1313,1157,9667
3/29/2019,2019,3,29, 6 ,7280,1350,1222,9852
3/29/2019,2019,3,29, 7 ,7451,1337,1187,9975
3/29/2019,2019,3,29, 8 ,8295,1497,1318,11110
3/29/2019,2019,3,29, 9 ,9152,1721,1524,12397
3/29/2019,2019,3,29, 10 ,9813,1848,1606,13267
3/29/2019,2019,3,29, 11 ,10122,1929,1686,13737
3/29/2019,2019,3,29, 12 ,10018,1895,1699,13612
3/29/2019,2019,3,29, 13 ,10036,1898,1748,13682
3/29/2019,2019,3,29, 14 ,10388,1964,1768,14120
3/29/2019,2019,3,29, 15 ,10320,1937,1740,13997
3/29/2019,2019,3,29, 16 ,10182,1915,1738,13835
3/29/2019,2019,3,29, 17 ,9615,1802,1647,13064
3/29/2019,2019,3,29, 18 ,9209,1792,1689,12690
3/29/2019,2019,3,29, 19 ,9610,1891,1716,13217
3/29/2019,2019,3,29, 20 ,9509,1830,1656,12995
3/29/2019,2019,3,29, 21 ,9362,1755,1580,12697
3/29/2019,2019,3,29, 22 ,9077,1627,1486,12190
3/29/2019,2019,3,29, 23 ,8619,1502,1376,11497
3/29/2019,2019,3,29, 24 ,8249,1396,1281,10926
3/30/2019,2019,3,30, 1 ,7854,1348,1198,10400
3/30/2019,2019,3,30, 2 ,7539,1301,1166,10006
3/30/2019,2019,3,30, 3 ,7338,1254,1127,9719
3/30/2019,2019,3,30, 4 ,7182,1212,1106,9500
3/30/2019,2019,3,30, 5 ,7069,1207,1131,9407
3/30/2019,2019,3,30, 6 ,6975,1212,1172,9359
3/30/2019,2019,3,30, 7 ,7008,1234,1170,9412
3/30/2019,2019,3,30, 8 ,7606,1344,1256,10206
3/30/2019,2019,3,30, 9 ,8326,1529,1394,11249
3/30/2019,2019,3,30, 10 ,9057,1637,1561,12255
3/30/2019,2019,3,30, 11 ,9348,1700,1600,12648
3/30/2019,2019,3,30, 12 ,9269,1687,1605,12561
3/30/2019,2019,3,30, 13 ,9219,1676,1638,12533
3/30/2019,2019,3,30, 14 ,9523,1760,1679,12962
3/30/2019,2019,3,30, 15 ,9394,1743,1646,12783
3/30/2019,2019,3,30, 16 ,9153,1694,1600,12447
3/30/2019,2019,3,30, 17 ,8659,1631,1541,11831
3/30/2019,2019,3,30, 18 ,8459,1687,1650,11796
3/30/2019,2019,3,30, 19 ,8931,1802,1647,12380
3/30/2019,2019,3,30, 20 ,8886,1723,1611,12220
3/30/2019,2019,3,30, 21 ,8709,1640,1533,11882
3/30/2019,2019,3,30, 22 ,8578,1568,1472,11618
3/30/2019,2019,3,30, 23 ,8235,1456,1370,11061
3/30/2019,2019,3,30, 24 ,7834,1358,1258,10450
3/31/2019,2019,3,31, 1 ,7479,1291,1202,9972
3/31/2019,2019,3,31, 2 ,7151,1240,1141,9532
3/31/2019,2019,3,31, 3 ,6953,1204,1107,9264
3/31/2019,2019,3,31, 4 ,6747,1174,1086,9007
3/31/2019,2019,3,31, 5 ,6609,1186,1113,8908
3/31/2019,2019,3,31, 6 ,6423,1182,1106,8711
3/31/2019,2019,3,31, 7 ,6377,1201,1096,8674
3/31/2019,2019,3,31, 8 ,6708,1244,1156,9108
3/31/2019,2019,3,31, 9 ,7224,1384,1249,9857
3/31/2019,2019,3,31, 10 ,7693,1483,1339,10515
3/31/2019,2019,3,31, 11 ,8002,1533,1418,10953
3/31/2019,2019,3,31, 12 ,8011,1540,1437,10988
3/31/2019,2019,3,31, 13 ,8068,1556,1437,11061
3/31/2019,2019,3,31, 14 ,8179,1569,1472,11220
3/31/2019,2019,3,31, 15 ,8108,1550,1450,11108
3/31/2019,2019,3,31, 16 ,7931,1523,1426,10880
3/31/2019,2019,3,31, 17 ,7723,1493,1373,10589
3/31/2019,2019,3,31, 18 ,7800,1581,1524,10905
3/31/2019,2019,3,31, 19 ,8450,1724,1604,11778
3/31/2019,2019,3,31, 20 ,8426,1665,1562,11653
3/31/2019,2019,3,31, 21 ,8433,1593,1488,11514
3/31/2019,2019,3,31, 22 ,8224,1495,1392,11111
3/31/2019,2019,3,31, 23 ,7929,1401,1278,10608
3/31/2019,2019,3,31, 24 ,7578,1313,1186,10077
4/1/2019,2019,4,1, 1 ,7203,1241,1104,9548
4/1/2019,2019,4,1, 2 ,6951,1205,1072,9228
4/1/2019,2019,4,1, 3 ,6761,1164,1054,8979
4/1/2019,2019,4,1, 4 ,6586,1163,1014,8763
4/1/2019,2019,4,1, 5 ,6661,1195,1050,8906
4/1/2019,2019,4,1, 6 ,6758,1252,1140,9150
4/1/2019,2019,4,1, 7 ,7038,1271,1120,9429
4/1/2019,2019,4,1, 8 ,8009,1431,1260,10700
4/1/2019,2019,4,1, 9 ,9034,1674,1464,12172
4/1/2019,2019,4,1, 10 ,9609,1821,1619,13049
4/1/2019,2019,4,1, 11 ,9972,1894,1686,13552
4/1/2019,2019,4,1, 12 ,9824,1835,1681,13340
4/1/2019,2019,4,1, 13 ,9818,1859,1693,13370
4/1/2019,2019,4,1, 14 ,10153,1931,1762,13846
4/1/2019,2019,4,1, 15 ,10036,1921,1732,13689
4/1/2019,2019,4,1, 16 ,9848,1884,1714,13446
4/1/2019,2019,4,1, 17 ,9353,1795,1609,12757
4/1/2019,2019,4,1, 18 ,8973,1790,1616,12379
4/1/2019,2019,4,1, 19 ,9326,1884,1662,12872
4/1/2019,2019,4,1, 20 ,9206,1834,1601,12641
4/1/2019,2019,4,1, 21 ,9070,1782,1562,12414
4/1/2019,2019,4,1, 22 ,8753,1658,1430,11841
4/1/2019,2019,4,1, 23 ,8355,1520,1331,11206
4/1/2019,2019,4,1, 24 ,7949,1435,1215,10599
4/2/2019,2019,4,2, 1 ,7558,1370,1168,10096
4/2/2019,2019,4,2, 2 ,7249,1328,1124,9701
4/2/2019,2019,4,2, 3 ,6985,1299,1089,9373
4/2/2019,2019,4,2, 4 ,6853,1279,1068,9200
4/2/2019,2019,4,2, 5 ,6850,1302,1125,9277
4/2/2019,2019,4,2, 6 ,6884,1335,1179,9398
4/2/2019,2019,4,2, 7 ,7088,1342,1155,9585
4/2/2019,2019,4,2, 8 ,7948,1502,1333,10783
4/2/2019,2019,4,2, 9 ,8856,1744,1522,12122
4/2/2019,2019,4,2, 10 ,9314,1845,1640,12799
4/2/2019,2019,4,2, 11 ,9809,1922,1754,13485
4/2/2019,2019,4,2, 12 ,9664,1881,1693,13238
4/2/2019,2019,4,2, 13 ,9673,1902,1702,13277
4/2/2019,2019,4,2, 14 ,10055,1964,1739,13758
4/2/2019,2019,4,2, 15 ,9997,1947,1744,13688
4/2/2019,2019,4,2, 16 ,9871,1914,1697,13482
4/2/2019,2019,4,2, 17 ,9363,1812,1637,12812
4/2/2019,2019,4,2, 18 ,9028,1829,1645,12502
4/2/2019,2019,4,2, 19 ,9342,1917,1667,12926
4/2/2019,2019,4,2, 20 ,9208,1851,1613,12672
4/2/2019,2019,4,2, 21 ,9105,1774,1587,12466
4/2/2019,2019,4,2, 22 ,8814,1664,1452,11930
4/2/2019,2019,4,2, 23 ,8414,1538,1253,11205
4/2/2019,2019,4,2, 24 ,7976,1449,1242,10667
4/3/2019,2019,4,3, 1 ,7655,1381,1194,10230
4/3/2019,2019,4,3, 2 ,7411,1330,1163,9904
4/3/2019,2019,4,3, 3 ,7185,1294,1159,9638
4/3/2019,2019,4,3, 4 ,7047,1271,1151,9469
4/3/2019,2019,4,3, 5 ,7033,1294,1156,9483
4/3/2019,2019,4,3, 6 ,7102,1318,1196,9616
4/3/2019,2019,4,3, 7 ,7316,1332,1212,9860
4/3/2019,2019,4,3, 8 ,8159,1510,1324,10993
4/3/2019,2019,4,3, 9 ,9118,1742,1481,12341
4/3/2019,2019,4,3, 10 ,9666,1879,1623,13168
4/3/2019,2019,4,3, 11 ,9981,1936,1724,13641
4/3/2019,2019,4,3, 12 ,9836,1908,1691,13435
4/3/2019,2019,4,3, 13 ,9766,1917,1685,13368
4/3/2019,2019,4,3, 14 ,10151,1977,1749,13877
4/3/2019,2019,4,3, 15 ,10060,1958,1752,13770
4/3/2019,2019,4,3, 16 ,9910,1935,1733,13578
4/3/2019,2019,4,3, 17 ,9424,1820,1584,12828
4/3/2019,2019,4,3, 18 ,9069,1814,1621,12504
4/3/2019,2019,4,3, 19 ,9385,1906,1687,12978
4/3/2019,2019,4,3, 20 ,9246,1848,1644,12738
4/3/2019,2019,4,3, 21 ,9168,1770,1607,12545
4/3/2019,2019,4,3, 22 ,8937,1659,1485,12081
4/3/2019,2019,4,3, 23 ,8495,1558,1364,11417
4/3/2019,2019,4,3, 24 ,8057,1460,1295,10812
4/4/2019,2019,4,4, 1 ,7738,1406,1237,10381
4/4/2019,2019,4,4, 2 ,7486,1352,1203,10041
4/4/2019,2019,4,4, 3 ,7224,1315,1174,9713
4/4/2019,2019,4,4, 4 ,7055,1293,1148,9496
4/4/2019,2019,4,4, 5 ,7070,1316,1173,9559
4/4/2019,2019,4,4, 6 ,7063,1345,1216,9624
4/4/2019,2019,4,4, 7 ,7343,1358,1226,9927
4/4/2019,2019,4,4, 8 ,8185,1513,1367,11065
4/4/2019,2019,4,4, 9 ,9101,1753,1608,12462
4/4/2019,2019,4,4, 10 ,9668,1875,1700,13243
4/4/2019,2019,4,4, 11 ,10109,1964,1798,13871
4/4/2019,2019,4,4, 12 ,9947,1908,1758,13613
4/4/2019,2019,4,4, 13 ,9987,1919,1773,13679
4/4/2019,2019,4,4, 14 ,10353,2010,1841,14204
4/4/2019,2019,4,4, 15 ,10281,2000,1811,14092
4/4/2019,2019,4,4, 16 ,10178,1976,1786,13940
4/4/2019,2019,4,4, 17 ,9610,1854,1678,13142
4/4/2019,2019,4,4, 18 ,9156,1840,1696,12692
4/4/2019,2019,4,4, 19 ,9551,1912,1720,13183
4/4/2019,2019,4,4, 20 ,9471,1855,1684,13010
4/4/2019,2019,4,4, 21 ,9349,1789,1620,12758
4/4/2019,2019,4,4, 22 ,9043,1673,1510,12226
4/4/2019,2019,4,4, 23 ,8706,1569,1386,11661
4/4/2019,2019,4,4, 24 ,8279,1480,1286,11045
4/5/2019,2019,4,5, 1 ,7973,1412,1233,10618
4/5/2019,2019,4,5, 2 ,7678,1359,1190,10227
4/5/2019,2019,4,5, 3 ,7401,1311,1152,9864
4/5/2019,2019,4,5, 4 ,7261,1291,1131,9683
4/5/2019,2019,4,5, 5 ,7237,1308,1162,9707
4/5/2019,2019,4,5, 6 ,7220,1330,1200,9750
4/5/2019,2019,4,5, 7 ,7417,1342,1205,9964
4/5/2019,2019,4,5, 8 ,8299,1527,1337,11163
4/5/2019,2019,4,5, 9 ,9208,1763,1546,12517
4/5/2019,2019,4,5, 10 ,9763,1902,1663,13328
4/5/2019,2019,4,5, 11 ,10166,1989,1728,13883
4/5/2019,2019,4,5, 12 ,9964,1941,1716,13621
4/5/2019,2019,4,5, 13 ,10063,1949,1750,13762
4/5/2019,2019,4,5, 14 ,10448,2022,1790,14260
4/5/2019,2019,4,5, 15 ,10381,1995,1762,14138
4/5/2019,2019,4,5, 16 ,10188,1978,1741,13907
4/5/2019,2019,4,5, 17 ,9603,1863,1646,13112
4/5/2019,2019,4,5, 18 ,9178,1866,1683,12727
4/5/2019,2019,4,5, 19 ,9537,1961,1726,13224
4/5/2019,2019,4,5, 20 ,9442,1897,1688,13027
4/5/2019,2019,4,5, 21 ,9398,1839,1636,12873
4/5/2019,2019,4,5, 22 ,9135,1737,1541,12413
4/5/2019,2019,4,5, 23 ,8776,1621,1430,11827
4/5/2019,2019,4,5, 24 ,8364,1542,1344,11250
4/6/2019,2019,4,6, 1 ,8083,1487,1274,10844
4/6/2019,2019,4,6, 2 ,7815,1430,1248,10493
4/6/2019,2019,4,6, 3 ,7579,1395,1199,10173
4/6/2019,2019,4,6, 4 ,7361,1365,1176,9902
4/6/2019,2019,4,6, 5 ,7267,1374,1182,9823
4/6/2019,2019,4,6, 6 ,7104,1301,1202,9607
4/6/2019,2019,4,6, 7 ,7152,1308,1175,9635
4/6/2019,2019,4,6, 8 ,7824,1436,1299,10559
4/6/2019,2019,4,6, 9 ,8561,1613,1403,11577
4/6/2019,2019,4,6, 10 ,9081,1747,1524,12352
4/6/2019,2019,4,6, 11 ,9516,1819,1605,12940
4/6/2019,2019,4,6, 12 ,9355,1791,1611,12757
4/6/2019,2019,4,6, 13 ,9415,1802,1648,12865
4/6/2019,2019,4,6, 14 ,9720,1839,1663,13222
4/6/2019,2019,4,6, 15 ,9640,1806,1630,13076
4/6/2019,2019,4,6, 16 ,9424,1778,1559,12761
4/6/2019,2019,4,6, 17 ,9002,1726,1574,12302
4/6/2019,2019,4,6, 18 ,8806,1785,1649,12240
4/6/2019,2019,4,6, 19 ,9338,1869,1659,12866
4/6/2019,2019,4,6, 20 ,9331,1836,1615,12782
4/6/2019,2019,4,6, 21 ,9365,1778,1538,12681
4/6/2019,2019,4,6, 22 ,9100,1692,1468,12260
4/6/2019,2019,4,6, 23 ,8810,1583,1324,11717
4/6/2019,2019,4,6, 24 ,8457,1507,1267,11231
4/7/2019,2019,4,7, 1 ,8109,1435,1230,10774
4/7/2019,2019,4,7, 2 ,7776,1397,1166,10339
4/7/2019,2019,4,7, 3 ,7549,1355,1152,10056
4/7/2019,2019,4,7, 4 ,7281,1323,1124,9728
4/7/2019,2019,4,7, 5 ,7073,1318,1130,9521
4/7/2019,2019,4,7, 6 ,6831,1302,1104,9237
4/7/2019,2019,4,7, 7 ,6763,1303,1114,9180
4/7/2019,2019,4,7, 8 ,7114,1358,1114,9586
4/7/2019,2019,4,7, 9 ,7665,1460,1232,10357
4/7/2019,2019,4,7, 10 ,8164,1565,1324,11053
4/7/2019,2019,4,7, 11 ,8480,1620,1373,11473
4/7/2019,2019,4,7, 12 ,8459,1615,1425,11499
4/7/2019,2019,4,7, 13 ,8601,1639,1432,11672
4/7/2019,2019,4,7, 14 ,8812,1661,1441,11914
4/7/2019,2019,4,7, 15 ,8774,1648,1462,11884
4/7/2019,2019,4,7, 16 ,8631,1617,1425,11673
4/7/2019,2019,4,7, 17 ,8301,1590,1417,11308
4/7/2019,2019,4,7, 18 ,8272,1675,1523,11470
4/7/2019,2019,4,7, 19 ,9012,1836,1595,12443
4/7/2019,2019,4,7, 20 ,9039,1802,1590,12431
4/7/2019,2019,4,7, 21 ,9111,1753,1543,12407
4/7/2019,2019,4,7, 22 ,8943,1675,1449,12067
4/7/2019,2019,4,7, 23 ,8642,1577,1346,11565
4/7/2019,2019,4,7, 24 ,8284,1487,1269,11040
4/8/2019,2019,4,8, 1 ,7931,1422,1216,10569
4/8/2019,2019,4,8, 2 ,7649,1359,1171,10179
4/8/2019,2019,4,8, 3 ,7355,1316,1139,9810
4/8/2019,2019,4,8, 4 ,7176,1301,1114,9591
4/8/2019,2019,4,8, 5 ,7112,1312,1146,9570
4/8/2019,2019,4,8, 6 ,7096,1328,1192,9616
4/8/2019,2019,4,8, 7 ,7379,1347,1195,9921
4/8/2019,2019,4,8, 8 ,8277,1507,1352,11136
4/8/2019,2019,4,8, 9 ,9258,1739,1563,12560
4/8/2019,2019,4,8, 10 ,9921,1848,1698,13467
4/8/2019,2019,4,8, 11 ,10269,1925,1743,13937
4/8/2019,2019,4,8, 12 ,10211,1877,1721,13809
4/8/2019,2019,4,8, 13 ,10213,1873,1712,13798
4/8/2019,2019,4,8, 14 ,10629,1935,1743,14307
4/8/2019,2019,4,8, 15 ,10573,1912,1709,14194
4/8/2019,2019,4,8, 16 ,10409,1921,1706,14036
4/8/2019,2019,4,8, 17 ,9816,1833,1613,13262
4/8/2019,2019,4,8, 18 ,9222,1868,1711,12801
4/8/2019,2019,4,8, 19 ,9624,1924,1697,13245
4/8/2019,2019,4,8, 20 ,9510,1861,1668,13039
4/8/2019,2019,4,8, 21 ,9428,1790,1593,12811
4/8/2019,2019,4,8, 22 ,9216,1678,1480,12374
4/8/2019,2019,4,8, 23 ,8832,1569,1379,11780
4/8/2019,2019,4,8, 24 ,8428,1482,1285,11195
4/9/2019,2019,4,9, 1 ,8106,1427,1217,10750
4/9/2019,2019,4,9, 2 ,7827,1388,1183,10398
4/9/2019,2019,4,9, 3 ,7582,1356,1152,10090
4/9/2019,2019,4,9, 4 ,7367,1338,1133,9838
4/9/2019,2019,4,9, 5 ,7226,1338,1134,9698
4/9/2019,2019,4,9, 6 ,7089,1345,1170,9604
4/9/2019,2019,4,9, 7 ,7065,1355,1167,9587
4/9/2019,2019,4,9, 8 ,7517,1440,1211,10168
4/9/2019,2019,4,9, 9 ,8105,1610,1399,11114
4/9/2019,2019,4,9, 10 ,8741,1716,1535,11992
4/9/2019,2019,4,9, 11 ,9157,1778,1611,12546
4/9/2019,2019,4,9, 12 ,9130,1749,1600,12479
4/9/2019,2019,4,9, 13 ,9220,1750,1603,12573
4/9/2019,2019,4,9, 14 ,9484,1804,1627,12915
4/9/2019,2019,4,9, 15 ,9399,1769,1587,12755
4/9/2019,2019,4,9, 16 ,9248,1721,1559,12528
4/9/2019,2019,4,9, 17 ,8847,1703,1504,12054
4/9/2019,2019,4,9, 18 ,8740,1812,1629,12181
4/9/2019,2019,4,9, 19 ,9416,1881,1625,12922
4/9/2019,2019,4,9, 20 ,9335,1816,1602,12753
4/9/2019,2019,4,9, 21 ,9230,1743,1531,12504
4/9/2019,2019,4,9, 22 ,8877,1637,1396,11910
4/9/2019,2019,4,9, 23 ,8601,1544,1348,11493
4/9/2019,2019,4,9, 24 ,8277,1457,1286,11020
4/10/2019,2019,4,10, 1 ,7895,1417,1204,10516
4/10/2019,2019,4,10, 2 ,7681,1375,1160,10216
4/10/2019,2019,4,10, 3 ,7408,1323,1119,9850
4/10/2019,2019,4,10, 4 ,7267,1317,1111,9695
4/10/2019,2019,4,10, 5 ,7254,1327,1148,9729
4/10/2019,2019,4,10, 6 ,7282,1365,1205,9852
4/10/2019,2019,4,10, 7 ,7620,1390,1218,10228
4/10/2019,2019,4,10, 8 ,8571,1561,1404,11536
4/10/2019,2019,4,10, 9 ,9523,1788,1576,12887
4/10/2019,2019,4,10, 10 ,10086,1889,1727,13702
4/10/2019,2019,4,10, 11 ,10390,1970,1792,14152
4/10/2019,2019,4,10, 12 ,10287,1930,1727,13944
4/10/2019,2019,4,10, 13 ,10283,1919,1706,13908
4/10/2019,2019,4,10, 14 ,10412,1998,1746,14156
4/10/2019,2019,4,10, 15 ,10284,1989,1744,14017
4/10/2019,2019,4,10, 16 ,10238,1960,1732,13930
4/10/2019,2019,4,10, 17 ,10025,1874,1676,13575
4/10/2019,2019,4,10, 18 ,9585,1918,1730,13233
4/10/2019,2019,4,10, 19 ,9954,1958,1547,13459
4/10/2019,2019,4,10, 20 ,9830,1907,1587,13324
4/10/2019,2019,4,10, 21 ,9752,1812,1543,13107
4/10/2019,2019,4,10, 22 ,9522,1712,1434,12668
4/10/2019,2019,4,10, 23 ,9152,1613,1336,12101
4/10/2019,2019,4,10, 24 ,8677,1514,1270,11461
4/11/2019,2019,4,11, 1 ,8365,1453,1226,11044
4/11/2019,2019,4,11, 2 ,8066,1412,1188,10666
4/11/2019,2019,4,11, 3 ,7833,1381,1161,10375
4/11/2019,2019,4,11, 4 ,7647,1365,1142,10154
4/11/2019,2019,4,11, 5 ,7568,1380,1169,10117
4/11/2019,2019,4,11, 6 ,7476,1413,1220,10109
4/11/2019,2019,4,11, 7 ,7755,1435,1226,10416
4/11/2019,2019,4,11, 8 ,8548,1603,1389,11540
4/11/2019,2019,4,11, 9 ,9183,1842,1602,12627
4/11/2019,2019,4,11, 10 ,9611,1960,1736,13307
4/11/2019,2019,4,11, 11 ,9883,2026,1814,13723
4/11/2019,2019,4,11, 12 ,9742,1974,1757,13473
4/11/2019,2019,4,11, 13 ,9804,2002,1782,13588
4/11/2019,2019,4,11, 14 ,10286,2076,1867,14229
4/11/2019,2019,4,11, 15 ,10219,2052,1846,14117
4/11/2019,2019,4,11, 16 ,10082,2032,1764,13878
4/11/2019,2019,4,11, 17 ,9777,1942,1704,13423
4/11/2019,2019,4,11, 18 ,9439,1954,1635,13028
4/11/2019,2019,4,11, 19 ,9686,2013,1750,13449
4/11/2019,2019,4,11, 20 ,9717,1949,1720,13386
4/11/2019,2019,4,11, 21 ,9744,1891,1665,13300
4/11/2019,2019,4,11, 22 ,9552,1786,1542,12880
4/11/2019,2019,4,11, 23 ,9224,1673,1440,12337
4/11/2019,2019,4,11, 24 ,8727,1576,1319,11622
4/12/2019,2019,4,12, 1 ,8390,1520,1262,11172
4/12/2019,2019,4,12, 2 ,8111,1477,1226,10814
4/12/2019,2019,4,12, 3 ,7874,1433,1183,10490
4/12/2019,2019,4,12, 4 ,7683,1404,1180,10267
4/12/2019,2019,4,12, 5 ,7633,1406,1210,10249
4/12/2019,2019,4,12, 6 ,7575,1422,1220,10217
4/12/2019,2019,4,12, 7 ,7802,1431,1233,10466
4/12/2019,2019,4,12, 8 ,8641,1608,1396,11645
4/12/2019,2019,4,12, 9 ,9583,1846,1622,13051
4/12/2019,2019,4,12, 10 ,9846,1966,1740,13552
4/12/2019,2019,4,12, 11 ,9788,2034,1825,13647
4/12/2019,2019,4,12, 12 ,9775,2004,1797,13576
4/12/2019,2019,4,12, 13 ,9842,2026,1812,13680
4/12/2019,2019,4,12, 14 ,9794,2095,1884,13773
4/12/2019,2019,4,12, 15 ,9826,2066,1889,13781
4/12/2019,2019,4,12, 16 ,9803,2050,1814,13667
4/12/2019,2019,4,12, 17 ,9394,1927,1730,13051
4/12/2019,2019,4,12, 18 ,9321,1961,1740,13022
4/12/2019,2019,4,12, 19 ,9495,2015,1763,13273
4/12/2019,2019,4,12, 20 ,9387,1954,1739,13080
4/12/2019,2019,4,12, 21 ,9483,1909,1686,13078
4/12/2019,2019,4,12, 22 ,9383,1805,1548,12736
4/12/2019,2019,4,12, 23 ,8995,1686,1483,12164
4/12/2019,2019,4,12, 24 ,8547,1595,1386,11528
4/13/2019,2019,4,13, 1 ,8276,1509,1323,11108
4/13/2019,2019,4,13, 2 ,7996,1460,1286,10742
4/13/2019,2019,4,13, 3 ,7763,1421,1238,10422
4/13/2019,2019,4,13, 4 ,7553,1402,1206,10161
4/13/2019,2019,4,13, 5 ,7472,1392,1222,10086
4/13/2019,2019,4,13, 6 ,7291,1370,1226,9887
4/13/2019,2019,4,13, 7 ,7340,1377,1194,9911
4/13/2019,2019,4,13, 8 ,8021,1499,1277,10797
4/13/2019,2019,4,13, 9 ,8778,1681,1471,11930
4/13/2019,2019,4,13, 10 ,9350,1808,1600,12758
4/13/2019,2019,4,13, 11 ,9706,1892,1674,13272
4/13/2019,2019,4,13, 12 ,9554,1840,1643,13037
4/13/2019,2019,4,13, 13 ,9637,1844,1632,13113
4/13/2019,2019,4,13, 14 ,9912,1924,1731,13567
4/13/2019,2019,4,13, 15 ,9850,1877,1691,13418
4/13/2019,2019,4,13, 16 ,9595,1797,1663,13055
4/13/2019,2019,4,13, 17 ,9119,1730,1612,12461
4/13/2019,2019,4,13, 18 ,8923,1810,1689,12422
4/13/2019,2019,4,13, 19 ,9418,1935,1727,13080
4/13/2019,2019,4,13, 20 ,9426,1893,1722,13041
4/13/2019,2019,4,13, 21 ,9455,1826,1629,12910
4/13/2019,2019,4,13, 22 ,9234,1755,1545,12534
4/13/2019,2019,4,13, 23 ,8937,1662,1432,12031
4/13/2019,2019,4,13, 24 ,8566,1560,1346,11472
4/14/2019,2019,4,14, 1 ,8235,1490,1258,10983
4/14/2019,2019,4,14, 2 ,7935,1447,1222,10604
4/14/2019,2019,4,14, 3 ,7753,1397,1178,10328
4/14/2019,2019,4,14, 4 ,7575,1359,1142,10076
4/14/2019,2019,4,14, 5 ,7395,1352,1136,9883
4/14/2019,2019,4,14, 6 ,7089,1325,1129,9543
4/14/2019,2019,4,14, 7 ,6978,1327,1122,9427
4/14/2019,2019,4,14, 8 ,7364,1390,1170,9924
4/14/2019,2019,4,14, 9 ,7841,1516,1291,10648
4/14/2019,2019,4,14, 10 ,8339,1625,1412,11376
4/14/2019,2019,4,14, 11 ,8591,1669,1496,11756
4/14/2019,2019,4,14, 12 ,8547,1682,1500,11729
4/14/2019,2019,4,14, 13 ,8694,1687,1520,11901
4/14/2019,2019,4,14, 14 ,8857,1708,1550,12115
4/14/2019,2019,4,14, 15 ,8799,1683,1534,12016
4/14/2019,2019,4,14, 16 ,8612,1656,1492,11760
4/14/2019,2019,4,14, 17 ,8316,1610,1459,11385
4/14/2019,2019,4,14, 18 ,8231,1700,1581,11512
4/14/2019,2019,4,14, 19 ,8852,1839,1656,12347
4/14/2019,2019,4,14, 20 ,8943,1816,1624,12383
4/14/2019,2019,4,14, 21 ,8983,1756,1569,12308
4/14/2019,2019,4,14, 22 ,8850,1663,1489,12002
4/14/2019,2019,4,14, 23 ,8637,1568,1374,11579
4/14/2019,2019,4,14, 24 ,8346,1490,1302,11138
4/15/2019,2019,4,15, 1 ,8021,1429,1237,10687
4/15/2019,2019,4,15, 2 ,7748,1385,1193,10326
4/15/2019,2019,4,15, 3 ,7480,1337,1148,9965
4/15/2019,2019,4,15, 4 ,7355,1316,1128,9799
4/15/2019,2019,4,15, 5 ,7284,1329,1145,9758
4/15/2019,2019,4,15, 6 ,7229,1346,1184,9759
4/15/2019,2019,4,15, 7 ,7511,1385,1191,10087
4/15/2019,2019,4,15, 8 ,8405,1574,1392,11371
4/15/2019,2019,4,15, 9 ,9210,1821,1628,12659
4/15/2019,2019,4,15, 10 ,9727,1943,1782,13452
4/15/2019,2019,4,15, 11 ,9953,2025,1832,13810
4/15/2019,2019,4,15, 12 ,9935,2005,1804,13744
4/15/2019,2019,4,15, 13 ,9860,2012,1820,13692
4/15/2019,2019,4,15, 14 ,10265,2086,1864,14215
4/15/2019,2019,4,15, 15 ,10251,2062,1876,14189
4/15/2019,2019,4,15, 16 ,10164,2041,1814,14019
4/15/2019,2019,4,15, 17 ,9704,1919,1715,13338
4/15/2019,2019,4,15, 18 ,9273,1902,1753,12928
4/15/2019,2019,4,15, 19 ,9731,2011,1779,13521
4/15/2019,2019,4,15, 20 ,9613,1949,1718,13280
4/15/2019,2019,4,15, 21 ,9561,1892,1666,13119
4/15/2019,2019,4,15, 22 ,9319,1776,1461,12556
4/15/2019,2019,4,15, 23 ,8575,1647,1461,11683
4/15/2019,2019,4,15, 24 ,8953,1559,1361,11873
4/16/2019,2019,4,16, 1 ,8236,1487,1290,11013
4/16/2019,2019,4,16, 2 ,7964,1431,1237,10632
4/16/2019,2019,4,16, 3 ,7658,1389,1205,10252
4/16/2019,2019,4,16, 4 ,7475,1370,1166,10011
4/16/2019,2019,4,16, 5 ,7394,1382,1195,9971
4/16/2019,2019,4,16, 6 ,7320,1376,1215,9911
4/16/2019,2019,4,16, 7 ,7537,1389,1216,10142
4/16/2019,2019,4,16, 8 ,8458,1590,1401,11449
4/16/2019,2019,4,16, 9 ,9344,1832,1638,12814
4/16/2019,2019,4,16, 10 ,9930,1946,1760,13636
4/16/2019,2019,4,16, 11 ,10296,2048,1850,14194
4/16/2019,2019,4,16, 12 ,10194,2015,1807,14016
4/16/2019,2019,4,16, 13 ,10214,2002,1839,14055
4/16/2019,2019,4,16, 14 ,10553,2094,1856,14503
4/16/2019,2019,4,16, 15 ,10536,2088,1843,14467
4/16/2019,2019,4,16, 16 ,10413,2056,1798,14267
4/16/2019,2019,4,16, 17 ,9808,1922,1725,13455
4/16/2019,2019,4,16, 18 ,9366,1902,1754,13022
4/16/2019,2019,4,16, 19 ,9722,2013,1758,13493
4/16/2019,2019,4,16, 20 ,9625,1955,1736,13316
4/16/2019,2019,4,16, 21 ,9555,1898,1698,13151
4/16/2019,2019,4,16, 22 ,9450,1791,1582,12823
4/16/2019,2019,4,16, 23 ,9154,1674,1468,12296
4/16/2019,2019,4,16, 24 ,8797,1573,1375,11745
4/17/2019,2019,4,17, 1 ,8467,1494,1264,11225
4/17/2019,2019,4,17, 2 ,8175,1455,1258,10888
4/17/2019,2019,4,17, 3 ,7860,1405,1205,10470
4/17/2019,2019,4,17, 4 ,7651,1379,1186,10216
4/17/2019,2019,4,17, 5 ,7452,1380,1198,10030
4/17/2019,2019,4,17, 6 ,7340,1368,1215,9923
4/17/2019,2019,4,17, 7 ,7519,1395,1223,10137
4/17/2019,2019,4,17, 8 ,8452,1579,1386,11417
4/17/2019,2019,4,17, 9 ,9286,1812,1588,12686
4/17/2019,2019,4,17, 10 ,9736,1937,1756,13429
4/17/2019,2019,4,17, 11 ,10111,2001,1822,13934
4/17/2019,2019,4,17, 12 ,9975,1949,1801,13725
4/17/2019,2019,4,17, 13 ,9892,1936,1798,13626
4/17/2019,2019,4,17, 14 ,10110,2001,1822,13933
4/17/2019,2019,4,17, 15 ,10001,1963,1795,13759
4/17/2019,2019,4,17, 16 ,9662,1922,1744,13328
4/17/2019,2019,4,17, 17 ,9073,1811,1617,12501
4/17/2019,2019,4,17, 18 ,8791,1825,1688,12304
4/17/2019,2019,4,17, 19 ,9212,1910,1731,12853
4/17/2019,2019,4,17, 20 ,9187,1882,1707,12776
4/17/2019,2019,4,17, 21 ,9155,1827,1655,12637
4/17/2019,2019,4,17, 22 ,9049,1722,1549,12320
4/17/2019,2019,4,17, 23 ,8764,1605,1438,11807
4/17/2019,2019,4,17, 24 ,8415,1513,1354,11282
4/18/2019,2019,4,18, 1 ,8018,1432,1267,10717
4/18/2019,2019,4,18, 2 ,7724,1384,1232,10340
4/18/2019,2019,4,18, 3 ,7420,1346,1193,9959
4/18/2019,2019,4,18, 4 ,7194,1300,1165,9659
4/18/2019,2019,4,18, 5 ,6956,1267,1154,9377
4/18/2019,2019,4,18, 6 ,6546,1227,1132,8905
4/18/2019,2019,4,18, 7 ,6288,1220,1121,8629
4/18/2019,2019,4,18, 8 ,6394,1284,1152,8830
4/18/2019,2019,4,18, 9 ,6767,1373,1219,9359
4/18/2019,2019,4,18, 10 ,7061,1453,1269,9783
4/18/2019,2019,4,18, 11 ,7360,1514,1338,10212
4/18/2019,2019,4,18, 12 ,7385,1531,1346,10262
4/18/2019,2019,4,18, 13 ,7492,1540,1350,10382
4/18/2019,2019,4,18, 14 ,7694,1566,1368,10628
4/18/2019,2019,4,18, 15 ,7666,1554,1335,10555
4/18/2019,2019,4,18, 16 ,7442,1502,1304,10248
4/18/2019,2019,4,18, 17 ,7074,1442,1255,9771
4/18/2019,2019,4,18, 18 ,7093,1513,1392,9998
4/18/2019,2019,4,18, 19 ,7682,1678,1440,10800
4/18/2019,2019,4,18, 20 ,7775,1647,1410,10832
4/18/2019,2019,4,18, 21 ,7875,1622,1373,10870
4/18/2019,2019,4,18, 22 ,7913,1570,1305,10788
4/18/2019,2019,4,18, 23 ,7714,1490,1224,10428
4/18/2019,2019,4,18, 24 ,7412,1424,1155,9991
4/19/2019,2019,4,19, 1 ,7062,1354,1111,9527
4/19/2019,2019,4,19, 2 ,6842,1305,1081,9228
4/19/2019,2019,4,19, 3 ,6603,1264,1046,8913
4/19/2019,2019,4,19, 4 ,6369,1242,1021,8632
4/19/2019,2019,4,19, 5 ,6152,1207,1009,8368
4/19/2019,2019,4,19, 6 ,5843,1184,984,8011
4/19/2019,2019,4,19, 7 ,5711,1183,995,7889
4/19/2019,2019,4,19, 8 ,5843,1235,1016,8094
4/19/2019,2019,4,19, 9 ,6005,1267,1028,8300
4/19/2019,2019,4,19, 10 ,6255,1300,1086,8641
4/19/2019,2019,4,19, 11 ,6497,1360,1131,8988
4/19/2019,2019,4,19, 12 ,6523,1342,1133,8998
4/19/2019,2019,4,19, 13 ,6667,1377,1149,9193
4/19/2019,2019,4,19, 14 ,6830,1392,1165,9387
4/19/2019,2019,4,19, 15 ,6823,1382,1151,9356
4/19/2019,2019,4,19, 16 ,6642,1336,1104,9082
4/19/2019,2019,4,19, 17 ,6398,1282,1111,8791
4/19/2019,2019,4,19, 18 ,6360,1364,1228,8952
4/19/2019,2019,4,19, 19 ,7089,1525,1343,9957
4/19/2019,2019,4,19, 20 ,7239,1548,1398,10185
4/19/2019,2019,4,19, 21 ,7522,1548,1381,10451
4/19/2019,2019,4,19, 22 ,7648,1521,1274,10443
4/19/2019,2019,4,19, 23 ,7486,1452,1196,10134
4/19/2019,2019,4,19, 24 ,7255,1386,1149,9790
4/20/2019,2019,4,20, 1 ,6981,1330,1094,9405
4/20/2019,2019,4,20, 2 ,6676,1278,1055,9009
4/20/2019,2019,4,20, 3 ,6420,1227,1036,8683
4/20/2019,2019,4,20, 4 ,6226,1195,1003,8424
4/20/2019,2019,4,20, 5 ,6074,1192,1020,8286
4/20/2019,2019,4,20, 6 ,5861,1182,1021,8064
4/20/2019,2019,4,20, 7 ,5989,1232,1048,8269
4/20/2019,2019,4,20, 8 ,6441,1314,1140,8895
4/20/2019,2019,4,20, 9 ,6989,1451,1282,9722
4/20/2019,2019,4,20, 10 ,7508,1571,1364,10443
4/20/2019,2019,4,20, 11 ,7764,1622,1466,10852
4/20/2019,2019,4,20, 12 ,7791,1629,1482,10902
4/20/2019,2019,4,20, 13 ,7897,1637,1495,11029
4/20/2019,2019,4,20, 14 ,8108,1661,1521,11290
4/20/2019,2019,4,20, 15 ,8078,1643,1494,11215
4/20/2019,2019,4,20, 16 ,7954,1611,1471,11036
4/20/2019,2019,4,20, 17 ,7714,1575,1438,10727
4/20/2019,2019,4,20, 18 ,7653,1664,1566,10883
4/20/2019,2019,4,20, 19 ,8340,1788,1606,11734
4/20/2019,2019,4,20, 20 ,8349,1707,1528,11584
4/20/2019,2019,4,20, 21 ,8347,1683,1524,11554
4/20/2019,2019,4,20, 22 ,8290,1599,1463,11352
4/20/2019,2019,4,20, 23 ,8014,1509,1325,10848
4/20/2019,2019,4,20, 24 ,7693,1455,1254,10402
4/21/2019,2019,4,21, 1 ,7420,1403,1193,10016
4/21/2019,2019,4,21, 2 ,7127,1359,1166,9652
4/21/2019,2019,4,21, 3 ,6830,1318,1138,9286
4/21/2019,2019,4,21, 4 ,6623,1278,1097,8998
4/21/2019,2019,4,21, 5 ,6454,1267,1084,8805
4/21/2019,2019,4,21, 6 ,6136,1233,1090,8459
4/21/2019,2019,4,21, 7 ,6165,1250,1125,8540
4/21/2019,2019,4,21, 8 ,6590,1330,1187,9107
4/21/2019,2019,4,21, 9 ,7237,1463,1256,9956
4/21/2019,2019,4,21, 10 ,7716,1552,1283,10551
4/21/2019,2019,4,21, 11 ,8018,1600,1358,10976
4/21/2019,2019,4,21, 12 ,8047,1591,1409,11047
4/21/2019,2019,4,21, 13 ,8181,1600,1432,11213
4/21/2019,2019,4,21, 14 ,8313,1619,1455,11387
4/21/2019,2019,4,21, 15 ,8377,1616,1438,11431
4/21/2019,2019,4,21, 16 ,8250,1590,1400,11240
4/21/2019,2019,4,21, 17 ,8042,1561,1398,11001
4/21/2019,2019,4,21, 18 ,7991,1647,1502,11140
4/21/2019,2019,4,21, 19 ,8685,1794,1597,12076
4/21/2019,2019,4,21, 20 ,8851,1765,1600,12216
4/21/2019,2019,4,21, 21 ,8977,1716,1522,12215
4/21/2019,2019,4,21, 22 ,8931,1610,1458,11999
4/21/2019,2019,4,21, 23 ,8678,1510,1337,11525
4/21/2019,2019,4,21, 24 ,8304,1435,1264,11003
4/22/2019,2019,4,22, 1 ,8033,1380,1208,10621
4/22/2019,2019,4,22, 2 ,7755,1338,1175,10268
4/22/2019,2019,4,22, 3 ,7528,1297,1132,9957
4/22/2019,2019,4,22, 4 ,7278,1275,1108,9661
4/22/2019,2019,4,22, 5 ,7204,1273,1135,9612
4/22/2019,2019,4,22, 6 ,7130,1279,1166,9575
4/22/2019,2019,4,22, 7 ,7540,1330,1174,10044
4/22/2019,2019,4,22, 8 ,8598,1541,1357,11496
4/22/2019,2019,4,22, 9 ,9470,1788,1605,12863
4/22/2019,2019,4,22, 10 ,10125,1929,1753,13807
4/22/2019,2019,4,22, 11 ,10454,2013,1829,14296
4/22/2019,2019,4,22, 12 ,10480,1970,1794,14244
4/22/2019,2019,4,22, 13 ,10474,1983,1797,14254
4/22/2019,2019,4,22, 14 ,10878,2064,1862,14804
4/22/2019,2019,4,22, 15 ,10837,2058,1839,14734
4/22/2019,2019,4,22, 16 ,10681,2035,1789,14505
4/22/2019,2019,4,22, 17 ,10084,1922,1688,13694
4/22/2019,2019,4,22, 18 ,8212,1889,1711,11812
4/22/2019,2019,4,22, 19 ,8887,2011,1730,12628
4/22/2019,2019,4,22, 20 ,8937,1940,1704,12581
4/22/2019,2019,4,22, 21 ,9043,1884,1691,12618
4/22/2019,2019,4,22, 22 ,8953,1787,1590,12330
4/22/2019,2019,4,22, 23 ,8789,1638,1485,11912
4/22/2019,2019,4,22, 24 ,8502,1556,1366,11424
4/23/2019,2019,4,23, 1 ,8157,1489,1309,10955
4/23/2019,2019,4,23, 2 ,7861,1447,1242,10550
4/23/2019,2019,4,23, 3 ,7636,1403,1220,10259
4/23/2019,2019,4,23, 4 ,7448,1386,1204,10038
4/23/2019,2019,4,23, 5 ,7380,1398,1211,9989
4/23/2019,2019,4,23, 6 ,7304,1396,1234,9934
4/23/2019,2019,4,23, 7 ,7509,1415,1239,10163
4/23/2019,2019,4,23, 8 ,8389,1607,1382,11378
4/23/2019,2019,4,23, 9 ,9250,1853,1640,12743
4/23/2019,2019,4,23, 10 ,9821,1962,1749,13532
4/23/2019,2019,4,23, 11 ,10184,2032,1821,14037
4/23/2019,2019,4,23, 12 ,10084,1979,1788,13851
4/23/2019,2019,4,23, 13 ,10038,2006,1795,13839
4/23/2019,2019,4,23, 14 ,10383,2000,1865,14248
4/23/2019,2019,4,23, 15 ,10306,2015,1877,14198
4/23/2019,2019,4,23, 16 ,10149,1999,1828,13976
4/23/2019,2019,4,23, 17 ,9690,1888,1688,13266
4/23/2019,2019,4,23, 18 ,9239,1871,1757,12867
4/23/2019,2019,4,23, 19 ,9753,1981,1780,13514
4/23/2019,2019,4,23, 20 ,9678,1935,1709,13322
4/23/2019,2019,4,23, 21 ,9648,1890,1674,13212
4/23/2019,2019,4,23, 22 ,9456,1790,1584,12830
4/23/2019,2019,4,23, 23 ,9167,1698,1469,12334
4/23/2019,2019,4,23, 24 ,8784,1603,1355,11742
4/24/2019,2019,4,24, 1 ,8467,1519,1308,11294
4/24/2019,2019,4,24, 2 ,8162,1467,1263,10892
4/24/2019,2019,4,24, 3 ,7919,1441,1219,10579
4/24/2019,2019,4,24, 4 ,7732,1426,1185,10343
4/24/2019,2019,4,24, 5 ,7656,1429,1202,10287
4/24/2019,2019,4,24, 6 ,7569,1433,1233,10235
4/24/2019,2019,4,24, 7 ,7809,1455,1236,10500
4/24/2019,2019,4,24, 8 ,8804,1605,1388,11797
4/24/2019,2019,4,24, 9 ,9623,1858,1663,13144
4/24/2019,2019,4,24, 10 ,10116,1969,1761,13846
4/24/2019,2019,4,24, 11 ,10467,2028,1792,14287
4/24/2019,2019,4,24, 12 ,10379,1987,1779,14145
4/24/2019,2019,4,24, 13 ,10383,2012,1808,14203
4/24/2019,2019,4,24, 14 ,10569,2082,1786,14437
4/24/2019,2019,4,24, 15 ,10816,2065,1735,14616
4/24/2019,2019,4,24, 16 ,10624,2066,1736,14426
4/24/2019,2019,4,24, 17 ,10003,1939,1654,13596
4/24/2019,2019,4,24, 18 ,9572,1915,1675,13162
4/24/2019,2019,4,24, 19 ,9990,2019,1742,13751
4/24/2019,2019,4,24, 20 ,9891,1972,1742,13605
4/24/2019,2019,4,24, 21 ,9903,1920,1714,13537
4/24/2019,2019,4,24, 22 ,9674,1803,1603,13080
4/24/2019,2019,4,24, 23 ,9455,1697,1489,12641
4/24/2019,2019,4,24, 24 ,9079,1604,1396,12079
4/25/2019,2019,4,25, 1 ,8735,1553,1336,11624
4/25/2019,2019,4,25, 2 ,8408,1502,1233,11143
4/25/2019,2019,4,25, 3 ,8155,1459,1239,10853
4/25/2019,2019,4,25, 4 ,7880,1429,1219,10528
4/25/2019,2019,4,25, 5 ,7781,1419,1241,10441
4/25/2019,2019,4,25, 6 ,7537,1414,1266,10217
4/25/2019,2019,4,25, 7 ,7809,1457,1270,10536
4/25/2019,2019,4,25, 8 ,8804,1633,1482,11919
4/25/2019,2019,4,25, 9 ,9623,1867,1623,13113
4/25/2019,2019,4,25, 10 ,10116,1985,1754,13855
4/25/2019,2019,4,25, 11 ,10467,2045,1852,14364
4/25/2019,2019,4,25, 12 ,10379,2032,1820,14231
4/25/2019,2019,4,25, 13 ,10383,2052,1832,14267
4/25/2019,2019,4,25, 14 ,10569,2116,1892,14577
4/25/2019,2019,4,25, 15 ,10624,2092,1841,14557
4/25/2019,2019,4,25, 16 ,9840,2061,1820,13721
4/25/2019,2019,4,25, 17 ,9674,1923,1751,13348
4/25/2019,2019,4,25, 18 ,9413,1914,1778,13105
4/25/2019,2019,4,25, 19 ,9580,2031,1775,13386
4/25/2019,2019,4,25, 20 ,9522,1964,1641,13127
4/25/2019,2019,4,25, 21 ,9554,1913,1568,13035
4/25/2019,2019,4,25, 22 ,9386,1813,1556,12755
4/25/2019,2019,4,25, 23 ,9240,1713,1464,12417
4/25/2019,2019,4,25, 24 ,8907,1620,1379,11906
4/26/2019,2019,4,26, 1 ,8588,1552,1324,11464
4/26/2019,2019,4,26, 2 ,8291,1489,1279,11059
4/26/2019,2019,4,26, 3 ,8007,1457,1249,10713
4/26/2019,2019,4,26, 4 ,7818,1435,1218,10471
4/26/2019,2019,4,26, 5 ,7649,1437,1238,10324
4/26/2019,2019,4,26, 6 ,7534,1436,1245,10215
4/26/2019,2019,4,26, 7 ,7808,1456,1266,10530
4/26/2019,2019,4,26, 8 ,8793,1635,1417,11845
4/26/2019,2019,4,26, 9 ,9695,1877,1580,13152
4/26/2019,2019,4,26, 10 ,10183,2001,1724,13908
4/26/2019,2019,4,26, 11 ,10504,2079,1797,14380
4/26/2019,2019,4,26, 12 ,10403,2043,1783,14229
4/26/2019,2019,4,26, 13 ,10455,2056,1799,14310
4/26/2019,2019,4,26, 14 ,10898,2142,1842,14882
4/26/2019,2019,4,26, 15 ,10812,2130,1814,14756
4/26/2019,2019,4,26, 16 ,10569,2082,1778,14429
4/26/2019,2019,4,26, 17 ,9903,1951,1658,13512
4/26/2019,2019,4,26, 18 ,9437,1924,1717,13078
4/26/2019,2019,4,26, 19 ,9755,2025,1783,13563
4/26/2019,2019,4,26, 20 ,9610,1991,1726,13327
4/26/2019,2019,4,26, 21 ,9659,1941,1678,13278
4/26/2019,2019,4,26, 22 ,9463,1868,1588,12919
4/26/2019,2019,4,26, 23 ,9131,1752,1449,12332
4/26/2019,2019,4,26, 24 ,8775,1645,1358,11778
4/27/2019,2019,4,27, 1 ,8941,1593,1334,11868
4/27/2019,2019,4,27, 2 ,8246,1528,1273,11047
4/27/2019,2019,4,27, 3 ,7924,1491,1240,10655
4/27/2019,2019,4,27, 4 ,7771,1473,1205,10449
4/27/2019,2019,4,27, 5 ,7528,1442,1199,10169
4/27/2019,2019,4,27, 6 ,7323,1406,1222,9951
4/27/2019,2019,4,27, 7 ,7407,1436,1220,10063
4/27/2019,2019,4,27, 8 ,8049,1546,1328,10923
4/27/2019,2019,4,27, 9 ,8791,1743,1500,12034
4/27/2019,2019,4,27, 10 ,9322,1858,1616,12796
4/27/2019,2019,4,27, 11 ,9569,1936,1683,13188
4/27/2019,2019,4,27, 12 ,9516,1896,1665,13077
4/27/2019,2019,4,27, 13 ,9842,1902,1673,13417
4/27/2019,2019,4,27, 14 ,9935,1973,1709,13617
4/27/2019,2019,4,27, 15 ,9842,1915,1692,13449
4/27/2019,2019,4,27, 16 ,9660,1876,1623,13159
4/27/2019,2019,4,27, 17 ,9130,1805,1598,12533
4/27/2019,2019,4,27, 18 ,8796,1849,1663,12308
4/27/2019,2019,4,27, 19 ,9273,1978,1715,12966
4/27/2019,2019,4,27, 20 ,9310,1939,1710,12959
4/27/2019,2019,4,27, 21 ,9279,1864,1563,12706
4/27/2019,2019,4,27, 22 ,9192,1802,1530,12524
4/27/2019,2019,4,27, 23 ,8874,1705,1465,12044
4/27/2019,2019,4,27, 24 ,8521,1625,1329,11475
4/28/2019,2019,4,28, 1 ,8207,1551,1276,11034
4/28/2019,2019,4,28, 2 ,7918,1496,1249,10663
4/28/2019,2019,4,28, 3 ,7628,1448,1222,10298
4/28/2019,2019,4,28, 4 ,7390,1416,1191,9997
4/28/2019,2019,4,28, 5 ,7187,1405,1205,9797
4/28/2019,2019,4,28, 6 ,6854,1356,1194,9404
4/28/2019,2019,4,28, 7 ,6864,1378,1194,9436
4/28/2019,2019,4,28, 8 ,7207,1447,1259,9913
4/28/2019,2019,4,28, 9 ,7752,1566,1333,10651
4/28/2019,2019,4,28, 10 ,8246,1669,1442,11357
4/28/2019,2019,4,28, 11 ,8518,1718,1516,11752
4/28/2019,2019,4,28, 12 ,8516,1732,1521,11769
4/28/2019,2019,4,28, 13 ,8635,1728,1515,11878
4/28/2019,2019,4,28, 14 ,8793,1748,1544,12085
4/28/2019,2019,4,28, 15 ,8729,1716,1513,11958
4/28/2019,2019,4,28, 16 ,8518,1667,1467,11652
4/28/2019,2019,4,28, 17 ,8311,1670,1422,11403
4/28/2019,2019,4,28, 18 ,8284,1768,1589,11641
4/28/2019,2019,4,28, 19 ,8893,1906,1641,12440
4/28/2019,2019,4,28, 20 ,8986,1881,1618,12485
4/28/2019,2019,4,28, 21 ,9074,1833,1589,12496
4/28/2019,2019,4,28, 22 ,9041,1771,1477,12289
4/28/2019,2019,4,28, 23 ,8861,1690,1400,11951
4/28/2019,2019,4,28, 24 ,8486,1587,1326,11399
4/29/2019,2019,4,29, 1 ,8176,1529,1247,10952
4/29/2019,2019,4,29, 2 ,7750,1469,1201,10420
4/29/2019,2019,4,29, 3 ,7599,1429,1170,10198
4/29/2019,2019,4,29, 4 ,7405,1397,1140,9942
4/29/2019,2019,4,29, 5 ,7270,1405,1157,9832
4/29/2019,2019,4,29, 6 ,7257,1407,1195,9859
4/29/2019,2019,4,29, 7 ,7632,1457,1204,10293
4/29/2019,2019,4,29, 8 ,8623,1659,1419,11701
4/29/2019,2019,4,29, 9 ,9544,1904,1582,13030
4/29/2019,2019,4,29, 10 ,10042,2035,1707,13784
4/29/2019,2019,4,29, 11 ,10420,2119,1815,14354
4/29/2019,2019,4,29, 12 ,10393,2067,1824,14284
4/29/2019,2019,4,29, 13 ,10337,2078,1855,14270
4/29/2019,2019,4,29, 14 ,10553,2137,1915,14605
4/29/2019,2019,4,29, 15 ,10445,2126,1896,14467
4/29/2019,2019,4,29, 16 ,10428,2088,1871,14387
4/29/2019,2019,4,29, 17 ,9973,1956,1763,13692
4/29/2019,2019,4,29, 18 ,9418,1970,1759,13147
4/29/2019,2019,4,29, 19 ,9797,2058,1778,13633
4/29/2019,2019,4,29, 20 ,9650,2013,1732,13395
4/29/2019,2019,4,29, 21 ,9598,1964,1681,13243
4/29/2019,2019,4,29, 22 ,9536,1873,1561,12970
4/29/2019,2019,4,29, 23 ,9187,1776,1458,12421
4/29/2019,2019,4,29, 24 ,8848,1682,1361,11891
4/30/2019,2019,4,30, 1 ,8438,1606,1299,11343
4/30/2019,2019,4,30, 2 ,8217,1554,1254,11025
4/30/2019,2019,4,30, 3 ,7838,1503,1217,10558
4/30/2019,2019,4,30, 4 ,7663,1468,1197,10328
4/30/2019,2019,4,30, 5 ,7543,1470,1210,10223
4/30/2019,2019,4,30, 6 ,7422,1462,1236,10120
4/30/2019,2019,4,30, 7 ,7714,1480,1238,10432
4/30/2019,2019,4,30, 8 ,8580,1659,1401,11640
4/30/2019,2019,4,30, 9 ,9547,1897,1630,13074
4/30/2019,2019,4,30, 10 ,10063,2009,1759,13831
4/30/2019,2019,4,30, 11 ,10369,2091,1847,14307
4/30/2019,2019,4,30, 12 ,10298,2050,1799,14147
4/30/2019,2019,4,30, 13 ,10342,2076,1836,14254
4/30/2019,2019,4,30, 14 ,10703,2139,1860,14702
4/30/2019,2019,4,30, 15 ,10649,2120,1839,14608
4/30/2019,2019,4,30, 16 ,10470,2087,1785,14342
4/30/2019,2019,4,30, 17 ,9899,1941,1688,13528
4/30/2019,2019,4,30, 18 ,9442,1957,1743,13142
4/30/2019,2019,4,30, 19 ,9843,2062,1762,13667
4/30/2019,2019,4,30, 20 ,9826,2017,1713,13556
4/30/2019,2019,4,30, 21 ,9739,1917,1666,13322
4/30/2019,2019,4,30, 22 ,9583,1870,1572,13025
4/30/2019,2019,4,30, 23 ,9313,1760,1465,12538
4/30/2019,2019,4,30, 24 ,8986,1667,1370,12023
5/1/2019,2019,5,1, 1 ,8610,1614,1293,11517
5/1/2019,2019,5,1, 2 ,8336,1567,1244,11147
5/1/2019,2019,5,1, 3 ,8037,1526,1231,10794
5/1/2019,2019,5,1, 4 ,7789,1486,1178,10453
5/1/2019,2019,5,1, 5 ,7565,1479,1159,10203
5/1/2019,2019,5,1, 6 ,7224,1437,1183,9844
5/1/2019,2019,5,1, 7 ,7160,1439,1153,9752
5/1/2019,2019,5,1, 8 ,7522,1518,1207,10247
5/1/2019,2019,5,1, 9 ,8085,1644,1367,11096
5/1/2019,2019,5,1, 10 ,8669,1733,1462,11864
5/1/2019,2019,5,1, 11 ,8984,1795,1557,12336
5/1/2019,2019,5,1, 12 ,8957,1806,1567,12330
5/1/2019,2019,5,1, 13 ,9046,1821,1555,12422
5/1/2019,2019,5,1, 14 ,9294,1856,1563,12713
5/1/2019,2019,5,1, 15 ,9298,1822,1541,12661
5/1/2019,2019,5,1, 16 ,9080,1806,1491,12377
5/1/2019,2019,5,1, 17 ,8717,1767,1493,11977
5/1/2019,2019,5,1, 18 ,8589,1845,1529,11963
5/1/2019,2019,5,1, 19 ,9295,1961,1554,12810
5/1/2019,2019,5,1, 20 ,9365,1942,1506,12813
5/1/2019,2019,5,1, 21 ,9505,1909,1478,12892
5/1/2019,2019,5,1, 22 ,9353,1821,1367,12541
5/1/2019,2019,5,1, 23 ,9081,1712,1269,12062
5/1/2019,2019,5,1, 24 ,8728,1615,1149,11492
5/2/2019,2019,5,2, 1 ,8408,1559,1175,11142
5/2/2019,2019,5,2, 2 ,8085,1517,1130,10732
5/2/2019,2019,5,2, 3 ,7832,1467,1116,10415
5/2/2019,2019,5,2, 4 ,7669,1443,1106,10218
5/2/2019,2019,5,2, 5 ,7536,1441,1134,10111
5/2/2019,2019,5,2, 6 ,7433,1440,1172,10045
5/2/2019,2019,5,2, 7 ,7808,1471,1147,10426
5/2/2019,2019,5,2, 8 ,8862,1664,1365,11891
5/2/2019,2019,5,2, 9 ,9813,1922,1567,13302
5/2/2019,2019,5,2, 10 ,10355,2061,1696,14112
5/2/2019,2019,5,2, 11 ,10702,2137,1788,14627
5/2/2019,2019,5,2, 12 ,10635,2108,1771,14514
5/2/2019,2019,5,2, 13 ,10691,2117,1797,14605
5/2/2019,2019,5,2, 14 ,11074,2197,1867,15138
5/2/2019,2019,5,2, 15 ,10962,2138,1787,14887
5/2/2019,2019,5,2, 16 ,10680,2135,1760,14575
5/2/2019,2019,5,2, 17 ,10130,2013,1711,13854
5/2/2019,2019,5,2, 18 ,9636,1990,1718,13344
5/2/2019,2019,5,2, 19 ,10047,2108,1771,13926
5/2/2019,2019,5,2, 20 ,10021,2068,1733,13822
5/2/2019,2019,5,2, 21 ,9958,2002,1697,13657
5/2/2019,2019,5,2, 22 ,9817,1898,1574,13289
5/2/2019,2019,5,2, 23 ,9348,1791,1463,12602
5/2/2019,2019,5,2, 24 ,8859,1696,1353,11908
5/3/2019,2019,5,3, 1 ,8585,1630,1287,11502
5/3/2019,2019,5,3, 2 ,8380,1573,1246,11199
5/3/2019,2019,5,3, 3 ,8061,1533,1216,10810
5/3/2019,2019,5,3, 4 ,7851,1504,1202,10557
5/3/2019,2019,5,3, 5 ,7767,1504,1217,10488
5/3/2019,2019,5,3, 6 ,7613,1484,1234,10331
5/3/2019,2019,5,3, 7 ,7925,1509,1242,10676
5/3/2019,2019,5,3, 8 ,8869,1672,1406,11947
5/3/2019,2019,5,3, 9 ,9748,1928,1607,13283
5/3/2019,2019,5,3, 10 ,10322,2042,1714,14078
5/3/2019,2019,5,3, 11 ,10573,2114,1803,14490
5/3/2019,2019,5,3, 12 ,10414,2062,1811,14287
5/3/2019,2019,5,3, 13 ,10444,2082,1793,14319
5/3/2019,2019,5,3, 14 ,10622,2159,1869,14650
5/3/2019,2019,5,3, 15 ,10513,2149,1865,14527
5/3/2019,2019,5,3, 16 ,10349,2115,1812,14276
5/3/2019,2019,5,3, 17 ,9987,1993,1665,13645
5/3/2019,2019,5,3, 18 ,9595,1984,1699,13278
5/3/2019,2019,5,3, 19 ,9898,2089,1778,13765
5/3/2019,2019,5,3, 20 ,9833,2045,1722,13600
5/3/2019,2019,5,3, 21 ,9823,2018,1696,13537
5/3/2019,2019,5,3, 22 ,9565,1893,1584,13042
5/3/2019,2019,5,3, 23 ,9287,1790,1487,12564
5/3/2019,2019,5,3, 24 ,8943,1693,1349,11985
5/4/2019,2019,5,4, 1 ,8597,1625,1281,11503
5/4/2019,2019,5,4, 2 ,8380,1581,1233,11194
5/4/2019,2019,5,4, 3 ,8088,1537,1148,10773
5/4/2019,2019,5,4, 4 ,7805,1499,1172,10476
5/4/2019,2019,5,4, 5 ,7679,1489,1188,10356
5/4/2019,2019,5,4, 6 ,7401,1450,1187,10038
5/4/2019,2019,5,4, 7 ,7576,1466,1167,10209
5/4/2019,2019,5,4, 8 ,8133,1585,1327,11045
5/4/2019,2019,5,4, 9 ,8865,1781,1495,12141
5/4/2019,2019,5,4, 10 ,9463,1892,1618,12973
5/4/2019,2019,5,4, 11 ,9759,1969,1687,13415
5/4/2019,2019,5,4, 12 ,9549,1948,1696,13193
5/4/2019,2019,5,4, 13 ,9478,1948,1720,13146
5/4/2019,2019,5,4, 14 ,9736,2003,1744,13483
5/4/2019,2019,5,4, 15 ,9617,1979,1683,13279
5/4/2019,2019,5,4, 16 ,9398,1895,1687,12980
5/4/2019,2019,5,4, 17 ,8947,1824,1570,12341
5/4/2019,2019,5,4, 18 ,8726,1883,1646,12255
5/4/2019,2019,5,4, 19 ,9321,1997,1712,13030
5/4/2019,2019,5,4, 20 ,9319,1962,1720,13001
5/4/2019,2019,5,4, 21 ,9390,1922,1693,13005
5/4/2019,2019,5,4, 22 ,9322,1862,1538,12722
5/4/2019,2019,5,4, 23 ,8970,1738,1444,12152
5/4/2019,2019,5,4, 24 ,8662,1651,1340,11653
5/5/2019,2019,5,5, 1 ,8396,1575,1227,11198
5/5/2019,2019,5,5, 2 ,8081,1528,1187,10796
5/5/2019,2019,5,5, 3 ,7804,1463,1143,10410
5/5/2019,2019,5,5, 4 ,7607,1430,1104,10141
5/5/2019,2019,5,5, 5 ,7489,1415,1105,10009
5/5/2019,2019,5,5, 6 ,7080,1371,1092,9543
5/5/2019,2019,5,5, 7 ,7019,1395,1139,9553
5/5/2019,2019,5,5, 8 ,7404,1459,1170,10033
5/5/2019,2019,5,5, 9 ,7922,1590,1263,10775
5/5/2019,2019,5,5, 10 ,8323,1690,1396,11409
5/5/2019,2019,5,5, 11 ,8708,1730,1482,11920
5/5/2019,2019,5,5, 12 ,8614,1741,1510,11865
5/5/2019,2019,5,5, 13 ,8670,1745,1539,11954
5/5/2019,2019,5,5, 14 ,8749,1760,1549,12058
5/5/2019,2019,5,5, 15 ,8721,1772,1533,12026
5/5/2019,2019,5,5, 16 ,8497,1726,1500,11723
5/5/2019,2019,5,5, 17 ,8253,1703,1461,11417
5/5/2019,2019,5,5, 18 ,8357,1777,1564,11698
5/5/2019,2019,5,5, 19 ,8921,1946,1610,12477
5/5/2019,2019,5,5, 20 ,9018,1929,1605,12552
5/5/2019,2019,5,5, 21 ,9106,1894,1547,12547
5/5/2019,2019,5,5, 22 ,9033,1797,1499,12329
5/5/2019,2019,5,5, 23 ,8851,1710,1398,11959
5/5/2019,2019,5,5, 24 ,8450,1617,1304,11371
5/6/2019,2019,5,6, 1 ,8217,1543,1254,11014
5/6/2019,2019,5,6, 2 ,7931,1491,1215,10637
5/6/2019,2019,5,6, 3 ,7598,1431,1177,10206
5/6/2019,2019,5,6, 4 ,7424,1405,1137,9966
5/6/2019,2019,5,6, 5 ,7317,1415,1146,9878
5/6/2019,2019,5,6, 6 ,7319,1406,1158,9883
5/6/2019,2019,5,6, 7 ,7771,1462,1191,10424
5/6/2019,2019,5,6, 8 ,8778,1680,1384,11842
5/6/2019,2019,5,6, 9 ,9750,1937,1651,13338
5/6/2019,2019,5,6, 10 ,10169,2074,1784,14027
5/6/2019,2019,5,6, 11 ,10390,2150,1871,14411
5/6/2019,2019,5,6, 12 ,10236,2118,1808,14162
5/6/2019,2019,5,6, 13 ,10093,2107,1866,14066
5/6/2019,2019,5,6, 14 ,10279,2158,1935,14372
5/6/2019,2019,5,6, 15 ,10152,2138,1923,14213
5/6/2019,2019,5,6, 16 ,10032,2136,1927,14095
5/6/2019,2019,5,6, 17 ,9706,2021,1805,13532
5/6/2019,2019,5,6, 18 ,9349,2018,1788,13155
5/6/2019,2019,5,6, 19 ,9593,2091,1834,13518
5/6/2019,2019,5,6, 20 ,9605,2060,1794,13459
5/6/2019,2019,5,6, 21 ,9501,2009,1745,13255
5/6/2019,2019,5,6, 22 ,9276,1902,1621,12799
5/6/2019,2019,5,6, 23 ,8896,1800,1519,12215
5/6/2019,2019,5,6, 24 ,8522,1690,1413,11625
5/7/2019,2019,5,7, 1 ,8200,1608,1328,11136
5/7/2019,2019,5,7, 2 ,7941,1564,1291,10796
5/7/2019,2019,5,7, 3 ,7729,1529,1257,10515
5/7/2019,2019,5,7, 4 ,7564,1483,1221,10268
5/7/2019,2019,5,7, 5 ,7509,1499,1219,10227
5/7/2019,2019,5,7, 6 ,7425,1475,1228,10128
5/7/2019,2019,5,7, 7 ,7773,1514,1259,10546
5/7/2019,2019,5,7, 8 ,8680,1712,1463,11855
5/7/2019,2019,5,7, 9 ,9508,1953,1678,13139
5/7/2019,2019,5,7, 10 ,10044,2073,1811,13928
5/7/2019,2019,5,7, 11 ,10439,2146,1923,14508
5/7/2019,2019,5,7, 12 ,10311,2122,1897,14330
5/7/2019,2019,5,7, 13 ,10157,2124,1906,14187
5/7/2019,2019,5,7, 14 ,10373,2173,1912,14458
5/7/2019,2019,5,7, 15 ,10184,2176,1928,14288
5/7/2019,2019,5,7, 16 ,10017,2094,1929,14040
5/7/2019,2019,5,7, 17 ,9588,2002,1800,13390
5/7/2019,2019,5,7, 18 ,9375,1999,1821,13195
5/7/2019,2019,5,7, 19 ,9607,2074,1810,13491
5/7/2019,2019,5,7, 20 ,9563,2039,1815,13417
5/7/2019,2019,5,7, 21 ,9480,2004,1768,13252
5/7/2019,2019,5,7, 22 ,9301,1893,1657,12851
5/7/2019,2019,5,7, 23 ,8943,1786,1566,12295
5/7/2019,2019,5,7, 24 ,8555,1676,1460,11691
5/8/2019,2019,5,8, 1 ,8237,1605,1380,11222
5/8/2019,2019,5,8, 2 ,7922,1560,1350,10832
5/8/2019,2019,5,8, 3 ,7673,1506,1315,10494
5/8/2019,2019,5,8, 4 ,7536,1487,1266,10289
5/8/2019,2019,5,8, 5 ,7469,1494,1266,10229
5/8/2019,2019,5,8, 6 ,7435,1479,1272,10186
5/8/2019,2019,5,8, 7 ,7765,1513,1264,10542
5/8/2019,2019,5,8, 8 ,8659,1708,1455,11822
5/8/2019,2019,5,8, 9 ,9521,1956,1724,13201
5/8/2019,2019,5,8, 10 ,10157,2087,1835,14079
5/8/2019,2019,5,8, 11 ,10407,2168,1928,14503
5/8/2019,2019,5,8, 12 ,10147,2110,1940,14197
5/8/2019,2019,5,8, 13 ,10073,2114,1958,14145
5/8/2019,2019,5,8, 14 ,10486,2175,2013,14674
5/8/2019,2019,5,8, 15 ,10438,2170,1931,14539
5/8/2019,2019,5,8, 16 ,10271,2148,1922,14341
5/8/2019,2019,5,8, 17 ,9842,2005,1844,13691
5/8/2019,2019,5,8, 18 ,9397,2027,1856,13280
5/8/2019,2019,5,8, 19 ,9564,2099,1880,13543
5/8/2019,2019,5,8, 20 ,9376,2066,1849,13291
5/8/2019,2019,5,8, 21 ,9213,2018,1840,13071
5/8/2019,2019,5,8, 22 ,8908,1916,1728,12552
5/8/2019,2019,5,8, 23 ,8527,1802,1683,12012
5/8/2019,2019,5,8, 24 ,8218,1708,1507,11433
5/9/2019,2019,5,9, 1 ,7903,1642,1437,10982
5/9/2019,2019,5,9, 2 ,7659,1586,1372,10617
5/9/2019,2019,5,9, 3 ,7446,1543,1362,10351
5/9/2019,2019,5,9, 4 ,7274,1520,1319,10113
5/9/2019,2019,5,9, 5 ,7259,1525,1305,10089
5/9/2019,2019,5,9, 6 ,7218,1506,1301,10025
5/9/2019,2019,5,9, 7 ,7551,1520,1309,10380
5/9/2019,2019,5,9, 8 ,8514,1714,1467,11695
5/9/2019,2019,5,9, 9 ,9424,1958,1710,13092
5/9/2019,2019,5,9, 10 ,10055,2082,1855,13992
5/9/2019,2019,5,9, 11 ,10419,2147,1948,14514
5/9/2019,2019,5,9, 12 ,10350,2091,1937,14378
5/9/2019,2019,5,9, 13 ,10252,2078,1968,14298
5/9/2019,2019,5,9, 14 ,10519,2091,1983,14593
5/9/2019,2019,5,9, 15 ,10408,2067,1954,14429
5/9/2019,2019,5,9, 16 ,10235,2046,1746,14027
5/9/2019,2019,5,9, 17 ,9740,1968,1807,13515
5/9/2019,2019,5,9, 18 ,9490,1998,1821,13309
5/9/2019,2019,5,9, 19 ,9786,2046,1799,13631
5/9/2019,2019,5,9, 20 ,9715,1983,1701,13399
5/9/2019,2019,5,9, 21 ,9575,1934,1667,13176
5/9/2019,2019,5,9, 22 ,9247,1802,1593,12642
5/9/2019,2019,5,9, 23 ,8932,1696,1547,12175
5/9/2019,2019,5,9, 24 ,8539,1617,1566,11722
5/10/2019,2019,5,10, 1 ,8151,1555,1340,11046
5/10/2019,2019,5,10, 2 ,7879,1501,1307,10687
5/10/2019,2019,5,10, 3 ,7572,1459,1289,10320
5/10/2019,2019,5,10, 4 ,7375,1436,1249,10060
5/10/2019,2019,5,10, 5 ,7332,1436,1251,10019
5/10/2019,2019,5,10, 6 ,7279,1427,1248,9954
5/10/2019,2019,5,10, 7 ,7593,1474,1278,10345
5/10/2019,2019,5,10, 8 ,8443,1679,1407,11529
5/10/2019,2019,5,10, 9 ,9444,1943,1716,13103
5/10/2019,2019,5,10, 10 ,9990,2063,1834,13887
5/10/2019,2019,5,10, 11 ,10365,2132,1903,14400
5/10/2019,2019,5,10, 12 ,10219,2089,1883,14191
5/10/2019,2019,5,10, 13 ,10263,2105,1887,14255
5/10/2019,2019,5,10, 14 ,10593,2180,1934,14707
5/10/2019,2019,5,10, 15 ,10476,2157,1889,14522
5/10/2019,2019,5,10, 16 ,10217,2127,1800,14144
5/10/2019,2019,5,10, 17 ,9744,2004,1716,13464
5/10/2019,2019,5,10, 18 ,9371,1985,1717,13073
5/10/2019,2019,5,10, 19 ,9682,2064,1695,13441
5/10/2019,2019,5,10, 20 ,9606,2024,1707,13337
5/10/2019,2019,5,10, 21 ,9467,1981,1660,13108
5/10/2019,2019,5,10, 22 ,9328,1872,1578,12778
5/10/2019,2019,5,10, 23 ,8975,1760,1449,12184
5/10/2019,2019,5,10, 24 ,8652,1673,1366,11691
5/11/2019,2019,5,11, 1 ,8344,1605,1296,11245
5/11/2019,2019,5,11, 2 ,8046,1559,1258,10863
5/11/2019,2019,5,11, 3 ,7737,1514,1234,10485
5/11/2019,2019,5,11, 4 ,7525,1476,1192,10193
5/11/2019,2019,5,11, 5 ,7420,1471,1199,10090
5/11/2019,2019,5,11, 6 ,7205,1433,1188,9826
5/11/2019,2019,5,11, 7 ,7351,1464,1182,9997
5/11/2019,2019,5,11, 8 ,8008,1607,1299,10914
5/11/2019,2019,5,11, 9 ,8823,1805,1534,12162
5/11/2019,2019,5,11, 10 ,9351,1927,1644,12922
5/11/2019,2019,5,11, 11 ,9692,2006,1722,13420
5/11/2019,2019,5,11, 12 ,9549,1960,1701,13210
5/11/2019,2019,5,11, 13 ,9528,1955,1707,13190
5/11/2019,2019,5,11, 14 ,9736,1961,1764,13461
5/11/2019,2019,5,11, 15 ,9502,1951,1700,13153
5/11/2019,2019,5,11, 16 ,9246,1900,1693,12839
5/11/2019,2019,5,11, 17 ,8858,1843,1586,12287
5/11/2019,2019,5,11, 18 ,8726,1897,1689,12312
5/11/2019,2019,5,11, 19 ,9150,1998,1721,12869
5/11/2019,2019,5,11, 20 ,9170,1966,1696,12832
5/11/2019,2019,5,11, 21 ,9149,1929,1671,12749
5/11/2019,2019,5,11, 22 ,8977,1858,1594,12429
5/11/2019,2019,5,11, 23 ,8709,1750,1502,11961
5/11/2019,2019,5,11, 24 ,8328,1657,1396,11381
5/12/2019,2019,5,12, 1 ,8019,1582,1327,10928
5/12/2019,2019,5,12, 2 ,7707,1541,1290,10538
5/12/2019,2019,5,12, 3 ,7440,1486,1258,10184
5/12/2019,2019,5,12, 4 ,7185,1450,1199,9834
5/12/2019,2019,5,12, 5 ,7058,1433,1182,9673
5/12/2019,2019,5,12, 6 ,6746,1380,1232,9358
5/12/2019,2019,5,12, 7 ,6766,1397,1167,9330
5/12/2019,2019,5,12, 8 ,7251,1475,1210,9936
5/12/2019,2019,5,12, 9 ,7786,1609,1321,10716
5/12/2019,2019,5,12, 10 ,8303,1711,1419,11433
5/12/2019,2019,5,12, 11 ,8538,1774,1478,11790
5/12/2019,2019,5,12, 12 ,8492,1782,1484,11758
5/12/2019,2019,5,12, 13 ,8471,1798,1444,11713
5/12/2019,2019,5,12, 14 ,8618,1821,1496,11935
5/12/2019,2019,5,12, 15 ,8580,1786,1471,11837
5/12/2019,2019,5,12, 16 ,8301,1751,1444,11496
5/12/2019,2019,5,12, 17 ,8096,1715,1437,11248
5/12/2019,2019,5,12, 18 ,8122,1790,1532,11444
5/12/2019,2019,5,12, 19 ,8702,1936,1634,12272
5/12/2019,2019,5,12, 20 ,8751,1911,1601,12263
5/12/2019,2019,5,12, 21 ,8859,1873,1577,12309
5/12/2019,2019,5,12, 22 ,8699,1821,1480,12000
5/12/2019,2019,5,12, 23 ,8526,1721,1389,11636
5/12/2019,2019,5,12, 24 ,8083,1635,1296,11014
5/13/2019,2019,5,13, 1 ,7811,1566,1250,10627
5/13/2019,2019,5,13, 2 ,7464,1517,1202,10183
5/13/2019,2019,5,13, 3 ,7233,1464,1124,9821
5/13/2019,2019,5,13, 4 ,7010,1441,1129,9580
5/13/2019,2019,5,13, 5 ,6853,1439,1138,9430
5/13/2019,2019,5,13, 6 ,6483,1386,1090,8959
5/13/2019,2019,5,13, 7 ,6442,1362,1054,8858
5/13/2019,2019,5,13, 8 ,6718,1397,1083,9198
5/13/2019,2019,5,13, 9 ,7035,1477,1171,9683
5/13/2019,2019,5,13, 10 ,7376,1538,1262,10176
5/13/2019,2019,5,13, 11 ,7846,1635,1356,10837
5/13/2019,2019,5,13, 12 ,8045,1690,1419,11154
5/13/2019,2019,5,13, 13 ,8226,1726,1457,11409
5/13/2019,2019,5,13, 14 ,8448,1718,1476,11642
5/13/2019,2019,5,13, 15 ,8390,1717,1464,11571
5/13/2019,2019,5,13, 16 ,8221,1696,1450,11367
5/13/2019,2019,5,13, 17 ,7988,1651,1418,11057
5/13/2019,2019,5,13, 18 ,8097,1772,1531,11400
5/13/2019,2019,5,13, 19 ,8846,1922,1603,12371
5/13/2019,2019,5,13, 20 ,8935,1886,1534,12355
5/13/2019,2019,5,13, 21 ,8966,1842,1521,12329
5/13/2019,2019,5,13, 22 ,8754,1754,1439,11947
5/13/2019,2019,5,13, 23 ,8411,1670,1338,11419
5/13/2019,2019,5,13, 24 ,8102,1587,1279,10968
5/14/2019,2019,5,14, 1 ,7790,1528,1201,10519
5/14/2019,2019,5,14, 2 ,7535,1477,1174,10186
5/14/2019,2019,5,14, 3 ,7294,1441,1146,9881
5/14/2019,2019,5,14, 4 ,7091,1404,1116,9611
5/14/2019,2019,5,14, 5 ,7016,1401,1118,9535
5/14/2019,2019,5,14, 6 ,6996,1393,1141,9530
5/14/2019,2019,5,14, 7 ,7508,1449,1220,10177
5/14/2019,2019,5,14, 8 ,8648,1666,1346,11660
5/14/2019,2019,5,14, 9 ,9648,1918,1550,13116
5/14/2019,2019,5,14, 10 ,10276,2060,1704,14040
5/14/2019,2019,5,14, 11 ,10695,2126,1820,14641
5/14/2019,2019,5,14, 12 ,10518,2120,1819,14457
5/14/2019,2019,5,14, 13 ,10616,2124,1825,14565
5/14/2019,2019,5,14, 14 ,10978,2189,1892,15059
5/14/2019,2019,5,14, 15 ,10881,2171,1866,14918
5/14/2019,2019,5,14, 16 ,10748,2151,1804,14703
5/14/2019,2019,5,14, 17 ,10109,2025,1712,13846
5/14/2019,2019,5,14, 18 ,9705,1994,1739,13438
5/14/2019,2019,5,14, 19 ,10035,2119,1745,13899
5/14/2019,2019,5,14, 20 ,10038,2058,1716,13812
5/14/2019,2019,5,14, 21 ,10069,2020,1658,13747
5/14/2019,2019,5,14, 22 ,9862,1894,1546,13302
5/14/2019,2019,5,14, 23 ,9519,1785,1421,12725
5/14/2019,2019,5,14, 24 ,9134,1706,1360,12200
5/15/2019,2019,5,15, 1 ,8809,1639,1275,11723
5/15/2019,2019,5,15, 2 ,8518,1587,1245,11350
5/15/2019,2019,5,15, 3 ,8280,1547,1214,11041
5/15/2019,2019,5,15, 4 ,8076,1515,1182,10773
5/15/2019,2019,5,15, 5 ,7934,1513,1187,10634
5/15/2019,2019,5,15, 6 ,7763,1493,1191,10447
5/15/2019,2019,5,15, 7 ,8087,1536,1216,10839
5/15/2019,2019,5,15, 8 ,9072,1725,1400,12197
5/15/2019,2019,5,15, 9 ,9987,1977,1634,13598
5/15/2019,2019,5,15, 10 ,10509,2110,1694,14313
5/15/2019,2019,5,15, 11 ,10882,2162,1800,14844
5/15/2019,2019,5,15, 12 ,10768,2131,1844,14743
5/15/2019,2019,5,15, 13 ,10790,2127,1866,14783
5/15/2019,2019,5,15, 14 ,11164,2167,1913,15244
5/15/2019,2019,5,15, 15 ,11034,2129,1859,15022
5/15/2019,2019,5,15, 16 ,10824,2097,1810,14731
5/15/2019,2019,5,15, 17 ,10263,2002,1727,13992
5/15/2019,2019,5,15, 18 ,9908,1992,1758,13658
5/15/2019,2019,5,15, 19 ,10004,2094,1771,13869
5/15/2019,2019,5,15, 20 ,9904,2038,1726,13668
5/15/2019,2019,5,15, 21 ,9903,1977,1688,13568
5/15/2019,2019,5,15, 22 ,9745,1897,1547,13189
5/15/2019,2019,5,15, 23 ,9383,1779,1466,12628
5/15/2019,2019,5,15, 24 ,9032,1684,1355,12071
5/16/2019,2019,5,16, 1 ,8755,1618,1316,11689
5/16/2019,2019,5,16, 2 ,8474,1564,1255,11293
5/16/2019,2019,5,16, 3 ,8189,1523,1235,10947
5/16/2019,2019,5,16, 4 ,7946,1495,1199,10640
5/16/2019,2019,5,16, 5 ,7831,1502,1194,10527
5/16/2019,2019,5,16, 6 ,7677,1475,1194,10346
5/16/2019,2019,5,16, 7 ,8043,1514,1215,10772
5/16/2019,2019,5,16, 8 ,8990,1703,1387,12080
5/16/2019,2019,5,16, 9 ,9936,1960,1634,13530
5/16/2019,2019,5,16, 10 ,10469,2087,1746,14302
5/16/2019,2019,5,16, 11 ,10817,2166,1828,14811
5/16/2019,2019,5,16, 12 ,10651,2110,1813,14574
5/16/2019,2019,5,16, 13 ,10713,2149,1870,14732
5/16/2019,2019,5,16, 14 ,11053,2224,1928,15205
5/16/2019,2019,5,16, 15 ,11005,2212,1933,15150
5/16/2019,2019,5,16, 16 ,10812,2164,1903,14879
5/16/2019,2019,5,16, 17 ,10277,2058,1800,14135
5/16/2019,2019,5,16, 18 ,9834,2042,1773,13649
5/16/2019,2019,5,16, 19 ,10163,2137,1849,14149
5/16/2019,2019,5,16, 20 ,10190,2098,1819,14107
5/16/2019,2019,5,16, 21 ,10180,2039,1778,13997
5/16/2019,2019,5,16, 22 ,10031,1934,1667,13632
5/16/2019,2019,5,16, 23 ,9740,1830,1592,13162
5/16/2019,2019,5,16, 24 ,9390,1737,1478,12605
5/17/2019,2019,5,17, 1 ,9055,1687,1401,12143
5/17/2019,2019,5,17, 2 ,8786,1594,1357,11737
5/17/2019,2019,5,17, 3 ,8452,1554,1323,11329
5/17/2019,2019,5,17, 4 ,8211,1519,1274,11004
5/17/2019,2019,5,17, 5 ,8092,1524,1259,10875
5/17/2019,2019,5,17, 6 ,7932,1487,1259,10678
5/17/2019,2019,5,17, 7 ,8266,1490,1254,11010
5/17/2019,2019,5,17, 8 ,9220,1677,1367,12264
5/17/2019,2019,5,17, 9 ,10109,1943,1611,13663
5/17/2019,2019,5,17, 10 ,10547,2058,1704,14309
5/17/2019,2019,5,17, 11 ,10844,2138,1794,14776
5/17/2019,2019,5,17, 12 ,10524,2068,1769,14361
5/17/2019,2019,5,17, 13 ,10471,2090,1760,14321
5/17/2019,2019,5,17, 14 ,10891,2126,1805,14822
5/17/2019,2019,5,17, 15 ,10777,2097,1794,14668
5/17/2019,2019,5,17, 16 ,10633,2083,1782,14498
5/17/2019,2019,5,17, 17 ,10052,1973,1721,13746
5/17/2019,2019,5,17, 18 ,9608,1954,1739,13301
5/17/2019,2019,5,17, 19 ,10011,2019,1747,13777
5/17/2019,2019,5,17, 20 ,10047,1974,1710,13731
5/17/2019,2019,5,17, 21 ,10035,1939,1609,13583
5/17/2019,2019,5,17, 22 ,9875,1825,1510,13210
5/17/2019,2019,5,17, 23 ,9602,1726,1445,12773
5/17/2019,2019,5,17, 24 ,9259,1633,1368,12260
5/18/2019,2019,5,18, 1 ,8873,1585,1294,11752
5/18/2019,2019,5,18, 2 ,8602,1527,1264,11393
5/18/2019,2019,5,18, 3 ,8313,1491,1255,11059
5/18/2019,2019,5,18, 4 ,8104,1460,1207,10771
5/18/2019,2019,5,18, 5 ,7913,1459,1229,10601
5/18/2019,2019,5,18, 6 ,7655,1423,1200,10278
5/18/2019,2019,5,18, 7 ,7820,1456,1211,10487
5/18/2019,2019,5,18, 8 ,8450,1623,1339,11412
5/18/2019,2019,5,18, 9 ,9133,1812,1536,12481
5/18/2019,2019,5,18, 10 ,9733,1928,1678,13339
5/18/2019,2019,5,18, 11 ,10070,1983,1727,13780
5/18/2019,2019,5,18, 12 ,9955,1963,1721,13639
5/18/2019,2019,5,18, 13 ,9985,1939,1730,13654
5/18/2019,2019,5,18, 14 ,10280,2003,1795,14078
5/18/2019,2019,5,18, 15 ,10179,1962,1745,13886
5/18/2019,2019,5,18, 16 ,10002,1932,1664,13598
5/18/2019,2019,5,18, 17 ,9463,1863,1666,12992
5/18/2019,2019,5,18, 18 ,9207,1924,1708,12839
5/18/2019,2019,5,18, 19 ,9671,2021,1732,13424
5/18/2019,2019,5,18, 20 ,9795,1994,1699,13488
5/18/2019,2019,5,18, 21 ,9916,1924,1689,13529
5/18/2019,2019,5,18, 22 ,9856,1838,1599,13293
5/18/2019,2019,5,18, 23 ,9497,1737,1483,12717
5/18/2019,2019,5,18, 24 ,9137,1646,1356,12139
5/19/2019,2019,5,19, 1 ,8773,1586,1343,11702
5/19/2019,2019,5,19, 2 ,8493,1536,1249,11278
5/19/2019,2019,5,19, 3 ,8205,1495,1221,10921
5/19/2019,2019,5,19, 4 ,7962,1467,1189,10618
5/19/2019,2019,5,19, 5 ,7776,1451,1185,10412
5/19/2019,2019,5,19, 6 ,7333,1396,1156,9885
5/19/2019,2019,5,19, 7 ,7363,1406,1162,9931
5/19/2019,2019,5,19, 8 ,7763,1498,1214,10475
5/19/2019,2019,5,19, 9 ,8323,1623,1349,11295
5/19/2019,2019,5,19, 10 ,8815,1731,1413,11959
5/19/2019,2019,5,19, 11 ,9096,1796,1500,12392
5/19/2019,2019,5,19, 12 ,9072,1778,1536,12386
5/19/2019,2019,5,19, 13 ,9179,1795,1544,12518
5/19/2019,2019,5,19, 14 ,9322,1799,1571,12692
5/19/2019,2019,5,19, 15 ,9229,1789,1573,12591
5/19/2019,2019,5,19, 16 ,9005,1752,1538,12295
5/19/2019,2019,5,19, 17 ,8725,1708,1519,11952
5/19/2019,2019,5,19, 18 ,8653,1816,1593,12062
5/19/2019,2019,5,19, 19 ,9306,1948,1691,12945
5/19/2019,2019,5,19, 20 ,9503,1933,1670,13106
5/19/2019,2019,5,19, 21 ,9593,1894,1646,13133
5/19/2019,2019,5,19, 22 ,9602,1793,1559,12954
5/19/2019,2019,5,19, 23 ,9235,1700,1453,12388
5/19/2019,2019,5,19, 24 ,8839,1614,1393,11846
5/20/2019,2019,5,20, 1 ,8496,1555,1306,11357
5/20/2019,2019,5,20, 2 ,8188,1508,1227,10923
5/20/2019,2019,5,20, 3 ,7967,1461,1211,10639
5/20/2019,2019,5,20, 4 ,7719,1436,1172,10327
5/20/2019,2019,5,20, 5 ,7639,1431,1177,10247
5/20/2019,2019,5,20, 6 ,7573,1423,1187,10183
5/20/2019,2019,5,20, 7 ,8028,1478,1205,10711
5/20/2019,2019,5,20, 8 ,9020,1665,1410,12095
5/20/2019,2019,5,20, 9 ,9990,1930,1625,13545
5/20/2019,2019,5,20, 10 ,10631,2059,1769,14459
5/20/2019,2019,5,20, 11 ,10957,2141,1829,14927
5/20/2019,2019,5,20, 12 ,10854,2107,1823,14784
5/20/2019,2019,5,20, 13 ,10804,2119,1874,14797
5/20/2019,2019,5,20, 14 ,11045,2191,1952,15188
5/20/2019,2019,5,20, 15 ,10935,2172,1937,15044
5/20/2019,2019,5,20, 16 ,10830,2148,1904,14882
5/20/2019,2019,5,20, 17 ,10288,2027,1810,14125
5/20/2019,2019,5,20, 18 ,9849,1992,1780,13621
5/20/2019,2019,5,20, 19 ,10167,2109,1793,14069
5/20/2019,2019,5,20, 20 ,10195,2060,1777,14032
5/20/2019,2019,5,20, 21 ,10249,2005,1723,13977
5/20/2019,2019,5,20, 22 ,9998,1910,1614,13522
5/20/2019,2019,5,20, 23 ,9663,1787,1497,12947
5/20/2019,2019,5,20, 24 ,9260,1695,1388,12343
5/21/2019,2019,5,21, 1 ,8905,1589,1342,11836
5/21/2019,2019,5,21, 2 ,8593,1554,1297,11444
5/21/2019,2019,5,21, 3 ,8345,1484,1283,11112
5/21/2019,2019,5,21, 4 ,8121,1441,1242,10804
5/21/2019,2019,5,21, 5 ,8047,1428,1244,10719
5/21/2019,2019,5,21, 6 ,7891,1488,1181,10560
5/21/2019,2019,5,21, 7 ,8201,1518,1171,10890
5/21/2019,2019,5,21, 8 ,9176,1717,1437,12330
5/21/2019,2019,5,21, 9 ,10083,1885,1649,13617
5/21/2019,2019,5,21, 10 ,10667,2103,1761,14531
5/21/2019,2019,5,21, 11 ,10765,2186,1854,14805
5/21/2019,2019,5,21, 12 ,10742,2127,1863,14732
5/21/2019,2019,5,21, 13 ,10752,2120,1875,14747
5/21/2019,2019,5,21, 14 ,11181,2168,1912,15261
5/21/2019,2019,5,21, 15 ,10872,2127,1911,14910
5/21/2019,2019,5,21, 16 ,10630,2107,1887,14624
5/21/2019,2019,5,21, 17 ,10137,1999,1798,13934
5/21/2019,2019,5,21, 18 ,9779,1964,1788,13531
5/21/2019,2019,5,21, 19 ,10034,2044,1760,13838
5/21/2019,2019,5,21, 20 ,9884,1998,1743,13625
5/21/2019,2019,5,21, 21 ,9750,1940,1704,13394
5/21/2019,2019,5,21, 22 ,9594,1833,1589,13016
5/21/2019,2019,5,21, 23 ,9265,1740,1491,12496
5/21/2019,2019,5,21, 24 ,8868,1645,1396,11909
5/22/2019,2019,5,22, 1 ,8556,1574,1344,11474
5/22/2019,2019,5,22, 2 ,8255,1534,1302,11091
5/22/2019,2019,5,22, 3 ,8008,1487,1272,10767
5/22/2019,2019,5,22, 4 ,7804,1461,1235,10500
5/22/2019,2019,5,22, 5 ,7729,1465,1225,10419
5/22/2019,2019,5,22, 6 ,7623,1455,1248,10326
5/22/2019,2019,5,22, 7 ,7999,1482,1269,10750
5/22/2019,2019,5,22, 8 ,8980,1700,1439,12119
5/22/2019,2019,5,22, 9 ,9999,1946,1695,13640
5/22/2019,2019,5,22, 10 ,10559,2072,1768,14399
5/22/2019,2019,5,22, 11 ,10863,2150,1853,14866
5/22/2019,2019,5,22, 12 ,10751,2097,1868,14716
5/22/2019,2019,5,22, 13 ,10742,2092,1853,14687
5/22/2019,2019,5,22, 14 ,11053,2120,1886,15059
5/22/2019,2019,5,22, 15 ,10814,2092,1887,14793
5/22/2019,2019,5,22, 16 ,10480,2079,1894,14453
5/22/2019,2019,5,22, 17 ,9826,1980,1784,13590
5/22/2019,2019,5,22, 18 ,9344,2002,1776,13122
5/22/2019,2019,5,22, 19 ,9726,2095,1776,13597
5/22/2019,2019,5,22, 20 ,9753,2037,1723,13513
5/22/2019,2019,5,22, 21 ,9648,1958,1686,13292
5/22/2019,2019,5,22, 22 ,9413,1837,1556,12806
5/22/2019,2019,5,22, 23 ,9101,1743,1465,12309
5/22/2019,2019,5,22, 24 ,8722,1638,1378,11738
5/23/2019,2019,5,23, 1 ,8313,1571,1319,11203
5/23/2019,2019,5,23, 2 ,8044,1526,1279,10849
5/23/2019,2019,5,23, 3 ,7852,1490,1253,10595
5/23/2019,2019,5,23, 4 ,7630,1452,1215,10297
5/23/2019,2019,5,23, 5 ,7558,1448,1220,10226
5/23/2019,2019,5,23, 6 ,7475,1436,1230,10141
5/23/2019,2019,5,23, 7 ,7753,1466,1247,10466
5/23/2019,2019,5,23, 8 ,8760,1676,1418,11854
5/23/2019,2019,5,23, 9 ,9742,1936,1676,13354
5/23/2019,2019,5,23, 10 ,10349,2068,1807,14224
5/23/2019,2019,5,23, 11 ,10679,2136,1890,14705
5/23/2019,2019,5,23, 12 ,10545,2095,1850,14490
5/23/2019,2019,5,23, 13 ,10647,2107,1873,14627
5/23/2019,2019,5,23, 14 ,10951,2151,1939,15041
5/23/2019,2019,5,23, 15 ,10805,2085,1908,14798
5/23/2019,2019,5,23, 16 ,10689,2045,1888,14622
5/23/2019,2019,5,23, 17 ,10045,1935,1780,13760
5/23/2019,2019,5,23, 18 ,9626,1934,1811,13371
5/23/2019,2019,5,23, 19 ,9954,2030,1810,13794
5/23/2019,2019,5,23, 20 ,9945,1990,1780,13715
5/23/2019,2019,5,23, 21 ,9872,1930,1726,13528
5/23/2019,2019,5,23, 22 ,9706,1818,1592,13116
5/23/2019,2019,5,23, 23 ,9343,1710,1490,12543
5/23/2019,2019,5,23, 24 ,8906,1624,1394,11924
5/24/2019,2019,5,24, 1 ,8648,1559,1322,11529
5/24/2019,2019,5,24, 2 ,8328,1512,1282,11122
5/24/2019,2019,5,24, 3 ,8041,1476,1268,10785
5/24/2019,2019,5,24, 4 ,7784,1444,1232,10460
5/24/2019,2019,5,24, 5 ,7721,1452,1231,10404
5/24/2019,2019,5,24, 6 ,7558,1446,1226,10230
5/24/2019,2019,5,24, 7 ,7957,1470,1270,10697
5/24/2019,2019,5,24, 8 ,8891,1659,1419,11969
5/24/2019,2019,5,24, 9 ,9892,1912,1714,13518
5/24/2019,2019,5,24, 10 ,10420,2038,1832,14290
5/24/2019,2019,5,24, 11 ,10782,2139,1895,14816
5/24/2019,2019,5,24, 12 ,10641,2086,1879,14606
5/24/2019,2019,5,24, 13 ,10516,2091,1909,14516
5/24/2019,2019,5,24, 14 ,10659,2106,1818,14583
5/24/2019,2019,5,24, 15 ,10485,2069,1793,14347
5/24/2019,2019,5,24, 16 ,10304,2036,1793,14133
5/24/2019,2019,5,24, 17 ,9814,1963,1697,13474
5/24/2019,2019,5,24, 18 ,9455,1957,1713,13125
5/24/2019,2019,5,24, 19 ,9783,2032,1764,13579
5/24/2019,2019,5,24, 20 ,9747,1991,1764,13502
5/24/2019,2019,5,24, 21 ,9739,1931,1724,13394
5/24/2019,2019,5,24, 22 ,9424,1825,1582,12831
5/24/2019,2019,5,24, 23 ,9107,1716,1471,12294
5/24/2019,2019,5,24, 24 ,8728,1621,1375,11724
5/25/2019,2019,5,25, 1 ,8415,1552,1308,11275
5/25/2019,2019,5,25, 2 ,8166,1513,1275,10954
5/25/2019,2019,5,25, 3 ,7928,1470,1272,10670
5/25/2019,2019,5,25, 4 ,7663,1440,1216,10319
5/25/2019,2019,5,25, 5 ,7567,1428,1210,10205
5/25/2019,2019,5,25, 6 ,7286,1409,1172,9867
5/25/2019,2019,5,25, 7 ,7403,1423,1219,10045
5/25/2019,2019,5,25, 8 ,8094,1541,1299,10934
5/25/2019,2019,5,25, 9 ,8783,1744,1501,12028
5/25/2019,2019,5,25, 10 ,9336,1855,1611,12802
5/25/2019,2019,5,25, 11 ,9712,1935,1690,13337
5/25/2019,2019,5,25, 12 ,9565,1904,1689,13158
5/25/2019,2019,5,25, 13 ,9592,1918,1715,13225
5/25/2019,2019,5,25, 14 ,9816,1958,1741,13515
5/25/2019,2019,5,25, 15 ,9688,1941,1727,13356
5/25/2019,2019,5,25, 16 ,9415,1897,1692,13004
5/25/2019,2019,5,25, 17 ,8933,1831,1643,12407
5/25/2019,2019,5,25, 18 ,8813,1895,1685,12393
5/25/2019,2019,5,25, 19 ,9187,1990,1756,12933
5/25/2019,2019,5,25, 20 ,9248,1970,1710,12928
5/25/2019,2019,5,25, 21 ,9204,1898,1671,12773
5/25/2019,2019,5,25, 22 ,9112,1817,1610,12539
5/25/2019,2019,5,25, 23 ,8721,1713,1498,11932
5/25/2019,2019,5,25, 24 ,8419,1625,1409,11453
5/26/2019,2019,5,26, 1 ,8086,1547,1345,10978
5/26/2019,2019,5,26, 2 ,7807,1497,1286,10590
5/26/2019,2019,5,26, 3 ,7592,1454,1253,10299
5/26/2019,2019,5,26, 4 ,7376,1415,1224,10015
5/26/2019,2019,5,26, 5 ,7211,1384,1212,9807
5/26/2019,2019,5,26, 6 ,6875,1344,1156,9375
5/26/2019,2019,5,26, 7 ,6897,1356,1143,9396
5/26/2019,2019,5,26, 8 ,7235,1436,1209,9880
5/26/2019,2019,5,26, 9 ,7863,1544,1282,10689
5/26/2019,2019,5,26, 10 ,8347,1654,1381,11382
5/26/2019,2019,5,26, 11 ,8580,1706,1478,11764
5/26/2019,2019,5,26, 12 ,8552,1716,1496,11764
5/26/2019,2019,5,26, 13 ,8487,1718,1510,11715
5/26/2019,2019,5,26, 14 ,8561,1714,1518,11793
5/26/2019,2019,5,26, 15 ,8390,1701,1505,11596
5/26/2019,2019,5,26, 16 ,8114,1663,1478,11255
5/26/2019,2019,5,26, 17 ,7978,1664,1460,11102
5/26/2019,2019,5,26, 18 ,8122,1758,1508,11388
5/26/2019,2019,5,26, 19 ,8462,1873,1644,11979
5/26/2019,2019,5,26, 20 ,8529,1851,1619,11999
5/26/2019,2019,5,26, 21 ,8459,1814,1593,11866
5/26/2019,2019,5,26, 22 ,8273,1732,1412,11417
5/26/2019,2019,5,26, 23 ,7911,1627,1335,10873
5/26/2019,2019,5,26, 24 ,7549,1540,1258,10347
5/27/2019,2019,5,27, 1 ,7275,1473,1270,10018
5/27/2019,2019,5,27, 2 ,7021,1430,1232,9683
5/27/2019,2019,5,27, 3 ,6787,1387,1209,9383
5/27/2019,2019,5,27, 4 ,6694,1366,1165,9225
5/27/2019,2019,5,27, 5 ,6655,1387,1172,9214
5/27/2019,2019,5,27, 6 ,6750,1389,1201,9340
5/27/2019,2019,5,27, 7 ,7158,1453,1211,9822
5/27/2019,2019,5,27, 8 ,8257,1658,1383,11298
5/27/2019,2019,5,27, 9 ,9255,1925,1685,12865
5/27/2019,2019,5,27, 10 ,9920,2054,1787,13761
5/27/2019,2019,5,27, 11 ,10341,2152,1901,14394
5/27/2019,2019,5,27, 12 ,10290,2109,1907,14306
5/27/2019,2019,5,27, 13 ,10239,2122,1921,14282
5/27/2019,2019,5,27, 14 ,10421,2175,1984,14580
5/27/2019,2019,5,27, 15 ,10098,2152,1958,14208
5/27/2019,2019,5,27, 16 ,9868,2136,1914,13918
5/27/2019,2019,5,27, 17 ,9363,2026,1805,13194
5/27/2019,2019,5,27, 18 ,9201,2015,1808,13024
5/27/2019,2019,5,27, 19 ,9414,2090,1838,13342
5/27/2019,2019,5,27, 20 ,9329,2057,1799,13185
5/27/2019,2019,5,27, 21 ,9198,1997,1758,12953
5/27/2019,2019,5,27, 22 ,8913,1863,1612,12388
5/27/2019,2019,5,27, 23 ,8547,1748,1525,11820
5/27/2019,2019,5,27, 24 ,8150,1652,1427,11229
5/28/2019,2019,5,28, 1 ,7793,1580,1362,10735
5/28/2019,2019,5,28, 2 ,7564,1537,1337,10438
5/28/2019,2019,5,28, 3 ,7302,1496,1305,10103
5/28/2019,2019,5,28, 4 ,7165,1448,1262,9875
5/28/2019,2019,5,28, 5 ,7159,1468,1271,9898
5/28/2019,2019,5,28, 6 ,7120,1462,1269,9851
5/28/2019,2019,5,28, 7 ,7515,1492,1274,10281
5/28/2019,2019,5,28, 8 ,8550,1708,1462,11720
5/28/2019,2019,5,28, 9 ,9493,1955,1686,13134
5/28/2019,2019,5,28, 10 ,10105,2083,1832,14020
5/28/2019,2019,5,28, 11 ,10463,2141,1929,14533
5/28/2019,2019,5,28, 12 ,10360,2074,1900,14334
5/28/2019,2019,5,28, 13 ,10430,2124,1929,14483
5/28/2019,2019,5,28, 14 ,10800,2205,2001,15006
5/28/2019,2019,5,28, 15 ,10601,2166,1957,14724
5/28/2019,2019,5,28, 16 ,10342,2165,1923,14430
5/28/2019,2019,5,28, 17 ,9780,2043,1826,13649
5/28/2019,2019,5,28, 18 ,9552,2003,1801,13356
5/28/2019,2019,5,28, 19 ,9776,2114,1869,13759
5/28/2019,2019,5,28, 20 ,9708,2078,1813,13599
5/28/2019,2019,5,28, 21 ,9660,2024,1777,13461
5/28/2019,2019,5,28, 22 ,9351,1892,1574,12817
5/28/2019,2019,5,28, 23 ,8950,1773,1548,12271
5/28/2019,2019,5,28, 24 ,8460,1693,1460,11613
5/29/2019,2019,5,29, 1 ,8235,1636,1363,11234
5/29/2019,2019,5,29, 2 ,7928,1574,1324,10826
5/29/2019,2019,5,29, 3 ,7657,1531,1289,10477
5/29/2019,2019,5,29, 4 ,7478,1496,1252,10226
5/29/2019,2019,5,29, 5 ,7423,1499,1247,10169
5/29/2019,2019,5,29, 6 ,7357,1482,1247,10086
5/29/2019,2019,5,29, 7 ,7711,1528,1257,10496
5/29/2019,2019,5,29, 8 ,8627,1711,1457,11795
5/29/2019,2019,5,29, 9 ,9361,1982,1723,13066
5/29/2019,2019,5,29, 10 ,10019,2125,1774,13918
5/29/2019,2019,5,29, 11 ,10408,2152,1938,14498
5/29/2019,2019,5,29, 12 ,10221,2106,1902,14229
5/29/2019,2019,5,29, 13 ,10246,2116,1931,14293
5/29/2019,2019,5,29, 14 ,10522,2199,1982,14703
5/29/2019,2019,5,29, 15 ,10385,2192,1977,14554
5/29/2019,2019,5,29, 16 ,10018,2172,1948,14138
5/29/2019,2019,5,29, 17 ,9465,2039,1834,13338
5/29/2019,2019,5,29, 18 ,9191,2003,1814,13008
5/29/2019,2019,5,29, 19 ,9458,2123,1851,13432
5/29/2019,2019,5,29, 20 ,9560,2070,1842,13472
5/29/2019,2019,5,29, 21 ,9538,2030,1794,13362
5/29/2019,2019,5,29, 22 ,9193,1926,1671,12790
5/29/2019,2019,5,29, 23 ,8863,1827,1554,12244
5/29/2019,2019,5,29, 24 ,8446,1731,1447,11624
5/30/2019,2019,5,30, 1 ,8180,1667,1398,11245
5/30/2019,2019,5,30, 2 ,7902,1628,1375,10905
5/30/2019,2019,5,30, 3 ,7628,1582,1342,10552
5/30/2019,2019,5,30, 4 ,7479,1540,1299,10318
5/30/2019,2019,5,30, 5 ,7450,1539,1298,10287
5/30/2019,2019,5,30, 6 ,7354,1517,1300,10171
5/30/2019,2019,5,30, 7 ,7630,1552,1283,10465
5/30/2019,2019,5,30, 8 ,8520,1739,1404,11663
5/30/2019,2019,5,30, 9 ,9538,2000,1605,13143
5/30/2019,2019,5,30, 10 ,10090,2106,1714,13910
5/30/2019,2019,5,30, 11 ,10530,2178,1785,14493
5/30/2019,2019,5,30, 12 ,10503,2126,1734,14363
5/30/2019,2019,5,30, 13 ,10525,2132,1740,14397
5/30/2019,2019,5,30, 14 ,10874,2204,1789,14867
5/30/2019,2019,5,30, 15 ,10718,2148,1780,14646
5/30/2019,2019,5,30, 16 ,10469,2131,1776,14376
5/30/2019,2019,5,30, 17 ,9962,2039,1690,13691
5/30/2019,2019,5,30, 18 ,9569,2015,1715,13299
5/30/2019,2019,5,30, 19 ,9921,2127,1748,13796
5/30/2019,2019,5,30, 20 ,9900,2084,1724,13708
5/30/2019,2019,5,30, 21 ,9883,2024,1649,13556
5/30/2019,2019,5,30, 22 ,9599,1913,1528,13040
5/30/2019,2019,5,30, 23 ,9267,1813,1434,12514
5/30/2019,2019,5,30, 24 ,8855,1727,1516,12098
5/31/2019,2019,5,31, 1 ,8535,1662,1286,11483
5/31/2019,2019,5,31, 2 ,8270,1613,1264,11147
5/31/2019,2019,5,31, 3 ,7922,1577,1230,10729
5/31/2019,2019,5,31, 4 ,7724,1534,1200,10458
5/31/2019,2019,5,31, 5 ,7576,1534,1205,10315
5/31/2019,2019,5,31, 6 ,7489,1515,1215,10219
5/31/2019,2019,5,31, 7 ,7798,1540,1253,10591
5/31/2019,2019,5,31, 8 ,8688,1737,1394,11819
5/31/2019,2019,5,31, 9 ,9756,2003,1653,13412
5/31/2019,2019,5,31, 10 ,10318,2122,1802,14242
5/31/2019,2019,5,31, 11 ,10728,2198,1876,14802
5/31/2019,2019,5,31, 12 ,10487,2143,1848,14478
5/31/2019,2019,5,31, 13 ,10489,2145,1835,14469
5/31/2019,2019,5,31, 14 ,10803,2196,1872,14871
5/31/2019,2019,5,31, 15 ,10792,2183,1835,14810
5/31/2019,2019,5,31, 16 ,10640,2143,1814,14597
5/31/2019,2019,5,31, 17 ,10071,2019,1715,13805
5/31/2019,2019,5,31, 18 ,9659,1987,1729,13375
5/31/2019,2019,5,31, 19 ,9992,2111,1754,13857
5/31/2019,2019,5,31, 20 ,9984,2070,1718,13772
5/31/2019,2019,5,31, 21 ,9967,2033,1684,13684
5/31/2019,2019,5,31, 22 ,9747,1918,1558,13223
5/31/2019,2019,5,31, 23 ,9434,1821,1452,12707
5/31/2019,2019,5,31, 24 ,9135,1728,1296,12159
6/1/2019,2019,6,1, 1 ,8735,1656,1288,11679
6/1/2019,2019,6,1, 2 ,8460,1602,1265,11327
6/1/2019,2019,6,1, 3 ,8179,1565,1228,10972
6/1/2019,2019,6,1, 4 ,7966,1523,1195,10684
6/1/2019,2019,6,1, 5 ,7769,1518,1205,10492
6/1/2019,2019,6,1, 6 ,7484,1483,1193,10160
6/1/2019,2019,6,1, 7 ,7579,1470,1203,10252
6/1/2019,2019,6,1, 8 ,8188,1585,1308,11081
6/1/2019,2019,6,1, 9 ,8926,1768,1484,12178
6/1/2019,2019,6,1, 10 ,9490,1901,1611,13002
6/1/2019,2019,6,1, 11 ,9830,1964,1666,13460
6/1/2019,2019,6,1, 12 ,9812,1927,1650,13389
6/1/2019,2019,6,1, 13 ,9827,1937,1617,13381
6/1/2019,2019,6,1, 14 ,10143,1986,1671,13800
6/1/2019,2019,6,1, 15 ,10033,1964,1626,13623
6/1/2019,2019,6,1, 16 ,9627,1900,1594,13121
6/1/2019,2019,6,1, 17 ,9217,1863,1558,12638
6/1/2019,2019,6,1, 18 ,9018,1883,1639,12540
6/1/2019,2019,6,1, 19 ,9478,2042,1683,13203
6/1/2019,2019,6,1, 20 ,9611,2019,1662,13292
6/1/2019,2019,6,1, 21 ,9541,1977,1598,13116
6/1/2019,2019,6,1, 22 ,9470,1924,1524,12918
6/1/2019,2019,6,1, 23 ,9154,1781,1424,12359
6/1/2019,2019,6,1, 24 ,8813,1690,1315,11818
6/2/2019,2019,6,2, 1 ,8548,1635,1261,11444
6/2/2019,2019,6,2, 2 ,8200,1572,1236,11008
6/2/2019,2019,6,2, 3 ,7946,1539,1208,10693
6/2/2019,2019,6,2, 4 ,7693,1493,1193,10379
6/2/2019,2019,6,2, 5 ,7511,1464,1132,10107
6/2/2019,2019,6,2, 6 ,7100,1422,1150,9672
6/2/2019,2019,6,2, 7 ,7073,1438,1127,9638
6/2/2019,2019,6,2, 8 ,7397,1502,1168,10067
6/2/2019,2019,6,2, 9 ,7956,1605,1272,10833
6/2/2019,2019,6,2, 10 ,8449,1693,1341,11483
6/2/2019,2019,6,2, 11 ,8743,1743,1420,11906
6/2/2019,2019,6,2, 12 ,8801,1756,1438,11995
6/2/2019,2019,6,2, 13 ,8867,1754,1411,12032
6/2/2019,2019,6,2, 14 ,8962,1736,1429,12127
6/2/2019,2019,6,2, 15 ,8942,1718,1419,12079
6/2/2019,2019,6,2, 16 ,8729,1684,1435,11848
6/2/2019,2019,6,2, 17 ,8515,1686,1438,11639
6/2/2019,2019,6,2, 18 ,8455,1785,1577,11817
6/2/2019,2019,6,2, 19 ,9054,1930,1624,12608
6/2/2019,2019,6,2, 20 ,9244,1924,1584,12752
6/2/2019,2019,6,2, 21 ,9419,1876,1497,12792
6/2/2019,2019,6,2, 22 ,9355,1783,1319,12457
6/2/2019,2019,6,2, 23 ,9029,1687,1079,11795
6/2/2019,2019,6,2, 24 ,8689,1598,1050,11337
6/3/2019,2019,6,3, 1 ,8399,1536,1203,11138
6/3/2019,2019,6,3, 2 ,8091,1495,1157,10743
6/3/2019,2019,6,3, 3 ,7793,1460,1112,10365
6/3/2019,2019,6,3, 4 ,7588,1439,1071,10098
6/3/2019,2019,6,3, 5 ,7597,1490,1176,10263
6/3/2019,2019,6,3, 6 ,7391,1465,1154,10010
6/3/2019,2019,6,3, 7 ,7711,1451,1165,10327
6/3/2019,2019,6,3, 8 ,8795,1677,1336,11808
6/3/2019,2019,6,3, 9 ,9864,1940,1579,13383
6/3/2019,2019,6,3, 10 ,10468,2085,1734,14287
6/3/2019,2019,6,3, 11 ,10751,2114,1708,14573
6/3/2019,2019,6,3, 12 ,10617,2086,1672,14375
6/3/2019,2019,6,3, 13 ,10705,2092,1705,14502
6/3/2019,2019,6,3, 14 ,11150,2170,1765,15085
6/3/2019,2019,6,3, 15 ,11066,2152,1745,14963
6/3/2019,2019,6,3, 16 ,10870,2124,1728,14722
6/3/2019,2019,6,3, 17 ,10128,2009,1681,13818
6/3/2019,2019,6,3, 18 ,9705,1985,1739,13429
6/3/2019,2019,6,3, 19 ,10044,2122,1722,13888
6/3/2019,2019,6,3, 20 ,10129,2084,1689,13902
6/3/2019,2019,6,3, 21 ,10160,2029,1589,13778
6/3/2019,2019,6,3, 22 ,9919,1890,1470,13279
6/3/2019,2019,6,3, 23 ,9612,1789,1385,12786
6/3/2019,2019,6,3, 24 ,9141,1713,1298,12152
6/4/2019,2019,6,4, 1 ,8812,1614,1243,11669
6/4/2019,2019,6,4, 2 ,8560,1571,1199,11330
6/4/2019,2019,6,4, 3 ,8305,1519,1177,11001
6/4/2019,2019,6,4, 4 ,8083,1498,1153,10734
6/4/2019,2019,6,4, 5 ,8080,1524,1226,10830
6/4/2019,2019,6,4, 6 ,7792,1501,1216,10509
6/4/2019,2019,6,4, 7 ,8044,1467,1167,10678
6/4/2019,2019,6,4, 8 ,9145,1698,1339,12182
6/4/2019,2019,6,4, 9 ,9995,1938,1565,13498
6/4/2019,2019,6,4, 10 ,10429,2063,1699,14191
6/4/2019,2019,6,4, 11 ,10766,2121,1699,14586
6/4/2019,2019,6,4, 12 ,10644,2084,1728,14456
6/4/2019,2019,6,4, 13 ,10699,2094,1750,14543
6/4/2019,2019,6,4, 14 ,11162,2196,1796,15154
6/4/2019,2019,6,4, 15 ,11094,2169,1778,15041
6/4/2019,2019,6,4, 16 ,10958,2142,1742,14842
6/4/2019,2019,6,4, 17 ,10342,2013,1660,14015
6/4/2019,2019,6,4, 18 ,9922,1979,1673,13574
6/4/2019,2019,6,4, 19 ,10256,2099,1676,14031
6/4/2019,2019,6,4, 20 ,10256,1996,1629,13881
6/4/2019,2019,6,4, 21 ,10209,1940,1546,13695
6/4/2019,2019,6,4, 22 ,9968,1827,1252,13047
6/4/2019,2019,6,4, 23 ,9654,1713,1309,12676
6/4/2019,2019,6,4, 24 ,9325,1604,1318,12247
6/5/2019,2019,6,5, 1 ,8921,1534,1194,11649
6/5/2019,2019,6,5, 2 ,8654,1479,1138,11271
6/5/2019,2019,6,5, 3 ,8317,1434,1123,10874
6/5/2019,2019,6,5, 4 ,8108,1380,1114,10602
6/5/2019,2019,6,5, 5 ,7888,1400,1159,10447
6/5/2019,2019,6,5, 6 ,7555,1381,1143,10079
6/5/2019,2019,6,5, 7 ,7618,1401,1118,10137
6/5/2019,2019,6,5, 8 ,8104,1521,1235,10860
6/5/2019,2019,6,5, 9 ,8771,1680,1390,11841
6/5/2019,2019,6,5, 10 ,9316,1813,1483,12612
6/5/2019,2019,6,5, 11 ,9698,1913,1572,13183
6/5/2019,2019,6,5, 12 ,9572,1887,1593,13052
6/5/2019,2019,6,5, 13 ,9639,1887,1597,13123
6/5/2019,2019,6,5, 14 ,9851,1913,1628,13392
6/5/2019,2019,6,5, 15 ,9705,1901,1554,13160
6/5/2019,2019,6,5, 16 ,9378,1862,1416,12656
6/5/2019,2019,6,5, 17 ,8970,1791,1406,12167
6/5/2019,2019,6,5, 18 ,9012,1759,1513,12284
6/5/2019,2019,6,5, 19 ,9526,1871,1515,12912
6/5/2019,2019,6,5, 20 ,9636,1848,1569,13053
6/5/2019,2019,6,5, 21 ,9608,1797,1483,12888
6/5/2019,2019,6,5, 22 ,9482,1691,1309,12482
6/5/2019,2019,6,5, 23 ,9146,1594,1235,11975
6/5/2019,2019,6,5, 24 ,8769,1502,1173,11444
6/6/2019,2019,6,6, 1 ,8416,1444,1148,11008
6/6/2019,2019,6,6, 2 ,8176,1404,1130,10710
6/6/2019,2019,6,6, 3 ,7900,1372,1097,10369
6/6/2019,2019,6,6, 4 ,7775,1349,1105,10229
6/6/2019,2019,6,6, 5 ,7752,1396,1156,10304
6/6/2019,2019,6,6, 6 ,7542,1390,1156,10088
6/6/2019,2019,6,6, 7 ,7885,1383,1104,10372
6/6/2019,2019,6,6, 8 ,8945,1566,1237,11748
6/6/2019,2019,6,6, 9 ,9845,1807,1511,13163
6/6/2019,2019,6,6, 10 ,10456,1963,1662,14081
6/6/2019,2019,6,6, 11 ,10836,2050,1753,14639
6/6/2019,2019,6,6, 12 ,10619,1979,1734,14332
6/6/2019,2019,6,6, 13 ,10666,1969,1721,14356
6/6/2019,2019,6,6, 14 ,11060,2006,1790,14856
6/6/2019,2019,6,6, 15 ,11025,1986,1802,14813
6/6/2019,2019,6,6, 16 ,10836,1963,1766,14565
6/6/2019,2019,6,6, 17 ,10312,1874,1679,13865
6/6/2019,2019,6,6, 18 ,9827,1864,1685,13376
6/6/2019,2019,6,6, 19 ,10189,1955,1725,13869
6/6/2019,2019,6,6, 20 ,10217,1899,1682,13798
6/6/2019,2019,6,6, 21 ,10220,1844,1653,13717
6/6/2019,2019,6,6, 22 ,9899,1696,1461,13056
6/6/2019,2019,6,6, 23 ,9631,1595,1352,12578
6/6/2019,2019,6,6, 24 ,9292,1509,1284,12085
6/7/2019,2019,6,7, 1 ,8947,1457,1237,11641
6/7/2019,2019,6,7, 2 ,8610,1415,1207,11232
6/7/2019,2019,6,7, 3 ,8310,1389,1164,10863
6/7/2019,2019,6,7, 4 ,8074,1365,1140,10579
6/7/2019,2019,6,7, 5 ,8065,1401,1208,10674
6/7/2019,2019,6,7, 6 ,7786,1376,1218,10380
6/7/2019,2019,6,7, 7 ,8099,1375,1149,10623
6/7/2019,2019,6,7, 8 ,9034,1586,1307,11927
6/7/2019,2019,6,7, 9 ,9886,1823,1573,13282
6/7/2019,2019,6,7, 10 ,10404,1963,1723,14090
6/7/2019,2019,6,7, 11 ,10602,2034,1788,14424
6/7/2019,2019,6,7, 12 ,10504,2006,1751,14261
6/7/2019,2019,6,7, 13 ,10528,2022,1771,14321
6/7/2019,2019,6,7, 14 ,10920,2098,1830,14848
6/7/2019,2019,6,7, 15 ,10851,2062,1800,14713
6/7/2019,2019,6,7, 16 ,10808,2043,1794,14645
6/7/2019,2019,6,7, 17 ,10242,1915,1694,13851
6/7/2019,2019,6,7, 18 ,9781,1885,1672,13338
6/7/2019,2019,6,7, 19 ,10104,2023,1720,13847
6/7/2019,2019,6,7, 20 ,10139,1988,1696,13823
6/7/2019,2019,6,7, 21 ,10171,1929,1629,13729
6/7/2019,2019,6,7, 22 ,9969,1805,1511,13285
6/7/2019,2019,6,7, 23 ,9645,1684,1397,12726
6/7/2019,2019,6,7, 24 ,9254,1601,1322,12177
6/8/2019,2019,6,8, 1 ,8960,1524,1261,11745
6/8/2019,2019,6,8, 2 ,8656,1492,1220,11368
6/8/2019,2019,6,8, 3 ,8347,1447,1181,10975
6/8/2019,2019,6,8, 4 ,8085,1407,1153,10645
6/8/2019,2019,6,8, 5 ,7912,1408,1160,10480
6/8/2019,2019,6,8, 6 ,7610,1376,1161,10147
6/8/2019,2019,6,8, 7 ,7713,1418,1181,10312
6/8/2019,2019,6,8, 8 ,8328,1538,1290,11156
6/8/2019,2019,6,8, 9 ,9091,1697,1451,12239
6/8/2019,2019,6,8, 10 ,9782,1830,1557,13169
6/8/2019,2019,6,8, 11 ,10036,1957,1672,13665
6/8/2019,2019,6,8, 12 ,9954,1898,1648,13500
6/8/2019,2019,6,8, 13 ,9943,1897,1654,13494
6/8/2019,2019,6,8, 14 ,10220,1958,1702,13880
6/8/2019,2019,6,8, 15 ,10199,1919,1659,13777
6/8/2019,2019,6,8, 16 ,9856,1866,1596,13318
6/8/2019,2019,6,8, 17 ,9363,1807,1546,12716
6/8/2019,2019,6,8, 18 ,9151,1816,1636,12603
6/8/2019,2019,6,8, 19 ,9636,1929,1627,13192
6/8/2019,2019,6,8, 20 ,9745,1912,1532,13189
6/8/2019,2019,6,8, 21 ,9770,1860,1493,13123
6/8/2019,2019,6,8, 22 ,9698,1787,1426,12911
6/8/2019,2019,6,8, 23 ,9389,1667,1323,12379
6/8/2019,2019,6,8, 24 ,9056,1563,1233,11852
6/9/2019,2019,6,9, 1 ,8660,1497,1202,11359
6/9/2019,2019,6,9, 2 ,8444,1454,1168,11066
6/9/2019,2019,6,9, 3 ,8119,1409,1125,10653
6/9/2019,2019,6,9, 4 ,7860,1384,1105,10349
6/9/2019,2019,6,9, 5 ,7609,1357,1126,10092
6/9/2019,2019,6,9, 6 ,7229,1321,1127,9677
6/9/2019,2019,6,9, 7 ,7266,1329,1119,9714
6/9/2019,2019,6,9, 8 ,7729,1401,1173,10303
6/9/2019,2019,6,9, 9 ,8224,1507,1281,11012
6/9/2019,2019,6,9, 10 ,8738,1597,1405,11740
6/9/2019,2019,6,9, 11 ,8984,1643,1464,12091
6/9/2019,2019,6,9, 12 ,9000,1648,1463,12111
6/9/2019,2019,6,9, 13 ,9095,1663,1479,12237
6/9/2019,2019,6,9, 14 ,9266,1671,1508,12445
6/9/2019,2019,6,9, 15 ,9187,1640,1493,12320
6/9/2019,2019,6,9, 16 ,8946,1594,1372,11912
6/9/2019,2019,6,9, 17 ,8717,1611,1455,11783
6/9/2019,2019,6,9, 18 ,8664,1695,1506,11865
6/9/2019,2019,6,9, 19 ,9313,1813,1598,12724
6/9/2019,2019,6,9, 20 ,9471,1792,1611,12874
6/9/2019,2019,6,9, 21 ,9511,1698,1551,12760
6/9/2019,2019,6,9, 22 ,9391,1624,1430,12445
6/9/2019,2019,6,9, 23 ,9058,1526,1319,11903
6/9/2019,2019,6,9, 24 ,8747,1451,1277,11475
6/10/2019,2019,6,10, 1 ,8414,1399,1225,11038
6/10/2019,2019,6,10, 2 ,8138,1343,1180,10661
6/10/2019,2019,6,10, 3 ,7819,1298,1140,10257
6/10/2019,2019,6,10, 4 ,7681,1288,1128,10097
6/10/2019,2019,6,10, 5 ,7690,1339,1217,10246
6/10/2019,2019,6,10, 6 ,7520,1345,1206,10071
6/10/2019,2019,6,10, 7 ,7862,1313,1106,10281
6/10/2019,2019,6,10, 8 ,9014,1550,1303,11867
6/10/2019,2019,6,10, 9 ,9936,1801,1557,13294
6/10/2019,2019,6,10, 10 ,10424,1938,1736,14098
6/10/2019,2019,6,10, 11 ,10805,2025,1788,14618
6/10/2019,2019,6,10, 12 ,10655,1978,1777,14410
6/10/2019,2019,6,10, 13 ,10513,1956,1787,14256
6/10/2019,2019,6,10, 14 ,10646,2049,1848,14543
6/10/2019,2019,6,10, 15 ,10499,2050,1814,14363
6/10/2019,2019,6,10, 16 ,10381,1998,1772,14151
6/10/2019,2019,6,10, 17 ,9907,1894,1696,13497
6/10/2019,2019,6,10, 18 ,9593,1905,1836,13334
6/10/2019,2019,6,10, 19 ,9886,2018,1835,13739
6/10/2019,2019,6,10, 20 ,9863,1949,1633,13445
6/10/2019,2019,6,10, 21 ,9841,1887,1636,13364
6/10/2019,2019,6,10, 22 ,9579,1741,1508,12828
6/10/2019,2019,6,10, 23 ,9258,1634,1322,12214
6/10/2019,2019,6,10, 24 ,8850,1558,1274,11682
6/11/2019,2019,6,11, 1 ,8549,1508,1217,11274
6/11/2019,2019,6,11, 2 ,8303,1454,1181,10938
6/11/2019,2019,6,11, 3 ,8032,1418,1160,10610
6/11/2019,2019,6,11, 4 ,7864,1397,1138,10399
6/11/2019,2019,6,11, 5 ,7879,1437,1217,10533
6/11/2019,2019,6,11, 6 ,7696,1430,1234,10360
6/11/2019,2019,6,11, 7 ,7949,1392,1154,10495
6/11/2019,2019,6,11, 8 ,8981,1606,1310,11897
6/11/2019,2019,6,11, 9 ,9823,1874,1553,13250
6/11/2019,2019,6,11, 10 ,10448,2018,1675,14141
6/11/2019,2019,6,11, 11 ,10577,2102,1777,14456
6/11/2019,2019,6,11, 12 ,10424,2042,1757,14223
6/11/2019,2019,6,11, 13 ,10397,2041,1772,14210
6/11/2019,2019,6,11, 14 ,10699,2100,1836,14635
6/11/2019,2019,6,11, 15 ,10622,2116,1805,14543
6/11/2019,2019,6,11, 16 ,10440,2062,1768,14270
6/11/2019,2019,6,11, 17 ,9996,1937,1690,13623
6/11/2019,2019,6,11, 18 ,9649,1900,1698,13247
6/11/2019,2019,6,11, 19 ,9970,2044,1765,13779
6/11/2019,2019,6,11, 20 ,9931,1990,1718,13639
6/11/2019,2019,6,11, 21 ,9880,1926,1680,13486
6/11/2019,2019,6,11, 22 ,9606,1804,1546,12956
6/11/2019,2019,6,11, 23 ,9282,1702,1425,12409
6/11/2019,2019,6,11, 24 ,8951,1607,1340,11898
6/12/2019,2019,6,12, 1 ,8667,1547,1286,11500
6/12/2019,2019,6,12, 2 ,8353,1500,1243,11096
6/12/2019,2019,6,12, 3 ,8006,1465,1222,10693
6/12/2019,2019,6,12, 4 ,7809,1434,1198,10441
6/12/2019,2019,6,12, 5 ,7589,1422,1219,10230
6/12/2019,2019,6,12, 6 ,7321,1387,1220,9928
6/12/2019,2019,6,12, 7 ,7315,1390,1224,9929
6/12/2019,2019,6,12, 8 ,7776,1514,1291,10581
6/12/2019,2019,6,12, 9 ,8444,1702,1467,11613
6/12/2019,2019,6,12, 10 ,8897,1834,1613,12344
6/12/2019,2019,6,12, 11 ,9301,1896,1675,12872
6/12/2019,2019,6,12, 12 ,9269,1880,1685,12834
6/12/2019,2019,6,12, 13 ,9328,1881,1673,12882
6/12/2019,2019,6,12, 14 ,9576,1915,1687,13178
6/12/2019,2019,6,12, 15 ,9494,1901,1627,13022
6/12/2019,2019,6,12, 16 ,9329,1866,1632,12827
6/12/2019,2019,6,12, 17 ,8943,1785,1617,12345
6/12/2019,2019,6,12, 18 ,8849,1825,1668,12342
6/12/2019,2019,6,12, 19 ,9428,1978,1749,13155
6/12/2019,2019,6,12, 20 ,9542,1961,1722,13225
6/12/2019,2019,6,12, 21 ,9555,1933,1686,13174
6/12/2019,2019,6,12, 22 ,9360,1812,1542,12714
6/12/2019,2019,6,12, 23 ,9032,1689,1442,12163
6/12/2019,2019,6,12, 24 ,8798,1596,1338,11732
6/13/2019,2019,6,13, 1 ,8480,1538,1277,11295
6/13/2019,2019,6,13, 2 ,8239,1495,1224,10958
6/13/2019,2019,6,13, 3 ,7943,1453,1205,10601
6/13/2019,2019,6,13, 4 ,7728,1428,1197,10353
6/13/2019,2019,6,13, 5 ,7804,1465,1279,10548
6/13/2019,2019,6,13, 6 ,7623,1442,1273,10338
6/13/2019,2019,6,13, 7 ,7972,1431,1196,10599
6/13/2019,2019,6,13, 8 ,9105,1659,1346,12110
6/13/2019,2019,6,13, 9 ,9945,1923,1615,13483
6/13/2019,2019,6,13, 10 ,10394,2069,1721,14184
6/13/2019,2019,6,13, 11 ,10621,2148,1844,14613
6/13/2019,2019,6,13, 12 ,10340,2100,1825,14265
6/13/2019,2019,6,13, 13 ,10318,2114,1856,14288
6/13/2019,2019,6,13, 14 ,10623,2201,1900,14724
6/13/2019,2019,6,13, 15 ,10462,2125,1861,14448
6/13/2019,2019,6,13, 16 ,10312,2097,1800,14209
6/13/2019,2019,6,13, 17 ,9999,1991,1753,13743
6/13/2019,2019,6,13, 18 ,9594,1965,1761,13320
6/13/2019,2019,6,13, 19 ,9900,2081,1794,13775
6/13/2019,2019,6,13, 20 ,9848,2029,1746,13623
6/13/2019,2019,6,13, 21 ,9804,1944,1662,13410
6/13/2019,2019,6,13, 22 ,9604,1808,1506,12918
6/13/2019,2019,6,13, 23 ,9340,1678,1442,12460
6/13/2019,2019,6,13, 24 ,8887,1579,1322,11788
6/14/2019,2019,6,14, 1 ,8538,1515,1276,11329
6/14/2019,2019,6,14, 2 ,8281,1478,1239,10998
6/14/2019,2019,6,14, 3 ,7890,1432,1192,10514
6/14/2019,2019,6,14, 4 ,7730,1406,1172,10308
6/14/2019,2019,6,14, 5 ,7762,1442,1255,10459
6/14/2019,2019,6,14, 6 ,7618,1435,1291,10344
6/14/2019,2019,6,14, 7 ,7870,1416,1169,10455
6/14/2019,2019,6,14, 8 ,8880,1630,1351,11861
6/14/2019,2019,6,14, 9 ,9833,1890,1585,13308
6/14/2019,2019,6,14, 10 ,10409,2017,1734,14160
6/14/2019,2019,6,14, 11 ,10688,2077,1798,14563
6/14/2019,2019,6,14, 12 ,10410,2037,1753,14200
6/14/2019,2019,6,14, 13 ,10464,2023,1734,14221
6/14/2019,2019,6,14, 14 ,10766,2101,1754,14621
6/14/2019,2019,6,14, 15 ,10629,2122,1701,14452
6/14/2019,2019,6,14, 16 ,10418,2004,1705,14127
6/14/2019,2019,6,14, 17 ,9907,1941,1549,13397
6/14/2019,2019,6,14, 18 ,9509,1901,1658,13068
6/14/2019,2019,6,14, 19 ,9757,2003,1690,13450
6/14/2019,2019,6,14, 20 ,9778,1934,1658,13370
6/14/2019,2019,6,14, 21 ,9746,1873,1593,13212
6/14/2019,2019,6,14, 22 ,9287,1767,1464,12518
6/14/2019,2019,6,14, 23 ,9001,1656,1352,12009
6/14/2019,2019,6,14, 24 ,8646,1563,1279,11488
6/15/2019,2019,6,15, 1 ,8347,1509,1212,11068
6/15/2019,2019,6,15, 2 ,8098,1475,1132,10705
6/15/2019,2019,6,15, 3 ,7814,1437,1103,10354
6/15/2019,2019,6,15, 4 ,7611,1418,1078,10107
6/15/2019,2019,6,15, 5 ,7479,1416,1087,9982
6/15/2019,2019,6,15, 6 ,7284,1381,1159,9824
6/15/2019,2019,6,15, 7 ,7448,1391,1170,10009
6/15/2019,2019,6,15, 8 ,8108,1540,1214,10862
6/15/2019,2019,6,15, 9 ,8841,1764,1314,11919
6/15/2019,2019,6,15, 10 ,9313,1859,1451,12623
6/15/2019,2019,6,15, 11 ,9572,1985,1533,13090
6/15/2019,2019,6,15, 12 ,9439,1938,1431,12808
6/15/2019,2019,6,15, 13 ,9477,1952,1518,12947
6/15/2019,2019,6,15, 14 ,9618,2010,1583,13211
6/15/2019,2019,6,15, 15 ,9647,1981,1578,13206
6/15/2019,2019,6,15, 16 ,9371,1948,1540,12859
6/15/2019,2019,6,15, 17 ,8886,1847,1507,12240
6/15/2019,2019,6,15, 18 ,8700,1858,1626,12184
6/15/2019,2019,6,15, 19 ,9054,1999,1689,12742
6/15/2019,2019,6,15, 20 ,9107,1958,1649,12714
6/15/2019,2019,6,15, 21 ,9104,1914,1593,12611
6/15/2019,2019,6,15, 22 ,8955,1827,1341,12123
6/15/2019,2019,6,15, 23 ,8600,1698,1262,11560
6/15/2019,2019,6,15, 24 ,8279,1626,1147,11052
6/16/2019,2019,6,16, 1 ,8037,1565,1227,10829
6/16/2019,2019,6,16, 2 ,7737,1526,1199,10462
6/16/2019,2019,6,16, 3 ,7428,1469,1166,10063
6/16/2019,2019,6,16, 4 ,7306,1432,1123,9861
6/16/2019,2019,6,16, 5 ,7198,1420,1117,9735
6/16/2019,2019,6,16, 6 ,6933,1373,1125,9431
6/16/2019,2019,6,16, 7 ,7000,1396,1134,9530
6/16/2019,2019,6,16, 8 ,7462,1472,1168,10102
6/16/2019,2019,6,16, 9 ,7950,1575,1269,10794
6/16/2019,2019,6,16, 10 ,8500,1682,1365,11547
6/16/2019,2019,6,16, 11 ,8710,1745,1451,11906
6/16/2019,2019,6,16, 12 ,8650,1723,1462,11835
6/16/2019,2019,6,16, 13 ,8695,1734,1448,11877
6/16/2019,2019,6,16, 14 ,8834,1762,1462,12058
6/16/2019,2019,6,16, 15 ,8718,1742,1462,11922
6/16/2019,2019,6,16, 16 ,8508,1701,1432,11641
6/16/2019,2019,6,16, 17 ,8357,1679,1452,11488
6/16/2019,2019,6,16, 18 ,8359,1753,1514,11626
6/16/2019,2019,6,16, 19 ,8994,1896,1611,12501
6/16/2019,2019,6,16, 20 ,9086,1883,1584,12553
6/16/2019,2019,6,16, 21 ,9220,1850,1565,12635
6/16/2019,2019,6,16, 22 ,9149,1748,1459,12356
6/16/2019,2019,6,16, 23 ,8853,1637,1354,11844
6/16/2019,2019,6,16, 24 ,8442,1551,1253,11246
6/17/2019,2019,6,17, 1 ,8135,1508,1214,10857
6/17/2019,2019,6,17, 2 ,7750,1446,1206,10402
6/17/2019,2019,6,17, 3 ,7484,1406,1160,10050
6/17/2019,2019,6,17, 4 ,7298,1389,1155,9842
6/17/2019,2019,6,17, 5 ,7363,1436,1236,10035
6/17/2019,2019,6,17, 6 ,7245,1434,1257,9936
6/17/2019,2019,6,17, 7 ,7618,1411,1160,10189
6/17/2019,2019,6,17, 8 ,8714,1626,1320,11660
6/17/2019,2019,6,17, 9 ,9740,1883,1567,13190
6/17/2019,2019,6,17, 10 ,10312,2007,1701,14020
6/17/2019,2019,6,17, 11 ,10639,2098,1793,14530
6/17/2019,2019,6,17, 12 ,10550,2064,1791,14405
6/17/2019,2019,6,17, 13 ,10620,2088,1808,14516
6/17/2019,2019,6,17, 14 ,11076,2133,1875,15084
6/17/2019,2019,6,17, 15 ,10981,2104,1886,14971
6/17/2019,2019,6,17, 16 ,10835,2075,1806,14716
6/17/2019,2019,6,17, 17 ,10222,1968,1743,13933
6/17/2019,2019,6,17, 18 ,9820,1957,1711,13488
6/17/2019,2019,6,17, 19 ,10144,2074,1779,13997
6/17/2019,2019,6,17, 20 ,10107,1986,1751,13844
6/17/2019,2019,6,17, 21 ,10097,1953,1670,13720
6/17/2019,2019,6,17, 22 ,9823,1822,1539,13184
6/17/2019,2019,6,17, 23 ,9437,1713,1414,12564
6/17/2019,2019,6,17, 24 ,8975,1614,1335,11924
6/18/2019,2019,6,18, 1 ,8690,1555,1253,11498
6/18/2019,2019,6,18, 2 ,8429,1510,1217,11156
6/18/2019,2019,6,18, 3 ,8133,1469,1176,10778
6/18/2019,2019,6,18, 4 ,7972,1448,1152,10572
6/18/2019,2019,6,18, 5 ,8009,1477,1233,10719
6/18/2019,2019,6,18, 6 ,7739,1467,1255,10461
6/18/2019,2019,6,18, 7 ,8000,1453,1165,10618
6/18/2019,2019,6,18, 8 ,9066,1650,1359,12075
6/18/2019,2019,6,18, 9 ,9960,1896,1531,13387
6/18/2019,2019,6,18, 10 ,10530,2025,1660,14215
6/18/2019,2019,6,18, 11 ,10782,2093,1739,14614
6/18/2019,2019,6,18, 12 ,10674,2063,1735,14472
6/18/2019,2019,6,18, 13 ,10803,2067,1752,14622
6/18/2019,2019,6,18, 14 ,11057,2180,1838,15075
6/18/2019,2019,6,18, 15 ,10966,2165,1813,14944
6/18/2019,2019,6,18, 16 ,10846,2126,1802,14774
6/18/2019,2019,6,18, 17 ,10314,2001,1705,14020
6/18/2019,2019,6,18, 18 ,9898,1979,1729,13606
6/18/2019,2019,6,18, 19 ,10153,2103,1803,14059
6/18/2019,2019,6,18, 20 ,10247,2059,1771,14077
6/18/2019,2019,6,18, 21 ,10284,2007,1710,14001
6/18/2019,2019,6,18, 22 ,9995,1870,1573,13438
6/18/2019,2019,6,18, 23 ,9588,1750,1479,12817
6/18/2019,2019,6,18, 24 ,9138,1659,1363,12160
6/19/2019,2019,6,19, 1 ,8836,1593,1301,11730
6/19/2019,2019,6,19, 2 ,8549,1557,1270,11376
6/19/2019,2019,6,19, 3 ,8248,1507,1230,10985
6/19/2019,2019,6,19, 4 ,8072,1478,1215,10765
6/19/2019,2019,6,19, 5 ,8022,1511,1286,10819
6/19/2019,2019,6,19, 6 ,7769,1488,1297,10554
6/19/2019,2019,6,19, 7 ,8038,1468,1194,10700
6/19/2019,2019,6,19, 8 ,9077,1674,1349,12100
6/19/2019,2019,6,19, 9 ,9909,1921,1581,13411
6/19/2019,2019,6,19, 10 ,10279,2055,1738,14072
6/19/2019,2019,6,19, 11 ,10442,2099,1812,14353
6/19/2019,2019,6,19, 12 ,10261,2083,1796,14140
6/19/2019,2019,6,19, 13 ,10340,2093,1797,14230
6/19/2019,2019,6,19, 14 ,10768,2173,1867,14808
6/19/2019,2019,6,19, 15 ,10651,2143,1853,14647
6/19/2019,2019,6,19, 16 ,10574,2116,1807,14497
6/19/2019,2019,6,19, 17 ,10203,2014,1725,13942
6/19/2019,2019,6,19, 18 ,9805,1983,1736,13524
6/19/2019,2019,6,19, 19 ,10116,2113,1803,14032
6/19/2019,2019,6,19, 20 ,10274,2070,1776,14120
6/19/2019,2019,6,19, 21 ,10301,2016,1745,14062
6/19/2019,2019,6,19, 22 ,10084,1886,1616,13586
6/19/2019,2019,6,19, 23 ,9671,1752,1518,12941
6/19/2019,2019,6,19, 24 ,9250,1632,1343,12225
6/20/2019,2019,6,20, 1 ,8899,1574,1321,11794
6/20/2019,2019,6,20, 2 ,8601,1536,1280,11417
6/20/2019,2019,6,20, 3 ,8334,1476,1240,11050
6/20/2019,2019,6,20, 4 ,8138,1466,1239,10843
6/20/2019,2019,6,20, 5 ,8143,1494,1299,10936
6/20/2019,2019,6,20, 6 ,7924,1480,1304,10708
6/20/2019,2019,6,20, 7 ,8154,1477,1216,10847
6/20/2019,2019,6,20, 8 ,9218,1698,1410,12326
6/20/2019,2019,6,20, 9 ,10157,1940,1621,13718
6/20/2019,2019,6,20, 10 ,10635,2051,1728,14414
6/20/2019,2019,6,20, 11 ,10931,2152,1817,14900
6/20/2019,2019,6,20, 12 ,10784,2106,1836,14726
6/20/2019,2019,6,20, 13 ,10897,2103,1851,14851
6/20/2019,2019,6,20, 14 ,11238,2220,1911,15369
6/20/2019,2019,6,20, 15 ,11096,2197,1891,15184
6/20/2019,2019,6,20, 16 ,10907,2183,1833,14923
6/20/2019,2019,6,20, 17 ,10483,2045,1741,14269
6/20/2019,2019,6,20, 18 ,9874,1994,1726,13594
6/20/2019,2019,6,20, 19 ,10052,2128,1813,13993
6/20/2019,2019,6,20, 20 ,10052,2081,1776,13909
6/20/2019,2019,6,20, 21 ,10101,2038,1764,13903
6/20/2019,2019,6,20, 22 ,9866,1898,1621,13385
6/20/2019,2019,6,20, 23 ,9511,1772,1485,12768
6/20/2019,2019,6,20, 24 ,9156,1680,1440,12276
6/21/2019,2019,6,21, 1 ,8802,1611,1365,11778
6/21/2019,2019,6,21, 2 ,8548,1557,1317,11422
6/21/2019,2019,6,21, 3 ,8267,1528,1288,11083
6/21/2019,2019,6,21, 4 ,8042,1499,1284,10825
6/21/2019,2019,6,21, 5 ,8117,1528,1328,10973
6/21/2019,2019,6,21, 6 ,7888,1505,1351,10744
6/21/2019,2019,6,21, 7 ,8137,1489,1241,10867
6/21/2019,2019,6,21, 8 ,9213,1691,1395,12299
6/21/2019,2019,6,21, 9 ,10176,1921,1611,13708
6/21/2019,2019,6,21, 10 ,10656,2046,1677,14379
6/21/2019,2019,6,21, 11 ,10813,2116,1844,14773
6/21/2019,2019,6,21, 12 ,10732,2104,1769,14605
6/21/2019,2019,6,21, 13 ,10844,2093,1803,14740
6/21/2019,2019,6,21, 14 ,11301,2179,1859,15339
6/21/2019,2019,6,21, 15 ,11146,2164,1801,15111
6/21/2019,2019,6,21, 16 ,10950,2128,1802,14880
6/21/2019,2019,6,21, 17 ,10369,1993,1712,14074
6/21/2019,2019,6,21, 18 ,9956,1930,1730,13616
6/21/2019,2019,6,21, 19 ,10187,2080,1753,14020
6/21/2019,2019,6,21, 20 ,10235,2036,1713,13984
6/21/2019,2019,6,21, 21 ,10304,1979,1662,13945
6/21/2019,2019,6,21, 22 ,10064,1863,1540,13467
6/21/2019,2019,6,21, 23 ,9668,1749,1433,12850
6/21/2019,2019,6,21, 24 ,9271,1649,1353,12273
6/22/2019,2019,6,22, 1 ,8933,1571,1277,11781
6/22/2019,2019,6,22, 2 ,8695,1541,1251,11487
6/22/2019,2019,6,22, 3 ,8366,1510,1220,11096
6/22/2019,2019,6,22, 4 ,8148,1465,1201,10814
6/22/2019,2019,6,22, 5 ,8058,1464,1224,10746
6/22/2019,2019,6,22, 6 ,7744,1427,1217,10388
6/22/2019,2019,6,22, 7 ,7947,1472,1228,10647
6/22/2019,2019,6,22, 8 ,8602,1606,1275,11483
6/22/2019,2019,6,22, 9 ,9348,1780,1481,12609
6/22/2019,2019,6,22, 10 ,9857,1907,1572,13336
6/22/2019,2019,6,22, 11 ,10254,1970,1693,13917
6/22/2019,2019,6,22, 12 ,10122,1903,1670,13695
6/22/2019,2019,6,22, 13 ,10155,1942,1677,13774
6/22/2019,2019,6,22, 14 ,10546,1995,1760,14301
6/22/2019,2019,6,22, 15 ,10391,1991,1718,14100
6/22/2019,2019,6,22, 16 ,10025,1932,1673,13630
6/22/2019,2019,6,22, 17 ,9471,1861,1650,12982
6/22/2019,2019,6,22, 18 ,9229,1848,1681,12758
6/22/2019,2019,6,22, 19 ,9537,2002,1751,13290
6/22/2019,2019,6,22, 20 ,9595,1966,1715,13276
6/22/2019,2019,6,22, 21 ,9651,1929,1673,13253
6/22/2019,2019,6,22, 22 ,9548,1832,1553,12933
6/22/2019,2019,6,22, 23 ,9178,1716,1429,12323
6/22/2019,2019,6,22, 24 ,8833,1619,1344,11796
6/23/2019,2019,6,23, 1 ,8522,1564,1355,11441
6/23/2019,2019,6,23, 2 ,8284,1514,1304,11102
6/23/2019,2019,6,23, 3 ,7974,1475,1257,10706
6/23/2019,2019,6,23, 4 ,7768,1436,1229,10433
6/23/2019,2019,6,23, 5 ,7564,1419,1209,10192
6/23/2019,2019,6,23, 6 ,7125,1380,1201,9706
6/23/2019,2019,6,23, 7 ,7147,1374,1164,9685
6/23/2019,2019,6,23, 8 ,7691,1411,1197,10299
6/23/2019,2019,6,23, 9 ,8239,1508,1268,11015
6/23/2019,2019,6,23, 10 ,8684,1627,1344,11655
6/23/2019,2019,6,23, 11 ,8923,1684,1468,12075
6/23/2019,2019,6,23, 12 ,8994,1687,1472,12153
6/23/2019,2019,6,23, 13 ,9034,1689,1547,12270
6/23/2019,2019,6,23, 14 ,9156,1706,1553,12415
6/23/2019,2019,6,23, 15 ,9146,1614,1430,12190
6/23/2019,2019,6,23, 16 ,8946,1593,1357,11896
6/23/2019,2019,6,23, 17 ,8685,1606,1449,11740
6/23/2019,2019,6,23, 18 ,8638,1715,1568,11921
6/23/2019,2019,6,23, 19 ,9256,1818,1638,12712
6/23/2019,2019,6,23, 20 ,9468,1808,1612,12888
6/23/2019,2019,6,23, 21 ,9665,1762,1548,12975
6/23/2019,2019,6,23, 22 ,9480,1659,1475,12614
6/23/2019,2019,6,23, 23 ,8964,1555,1326,11845
6/23/2019,2019,6,23, 24 ,8404,1484,1251,11139
6/24/2019,2019,6,24, 1 ,8012,1425,1198,10635
6/24/2019,2019,6,24, 2 ,7748,1382,1159,10289
6/24/2019,2019,6,24, 3 ,7493,1352,1128,9973
6/24/2019,2019,6,24, 4 ,7355,1345,1133,9833
6/24/2019,2019,6,24, 5 ,7424,1392,1213,10029
6/24/2019,2019,6,24, 6 ,7333,1397,1256,9986
6/24/2019,2019,6,24, 7 ,7552,1382,1169,10103
6/24/2019,2019,6,24, 8 ,8578,1591,1358,11527
6/24/2019,2019,6,24, 9 ,9549,1833,1562,12944
6/24/2019,2019,6,24, 10 ,10128,1926,1722,13776
6/24/2019,2019,6,24, 11 ,10412,2002,1787,14201
6/24/2019,2019,6,24, 12 ,10299,1952,1756,14007
6/24/2019,2019,6,24, 13 ,10253,1915,1752,13920
6/24/2019,2019,6,24, 14 ,10662,1901,1832,14395
6/24/2019,2019,6,24, 15 ,10597,1923,1732,14252
6/24/2019,2019,6,24, 16 ,10511,1914,1689,14114
6/24/2019,2019,6,24, 17 ,10164,1844,1689,13697
6/24/2019,2019,6,24, 18 ,9682,1881,1730,13293
6/24/2019,2019,6,24, 19 ,9995,1972,1685,13652
6/24/2019,2019,6,24, 20 ,10073,1916,1667,13656
6/24/2019,2019,6,24, 21 ,10064,1839,1600,13503
6/24/2019,2019,6,24, 22 ,9715,1687,1444,12846
6/24/2019,2019,6,24, 23 ,9084,1583,1351,12018
6/24/2019,2019,6,24, 24 ,8474,1508,1276,11258
6/25/2019,2019,6,25, 1 ,8215,1475,1209,10899
6/25/2019,2019,6,25, 2 ,7719,1451,1179,10349
6/25/2019,2019,6,25, 3 ,7653,1394,1152,10199
6/25/2019,2019,6,25, 4 ,7512,1372,1139,10023
6/25/2019,2019,6,25, 5 ,7583,1420,1198,10201
6/25/2019,2019,6,25, 6 ,7475,1423,1237,10135
6/25/2019,2019,6,25, 7 ,7622,1380,1134,10136
6/25/2019,2019,6,25, 8 ,8618,1589,1303,11510
6/25/2019,2019,6,25, 9 ,9626,1850,1535,13011
6/25/2019,2019,6,25, 10 ,10178,1961,1698,13837
6/25/2019,2019,6,25, 11 ,10513,2040,1809,14362
6/25/2019,2019,6,25, 12 ,10355,2002,1789,14146
6/25/2019,2019,6,25, 13 ,10414,1990,1805,14209
6/25/2019,2019,6,25, 14 ,10822,2081,1883,14786
6/25/2019,2019,6,25, 15 ,10677,2051,1836,14564
6/25/2019,2019,6,25, 16 ,10551,2037,1815,14403
6/25/2019,2019,6,25, 17 ,10040,1903,1753,13696
6/25/2019,2019,6,25, 18 ,9744,1941,1752,13437
6/25/2019,2019,6,25, 19 ,9796,2063,1844,13703
6/25/2019,2019,6,25, 20 ,9788,2000,1792,13580
6/25/2019,2019,6,25, 21 ,9710,1938,1721,13369
6/25/2019,2019,6,25, 22 ,9378,1797,1574,12749
6/25/2019,2019,6,25, 23 ,8970,1682,1468,12120
6/25/2019,2019,6,25, 24 ,8567,1583,1368,11518
6/26/2019,2019,6,26, 1 ,8188,1508,1323,11019
6/26/2019,2019,6,26, 2 ,7994,1463,1268,10725
6/26/2019,2019,6,26, 3 ,7691,1430,1242,10363
6/26/2019,2019,6,26, 4 ,7585,1413,1229,10227
6/26/2019,2019,6,26, 5 ,7653,1458,1312,10423
6/26/2019,2019,6,26, 6 ,7575,1455,1316,10346
6/26/2019,2019,6,26, 7 ,7773,1400,1207,10380
6/26/2019,2019,6,26, 8 ,8813,1616,1411,11840
6/26/2019,2019,6,26, 9 ,9742,1867,1654,13263
6/26/2019,2019,6,26, 10 ,10261,1978,1761,14000
6/26/2019,2019,6,26, 11 ,10583,2052,1837,14472
6/26/2019,2019,6,26, 12 ,10336,2020,1813,14169
6/26/2019,2019,6,26, 13 ,10350,2003,1823,14176
6/26/2019,2019,6,26, 14 ,10700,2039,1898,14637
6/26/2019,2019,6,26, 15 ,10418,1998,1875,14291
6/26/2019,2019,6,26, 16 ,10172,1989,1793,13954
6/26/2019,2019,6,26, 17 ,9762,1904,1754,13420
6/26/2019,2019,6,26, 18 ,9426,1920,1787,13133
6/26/2019,2019,6,26, 19 ,9659,2021,1835,13515
6/26/2019,2019,6,26, 20 ,9659,1978,1778,13415
6/26/2019,2019,6,26, 21 ,9515,1889,1686,13090
6/26/2019,2019,6,26, 22 ,9183,1762,1530,12475
6/26/2019,2019,6,26, 23 ,8807,1638,1438,11883
6/26/2019,2019,6,26, 24 ,8403,1549,1340,11292
6/27/2019,2019,6,27, 1 ,8049,1486,1314,10849
6/27/2019,2019,6,27, 2 ,7838,1442,1255,10535
6/27/2019,2019,6,27, 3 ,7576,1408,1206,10190
6/27/2019,2019,6,27, 4 ,7455,1393,1208,10056
6/27/2019,2019,6,27, 5 ,7500,1435,1256,10191
6/27/2019,2019,6,27, 6 ,7466,1448,1303,10217
6/27/2019,2019,6,27, 7 ,7634,1396,1208,10238
6/27/2019,2019,6,27, 8 ,8581,1583,1353,11517
6/27/2019,2019,6,27, 9 ,9491,1821,1578,12890
6/27/2019,2019,6,27, 10 ,10058,1943,1690,13691
6/27/2019,2019,6,27, 11 ,10268,2003,1766,14037
6/27/2019,2019,6,27, 12 ,9893,1959,1743,13595
6/27/2019,2019,6,27, 13 ,9612,1957,1744,13313
6/27/2019,2019,6,27, 14 ,9760,2048,1817,13625
6/27/2019,2019,6,27, 15 ,9684,2030,1798,13512
6/27/2019,2019,6,27, 16 ,9570,1996,1786,13352
6/27/2019,2019,6,27, 17 ,9257,1892,1713,12862
6/27/2019,2019,6,27, 18 ,9040,1894,1718,12652
6/27/2019,2019,6,27, 19 ,9289,1996,1802,13087
6/27/2019,2019,6,27, 20 ,9261,1944,1754,12959
6/27/2019,2019,6,27, 21 ,9166,1890,1707,12763
6/27/2019,2019,6,27, 22 ,8815,1745,1524,12084
6/27/2019,2019,6,27, 23 ,8407,1633,1420,11460
6/27/2019,2019,6,27, 24 ,8018,1550,1332,10900
6/28/2019,2019,6,28, 1 ,7679,1488,1278,10445
6/28/2019,2019,6,28, 2 ,7427,1450,1244,10121
6/28/2019,2019,6,28, 3 ,7193,1408,1213,9814
6/28/2019,2019,6,28, 4 ,7113,1370,1203,9686
6/28/2019,2019,6,28, 5 ,7211,1405,1249,9865
6/28/2019,2019,6,28, 6 ,7222,1424,1271,9917
6/28/2019,2019,6,28, 7 ,7412,1383,1181,9976
6/28/2019,2019,6,28, 8 ,8352,1560,1363,11275
6/28/2019,2019,6,28, 9 ,9254,1782,1561,12597
6/28/2019,2019,6,28, 10 ,9794,1915,1737,13446
6/28/2019,2019,6,28, 11 ,9930,1958,1854,13742
6/28/2019,2019,6,28, 12 ,9776,1897,1786,13459
6/28/2019,2019,6,28, 13 ,9656,1888,1756,13300
6/28/2019,2019,6,28, 14 ,9723,1948,1802,13473
6/28/2019,2019,6,28, 15 ,9601,1932,1779,13312
6/28/2019,2019,6,28, 16 ,9509,1914,1763,13186
6/28/2019,2019,6,28, 17 ,9157,1830,1637,12624
6/28/2019,2019,6,28, 18 ,8958,1845,1660,12463
6/28/2019,2019,6,28, 19 ,9185,1959,1722,12866
6/28/2019,2019,6,28, 20 ,9065,1906,1686,12657
6/28/2019,2019,6,28, 21 ,8792,1854,1636,12282
6/28/2019,2019,6,28, 22 ,8412,1730,1495,11637
6/28/2019,2019,6,28, 23 ,8012,1624,1392,11028
6/28/2019,2019,6,28, 24 ,7640,1548,1319,10507
6/29/2019,2019,6,29, 1 ,7364,1492,1260,10116
6/29/2019,2019,6,29, 2 ,7144,1447,1233,9824
6/29/2019,2019,6,29, 3 ,7011,1418,1195,9624
6/29/2019,2019,6,29, 4 ,6926,1392,1180,9498
6/29/2019,2019,6,29, 5 ,6881,1396,1188,9465
6/29/2019,2019,6,29, 6 ,6754,1381,1221,9356
6/29/2019,2019,6,29, 7 ,6973,1388,1241,9602
6/29/2019,2019,6,29, 8 ,7720,1517,1340,10577
6/29/2019,2019,6,29, 9 ,8335,1710,1499,11544
6/29/2019,2019,6,29, 10 ,8768,1821,1616,12205
6/29/2019,2019,6,29, 11 ,9055,1876,1665,12596
6/29/2019,2019,6,29, 12 ,8684,1804,1631,12119
6/29/2019,2019,6,29, 13 ,8463,1818,1613,11894
6/29/2019,2019,6,29, 14 ,8573,1879,1654,12106
6/29/2019,2019,6,29, 15 ,8450,1829,1711,11990
6/29/2019,2019,6,29, 16 ,8293,1792,1650,11735
6/29/2019,2019,6,29, 17 ,8142,1746,1582,11470
6/29/2019,2019,6,29, 18 ,8096,1776,1626,11498
6/29/2019,2019,6,29, 19 ,8453,1924,1677,12054
6/29/2019,2019,6,29, 20 ,8421,1871,1630,11922
6/29/2019,2019,6,29, 21 ,8366,1829,1580,11775
6/29/2019,2019,6,29, 22 ,8109,1746,1501,11356
6/29/2019,2019,6,29, 23 ,7735,1626,1386,10747
6/29/2019,2019,6,29, 24 ,7394,1532,1290,10216
6/30/2019,2019,6,30, 1 ,7087,1439,1248,9774
6/30/2019,2019,6,30, 2 ,6843,1405,1216,9464
6/30/2019,2019,6,30, 3 ,6714,1382,1166,9262
6/30/2019,2019,6,30, 4 ,6508,1367,1150,9025
6/30/2019,2019,6,30, 5 ,6461,1321,1158,8940
6/30/2019,2019,6,30, 6 ,6291,1302,1182,8775
6/30/2019,2019,6,30, 7 ,6386,1308,1157,8851
6/30/2019,2019,6,30, 8 ,6753,1384,1194,9331
6/30/2019,2019,6,30, 9 ,7267,1492,1294,10053
6/30/2019,2019,6,30, 10 ,7802,1591,1382,10775
6/30/2019,2019,6,30, 11 ,8068,1635,1436,11139
6/30/2019,2019,6,30, 12 ,8017,1605,1492,11114
6/30/2019,2019,6,30, 13 ,7992,1604,1486,11082
6/30/2019,2019,6,30, 14 ,7996,1616,1486,11098
6/30/2019,2019,6,30, 15 ,7914,1607,1460,10981
6/30/2019,2019,6,30, 16 ,7783,1593,1443,10819
6/30/2019,2019,6,30, 17 ,7692,1612,1449,10753
6/30/2019,2019,6,30, 18 ,7766,1686,1581,11033
6/30/2019,2019,6,30, 19 ,8370,1823,1641,11834
6/30/2019,2019,6,30, 20 ,8458,1794,1626,11878
6/30/2019,2019,6,30, 21 ,8430,1731,1565,11726
6/30/2019,2019,6,30, 22 ,8205,1635,1475,11315
6/30/2019,2019,6,30, 23 ,7787,1520,1361,10668
6/30/2019,2019,6,30, 24 ,7384,1446,1271,10101
